time,subj_course_id,sec_code,sec_id,prof,available,waitlist,total,enrolled_ct
1708246272128,AAS 10,A01,392963,Butler; Elizabeth Annette,34,0,34,0
1708246272128,AAS 10,A02,392965,Butler; Elizabeth Annette,33,0,34,1
1708246272654,AAS 170,A00,392977,Butler; Elizabeth Annette,31,0,32,1
1708246273180,AAS 198,001,479182,Childs; Dennis R.,20,0,20,0
1708246273709,AESE 261,A00,387945,Staff,33,0,33,0
1708246274236,AESE 278D,A00,387953,Staff,33,0,33,0
1708246274761,AESE 278E,A00,387954,Staff,33,0,33,0
1708246275287,AESE 279A,A00,387956,Staff,33,0,33,0
1708246275815,AIP 197P,001,494494,Goldfarb; Brian,9999,0,9999,0
1708246276339,ANAR 100,A00,387884,Shtienberg; Gilad,15,0,16,1
1708246276865,ANAR 104,A01,387886,Tamberino; Anthony Thomas,21,0,25,4
1708246277395,ANAR 111,A00,387888,Staff,36,0,36,0
1708246277921,ANAR 115,A00,387889,Shtienberg; Gilad,36,0,36,0
1708246278450,ANAR 120,A00,387890,Staff,36,0,36,0
1708246278979,ANAR 155,A00,387891,Braswell; Geoffrey E.,15,0,25,10
1708246279513,ANAR 164,A00,387892,Staff,32,0,35,3
1708246280042,ANBI 100,A00,489626,Fox; Patrick Keolu Ozer,39,0,40,1
1708246280568,ANBI 111,A00,387893,Hrvoj Mihic; Branka,37,0,40,3
1708246281625,ANBI 144,A00,387896,Wilder; Linnea Lorene,72,0,75,3
1708246282152,ANBI 149,A00,489628,Non; Amy L,0,0,0,0
1708246282679,ANBI 173,A00,387897,Wilder; Linnea Lorene,74,0,75,1
1708246283204,ANBI 174,A00,489627,Strum; Shirley C.,13,0,15,2
1708246283734,ANES 296,001,463968,Gabriel; Rodney A,49,0,50,1
1708246283734,ANES 296,002,463969,Staff,50,0,50,0
1708246283734,ANES 296,003,463970,Staff,50,0,50,0
1708246284262,ANSC 100,A00,387898,Bialecki; Jon Anthony,40,0,40,0
1708246284792,ANSC 101,A00,387900,Sloane; Julia Kathryn,34,0,40,6
1708246285320,ANSC 117,A00,387901,Martin Sandino; Amanda Maria Yoland,13,0,15,2
1708246285846,ANSC 134,A00,387902,Staff,38,0,40,2
1708246286376,ANSC 137,A00,387903,Stewart; Alexander B,80,0,80,0
1708246286905,ANSC 138,A00,387904,Parish; Steven Martin,14,0,15,1
1708246287431,ANSC 142,A00,387905,Stone; Annika Britt,34,0,40,6
1708246287961,ANSC 147,A00,387906,Stewart; Alexander B,40,0,40,0
1708246288487,ANSC 148,A00,387907,Olivas Hernandez; Olga Lid,92,0,92,0
1708246289012,ANSC 186,A00,387910,Hankins; Joseph D.,28,0,30,2
1708246289542,ANTH 2,A01,387863,Marchetto; Maria Carolina,37,0,40,3
1708246289542,ANTH 2,A02,387864,Marchetto; Maria Carolina,40,0,40,0
1708246289542,ANTH 2,A03,387865,Marchetto; Maria Carolina,36,0,40,4
1708246289542,ANTH 2,A04,387866,Marchetto; Maria Carolina,39,0,40,1
1708246290068,ANTH 3,A01,387868,Stroth; Luke Reyneri,28,0,30,2
1708246290068,ANTH 3,A02,387869,Stroth; Luke Reyneri,29,0,30,1
1708246290068,ANTH 3,A03,387870,Stroth; Luke Reyneri,30,0,30,0
1708246290068,ANTH 3,A04,387871,Stroth; Luke Reyneri,29,0,30,1
1708246290597,ANTH 10,A00,387872,Stewart; Alexander B,80,0,80,0
1708246291121,ANTH 21,A01,387874,Stone; Annika Britt,40,0,40,0
1708246291121,ANTH 21,A02,387875,Stone; Annika Britt,40,0,40,0
1708246291121,ANTH 21,A03,387876,Stone; Annika Britt,40,0,40,0
1708246291121,ANTH 21,A04,387877,Stone; Annika Britt,39,0,40,1
1708246291646,ANTH 23,A01,387879,Staff,40,0,40,0
1708246291646,ANTH 23,A02,387880,Staff,40,0,40,0
1708246291646,ANTH 23,A03,387881,Staff,40,0,40,0
1708246291646,ANTH 23,A04,387882,Staff,40,0,40,0
1708246292175,ANTH 24,A00,387883,Pedersen; David,40,0,40,0
1708246292703,ANTH 103,A00,387911,Staff,343,0,350,7
1708246293228,ANTH 105,A00,387912,Staff,73,0,75,2
1708246293756,ANTH 112,A00,387913,Staff,23,0,25,2
1708246294281,ANTH 120,A00,479486,Parish; Steven Martin,28,0,30,2
1708246294806,ANTH 128B,A01,387923,Lewis; Leslie R,12,0,12,0
1708246295330,ANTH 192,A00,387925,Varma; Saiba,20,0,20,0
1708246295856,ANTH 196C,A00,387927,Varma; Saiba,15,0,15,0
1708246296382,ANTH 212,A00,387931,Marchetto; Maria Carolina,25,0,25,0
1708246296382,ANTH 212,B00,479487,Semendeferi; Ekaterini,25,0,25,0
1708246296909,ANTH 220,A00,387932,Csordas; Thomas J.,9,0,12,3
1708246297436,ANTH 230,001,493297,Goldstein; Paul S,18,0,20,2
1708246297961,ANTH 260,A00,479223,Jenkins; Janis A.,25,0,25,0
1708246298486,ANTH 272,A00,387936,Serlin; David,5,0,5,0
1708246299010,ANTH 273,A00,387938,Gates; Kelly,5,0,5,0
1708246299541,ANTH 288,A00,387940,Braswell; Geoffrey E.,25,0,25,0
1708246300073,ANTH 295,001,493298,Algaze; Guillermo,3,0,3,0
1708246300073,ANTH 295,002,493299,Brenner; Suzanne A,3,0,3,0
1708246300073,ANTH 295,003,493300,Csordas; Thomas J.,3,0,3,0
1708246300073,ANTH 295,004,493422,Fox; Patrick Keolu Ozer,3,0,3,0
1708246300073,ANTH 295,005,493472,Gagneux; Pascal,3,0,3,0
1708246300073,ANTH 295,006,493515,Goldstein; Paul S,3,0,3,0
1708246300073,ANTH 295,007,493592,Hankins; Joseph D.,3,0,3,0
1708246300073,ANTH 295,008,493631,Jassal; Aftab,3,0,3,0
1708246300073,ANTH 295,009,493639,Jenkins; Janis A.,3,0,3,0
1708246300073,ANTH 295,010,493657,Kaiser; Bronwyn Nicole,3,0,3,0
1708246300073,ANTH 295,011,493692,Kang; Byung Chu,3,0,3,0
1708246300073,ANTH 295,012,493758,Marchetto; Maria Carolina,3,0,3,0
1708246300073,ANTH 295,013,493761,Non; Amy L,3,0,3,0
1708246300073,ANTH 295,014,493762,Pedersen; David,3,0,3,0
1708246300073,ANTH 295,015,493825,Rivera-Collazo; Isabel C,3,0,3,0
1708246300073,ANTH 295,016,493826,Varma; Saiba,3,0,3,0
1708246300073,ANTH 295,017,493828,Yeh; Rihan Wen Xin,3,0,3,0
1708246300605,ANTH 296,001,493830,Braswell; Geoffrey E.,3,0,3,0
1708246300605,ANTH 296,002,493836,Marchetto; Maria Carolina,3,0,3,0
1708246300605,ANTH 296,003,493838,Rivera-Collazo; Isabel C,3,0,3,0
1708246300605,ANTH 296,004,493840,Varma; Saiba,3,0,3,0
1708246300605,ANTH 296,005,493842,Algaze; Guillermo,3,0,3,0
1708246300605,ANTH 296,006,493845,Brenner; Suzanne A,3,0,3,0
1708246300605,ANTH 296,007,493846,Csordas; Thomas J.,3,0,3,0
1708246300605,ANTH 296,008,493907,Fox; Patrick Keolu Ozer,3,0,3,0
1708246300605,ANTH 296,009,493949,Gagneux; Pascal,3,0,3,0
1708246300605,ANTH 296,010,493960,Goldstein; Paul S,3,0,3,0
1708246300605,ANTH 296,011,493961,Hankins; Joseph D.,3,0,3,0
1708246300605,ANTH 296,012,493962,Jassal; Aftab,3,0,3,0
1708246300605,ANTH 296,013,493963,Jenkins; Janis A.,3,0,3,0
1708246300605,ANTH 296,014,493964,Kaiser; Bronwyn Nicole,3,0,3,0
1708246300605,ANTH 296,015,493965,Kang; Byung Chu,3,0,3,0
1708246300605,ANTH 296,016,493966,Levy; Thomas E,3,0,3,0
1708246300605,ANTH 296,017,493967,Non; Amy L,3,0,3,0
1708246300605,ANTH 296,018,493968,Pedersen; David,3,0,3,0
1708246300605,ANTH 296,019,493969,Postero; Nancy Grey,3,0,3,0
1708246300605,ANTH 296,020,493970,Semendeferi; Ekaterini,3,0,3,0
1708246300605,ANTH 296,021,493971,Yeh; Rihan Wen Xin,3,0,3,0
1708246301132,AUD 236,A00,480192,Harris; Jeffrey Paul,12,0,12,0
1708246301660,AUD 260,A00,480227,Spriggs; Meghan K,12,0,12,0
1708246302187,AUD 272,A00,480367,Zettner; Erika,12,0,12,0
1708246302715,AUD 275,A00,480369,Zettner; Erika,12,0,12,0
1708246303243,AUD 284,A00,480370,Zettner; Erika,12,0,12,0
1708246303243,AUD 284,B00,480372,Spriggs; Meghan K,12,0,12,0
1708246303769,AUD 291,A00,480374,Zettner; Erika,12,0,12,0
1708246304294,AUD 296,A00,480375,Zettner; Erika,12,0,12,0
1708246304294,AUD 296,B00,480376,Harris; Jeffrey Paul,12,0,12,0
1708246304294,AUD 296,C00,480377,Ryan; Allen F.,12,0,12,0
1708246304824,AWP 3,002,387672,Given; William Allan,9,0,9,0
1708246304824,AWP 3,003,387678,Staff,5,0,5,0
1708246304824,AWP 3,004,387681,Staff,0,0,0,0
1708246304824,AWP 3,007,387784,West; Geoffrey Scott,4,0,5,1
1708246304824,AWP 3,009,387786,Kolodezh; Samuel,5,0,5,0
1708246304824,AWP 3,010,387787,Gilbert; Peter W,5,0,5,0
1708246305349,AWP 4A,001,387791,Staff,12,0,12,0
1708246305349,AWP 4A,002,387792,Staff,0,0,0,0
1708246305879,AWP 4B,001,387793,Bolin; Jillian,0,0,0,0
1708246305879,AWP 4B,002,387794,Bolin; Jillian,0,0,0,0
1708246305879,AWP 4B,003,387795,Bauer; Holly Jean,0,0,0,0
1708246305879,AWP 4B,004,387796,Vaughn; Kelsey Sara,0,0,0,0
1708246305879,AWP 4B,005,387797,Vaughn; Kelsey Sara,0,0,0,0
1708246305879,AWP 4B,007,387799,Ajo; Frances Margaret,0,0,0,0
1708246305879,AWP 4B,008,387800,Ajo; Frances Margaret,0,0,0,0
1708246305879,AWP 4B,009,387801,Hall; Graham T,0,0,0,0
1708246305879,AWP 4B,010,387802,Hall; Graham T,0,0,0,0
1708246305879,AWP 4B,011,387803,Heiser; Jerrod A,0,0,0,0
1708246305879,AWP 4B,012,387804,Heiser; Jerrod A,0,0,0,0
1708246305879,AWP 4B,013,387805,Jones; William Jadie,0,0,0,0
1708246305879,AWP 4B,014,387806,Jones; William Jadie,0,0,0,0
1708246305879,AWP 4B,015,387807,Christie; Veronica Ann,0,0,0,0
1708246305879,AWP 4B,016,387808,Christie; Veronica Ann,0,0,0,0
1708246305879,AWP 4B,019,387820,Falcon; Jennifer A,0,0,0,0
1708246305879,AWP 4B,020,387821,Falcon; Jennifer A,0,0,0,0
1708246305879,AWP 4B,021,387822,Eastin; Schuyler E.,0,0,0,0
1708246305879,AWP 4B,023,387824,Coulter; Jane Elisabeth,0,0,0,0
1708246305879,AWP 4B,025,387826,O'Neil; Courtney L,0,0,0,0
1708246305879,AWP 4B,026,387827,O'Neil; Courtney L,0,0,0,0
1708246305879,AWP 4B,027,387828,Tsurska Svetina; Olena,0,0,0,0
1708246305879,AWP 4B,028,387829,Tsurska Svetina; Olena,0,0,0,0
1708246305879,AWP 4B,029,387830,Spicer; Jacqueline,0,0,0,0
1708246305879,AWP 4B,030,387831,Spicer; Jacqueline,0,0,0,0
1708246305879,AWP 4B,031,387832,Steinberg; Stacy A,0,0,0,0
1708246305879,AWP 4B,032,387833,Steinberg; Stacy A,0,0,0,0
1708246305879,AWP 4B,033,387834,Chandler; Bailee Daniele,0,0,0,0
1708246305879,AWP 4B,034,387835,Chandler; Bailee Daniele,0,0,0,0
1708246305879,AWP 4B,035,387836,Tiernan; Christa Michelle,0,0,0,0
1708246305879,AWP 4B,036,387837,Tiernan; Christa Michelle,0,0,0,0
1708246305879,AWP 4B,037,387840,Gardella; Alexander Drew,0,0,0,0
1708246305879,AWP 4B,038,387841,Gardella; Alexander Drew,0,0,0,0
1708246305879,AWP 4B,039,387857,Zimmerman; Guy,0,0,0,0
1708246305879,AWP 4B,040,387858,Zimmerman; Guy,0,0,0,0
1708246305879,AWP 4B,041,387859,Zroka; Amy Liane,0,0,0,0
1708246305879,AWP 4B,042,387860,Zroka; Amy Liane,0,0,0,0
1708246306405,BENG 87,A00,489656,Sah; Robert Lie-Yuan,20,0,20,0
1708246306405,BENG 87,B00,489657,Sah; Robert Lie-Yuan,20,0,20,0
1708246306405,BENG 87,C00,494754,Omens; Jeffrey Howard,20,0,20,0
1708246306930,BENG 100,A01,387959,Alexandrov; Ludmil B,26,0,28,2
1708246306930,BENG 100,A02,387960,Alexandrov; Ludmil B,26,0,28,2
1708246306930,BENG 100,A03,387984,Alexandrov; Ludmil B,26,0,28,2
1708246306930,BENG 100,A04,387985,Alexandrov; Ludmil B,25,0,28,3
1708246306930,BENG 100,A05,387986,Alexandrov; Ludmil B,27,0,28,1
1708246307456,BENG 102,A00,387987,Chapelin; Fanny,55,0,56,1
1708246307986,BENG 103B,A00,387993,Fraley; Stephanie I.,116,0,120,4
1708246308512,BENG 112B,A01,388053,Shi; Lingyan,26,0,30,4
1708246308512,BENG 112B,A02,388054,Shi; Lingyan,29,0,30,1
1708246309041,BENG 125,A00,388055,Hasty; Jeff M,120,0,160,40
1708246309568,BENG 133,A01,388866,Mali; Prashant Gulab Ram,36,0,40,4
1708246310098,BENG 140B,A01,388884,Cabrales; Pedro,28,0,30,2
1708246310098,BENG 140B,A02,388885,Cabrales; Pedro,30,0,30,0
1708246310098,BENG 140B,A03,388886,Cabrales; Pedro,26,0,30,4
1708246310623,BENG 160,A50,388889,Aguado; Brian Alberto,23,0,25,2
1708246310623,BENG 160,A51,388919,Aguado; Brian Alberto,25,0,25,0
1708246310623,BENG 160,A52,388920,Aguado; Brian Alberto,25,0,25,0
1708246311147,BENG 168,A01,388961,Khojah; Reem I,30,0,30,0
1708246311674,BENG 172,A50,389087,Omens; Jeffrey Howard & Cabrales; Pedro,15,0,20,5
1708246311674,BENG 172,A51,389088,Omens; Jeffrey Howard & Cabrales; Pedro,14,0,20,6
1708246312199,BENG 182,A01,389128,Bafna; Vineet,28,0,30,2
1708246312728,BENG 186A,A00,389130,Kwon; Ester Jihae,105,0,120,15
1708246313254,BENG 187A,A00,389289,Taylor Amos; Alyssa C,157,0,170,13
1708246313785,BENG 187D,A00,389290,Taylor Amos; Alyssa C,33,0,60,27
1708246313785,BENG 187D,B00,389300,Taylor Amos; Alyssa C,51,0,60,9
1708246313785,BENG 187D,C00,389302,Taylor Amos; Alyssa C,35,0,60,25
1708246314312,BENG 189,A00,389303,Contijoch; Francisco,26,0,30,4
1708246314837,BENG 193,A00,389328,Engler; Adam J.,0,0,0,0
1708246315372,BENG 196,A00,436038,Engler; Adam J.,9999,0,9999,0
1708246315899,BENG 197,A00,436081,Engler; Adam J.,9999,0,9999,0
1708246316427,BENG 203,A00,389385,Bafna; Vineet & Zhong; Sheng,20,0,20,0
1708246316955,BENG 207,A00,389386,Kwon; Ester Jihae,10,0,40,30
1708246316955,BENG 207,B00,389400,Taylor Amos; Alyssa C,8,0,30,22
1708246316955,BENG 207,C00,389432,Khojah; Reem I,20,0,40,20
1708246317485,BENG 209,A00,389456,Scholtes Acevedo; Claire,30,0,30,0
1708246318013,BENG 213,A00,389496,Palsson; Bernhard O.,16,0,20,4
1708246319067,BENG 224,A00,389515,Staff,0,0,0,0
1708246319597,BENG 226,A01,479043,Schmid-Schoenbein; Geert W,7,0,30,23
1708246320125,BENG 227,A00,389591,Fraley; Stephanie I.,56,0,120,64
1708246320719,BENG 230C,A00,389810,Mc Culloch; Andrew Douglas,43,0,90,47
1708246321249,BENG 232,A01,390161,Sah; Robert Lie-Yuan,6,0,50,44
1708246321775,BENG 233,A00,390290,Shah; Sameer B,33,0,50,17
1708246322304,BENG 234,A00,390291,Silva; Gabriel,21,0,56,35
1708246322832,BENG 235,A00,390318,Bintu; Bogdan,16,0,40,24
1708246323359,BENG 276,A00,390357,Mc Culloch; Andrew Douglas & Amaro; Rommie E,0,0,0,0
1708246323888,BENG 280C,A01,390443,McVeigh; Elliot R.,45,0,56,11
1708246324413,BENG 281,A00,390444,Kravets; Vira V.,50,0,110,60
1708246324941,BENG 283,A00,390445,Komives; Elizabeth A,4,0,4,0
1708246325466,BENG 292,A01,390623,Ross; Camille,20,0,20,0
1708246325991,BENG 294C,A00,390709,Engler; Adam J.,17,0,20,3
1708246326516,BENG 295,A00,436300,Watson; John Thomas,9999,0,9999,0
1708246327044,BGGN 205,A00,423656,Daugherty; Matthew Dorton,47,0,60,13
1708246327572,BGGN 207,A01,423703,Ross; Camille,0,0,0,0
1708246328101,BGGN 215,A00,423704,Petrie; Katherine Lynn,22,0,30,8
1708246328627,BGGN 216,A01,423855,Mueller; Liam O'Connor,37,0,50,13
1708246329157,BGGN 218,A00,423861,David; Michael,19,0,30,11
1708246329682,BGGN 223,A00,423862,Bier; Ethan,18,0,35,17
1708246330211,BGGN 230,A00,423863,Taylor; Susan S.,8,0,15,7
1708246330737,BGGN 232,A00,423864,Briggs; Steven & Troemel; Emily Ruth,25,0,30,5
1708246331261,BGGN 239,A01,424014,Kronenberg; Mitchell E.,30,0,30,0
1708246331786,BGGN 240,A01,424016,Juavinett; Ashley Lauren,0,0,6,6
1708246332314,BGGN 248,A00,424017,Halpain; Shelley,26,0,30,4
1708246332838,BGGN 249C,A00,424052,Staff,33,0,33,0
1708246333363,BGGN 250,A01,424091,Zou; Yimin,7,0,8,1
1708246333891,BGGN 252,A01,424093,Sejnowski; Terrence J,4,0,6,2
1708246334414,BGGN 255,A00,424094,Root; Cory Matthew,29,0,30,1
1708246334942,BGGN 262,A01,424096,Villa Rodriguez; Elizabeth,30,0,30,0
1708246335467,BGGN 267,A01,424099,Benna; Marcus K & Aljadeff; Johnatan,5,0,6,1
1708246335991,BGGN 270,A00,477483,Juavinett; Ashley Lauren,67,0,75,8
1708246336543,BGGN 271,001,481745,Ackerman; Susan,9998,0,9999,1
1708246336543,BGGN 271,002,481746,Akbari; Omar Sultan,9999,0,9999,0
1708246336543,BGGN 271,003,481747,Allen; Nicola J,9999,0,9999,0
1708246336543,BGGN 271,004,481748,Banegas; Matthew Patrick,9999,0,9999,0
1708246336543,BGGN 271,005,481749,Breen; Ellen C.,9998,0,9999,1
1708246336543,BGGN 271,006,481750,Briggs; Steven,9998,0,9999,1
1708246336543,BGGN 271,007,481751,Bui; Jack D,9999,0,9999,0
1708246336543,BGGN 271,008,481762,Busch; Wolfgang,9999,0,9999,0
1708246336543,BGGN 271,009,481763,Castle; Michael James,9999,0,9999,0
1708246336543,BGGN 271,010,481764,Chang; John Tzu-yu,9999,0,9999,0
1708246336543,BGGN 271,011,481765,Chen; Ju,9998,0,9999,1
1708246336543,BGGN 271,012,481766,Chen; Xu,9999,0,9999,0
1708246336543,BGGN 271,013,481767,Cheng; Christine Shiang-Ling,9999,0,9999,0
1708246336543,BGGN 271,014,481768,Cherqui; Stephanie,9999,0,9999,0
1708246336543,BGGN 271,015,481769,Cho; Yoshitake,9999,0,9999,0
1708246336543,BGGN 271,016,481770,Church; Kellie Breen,9998,0,9999,1
1708246336543,BGGN 271,017,481771,Cleland; Elsa Eleanor,9999,0,9999,0
1708246336543,BGGN 271,018,481779,Cohen; Shiran,9998,0,9999,1
1708246336543,BGGN 271,019,481814,Cook-Andersen; Heidi Leigh,9999,0,9999,0
1708246336543,BGGN 271,020,481815,Cooke; James Edward,9999,0,9999,0
1708246336543,BGGN 271,021,481816,Coufal; Nicole Gabriele,9998,0,9999,1
1708246336543,BGGN 271,022,481818,Crotty Alexander; Laura E,9999,0,9999,0
1708246336543,BGGN 271,023,481819,Daugherty; Matthew Dorton,9998,0,9999,1
1708246336543,BGGN 271,024,481820,De Guglielmo; Giordano,9998,0,9999,1
1708246336543,BGGN 271,025,481821,Doherty; Taylor Alan,9998,0,9999,1
1708246336543,BGGN 271,026,481822,Dulawa; Stephanie Carole,9999,0,9999,0
1708246336543,BGGN 271,027,481823,Esko; Jeffrey D.,9998,0,9999,1
1708246336543,BGGN 271,028,481824,Feldstein; Ariel E,9998,0,9999,1
1708246336543,BGGN 271,029,481825,Friedman; Rick Adam,9999,0,9999,0
1708246336543,BGGN 271,030,481826,Furnari; Frank,9999,0,9999,0
1708246336543,BGGN 271,031,481829,Ghosh; Pradipta,9998,0,9999,1
1708246336543,BGGN 271,032,481830,Gleeson; Joseph Gerard,9999,0,9999,0
1708246336543,BGGN 271,033,481831,Golden; Susan S.,9998,0,9999,1
1708246336543,BGGN 271,034,481832,Goren; Alon M,9998,0,9999,1
1708246336543,BGGN 271,035,481834,Gustafsson; Asa Birgitta,9999,0,9999,0
1708246336543,BGGN 271,036,481836,Hamdoun; Amr,9999,0,9999,0
1708246336543,BGGN 271,037,481837,Hao; Nan,9999,0,9999,0
1708246336543,BGGN 271,038,481840,Holway; David A.,9998,0,9999,1
1708246336543,BGGN 271,039,481841,Huffaker; Alisa,9998,0,9999,1
1708246336543,BGGN 271,040,481843,Sebat; Lilia Mikhailovna,9998,0,9999,1
1708246336543,BGGN 271,041,481889,Ideker; Trey,9999,0,9999,0
1708246336543,BGGN 271,042,481890,Jiang; Qingfei,9998,0,9999,1
1708246336543,BGGN 271,043,482311,Jin; Yishi,9999,0,9999,0
1708246336543,BGGN 271,044,482334,Joiner; William J.,9999,0,9999,0
1708246336543,BGGN 271,045,482353,Kaech; Susan Michelle,9998,0,9999,1
1708246336543,BGGN 271,046,482378,Karin; Michael,9999,0,9999,0
1708246336543,BGGN 271,047,482379,Kleinfeld; David,9999,0,9999,0
1708246336543,BGGN 271,048,482413,Koffler; Yacov,9999,0,9999,0
1708246336543,BGGN 271,049,482414,Komiyama; Takaki,9999,0,9999,0
1708246336543,BGGN 271,050,482415,Kryazhimskiy; Sergey A,9999,0,9999,0
1708246336543,BGGN 271,051,482416,Lawson; Mark Andrew,9999,0,9999,0
1708246336543,BGGN 271,052,482417,Lee; Yun Sok,9999,0,9999,0
1708246336543,BGGN 271,053,482451,Leutgeb; Stefan,9998,0,9999,1
1708246336543,BGGN 271,054,482452,Lo; Stanley M.,9999,0,9999,0
1708246336543,BGGN 271,055,482453,Lu; Pengzhe,9998,0,9999,1
1708246336543,BGGN 271,056,482454,Lykke-Andersen; Jens,9998,0,9999,1
1708246336543,BGGN 271,057,482456,McDonnell; Lisa Marie,9999,0,9999,0
1708246336543,BGGN 271,058,482461,McHugh; Colleen A,9998,0,9999,1
1708246336543,BGGN 271,059,482478,Meharena; Hiruy Sibhatu,9999,0,9999,0
1708246336543,BGGN 271,060,482497,Morris; Gerald P,9999,0,9999,0
1708246336543,BGGN 271,061,482499,Mukamel; Eran A,9999,0,9999,0
1708246336543,BGGN 271,062,482535,Muotri; Alysson,9999,0,9999,0
1708246336543,BGGN 271,063,482551,Muroyama; Andrew David,9999,0,9999,0
1708246336543,BGGN 271,064,482552,Neal; Sonya E,9999,0,9999,0
1708246336543,BGGN 271,065,482618,Nieh; James Charles,9999,0,9999,0
1708246336543,BGGN 271,066,482619,O'Donoghue; Anthony John,9999,0,9999,0
1708246336543,BGGN 271,067,482626,Pantham; Priyadarshini,9999,0,9999,0
1708246336543,BGGN 271,068,482633,Parast; Mana,9999,0,9999,0
1708246336543,BGGN 271,069,482634,Perry; Michael William,9999,0,9999,0
1708246336543,BGGN 271,070,482639,Pride; David Tevis,9999,0,9999,0
1708246336543,BGGN 271,071,482645,Pruneda-Paz; Jose L.,9999,0,9999,0
1708246336543,BGGN 271,072,482648,Rana; Tariq,9999,0,9999,0
1708246336543,BGGN 271,073,482650,Risbrough; Victoria Blythe,9999,0,9999,0
1708246336543,BGGN 271,074,482655,Rissman; Robert Andrew,9999,0,9999,0
1708246336543,BGGN 271,075,482656,Rosenfeld; Michael G,9999,0,9999,0
1708246336543,BGGN 271,076,482657,Saier; Milton H.,9999,0,9999,0
1708246336543,BGGN 271,077,482663,Sander; Maike,9999,0,9999,0
1708246336543,BGGN 271,078,482664,Schenk; Simon,9999,0,9999,0
1708246336543,BGGN 271,079,482665,Schoeneberg; Johannes,9998,0,9999,1
1708246336543,BGGN 271,080,482666,Schroeder; Julian I,9998,0,9999,1
1708246336543,BGGN 271,081,482667,Shaner; Nathan C.,9999,0,9999,0
1708246336543,BGGN 271,082,482668,Sheikh; Farah,9999,0,9999,0
1708246336543,BGGN 271,083,482669,Shurin; Jonathan,9999,0,9999,0
1708246336543,BGGN 271,084,482675,Sigurdson; Christina,9999,0,9999,0
1708246336543,BGGN 271,085,482676,Smith; David M.,9999,0,9999,0
1708246336543,BGGN 271,086,482677,Steinmetz; Nicole F,9999,0,9999,0
1708246336543,BGGN 271,087,482692,Su; Chih-Ying,9999,0,9999,0
1708246336543,BGGN 271,088,482694,Suel; Gurol Mehmet,9999,0,9999,0
1708246336543,BGGN 271,089,482695,Telese; Francesca,9999,0,9999,0
1708246336543,BGGN 271,090,482745,Thackray; Varykina G.,9999,0,9999,0
1708246336543,BGGN 271,091,482746,Towers; Christina Garlingt,9999,0,9999,0
1708246336543,BGGN 271,092,482747,Troemel; Emily Ruth,9998,0,9999,1
1708246336543,BGGN 271,093,482748,Tye; Kay M,9999,0,9999,0
1708246336543,BGGN 271,094,482749,Valdez-Jasso; Daniela,9998,0,9999,1
1708246336543,BGGN 271,095,482750,Wahlin; Karl Jonas,9997,0,9999,2
1708246336543,BGGN 271,096,482751,Welsbie; Derek,9999,0,9999,0
1708246336543,BGGN 271,097,482752,Wilkinson; Miles Frome,9999,0,9999,0
1708246336543,BGGN 271,098,482754,Yaksh; Tony L.,9999,0,9999,0
1708246336543,BGGN 271,099,482760,Yang; Jing,9999,0,9999,0
1708246336543,BGGN 271,100,482761,Yeo; Eugene Wei-Ming,9998,0,9999,1
1708246336543,BGGN 271,101,482763,Ying; Wei,9999,0,9999,0
1708246336543,BGGN 271,102,482764,Zarrinpar; Amir,9999,0,9999,0
1708246336543,BGGN 271,103,482765,Zengler; Karsten B,9999,0,9999,0
1708246336543,BGGN 271,104,482766,Zhang; Dong-Er,9999,0,9999,0
1708246336543,BGGN 271,105,482768,Zhao; Yunde,9999,0,9999,0
1708246336543,BGGN 271,106,482776,Zheng; Binhai,9999,0,9999,0
1708246336543,BGGN 271,107,482777,Zheng; Ye,9998,0,9999,1
1708246336543,BGGN 271,108,482806,Zuniga; Elina I,9999,0,9999,0
1708246337074,BGGN 273,A01,424101,Mueller; Liam O'Connor,43,0,50,7
1708246337602,BGGN 280,A00,424102,Ernst; Andreas,3,0,5,2
1708246337602,BGGN 280,C00,481361,Amaro; Rommie E,2,0,5,3
1708246338127,BGGN 281,A00,424103,Desai; Arshad & Oegema; Karen,0,0,5,5
1708246338652,BGGN 283,A00,424104,Rivera; Fabian Chavez,0,0,5,5
1708246338652,BGGN 283,B00,424105,Russell; Alistair B,4,0,5,1
1708246338652,BGGN 283,D00,424107,Wildonger; Jill Cathleen,2,0,5,3
1708246339177,BGGN 284,A00,424108,Glasgow; Stacey Marie,2,0,5,3
1708246349414,BGGN 285,A00,424109,Chisholm; Andrew D.,1,0,5,4
1708246349414,BGGN 285,B00,424110,Farley; Emma Kristen,2,0,5,3
1708246349943,BGGN 295,A00,424120,Tour; Ella,11,0,30,19
1708246350468,BGJC 204,A00,424138,Lu; Li-Fan & Chang; John Tzu-yu,9998,0,9999,1
1708246350997,BGJC 215,A00,424139,Cooke; James Edward & Lo; Stanley M.,10,0,10,0
1708246351635,BGRD 200,001,485528,Ackerman; Susan,9998,0,9999,1
1708246351635,BGRD 200,002,485529,Akbari; Omar Sultan,9999,0,9999,0
1708246351635,BGRD 200,003,485530,Allen; Eric,9999,0,9999,0
1708246351635,BGRD 200,004,485531,Allen; Nicola J,9999,0,9999,0
1708246351635,BGRD 200,005,485533,Amaro; Rommie E,9999,0,9999,0
1708246351635,BGRD 200,006,485535,Augustine; Vineet,9999,0,9999,0
1708246351635,BGRD 200,007,485536,Ayres; Janelle Samantha,9999,0,9999,0
1708246351635,BGRD 200,008,485538,Banegas; Matthew Patrick,9999,0,9999,0
1708246351635,BGRD 200,009,485539,Banghart; Matthew Ryan,9999,0,9999,0
1708246351635,BGRD 200,010,485542,Benna; Marcus K,9999,0,9999,0
1708246351635,BGRD 200,011,485543,Bennett; Eric J,9999,0,9999,0
1708246351635,BGRD 200,012,485545,Bloodgood; Brenda Laurie,9999,0,9999,0
1708246351635,BGRD 200,013,485546,Breen; Ellen C.,9998,0,9999,1
1708246351635,BGRD 200,014,485548,Briggs; Steven,9998,0,9999,1
1708246351635,BGRD 200,015,485549,Bui; Jack D,9999,0,9999,0
1708246351635,BGRD 200,016,485552,Busch; Wolfgang,9999,0,9999,0
1708246351635,BGRD 200,017,485621,Callaway; Edward M,9999,0,9999,0
1708246351635,BGRD 200,018,485622,Castle; Michael James,9999,0,9999,0
1708246351635,BGRD 200,019,485623,Chaim; Isaac,9999,0,9999,0
1708246351635,BGRD 200,020,485624,Chang; John Tzu-yu,9999,0,9999,0
1708246351635,BGRD 200,021,485625,Chen; Ju,9999,0,9999,0
1708246351635,BGRD 200,022,485626,Chen; Xu,9999,0,9999,0
1708246351635,BGRD 200,023,485627,Cheng; Christine Shiang-Ling,9999,0,9999,0
1708246351635,BGRD 200,024,485632,Cherqui; Stephanie,9999,0,9999,0
1708246351635,BGRD 200,025,485633,Cho; Yoshitake,9999,0,9999,0
1708246351635,BGRD 200,026,485634,Church; Kellie Breen,9999,0,9999,0
1708246351635,BGRD 200,027,485635,Cleland; Elsa Eleanor,9999,0,9999,0
1708246351635,BGRD 200,028,485636,Cohen; Shiran,9998,0,9999,1
1708246351635,BGRD 200,029,485639,Cook-Andersen; Heidi Leigh,9999,0,9999,0
1708246351635,BGRD 200,030,485686,Cooke; James Edward,9999,0,9999,0
1708246351635,BGRD 200,031,485688,Cooper; Kimberly Lynn,9999,0,9999,0
1708246351635,BGRD 200,032,485689,Coufal; Nicole Gabriele,9998,0,9999,1
1708246351635,BGRD 200,033,485690,Crotty Alexander; Laura E,9999,0,9999,0
1708246351635,BGRD 200,034,485691,Staff,9999,0,9999,0
1708246351635,BGRD 200,035,485692,De Guglielmo; Giordano,9999,0,9999,0
1708246351635,BGRD 200,036,485693,De Silva; Shermin,9999,0,9999,0
1708246351635,BGRD 200,037,485694,Desai; Arshad,9999,0,9999,0
1708246351635,BGRD 200,038,485695,Dickinson; Alexandra Jazz,9999,0,9999,0
1708246351635,BGRD 200,039,485717,Doherty; Taylor Alan,9998,0,9999,1
1708246351635,BGRD 200,040,485720,Dulawa; Stephanie Carole,9999,0,9999,0
1708246351635,BGRD 200,041,485721,Ecker; Joseph R,9999,0,9999,0
1708246351635,BGRD 200,042,485760,Engle; Dannielle D,9999,0,9999,0
1708246351635,BGRD 200,043,485761,Ernst; Andreas,9998,0,9999,1
1708246351635,BGRD 200,044,485766,Esko; Jeffrey D.,9998,0,9999,1
1708246351635,BGRD 200,045,485905,Evans; Ronald M,9999,0,9999,0
1708246351635,BGRD 200,046,485907,Staff,9999,0,9999,0
1708246351635,BGRD 200,047,485918,Feldstein; Ariel E,9998,0,9999,1
1708246351635,BGRD 200,048,485938,Friedman; Rick Adam,9999,0,9999,0
1708246351635,BGRD 200,049,485986,Furnari; Frank,9999,0,9999,0
1708246351635,BGRD 200,050,486018,Gage; Fred H,9999,0,9999,0
1708246351635,BGRD 200,051,486139,George; Monique Leana,9999,0,9999,0
1708246351635,BGRD 200,052,486140,Ghosh; Pradipta,9998,0,9999,1
1708246351635,BGRD 200,053,486141,Glass; Christopher,9998,0,9999,1
1708246351635,BGRD 200,054,486142,Gleeson; Joseph Gerard,9999,0,9999,0
1708246351635,BGRD 200,055,486143,Golden; Susan S.,9999,0,9999,0
1708246351635,BGRD 200,056,486144,Goldrath; Ananda,9999,0,9999,0
1708246351635,BGRD 200,057,486145,Goren; Alon M,9998,0,9999,1
1708246351635,BGRD 200,058,486146,Gustafsson; Asa Birgitta,9999,0,9999,0
1708246351635,BGRD 200,059,486164,Gutkind; Jorge Silvio,9999,0,9999,0
1708246351635,BGRD 200,060,486203,Hamdoun; Amr,9999,0,9999,0
1708246351635,BGRD 200,061,486204,Hampton; Randolph Y.,9999,0,9999,0
1708246351635,BGRD 200,062,486205,Hao; Nan,9999,0,9999,0
1708246351635,BGRD 200,063,486206,Staff,9999,0,9999,0
1708246351635,BGRD 200,064,486207,Hasty; Jeff M,9999,0,9999,0
1708246351635,BGRD 200,065,486208,Hollern; Daniel Patrick,9999,0,9999,0
1708246351635,BGRD 200,066,486209,Holway; David A.,9997,0,9999,2
1708246351635,BGRD 200,067,486214,Huffaker; Alisa,9998,0,9999,1
1708246351635,BGRD 200,068,486215,Hui; Enfu,9999,0,9999,0
1708246351635,BGRD 200,069,486216,Hwa; Terence T.,9999,0,9999,0
1708246351635,BGRD 200,070,486217,Sebat; Lilia Mikhailovna,9998,0,9999,1
1708246351635,BGRD 200,071,486218,Ideker; Trey,9999,0,9999,0
1708246351635,BGRD 200,072,486219,Jackrel; Sara,9998,0,9999,1
1708246351635,BGRD 200,073,486224,Jiang; Qingfei,9998,0,9999,1
1708246351635,BGRD 200,074,486225,Jin; Yishi,9999,0,9999,0
1708246351635,BGRD 200,075,486226,Joiner; William J.,9999,0,9999,0
1708246351635,BGRD 200,076,486227,Jun; Suckjoon,9999,0,9999,0
1708246351635,BGRD 200,077,486228,Kadonaga; James T,9998,0,9999,1
1708246351635,BGRD 200,078,486229,Kaech; Susan Michelle,9997,0,9999,2
1708246351635,BGRD 200,079,486237,Karin; Michael,9999,0,9999,0
1708246351635,BGRD 200,080,486238,Kleinfeld; David,9999,0,9999,0
1708246351635,BGRD 200,081,486239,Knight; Robin,9999,0,9999,0
1708246351635,BGRD 200,082,486335,Koffler; Yacov,9999,0,9999,0
1708246351635,BGRD 200,083,486336,Komiyama; Takaki,9999,0,9999,0
1708246351635,BGRD 200,084,486337,Kosuri; Pallav,9999,0,9999,0
1708246351635,BGRD 200,085,486353,Kryazhimskiy; Sergey A,9999,0,9999,0
1708246351635,BGRD 200,086,486354,Kurle; Carolyn M.,9999,0,9999,0
1708246351635,BGRD 200,087,486355,Law; Julie A,9999,0,9999,0
1708246351635,BGRD 200,088,486356,Lawson; Mark Andrew,9999,0,9999,0
1708246351635,BGRD 200,089,486357,Lee; Kuo Fen,9999,0,9999,0
1708246351635,BGRD 200,090,486376,Lee; Yun Sok,9999,0,9999,0
1708246351635,BGRD 200,091,486413,Leutgeb; Jill K.,9999,0,9999,0
1708246351635,BGRD 200,092,486414,Leutgeb; Stefan,9998,0,9999,1
1708246351635,BGRD 200,093,486415,Lim; Byungkook,9999,0,9999,0
1708246351635,BGRD 200,094,486419,Lo; Stanley M.,9999,0,9999,0
1708246351635,BGRD 200,095,486420,Looger; Loren Lee,9999,0,9999,0
1708246351635,BGRD 200,096,486422,Lovett-Barron; Matthew Rod,9999,0,9999,0
1708246351635,BGRD 200,097,486423,Lu; Li-Fan,9998,0,9999,1
1708246351635,BGRD 200,098,486424,Lu; Pengzhe,9998,0,9999,1
1708246351635,BGRD 200,099,486425,Lykke-Andersen; Jens,9998,0,9999,1
1708246351635,BGRD 200,100,486426,Lyumkis; Dmitry Evgenievich,9999,0,9999,0
1708246351635,BGRD 200,101,486427,Madigan; Cressida Ariana,9999,0,9999,0
1708246351635,BGRD 200,102,486428,Staff,9999,0,9999,0
1708246351635,BGRD 200,103,486429,Mayfield; Stephen P.,9998,0,9999,1
1708246351635,BGRD 200,104,486430,McDonnell; Lisa Marie,9999,0,9999,0
1708246351635,BGRD 200,105,486620,McHugh; Colleen A,9998,0,9999,1
1708246351635,BGRD 200,106,486621,Meharena; Hiruy Sibhatu,9999,0,9999,0
1708246351635,BGRD 200,107,486622,Staff,9999,0,9999,0
1708246351635,BGRD 200,108,486681,Morris; Gerald P,9999,0,9999,0
1708246351635,BGRD 200,109,486682,Mukamel; Eran A,9998,0,9999,1
1708246351635,BGRD 200,110,486683,Muotri; Alysson,9999,0,9999,0
1708246351635,BGRD 200,111,486684,Muroyama; Andrew David,9999,0,9999,0
1708246351635,BGRD 200,112,486687,Murre; Cornelis,9999,0,9999,0
1708246351635,BGRD 200,113,486691,Neal; Sonya E,9999,0,9999,0
1708246351635,BGRD 200,114,486692,Nieh; James Charles,9998,0,9999,1
1708246351635,BGRD 200,115,486693,Nimmerjahn; Axel,9999,0,9999,0
1708246351635,BGRD 200,116,486694,Nizet; Victor F.,9999,0,9999,0
1708246351635,BGRD 200,117,486695,O'Donoghue; Anthony John,9999,0,9999,0
1708246351635,BGRD 200,118,486706,Oegema; Karen,9999,0,9999,0
1708246351635,BGRD 200,119,486708,O'Shea; Clodagh,9999,0,9999,0
1708246351635,BGRD 200,120,486709,Pantham; Priyadarshini,9999,0,9999,0
1708246351635,BGRD 200,121,486715,Parast; Mana,9999,0,9999,0
1708246351635,BGRD 200,122,486716,Pasquinelli; Amy,9998,0,9999,1
1708246351635,BGRD 200,123,486718,Pekkurnaz Banghart; Gulcin,9999,0,9999,0
1708246351635,BGRD 200,124,486720,Perry; Michael William,9999,0,9999,0
1708246351635,BGRD 200,125,486721,Pfaff; Samuel,9999,0,9999,0
1708246351635,BGRD 200,126,486723,Pogliano; Joseph,9999,0,9999,0
1708246351635,BGRD 200,127,486724,Pogliano; Kit J.,9999,0,9999,0
1708246351635,BGRD 200,128,486727,Pride; David Tevis,9999,0,9999,0
1708246351635,BGRD 200,129,486728,Pruneda-Paz; Jose L.,9999,0,9999,0
1708246351635,BGRD 200,130,486733,Staff,9999,0,9999,0
1708246351635,BGRD 200,131,486734,Rana; Tariq,9999,0,9999,0
1708246351635,BGRD 200,132,486736,Reck-Peterson; Samara L,9999,0,9999,0
1708246351635,BGRD 200,133,486738,Rennison; Diana,9999,0,9999,0
1708246351635,BGRD 200,134,486741,Rifkin; Scott,9999,0,9999,0
1708246351635,BGRD 200,135,486743,Risbrough; Victoria Blythe,9999,0,9999,0
1708246351635,BGRD 200,136,486749,Rissman; Robert Andrew,9999,0,9999,0
1708246351635,BGRD 200,137,486750,Rivera; Fabian Chavez,9999,0,9999,0
1708246351635,BGRD 200,138,486753,Root; Cory Matthew,9999,0,9999,0
1708246351635,BGRD 200,139,486760,Rosenfeld; Michael G,9998,0,9999,1
1708246351635,BGRD 200,140,486763,Russell; Alistair B,9999,0,9999,0
1708246351635,BGRD 200,141,486766,Saier; Milton H.,9999,0,9999,0
1708246351635,BGRD 200,142,486768,Sander; Maike,9999,0,9999,0
1708246351635,BGRD 200,143,486770,Saphire; Erica Ollmann,9999,0,9999,0
1708246351635,BGRD 200,144,486771,Schenk; Simon,9999,0,9999,0
1708246351635,BGRD 200,145,486774,Schoeneberg; Johannes,9999,0,9999,0
1708246351635,BGRD 200,146,486777,Schroeder; Julian I,9998,0,9999,1
1708246351635,BGRD 200,147,486783,Shah; Sameer B,9999,0,9999,0
1708246351635,BGRD 200,148,486784,Shaner; Nathan C.,9999,0,9999,0
1708246351635,BGRD 200,149,486785,Shaw; Reuben,9999,0,9999,0
1708246351635,BGRD 200,150,486786,Sheikh; Farah,9999,0,9999,0
1708246351635,BGRD 200,151,486787,Staff,9999,0,9999,0
1708246351635,BGRD 200,152,486788,Signer; Robert,9999,0,9999,0
1708246351635,BGRD 200,153,486789,Sigurdson; Christina,9999,0,9999,0
1708246351635,BGRD 200,154,486790,Smith; David M.,9999,0,9999,0
1708246351635,BGRD 200,155,486791,Soncin; Francesca,9999,0,9999,0
1708246351635,BGRD 200,156,486792,Steinmetz; Nicole F,9999,0,9999,0
1708246351635,BGRD 200,157,486793,Su; Chih-Ying,9999,0,9999,0
1708246351635,BGRD 200,158,486794,Suel; Gurol Mehmet,9999,0,9999,0
1708246351635,BGRD 200,159,486795,Sun; Xin,9999,0,9999,0
1708246351635,BGRD 200,160,486796,Telese; Francesca,9999,0,9999,0
1708246351635,BGRD 200,161,486797,Thackray; Varykina G.,9999,0,9999,0
1708246351635,BGRD 200,162,486798,Towers; Christina Garlingt,9999,0,9999,0
1708246351635,BGRD 200,163,486799,Traver; David,9999,0,9999,0
1708246351635,BGRD 200,164,486800,Troemel; Emily Ruth,9998,0,9999,1
1708246351635,BGRD 200,165,486801,Tye; Kay M,9999,0,9999,0
1708246351635,BGRD 200,166,486802,Valdez-Jasso; Daniela,9998,0,9999,1
1708246351635,BGRD 200,167,486803,Vijayanand; Pandurangan,9999,0,9999,0
1708246351635,BGRD 200,168,486804,Villa Rodriguez; Elizabeth,9999,0,9999,0
1708246351635,BGRD 200,169,486805,Wahlin; Karl Jonas,9997,0,9999,2
1708246351635,BGRD 200,170,486806,Wang; Jean Yin Jen,9999,0,9999,0
1708246351635,BGRD 200,171,486807,Welsbie; Derek,9999,0,9999,0
1708246351635,BGRD 200,172,486808,Wildonger; Jill Cathleen,9998,0,9999,1
1708246351635,BGRD 200,173,486809,Wilkinson; Miles Frome,9999,0,9999,0
1708246351635,BGRD 200,174,486810,Winzeler; Elizabeth A,9999,0,9999,0
1708246351635,BGRD 200,175,486811,Yaksh; Tony L.,9999,0,9999,0
1708246351635,BGRD 200,176,486812,Yang; Jing,9999,0,9999,0
1708246351635,BGRD 200,177,486813,Staff,9999,0,9999,0
1708246351635,BGRD 200,178,486814,Yeo; Eugene Wei-Ming,9998,0,9999,1
1708246351635,BGRD 200,179,486815,Ying; Wei,9999,0,9999,0
1708246351635,BGRD 200,180,486816,Zarrinpar; Amir,9999,0,9999,0
1708246351635,BGRD 200,181,486817,Zengler; Karsten B,9999,0,9999,0
1708246351635,BGRD 200,182,486818,Zhang; Dong-Er,9999,0,9999,0
1708246351635,BGRD 200,183,486819,Zhao; Yunde,9999,0,9999,0
1708246351635,BGRD 200,184,486820,Zheng; Binhai,9999,0,9999,0
1708246351635,BGRD 200,185,486821,Zheng; Ye,9998,0,9999,1
1708246351635,BGRD 200,186,486822,Zuniga; Elina I,9999,0,9999,0
1708246352161,BGSE 200,A00,424140,Tour; Ella & Petrie; Katherine Lynn,9995,0,9999,4
1708246352688,BGSE 205,A00,424177,Bennett; Eric J,49,0,50,1
1708246352688,BGSE 205,B00,424179,Bennett; Eric J,48,0,50,2
1708246352688,BGSE 205,C00,424182,Bennett; Eric J,47,0,50,3
1708246352688,BGSE 205,D00,424184,Bennett; Eric J,46,0,50,4
1708246352688,BGSE 205,E00,424185,Bennett; Eric J,50,0,50,0
1708246353214,BIBC 100,A01,425401,Corbett; Kevin Daniel,150,0,158,8
1708246353214,BIBC 100,B01,477769,Amaro; Rommie E,156,0,158,2
1708246353741,BIBC 102,A01,425425,Bozinovic; Goran,255,0,256,1
1708246353741,BIBC 102,B01,425440,Hampton; Randolph Y.,250,0,256,6
1708246353741,BIBC 102,C01,486849,Flagg; Matthew Paul,63,0,120,57
1708246354272,BIBC 103,A01,425476,Grossman; Emily N,17,0,24,7
1708246354272,BIBC 103,A02,425509,Grossman; Emily N,21,0,24,3
1708246354272,BIBC 103,A03,425530,Grossman; Emily N,18,0,24,6
1708246354272,BIBC 103,A04,425536,Grossman; Emily N,22,0,24,2
1708246354272,BIBC 103,B01,425538,Boumechache; Miyyada,20,0,24,4
1708246354272,BIBC 103,B02,425539,Boumechache; Miyyada,24,0,24,0
1708246354272,BIBC 103,B03,425548,Boumechache; Miyyada,24,0,24,0
1708246354272,BIBC 103,B04,425549,Boumechache; Miyyada,24,0,24,0
1708246354797,BIBC 120,A01,425592,Coleman; Aaron B.,242,0,256,14
1708246355323,BIBC 194,A00,425609,Ernst; Andreas,21,0,27,6
1708246355323,BIBC 194,B00,477632,Saier; Milton H.,26,0,27,1
1708246355323,BIBC 194,C00,481360,Amaro; Rommie E,23,0,27,4
1708246355323,BIBC 194,D00,486852,Flagg; Matthew Paul,21,0,32,11
1708246355851,BICD 100,A01,470377,Troemel; Emily Ruth,127,0,128,1
1708246355851,BICD 100,A02,470378,Troemel; Emily Ruth,126,0,128,2
1708246355851,BICD 100,B01,470409,Reinagel; Pam,59,0,64,5
1708246355851,BICD 100,B02,470413,Reinagel; Pam,62,0,64,2
1708246355851,BICD 100,B03,470464,Reinagel; Pam,64,0,64,0
1708246355851,BICD 100,B04,470468,Reinagel; Pam,63,0,64,1
1708246355851,BICD 100,C01,470469,Beyhan; Sinem,51,0,64,13
1708246355851,BICD 100,C02,470605,Beyhan; Sinem,58,0,64,6
1708246355851,BICD 100,C03,470606,Beyhan; Sinem,60,0,64,4
1708246355851,BICD 100,C04,470607,Beyhan; Sinem,63,0,64,1
1708246355851,BICD 100,D01,477465,Nguyen; Vu Quang,158,0,160,2
1708246356382,BICD 100R,A01,425674,Smith; Laurie,29,0,34,5
1708246356382,BICD 100R,A02,425675,Smith; Laurie,30,0,34,4
1708246356382,BICD 100R,A03,425676,Smith; Laurie,30,0,34,4
1708246356917,BICD 104,A01,425696,Greenspan; Ralph J.,60,0,64,4
1708246357447,BICD 110,A01,470608,Muroyama; Andrew David,264,0,275,11
1708246357447,BICD 110,B01,425721,Ernst; Andreas,246,0,275,29
1708246357976,BICD 112,A01,458177,Cooper; Kimberly Lynn & Traver; David,10,0,32,22
1708246357976,BICD 112,A02,458180,Cooper; Kimberly Lynn & Traver; David,28,0,32,4
1708246358502,BICD 123,A01,425725,Zhao; Yunde,24,0,32,8
1708246359030,BICD 140,A01,425728,Lu; Li-Fan,228,0,240,12
1708246359557,BICD 158,A01,425730,Bier; Ethan,136,0,145,9
1708246360086,BICD 194,A00,425731,Desai; Arshad & Oegema; Karen,18,0,27,9
1708246360086,BICD 194,B00,481735,Wilhelm; James E.,29,0,32,3
1708246360613,BIEB 121,A00,425732,Butler; Shannon Rhey,21,0,32,11
1708246360613,BIEB 121,B00,425733,Butler; Shannon Rhey,24,0,32,8
1708246361141,BIEB 130,A01,425735,Kurle; Carolyn M.,243,0,295,52
1708246361666,BIEB 146,A01,425737,Petrie; Katherine Lynn,367,0,395,28
1708246362195,BIEB 148,A01,470637,Rose; Noah Hartmann,59,0,63,4
1708246362195,BIEB 148,A02,470638,Rose; Noah Hartmann,61,0,63,2
1708246362725,BIEB 154,A01,458184,Stockwell; Sarah R,29,0,30,1
1708246362725,BIEB 154,A02,458186,Stockwell; Sarah R,29,0,30,1
1708246363253,BIEB 176,A01,425741,De Silva; Shermin,56,0,64,8
1708246363781,BIEB 182,A01,458194,Roy; Kaustuv,25,0,32,7
1708246363781,BIEB 182,A02,458215,Roy; Kaustuv,31,0,32,1
1708246364313,BILD 1,A01,424267,Patrick; Gentry,249,0,250,1
1708246364313,BILD 1,B01,424272,Burg; Michael,231,0,250,19
1708246364313,BILD 1,C01,424293,Pickett; Brooke Elizabeth,245,0,250,5
1708246364313,BILD 1,D01,458292,Gonzalez Gamboa; Ivonne,48,0,50,2
1708246364313,BILD 1,D02,458295,Gonzalez Gamboa; Ivonne,50,0,50,0
1708246364313,BILD 1,D03,458296,Gonzalez Gamboa; Ivonne,50,0,50,0
1708246364313,BILD 1,D04,458297,Gonzalez Gamboa; Ivonne,49,0,50,1
1708246364313,BILD 1,D05,458303,Gonzalez Gamboa; Ivonne,50,0,50,0
1708246364846,BILD 2,A01,458304,Reyes Gonzalez; Catalina,53,0,56,3
1708246364846,BILD 2,A02,458307,Reyes Gonzalez; Catalina,55,0,56,1
1708246364846,BILD 2,A03,458313,Reyes Gonzalez; Catalina,55,0,56,1
1708246364846,BILD 2,A04,458320,Reyes Gonzalez; Catalina,56,0,56,0
1708246364846,BILD 2,B01,458324,Reyes Gonzalez; Catalina,47,0,56,9
1708246364846,BILD 2,B02,458327,Reyes Gonzalez; Catalina,54,0,56,2
1708246364846,BILD 2,B03,458339,Reyes Gonzalez; Catalina,56,0,56,0
1708246364846,BILD 2,B04,458340,Reyes Gonzalez; Catalina,56,0,56,0
1708246364846,BILD 2,C01,458387,Park; Ji Young,44,0,49,5
1708246364846,BILD 2,C02,458544,Park; Ji Young,46,0,49,3
1708246364846,BILD 2,C03,458557,Park; Ji Young,47,0,49,2
1708246364846,BILD 2,C04,458563,Park; Ji Young,46,0,49,3
1708246365378,BILD 3,A01,424312,Hammond; LaTisha Marie,331,0,350,19
1708246365378,BILD 3,B01,470107,Stockwell; Sarah R,66,0,70,4
1708246365378,BILD 3,B02,470110,Stockwell; Sarah R,70,0,70,0
1708246365378,BILD 3,B03,470116,Stockwell; Sarah R,70,0,70,0
1708246365378,BILD 3,B04,470123,Stockwell; Sarah R,67,0,70,3
1708246365378,BILD 3,B05,470150,Stockwell; Sarah R,70,0,70,0
1708246365378,BILD 3,C01,470159,Cooper; Kimberly Lynn,67,0,70,3
1708246365378,BILD 3,C02,470160,Cooper; Kimberly Lynn,69,0,70,1
1708246365378,BILD 3,C03,470164,Cooper; Kimberly Lynn,70,0,70,0
1708246365378,BILD 3,C04,470165,Cooper; Kimberly Lynn,69,0,70,1
1708246365378,BILD 3,C05,470374,Cooper; Kimberly Lynn,68,0,70,2
1708246365907,BILD 4,A01,424318,Staff,22,0,24,2
1708246365907,BILD 4,A02,424324,Staff,24,0,24,0
1708246365907,BILD 4,A03,424325,Staff,24,0,24,0
1708246365907,BILD 4,A04,424326,Staff,22,0,24,2
1708246365907,BILD 4,A05,424327,Staff,24,0,24,0
1708246365907,BILD 4,A06,424330,Staff,24,0,24,0
1708246365907,BILD 4,A07,424331,Staff,24,0,24,0
1708246365907,BILD 4,A08,424342,Staff,24,0,24,0
1708246365907,BILD 4,B01,424462,Pickett; Brooke Elizabeth,23,0,24,1
1708246365907,BILD 4,B02,424466,Pickett; Brooke Elizabeth,24,0,24,0
1708246365907,BILD 4,B03,424469,Pickett; Brooke Elizabeth,23,0,24,1
1708246365907,BILD 4,B04,424470,Pickett; Brooke Elizabeth,22,0,24,2
1708246365907,BILD 4,B05,424700,Pickett; Brooke Elizabeth,23,0,24,1
1708246365907,BILD 4,B06,424723,Pickett; Brooke Elizabeth,24,0,24,0
1708246365907,BILD 4,B07,424730,Pickett; Brooke Elizabeth,24,0,24,0
1708246365907,BILD 4,B08,424929,Pickett; Brooke Elizabeth,22,0,24,2
1708246365907,BILD 4,C01,424947,Gonzalez Gamboa; Ivonne,22,0,24,2
1708246365907,BILD 4,C02,424951,Gonzalez Gamboa; Ivonne,23,0,24,1
1708246365907,BILD 4,C03,424991,Gonzalez Gamboa; Ivonne,23,0,24,1
1708246365907,BILD 4,C04,424993,Gonzalez Gamboa; Ivonne,24,0,24,0
1708246365907,BILD 4,C05,424994,Gonzalez Gamboa; Ivonne,24,0,24,0
1708246365907,BILD 4,C06,425209,Gonzalez Gamboa; Ivonne,24,0,24,0
1708246365907,BILD 4,C07,425233,Gonzalez Gamboa; Ivonne,24,0,24,0
1708246365907,BILD 4,C08,425247,Gonzalez Gamboa; Ivonne,24,0,24,0
1708246366439,BILD 60,A01,425326,Hammond; LaTisha Marie,62,0,64,2
1708246366964,BILD 83,A00,425347,Pogliano; Joseph,25,0,30,5
1708246367491,BILD 87,A00,425368,Saier; Milton H.,20,0,20,0
1708246368017,BIMM 100,A01,425744,Cooper; Andrew Michael,303,0,320,17
1708246368017,BIMM 100,B01,425746,Cooper; Andrew Michael,315,0,320,5
1708246368544,BIMM 101,A01,425748,McDonnell; Lisa Marie,8,0,24,16
1708246368544,BIMM 101,A02,425749,McDonnell; Lisa Marie,23,0,24,1
1708246368544,BIMM 101,B01,425751,Day; Christopher D,22,0,24,2
1708246368544,BIMM 101,B02,425752,Day; Christopher D,24,0,24,0
1708246368544,BIMM 101,B03,425753,Day; Christopher D,22,0,24,2
1708246368544,BIMM 101,B04,425754,Day; Christopher D,24,0,24,0
1708246368544,BIMM 101,C01,425756,Rusert; Jessica Marie,17,0,24,7
1708246368544,BIMM 101,C02,425757,Rusert; Jessica Marie,23,0,24,1
1708246368544,BIMM 101,C03,425758,Rusert; Jessica Marie,23,0,24,1
1708246368544,BIMM 101,C04,425759,Rusert; Jessica Marie,23,0,24,1
1708246369070,BIMM 110,A01,425764,Niwa; Maho,55,0,56,1
1708246369070,BIMM 110,A02,425765,Niwa; Maho,56,0,56,0
1708246369070,BIMM 110,A03,425766,Niwa; Maho,56,0,56,0
1708246369070,BIMM 110,A04,425767,Niwa; Maho,55,0,56,1
1708246369598,BIMM 116R,A01,425771,Golden; Susan S. & Gorman; Michael R.,55,0,72,17
1708246369598,BIMM 116R,A02,425772,Golden; Susan S. & Gorman; Michael R.,54,0,72,18
1708246369598,BIMM 116R,A03,425773,Golden; Susan S. & Gorman; Michael R.,66,0,72,6
1708246369598,BIMM 116R,A04,425774,Golden; Susan S. & Gorman; Michael R.,70,0,72,2
1708246370131,BIMM 118,A01,425779,David; Michael,83,0,96,13
1708246370663,BIMM 120,A01,425792,Pirino; Giorgia,203,0,216,13
1708246370663,BIMM 120,B01,470639,Saier; Milton H.,201,0,216,15
1708246371191,BIMM 121,A01,425830,Gustafson-Brown; Cindy,18,0,24,6
1708246371191,BIMM 121,A02,425831,Gustafson-Brown; Cindy,21,0,24,3
1708246371191,BIMM 121,A03,425832,Gustafson-Brown; Cindy,24,0,24,0
1708246371191,BIMM 121,A04,425833,Gustafson-Brown; Cindy,23,0,24,1
1708246371191,BIMM 121,B01,425835,Pirino; Giorgia,19,0,24,5
1708246371191,BIMM 121,B02,425836,Pirino; Giorgia,24,0,24,0
1708246371191,BIMM 121,C01,425838,Park; Ji Young,6,0,24,18
1708246371191,BIMM 121,C02,425839,Park; Ji Young,20,0,24,4
1708246371723,BIMM 134,A01,425841,Burg; Michael,393,0,416,23
1708246372252,BIMM 143,A01,425843,Grant; Barry J,17,0,40,23
1708246372252,BIMM 143,B01,425845,Bozinovic; Goran,33,0,40,7
1708246372778,BIMM 182,A01,455012,Bafna; Vineet,28,0,50,22
1708246373304,BIMM 194,A00,425847,Rivera; Fabian Chavez,24,0,27,3
1708246373304,BIMM 194,B00,425868,Russell; Alistair B,16,0,27,11
1708246373304,BIMM 194,D00,425870,Wildonger; Jill Cathleen,14,0,27,13
1708246373829,BIOM 202,A00,390710,Corbett; Kevin Daniel,93,0,100,7
1708246374355,BIOM 219,A00,390713,Ross; Camille,0,0,0,7
1708246374883,BIOM 231,A00,455099,Furnari; Frank,0,0,0,0
1708246374883,BIOM 231,B00,455100,Lopez Ramirez; Miguel Alej,0,0,0,0
1708246375412,BIOM 242,A00,390714,Hamilton; Bruce Alan,20,0,20,0
1708246375943,BIOM 246,A00,492784,Gordts; Philip & Varki; Ajit P & Lewis; Amanda Lark & Godula; Kamil & Gagneux; Pascal & Esko; Jeffrey D. & Bode; Lars,0,0,0,0
1708246376471,BIOM 252,A00,390715,Ayyagari; Radha,27,0,28,1
1708246377001,BIOM 254,A00,390718,Corbett; Kevin Daniel,14,0,20,6
1708246377529,BIOM 272,A00,390722,Hangauer; Matthew John,16,0,20,4
1708246378060,BIOM 274,A00,390725,Sun; Bryan Kee-Hong,7,0,15,8
1708246378587,BIOM 283,A00,390728,Komives; Elizabeth A,2,0,2,0
1708246379118,BIOM 285,A00,390730,Gaulton; Kyle J,10,0,20,10
1708246379647,BIOM 295,A00,455083,Brown; Joan Heller,0,0,0,0
1708246380174,BIPN 100,A01,425872,Augustine; Vineet,240,0,245,5
1708246380174,BIPN 100,B01,425874,George; Monique Leana,240,0,245,5
1708246380174,BIPN 100,C01,458640,Maita; Isabella Vincenza,44,0,49,5
1708246380174,BIPN 100,C02,458646,Maita; Isabella Vincenza,48,0,49,1
1708246380174,BIPN 100,C03,458714,Maita; Isabella Vincenza,48,0,49,1
1708246380174,BIPN 100,C04,458716,Maita; Isabella Vincenza,48,0,49,1
1708246380174,BIPN 100,C05,458717,Maita; Isabella Vincenza,46,0,49,3
1708246380700,BIPN 105,A01,425877,Armour; Jon Christopher,13,0,21,8
1708246380700,BIPN 105,A02,425878,Armour; Jon Christopher,21,0,21,0
1708246380700,BIPN 105,A03,425879,Armour; Jon Christopher,9,0,21,12
1708246380700,BIPN 105,A04,425880,Armour; Jon Christopher,20,0,21,1
1708246381231,BIPN 120,A01,425882,Cooke; James Edward,371,0,395,24
1708246381759,BIPN 140,A01,425884,Hibbs; Ryan E.,183,0,192,9
1708246382285,BIPN 144,A01,425886,Zou; Yimin,153,0,158,5
1708246382812,BIPN 145,A01,425888,Maita; Isabella Vincenza,41,0,42,1
1708246382812,BIPN 145,B01,425918,Marino; Marc J,38,0,42,4
1708246382812,BIPN 145,B02,425954,Marino; Marc J,40,0,42,2
1708246383342,BIPN 147,A01,426086,Sejnowski; Terrence J,53,0,64,11
1708246383922,BIPN 152,A01,426112,Halpain; Shelley,98,0,128,30
1708246384451,BIPN 162,A01,426120,Juavinett; Ashley Lauren,17,0,30,13
1708246384978,BIPN 164,A01,455010,Benna; Marcus K & Aljadeff; Johnatan,120,0,120,0
1708246385503,BIPN 194,A00,426122,Glasgow; Stacey Marie,20,0,27,7
1708246386031,BISP 170,A00,426158,French; Kathleen Ann,26,0,30,4
1708246386558,BISP 182,A00,426168,Pogliano; Joseph,9999,0,9999,0
1708246387084,BISP 194,A00,426240,Chisholm; Andrew D.,11,0,27,16
1708246387084,BISP 194,B00,426241,Farley; Emma Kristen,25,0,27,2
1708246388629,BNFO 281,A00,427175,Gaasterland; Theresa,85,0,100,15
1708246389155,BNFO 283,A00,427211,Carter; Hannah Kathryn & Chavez; Alejandro,39,0,50,11
1708246389155,BNFO 283,B00,480483,Amariuta-Bartell; Tiffany & Dorrestein; Pieter,21,0,30,9
1708246389680,BNFO 294,B01,427269,Ross; Camille,47,0,50,3
1708246390303,CAT 3,A01,396994,Glaser; Amelia,15,0,15,0
1708246390303,CAT 3,A02,396995,Glaser; Amelia,15,0,15,0
1708246390303,CAT 3,A03,396996,Glaser; Amelia,7,0,15,8
1708246390303,CAT 3,A04,396997,Glaser; Amelia,12,0,15,3
1708246390303,CAT 3,A05,397004,Glaser; Amelia,15,0,15,0
1708246390303,CAT 3,A06,397039,Glaser; Amelia,11,0,15,4
1708246390303,CAT 3,A07,397040,Glaser; Amelia,13,0,15,2
1708246390303,CAT 3,A08,397084,Glaser; Amelia,15,0,15,0
1708246390303,CAT 3,A09,397269,Glaser; Amelia,13,0,15,2
1708246390303,CAT 3,A10,397270,Glaser; Amelia,0,0,15,15
1708246390303,CAT 3,A11,397271,Glaser; Amelia,9,0,15,6
1708246390303,CAT 3,A12,397272,Glaser; Amelia,12,0,15,3
1708246390303,CAT 3,A13,397273,Glaser; Amelia,15,0,15,0
1708246390303,CAT 3,A14,397274,Glaser; Amelia,14,0,15,1
1708246390303,CAT 3,B01,397276,Porter; Lisa,15,0,15,0
1708246390303,CAT 3,B02,397277,Porter; Lisa,15,0,15,0
1708246390303,CAT 3,B03,397278,Porter; Lisa,14,0,15,1
1708246390303,CAT 3,B04,397279,Porter; Lisa,15,0,15,0
1708246390303,CAT 3,B06,397281,Porter; Lisa,15,0,15,0
1708246390303,CAT 3,B07,397291,Porter; Lisa,15,0,15,0
1708246390303,CAT 3,B09,397293,Porter; Lisa,15,0,15,0
1708246390303,CAT 3,B10,397294,Porter; Lisa,15,0,15,0
1708246390303,CAT 3,B11,397295,Porter; Lisa,12,0,15,3
1708246390303,CAT 3,B12,397296,Porter; Lisa,14,0,15,1
1708246390303,CAT 3,B13,397297,Porter; Lisa,11,0,15,4
1708246390303,CAT 3,B14,397298,Porter; Lisa,15,0,15,0
1708246390303,CAT 3,B15,397299,Porter; Lisa,15,0,15,0
1708246390303,CAT 3,B16,397300,Porter; Lisa,15,0,15,0
1708246390303,CAT 3,C01,397302,Marchisotto; Jennifer Anne,13,0,15,2
1708246390303,CAT 3,C02,397308,Marchisotto; Jennifer Anne,9,0,15,6
1708246390303,CAT 3,C03,397309,Marchisotto; Jennifer Anne,9,0,15,6
1708246390303,CAT 3,C04,397315,Marchisotto; Jennifer Anne,11,0,15,4
1708246390303,CAT 3,C05,397316,Marchisotto; Jennifer Anne,14,0,15,1
1708246390303,CAT 3,C06,397322,Marchisotto; Jennifer Anne,15,0,15,0
1708246390303,CAT 3,C07,397323,Marchisotto; Jennifer Anne,15,0,15,0
1708246390303,CAT 3,C08,397329,Marchisotto; Jennifer Anne,15,0,15,0
1708246390303,CAT 3,C09,397333,Marchisotto; Jennifer Anne,15,0,15,0
1708246390303,CAT 3,C10,397336,Marchisotto; Jennifer Anne,15,0,15,0
1708246390303,CAT 3,C11,397354,Marchisotto; Jennifer Anne,13,0,15,2
1708246390303,CAT 3,C12,397357,Marchisotto; Jennifer Anne,15,0,15,0
1708246390303,CAT 3,C13,397364,Marchisotto; Jennifer Anne,14,0,15,1
1708246390303,CAT 3,C14,397367,Marchisotto; Jennifer Anne,14,0,15,1
1708246390303,CAT 3,C15,397369,Marchisotto; Jennifer Anne,15,0,15,0
1708246390303,CAT 3,C16,397373,Marchisotto; Jennifer Anne,15,0,15,0
1708246390303,CAT 3,C17,397374,Marchisotto; Jennifer Anne,15,0,15,0
1708246390303,CAT 3,C18,397380,Marchisotto; Jennifer Anne,14,0,15,1
1708246390303,CAT 3,D02,397405,Rahimi; Babak,13,0,15,2
1708246390303,CAT 3,D03,397408,Rahimi; Babak,14,0,15,1
1708246390303,CAT 3,D04,397415,Rahimi; Babak,15,0,15,0
1708246390303,CAT 3,D05,397416,Rahimi; Babak,15,0,15,0
1708246390303,CAT 3,D06,397422,Rahimi; Babak,15,0,15,0
1708246390303,CAT 3,D07,397426,Rahimi; Babak,14,0,15,1
1708246390303,CAT 3,D09,397447,Rahimi; Babak,11,0,15,4
1708246390303,CAT 3,D10,397450,Rahimi; Babak,13,0,15,2
1708246390303,CAT 3,D11,397625,Rahimi; Babak,13,0,15,2
1708246390303,CAT 3,D12,397630,Rahimi; Babak,15,0,15,0
1708246390303,CAT 3,D13,397631,Rahimi; Babak,14,0,15,1
1708246390303,CAT 3,D14,397635,Rahimi; Babak,14,0,15,1
1708246390828,CAT 3CE,A01,397642,Bronstein; Phoebe Malan,25,0,25,0
1708246391356,CAT 87,A00,397645,Bronstein; Phoebe Malan,19,0,20,1
1708246391899,CAT 90,A00,480731,Bronstein; Phoebe Malan,20,0,20,0
1708246392429,CAT 124,A01,397662,Knight; Amy,5,0,5,0
1708246392429,CAT 124,A02,397722,Knight; Amy,5,0,5,0
1708246392429,CAT 124,A03,397726,Knight; Amy,5,0,5,0
1708246392429,CAT 124,A04,397829,Knight; Amy,4,0,5,1
1708246392974,CAT 125,001,397832,Popko; Elizabeth Ashley,20,0,20,0
1708246392974,CAT 125,002,397833,Delaville; Romain,20,0,20,0
1708246392974,CAT 125,003,397834,Marchisotto; Jennifer Anne,18,0,20,2
1708246392974,CAT 125,004,397835,Bigham; David Joseph,20,0,20,0
1708246392974,CAT 125,005,397836,Bigham; David Joseph,19,0,20,1
1708246392974,CAT 125,006,397837,Bigham; David Joseph,16,0,20,4
1708246392974,CAT 125,007,397838,Vanderschuit; Maya Alysia,20,0,20,0
1708246392974,CAT 125,008,397839,Vanderschuit; Maya Alysia,20,0,20,0
1708246392974,CAT 125,009,397840,Vanderschuit; Maya Alysia,20,0,20,0
1708246392974,CAT 125,010,397841,Morales; Celeste Georgianna,15,0,16,1
1708246392974,CAT 125,011,397842,Morales; Celeste Georgianna,16,0,16,0
1708246392974,CAT 125,012,397881,Morales; Celeste Georgianna,19,0,20,1
1708246392974,CAT 125,013,397954,Rose; Becca Rae,18,0,20,2
1708246392974,CAT 125,014,397956,Rose; Becca Rae,20,0,20,0
1708246392974,CAT 125,015,397998,Rose; Becca Rae,19,0,20,1
1708246392974,CAT 125,016,397999,Tosun; Adriana,20,0,20,0
1708246392974,CAT 125,017,398001,Tosun; Adriana,20,0,20,0
1708246392974,CAT 125,018,398009,Irwin; Matthew Joseph,19,0,20,1
1708246392974,CAT 125,019,398010,Irwin; Matthew Joseph,18,0,20,2
1708246392974,CAT 125,020,398014,Irwin; Matthew Joseph,20,0,20,0
1708246393500,CAT 125R,A00,398015,Smith; Lauryn Alissa,19,0,20,1
1708246393500,CAT 125R,B00,398016,Smith; Lauryn Alissa,17,0,20,3
1708246393500,CAT 125R,C00,398017,Smith; Lauryn Alissa,19,0,20,1
1708246393500,CAT 125R,D00,398019,Tosun; Adriana,19,0,20,1
1708246393500,CAT 125R,E00,398020,Hyland; Tina Mae,12,0,20,8
1708246393500,CAT 125R,F00,398027,Hyland; Tina Mae,18,0,20,2
1708246393500,CAT 125R,G00,398028,Hyland; Tina Mae,18,0,20,2
1708246394058,CCE 1,A01,396087,Kenley Grounds; Nicole,40,0,40,0
1708246394058,CCE 1,B01,396142,Quijada; David,39,0,40,1
1708246394058,CCE 1,C01,396159,Bigley; Michele Heather,39,0,40,1
1708246394058,CCE 1,D01,396164,Bigley; Michele Heather,40,0,40,0
1708246394058,CCE 1,E01,396166,Lee; Kassandra,40,0,40,0
1708246394058,CCE 1,F01,396168,Lee; Kassandra,40,0,40,0
1708246394058,CCE 1,G01,396170,Staff,40,0,40,0
1708246394058,CCE 1,H01,396172,Staff,40,0,40,0
1708246394583,CENG 101B,A00,392993,Chen; Shaochen,44,0,45,1
1708246395108,CENG 101C,A00,392997,Li; Yanran,148,0,150,2
1708246395653,CENG 113,A00,393000,Chen; Zheng,69,0,70,1
1708246395653,CENG 113,B00,393001,Li; Wan-Lu,69,0,70,1
1708246396183,CENG 124B,A00,393036,Powell; Alyssa & Russ; Benjamin Edward,113,0,120,7
1708246396707,CENG 157,A00,393220,Opatkiewicz; Justin Paul,50,0,57,7
1708246397232,CENG 160,A00,393231,Powell; Alyssa,70,0,80,10
1708246397758,CENG 170,A01,393238,Drews; Aaron,27,0,30,3
1708246398301,CENG 175,A00,393239,Steinmetz; Nicole F,34,0,35,1
1708246398831,CENG 176B,A01,393285,Opatkiewicz; Justin Paul,46,0,52,6
1708246398831,CENG 176B,B01,393629,Zhang; Liangfang,40,0,49,9
1708246399356,CENG 205,A00,393681,Jahed Motlagh; Zeinab,53,0,60,7
1708246399883,CENG 257,A00,393682,Opatkiewicz; Justin Paul,10,0,13,3
1708246400409,CGS 87,A00,489609,Wesling; Megan E.,20,0,20,0
1708246400938,CGS 100B,A00,396181,Whitley; Leila Marie,28,0,30,2
1708246401465,CGS 109,A00,396194,Whitley; Leila Marie,19,0,20,1
1708246401990,CGS 112,A00,396220,Martin Sandino; Amanda Maria Yoland,22,0,25,3
1708246402518,CGS 114,A00,396223,Steelman; Katherine Wallis,14,0,16,2
1708246403046,CGS 116,A00,396295,Staff,19,0,20,1
1708246403574,CGS 117,A00,396306,Martin Sandino; Amanda Maria Yoland,14,0,15,1
1708246404099,CGS 118,A00,396314,Hankins; Joseph D.,28,0,29,1
1708246404627,CGS 128,A00,396366,Whitley; Leila Marie,14,0,15,1
1708246405155,CGS 137,A00,396865,Martin Sandino; Amanda Maria Yoland,16,0,19,3
1708246405680,CGS 150,A00,396901,Taylor-Garcia; Daphne,18,0,18,0
1708246406205,CGS 196B,A00,396904,Lo; Stanley M.,7,0,7,0
1708246406205,CGS 196B,B00,396973,Brenner; Suzanne A,7,0,7,0
1708246406205,CGS 196B,C00,396985,Jones; Makeba,7,0,7,0
1708246406730,CGS 198,001,396987,Anderson; Patrick W.,0,0,0,0
1708246406730,CGS 198,002,396988,Anderson; Patrick W.,0,0,0,0
1708246406730,CGS 198,003,396989,Anderson; Patrick W.,0,0,0,0
1708246406730,CGS 198,004,396990,Anderson; Patrick W.,0,0,0,0
1708246407254,CGS 200,A00,396991,Perez; Roy,0,0,0,3
1708246407801,CHEM 6A,A01,459563,Deshmukh; Lalit,40,0,40,0
1708246407801,CHEM 6A,A02,459564,Deshmukh; Lalit,35,0,40,5
1708246407801,CHEM 6A,A03,459565,Deshmukh; Lalit,31,0,40,9
1708246407801,CHEM 6A,A04,459566,Deshmukh; Lalit,30,0,38,8
1708246407801,CHEM 6A,A05,459567,Deshmukh; Lalit,40,0,40,0
1708246407801,CHEM 6A,A06,459568,Deshmukh; Lalit,37,0,40,3
1708246407801,CHEM 6A,A07,459569,Deshmukh; Lalit,37,0,40,3
1708246407801,CHEM 6A,A08,459570,Deshmukh; Lalit,0,0,0,0
1708246408343,CHEM 6B,A01,467314,Ortony; Julia Helen,39,0,40,1
1708246408343,CHEM 6B,A02,467322,Ortony; Julia Helen,32,0,40,8
1708246408343,CHEM 6B,A03,467323,Ortony; Julia Helen,40,0,40,0
1708246408343,CHEM 6B,A04,467325,Ortony; Julia Helen,32,0,40,8
1708246408343,CHEM 6B,A05,467326,Ortony; Julia Helen,39,0,40,1
1708246408343,CHEM 6B,A06,467346,Ortony; Julia Helen,40,0,40,0
1708246408343,CHEM 6B,B01,467360,Hopkins; Patrycja Anna,35,0,40,5
1708246408343,CHEM 6B,B02,467363,Hopkins; Patrycja Anna,37,0,40,3
1708246408343,CHEM 6B,B03,467364,Hopkins; Patrycja Anna,35,0,40,5
1708246408343,CHEM 6B,B04,467380,Hopkins; Patrycja Anna,40,0,40,0
1708246408343,CHEM 6B,B05,467381,Hopkins; Patrycja Anna,40,0,40,0
1708246408343,CHEM 6B,B06,467382,Hopkins; Patrycja Anna,39,0,40,1
1708246408912,CHEM 6C,A01,468994,Ternansky; Robert J.,39,0,40,1
1708246408912,CHEM 6C,A02,469054,Ternansky; Robert J.,38,0,40,2
1708246408912,CHEM 6C,A03,469065,Ternansky; Robert J.,39,0,40,1
1708246408912,CHEM 6C,A04,469069,Ternansky; Robert J.,40,0,40,0
1708246408912,CHEM 6C,A05,469080,Ternansky; Robert J.,40,0,40,0
1708246408912,CHEM 6C,B01,469318,Ternansky; Robert J.,39,0,40,1
1708246408912,CHEM 6C,B02,469319,Ternansky; Robert J.,40,0,40,0
1708246408912,CHEM 6C,B03,469320,Ternansky; Robert J.,39,0,40,1
1708246408912,CHEM 6C,B04,469321,Ternansky; Robert J.,40,0,40,0
1708246408912,CHEM 6C,B05,469322,Ternansky; Robert J.,40,0,40,0
1708246408912,CHEM 6C,C01,469323,Schurmeier; Kimberly,38,0,40,2
1708246408912,CHEM 6C,C02,469324,Schurmeier; Kimberly,36,0,40,4
1708246408912,CHEM 6C,C03,469325,Schurmeier; Kimberly,38,0,40,2
1708246408912,CHEM 6C,C04,469326,Schurmeier; Kimberly,36,0,40,4
1708246408912,CHEM 6C,C05,469327,Schurmeier; Kimberly,40,0,40,0
1708246408912,CHEM 6C,D01,460183,Schurmeier; Kimberly,39,0,40,1
1708246408912,CHEM 6C,D02,460184,Schurmeier; Kimberly,32,0,40,8
1708246408912,CHEM 6C,D03,460185,Schurmeier; Kimberly,26,0,40,14
1708246408912,CHEM 6C,D04,460186,Schurmeier; Kimberly,38,0,40,2
1708246408912,CHEM 6C,D05,460187,Schurmeier; Kimberly,40,0,40,0
1708246408912,CHEM 6C,E01,460188,Stallings; Dontarie M,24,0,40,16
1708246408912,CHEM 6C,E02,460190,Stallings; Dontarie M,25,0,40,15
1708246408912,CHEM 6C,E03,460191,Stallings; Dontarie M,3,0,20,17
1708246408912,CHEM 6C,E04,460192,Stallings; Dontarie M,36,0,40,4
1708246408912,CHEM 6C,E05,460193,Stallings; Dontarie M,37,0,40,3
1708246409440,CHEM 6CH,A01,459630,Tezcan; Faik,40,0,40,0
1708246410000,CHEM 7L,A01,393998,Jazzar; Rodolphe,0,0,0,3
1708246410000,CHEM 7L,A02,393999,Jazzar; Rodolphe,10,0,24,14
1708246410000,CHEM 7L,A03,394000,Jazzar; Rodolphe,21,0,24,3
1708246410000,CHEM 7L,A04,394001,Jazzar; Rodolphe,22,0,24,2
1708246410000,CHEM 7L,A05,394002,Jazzar; Rodolphe,18,0,24,6
1708246410000,CHEM 7L,A06,394003,Jazzar; Rodolphe,22,0,24,2
1708246410000,CHEM 7L,A07,394004,Jazzar; Rodolphe,18,0,21,3
1708246410000,CHEM 7L,A08,394005,Jazzar; Rodolphe,0,0,0,0
1708246410000,CHEM 7L,A09,394006,Jazzar; Rodolphe,20,0,24,4
1708246410000,CHEM 7L,A10,394007,Jazzar; Rodolphe,24,0,24,0
1708246410000,CHEM 7L,B01,394009,Jazzar; Rodolphe,0,0,0,1
1708246410000,CHEM 7L,B02,394010,Jazzar; Rodolphe,1,0,6,5
1708246410000,CHEM 7L,B03,394011,Jazzar; Rodolphe,15,0,24,9
1708246410000,CHEM 7L,B04,394012,Jazzar; Rodolphe,18,0,21,3
1708246410000,CHEM 7L,B05,394013,Jazzar; Rodolphe,0,0,0,0
1708246410000,CHEM 7L,B06,394014,Jazzar; Rodolphe,15,0,24,9
1708246410000,CHEM 7L,B07,394015,Jazzar; Rodolphe,18,0,24,6
1708246410000,CHEM 7L,B08,394016,Jazzar; Rodolphe,23,0,24,1
1708246410000,CHEM 7L,B09,394017,Jazzar; Rodolphe,24,0,24,0
1708246410000,CHEM 7L,B10,394018,Jazzar; Rodolphe,24,0,24,0
1708246410000,CHEM 7L,C01,394020,Staff,0,0,0,0
1708246410000,CHEM 7L,C02,394021,Staff,21,0,24,3
1708246410000,CHEM 7L,C03,394022,Staff,23,0,24,1
1708246410000,CHEM 7L,C04,394023,Staff,24,0,24,0
1708246410000,CHEM 7L,C05,394024,Staff,0,0,0,0
1708246410000,CHEM 7L,C06,394025,Staff,20,0,24,4
1708246410000,CHEM 7L,C07,394026,Staff,22,0,24,2
1708246410000,CHEM 7L,C08,394027,Staff,23,0,24,1
1708246410000,CHEM 7L,C09,394028,Staff,24,0,24,0
1708246410000,CHEM 7L,C10,394029,Staff,23,0,24,1
1708246410545,CHEM 11,A01,459661,Staff,42,0,44,2
1708246410545,CHEM 11,A02,459664,Staff,44,0,44,0
1708246410545,CHEM 11,A03,459702,Staff,42,0,44,2
1708246410545,CHEM 11,A04,459707,Staff,44,0,44,0
1708246410545,CHEM 11,A05,459708,Staff,43,0,44,1
1708246410545,CHEM 11,A06,459711,Staff,41,0,44,3
1708246411090,CHEM 40A,A01,459576,Albizati; Kim F.,36,0,40,4
1708246411090,CHEM 40A,A02,459577,Albizati; Kim F.,33,0,40,7
1708246411090,CHEM 40A,A03,459578,Albizati; Kim F.,37,0,40,3
1708246411090,CHEM 40A,A04,459579,Albizati; Kim F.,38,0,40,2
1708246411090,CHEM 40A,A05,459580,Albizati; Kim F.,40,0,40,0
1708246411090,CHEM 40A,A06,459581,Albizati; Kim F.,37,0,40,3
1708246411090,CHEM 40A,A07,459582,Albizati; Kim F.,38,0,40,2
1708246411090,CHEM 40A,A08,459588,Albizati; Kim F.,39,0,40,1
1708246411650,CHEM 40B,A01,467442,Weizman; Haim,29,0,40,11
1708246411650,CHEM 40B,A02,467443,Weizman; Haim,33,0,40,7
1708246411650,CHEM 40B,A03,467444,Weizman; Haim,39,0,40,1
1708246411650,CHEM 40B,A04,467445,Weizman; Haim,38,0,40,2
1708246411650,CHEM 40B,A05,467446,Weizman; Haim,39,0,40,1
1708246411650,CHEM 40B,A06,467447,Weizman; Haim,37,0,40,3
1708246411650,CHEM 40B,A07,467448,Weizman; Haim,31,0,40,9
1708246411650,CHEM 40B,A08,467449,Weizman; Haim,40,0,40,0
1708246411650,CHEM 40B,B01,467383,Molinski; Tadeusz,40,0,40,0
1708246411650,CHEM 40B,B02,467384,Molinski; Tadeusz,40,0,40,0
1708246411650,CHEM 40B,B03,467385,Molinski; Tadeusz,40,0,40,0
1708246411650,CHEM 40B,B04,467399,Molinski; Tadeusz,40,0,40,0
1708246411650,CHEM 40B,B05,467400,Molinski; Tadeusz,40,0,40,0
1708246411650,CHEM 40B,B06,467401,Molinski; Tadeusz,40,0,40,0
1708246411650,CHEM 40B,B07,467402,Molinski; Tadeusz,40,0,40,0
1708246411650,CHEM 40B,B08,467404,Molinski; Tadeusz,39,0,40,1
1708246412195,CHEM 41B,A01,459571,Klosterman; Jeremy K,40,0,40,0
1708246412195,CHEM 41B,A02,459572,Klosterman; Jeremy K,36,0,37,1
1708246412195,CHEM 41B,A03,459573,Klosterman; Jeremy K,40,0,40,0
1708246412742,CHEM 41C,A01,459589,Tor; Yitzhak,40,0,40,0
1708246412742,CHEM 41C,A02,459624,Tor; Yitzhak,38,0,40,2
1708246412742,CHEM 41C,A03,459625,Tor; Yitzhak,40,0,40,0
1708246412742,CHEM 41C,A04,459626,Tor; Yitzhak,40,0,40,0
1708246412742,CHEM 41C,A05,459627,Tor; Yitzhak,29,0,29,0
1708246412742,CHEM 41C,A06,459628,Tor; Yitzhak,38,0,40,2
1708246412742,CHEM 41C,A07,459629,Tor; Yitzhak,40,0,40,0
1708246413332,CHEM 43A,A01,394068,Lam; Tin Yiu,12,0,24,12
1708246413332,CHEM 43A,A02,394088,Lam; Tin Yiu,23,0,24,1
1708246413332,CHEM 43A,A03,394092,Lam; Tin Yiu,23,0,24,1
1708246413332,CHEM 43A,A04,394093,Lam; Tin Yiu,21,0,24,3
1708246413332,CHEM 43A,A05,394094,Lam; Tin Yiu,23,0,24,1
1708246413332,CHEM 43A,A06,394096,Lam; Tin Yiu,15,0,24,9
1708246413332,CHEM 43A,A07,394115,Lam; Tin Yiu,20,0,24,4
1708246413332,CHEM 43A,A08,394116,Lam; Tin Yiu,22,0,24,2
1708246413332,CHEM 43A,A09,394117,Lam; Tin Yiu,22,0,24,2
1708246413332,CHEM 43A,A10,394118,Lam; Tin Yiu,20,0,24,4
1708246413332,CHEM 43A,A11,394119,Lam; Tin Yiu,8,0,13,5
1708246413332,CHEM 43A,A12,394120,Lam; Tin Yiu,24,0,24,0
1708246413332,CHEM 43A,A13,394132,Lam; Tin Yiu,24,0,24,0
1708246413332,CHEM 43A,B01,394134,Lam; Tin Yiu,24,0,24,0
1708246413332,CHEM 43A,B02,394135,Lam; Tin Yiu,16,0,24,8
1708246413332,CHEM 43A,B03,394136,Lam; Tin Yiu,14,0,24,10
1708246413332,CHEM 43A,B04,394137,Lam; Tin Yiu,17,0,24,7
1708246413332,CHEM 43A,B05,394138,Lam; Tin Yiu,20,0,24,4
1708246413332,CHEM 43A,B06,394139,Lam; Tin Yiu,19,0,24,5
1708246413332,CHEM 43A,B07,394140,Lam; Tin Yiu,20,0,24,4
1708246413332,CHEM 43A,B08,394141,Lam; Tin Yiu,24,0,24,0
1708246413332,CHEM 43A,B09,394142,Lam; Tin Yiu,20,0,24,4
1708246413332,CHEM 43A,B10,394143,Lam; Tin Yiu,24,0,24,0
1708246413332,CHEM 43A,B11,394145,Lam; Tin Yiu,22,0,24,2
1708246413332,CHEM 43A,B12,394146,Lam; Tin Yiu,23,0,24,1
1708246413858,CHEM 96,A00,394159,Bussey; Thomas J,24,0,25,1
1708246414385,CHEM 100A,A01,394161,Li; Shaowei,16,0,22,6
1708246414385,CHEM 100A,A02,394162,Li; Shaowei,20,0,24,4
1708246414385,CHEM 100A,A03,394163,Li; Shaowei,22,0,24,2
1708246414385,CHEM 100A,A04,394164,Li; Shaowei,24,0,24,0
1708246414385,CHEM 100A,A05,394165,Li; Shaowei,24,0,24,0
1708246414385,CHEM 100A,A06,394166,Li; Shaowei,20,0,22,2
1708246414910,CHEM 100B,A01,394175,Pomeroy; Robert S.,19,0,25,6
1708246415439,CHEM 105A,A01,394177,Young; Mark,31,0,39,8
1708246415439,CHEM 105A,B01,394179,Young; Mark,0,0,0,0
1708246415982,CHEM 108,A01,394181,Staff,14,0,20,6
1708246415982,CHEM 108,A02,394182,Staff,23,0,24,1
1708246415982,CHEM 108,B01,394184,Staff,5,0,20,15
1708246415982,CHEM 108,B02,394185,Staff,23,0,24,1
1708246416509,CHEM 109,A01,394187,Piercy; Marc Anthony,17,0,20,3
1708246416509,CHEM 109,A02,394188,Piercy; Marc Anthony,22,0,24,2
1708246416509,CHEM 109,B01,394193,Piercy; Marc Anthony,12,0,20,8
1708246416509,CHEM 109,B02,394194,Piercy; Marc Anthony,23,0,24,1
1708246417035,CHEM 111,A00,394195,Thiemens; Mark H,97,0,100,3
1708246417561,CHEM 114B,A01,459574,Piercy; Marc Anthony,40,0,45,5
1708246417561,CHEM 114B,A02,459575,Piercy; Marc Anthony,40,0,45,5
1708246418088,CHEM 114C,A01,467286,Komives; Elizabeth A,32,0,44,12
1708246418088,CHEM 114C,A02,467287,Komives; Elizabeth A,43,0,44,1
1708246418088,CHEM 114C,A03,467290,Komives; Elizabeth A,42,0,44,2
1708246418088,CHEM 114C,A04,467295,Komives; Elizabeth A,43,0,44,1
1708246418618,CHEM 114D,A00,394198,Ghosh; Gourisankar,29,0,30,1
1708246419144,CHEM 118,A01,459788,Donoghue; Daniel J.,37,0,40,3
1708246419144,CHEM 118,A02,459800,Donoghue; Daniel J.,37,0,40,3
1708246419144,CHEM 118,A03,459807,Donoghue; Daniel J.,36,0,40,4
1708246419144,CHEM 118,A04,459809,Donoghue; Daniel J.,38,0,40,2
1708246419144,CHEM 118,A05,459811,Donoghue; Daniel J.,37,0,40,3
1708246419144,CHEM 118,A06,459826,Donoghue; Daniel J.,39,0,40,1
1708246419671,CHEM 119,A01,467427,Joseph; Simpson,35,0,40,5
1708246419671,CHEM 119,A02,467441,Joseph; Simpson,0,0,0,0
1708246420207,CHEM 120B,A01,467450,Griffith; Kent,37,0,40,3
1708246420207,CHEM 120B,A02,467451,Griffith; Kent,34,0,40,6
1708246420207,CHEM 120B,A03,467452,Griffith; Kent,35,0,40,5
1708246420733,CHEM 123,A00,394211,Schimpf; Alina M,0,0,0,1
1708246421274,CHEM 125,A00,394217,Tezcan; Faik,18,0,20,2
1708246421800,CHEM 126A,A01,459715,Yong; Haiwang,39,0,40,1
1708246421800,CHEM 126A,A02,459725,Yong; Haiwang,36,0,40,4
1708246422326,CHEM 126B,A01,467405,Tauber; Michael,37,0,40,3
1708246422326,CHEM 126B,A02,467406,Tauber; Michael,39,0,40,1
1708246422326,CHEM 126B,A03,467426,Tauber; Michael,39,0,40,1
1708246422860,CHEM 132,A01,460181,Galperin; Michael,42,0,45,3
1708246422860,CHEM 132,A02,460182,Galperin; Michael,37,0,45,8
1708246423386,CHEM 135,A01,394222,Tauber; Michael,15,0,15,0
1708246423912,CHEM 143B,A01,394229,Klosterman; Jeremy K,16,0,24,8
1708246423912,CHEM 143B,A02,394230,Klosterman; Jeremy K,21,0,24,3
1708246424442,CHEM 156,A00,394231,Romero; Erik Anthony,30,0,30,0
1708246424970,CHEM 157,A00,394232,Tor; Yitzhak,74,0,80,6
1708246425496,CHEM 165,A01,460194,Herzik; Mark Anthony,21,0,25,4
1708246426023,CHEM 167,A01,467296,Deshmukh; Lalit,39,0,40,1
1708246426023,CHEM 167,A02,467297,Deshmukh; Lalit,33,0,40,7
1708246426023,CHEM 167,A03,467298,Deshmukh; Lalit,37,0,40,3
1708246426023,CHEM 167,A04,467312,Deshmukh; Lalit,37,0,40,3
1708246426553,CHEM 173,A00,394284,Young; Mark,48,0,50,2
1708246427082,CHEM 174,A01,455015,Pomeroy; Robert S.,45,0,50,5
1708246427624,CHEM 186,A00,477716,Paesani; Francesco & Gilson; Michael K.,6,0,12,6
1708246428149,CHEM 188,A00,394294,Bussey; Thomas J,19,0,20,1
1708246428675,CHEM 214,A00,394336,Ghosh; Gourisankar,12,0,20,8
1708246429203,CHEM 217,A00,394341,Joseph; Simpson,25,0,30,5
1708246429731,CHEM 221,A00,394425,Taylor; Susan S.,10,0,20,10
1708246430261,CHEM 225,A00,394429,Tezcan; Faik,4,0,10,6
1708246430804,CHEM 227,A00,394430,Schimpf; Alina M,27,0,30,3
1708246431346,CHEM 229,A00,394431,Stauber; Julia Megan,13,0,20,7
1708246431877,CHEM 235,A01,394433,Tauber; Michael,20,0,20,0
1708246432402,CHEM 236,A00,394434,Kummel; Andrew C,14,0,15,1
1708246432934,CHEM 241,A00,394435,Pokorski; Jonathan Kyle,14,0,15,1
1708246433460,CHEM 250,A00,394436,Weizman; Haim,0,0,0,16
1708246433985,CHEM 256,A00,394437,Romero; Erik Anthony,15,0,20,5
1708246434512,CHEM 257,A00,394438,Tor; Yitzhak,23,0,30,7
1708246435061,CHEM 265,A01,460195,Herzik; Mark Anthony,13,0,20,7
1708246435591,CHEM 273,A00,394440,Young; Mark,13,0,20,7
1708246436120,CHEM 276,A00,394441,Mc Culloch; Andrew Douglas & Amaro; Rommie E,0,0,0,0
1708246436649,CHEM 283,A00,394443,Komives; Elizabeth A,2,0,4,2
1708246437177,CHEM 286,A00,477693,Paesani; Francesco & Gilson; Michael K.,26,0,34,8
1708246437703,CHEM 291,A00,394446,Komives; Elizabeth A,20,0,20,0
1708246438246,CHEM 294,A00,394447,Romero; Erik Anthony,50,0,50,0
1708246438827,CHIN 10CD,A01,394453,Liu; Mingming,17,0,17,0
1708246438827,CHIN 10CD,A02,394457,Liu; Mingming,18,0,18,0
1708246439358,CHIN 10CM,A01,394465,Chen; Pei-Chia,11,0,12,1
1708246439358,CHIN 10CM,A02,394466,Chen; Pei-Chia,12,0,12,0
1708246439358,CHIN 10CM,B01,394468,Liu; Mingming,11,0,13,2
1708246439358,CHIN 10CM,B02,394469,Liu; Mingming,13,0,13,0
1708246439890,CHIN 10CN,A01,394581,Xu; Li,14,0,14,0
1708246439890,CHIN 10CN,A02,394582,Xu; Li,14,0,14,0
1708246439890,CHIN 10CN,B01,394585,Xu; Li,14,0,14,0
1708246439890,CHIN 10CN,B02,394586,Xu; Li,13,0,14,1
1708246440422,CHIN 20CD,A01,394591,Wang; Xiao,11,0,12,1
1708246440422,CHIN 20CD,A02,394592,Wang; Xiao,11,0,12,1
1708246440963,CHIN 20CN,A01,394597,Anderson; Qin-Hong,7,0,8,1
1708246440963,CHIN 20CN,A02,394599,Anderson; Qin-Hong,8,0,8,0
1708246440963,CHIN 20CN,B01,394601,Anderson; Qin-Hong,14,0,15,1
1708246441489,CHIN 100CM,A00,394602,Anderson; Qin-Hong,19,0,20,1
1708246442016,CHIN 100CN,A00,394603,Chen; Pei-Chia,24,0,24,0
1708246442541,CHIN 169B,A00,394623,Wang; Xiao,19,0,20,1
1708246443066,CLAS 87,A00,394669,Herbst; Matthew,19,0,20,1
1708246443591,CLAS 121R,A01,394671,Herbst; Matthew,11,0,12,1
1708246443591,CLAS 121R,B01,486854,Herbst; Matthew,8,0,8,0
1708246444120,CLIN 294C,A00,476856,Wierenga; Christina E & Banks; Sarah Jane,20,0,20,0
1708246444645,CLIN 296,001,476768,Brookman; Lauren Irene,94,0,100,6
1708246444645,CLIN 296,002,476855,Brookman; Lauren Irene,10,0,10,0
1708246445171,CLRE 238R,A00,394675,Mehta; Ravindra L.,9998,0,9999,1
1708246445696,CLRE 254,A00,394678,Vaida; Florin,9999,0,9999,0
1708246446225,CLRE 256,A00,394685,Morris; Sheldon,9999,0,9999,0
1708246446751,CLRE 258,A00,394692,Mehta; Ravindra L.,9999,0,9999,0
1708246447280,CLRE 260,A00,394693,Cuomo; Raphael Eduardo,9999,0,9999,0
1708246447809,CLRE 264,A00,394696,Mehta; Ravindra L.,9999,0,9999,0
1708246448338,CLRE 267,A00,394703,Vaida; Florin,9999,0,9999,0
1708246448866,CLRE 297,001,394705,Cuomo; Raphael Eduardo,9999,0,9999,0
1708246449391,CMM 246,A00,492783,Gordts; Philip & Varki; Ajit P & Lewis; Amanda Lark & Godula; Kamil & Gagneux; Pascal & Esko; Jeffrey D. & Bode; Lars,9,0,10,1
1708246449917,CMM 250,A00,492943,Willert; Karl Heinrich,31,0,40,9
1708246450447,COGR 200B,A00,395746,Jack; Caroline Sarah,2,0,5,3
1708246450973,COGR 225B,A00,395750,Serlin; David,1,0,5,4
1708246451502,COGR 225C,A00,395753,Gates; Kelly,1,0,5,4
1708246452027,COGR 275,A00,395943,Goldfarb; Brian,6,0,10,4
1708246452027,COGR 275,B00,396046,Fattal; Alexander Leor,4,0,10,6
1708246452027,COGR 275,C00,396047,Kidman; Shawna F,4,0,10,6
1708246452553,COGR 280,A00,396048,Ahn; Patricia Jeehyun,6,0,10,4
1708246453086,COGS 1,A01,407484,Boyle; Mary E. T.,52,0,60,8
1708246453086,COGS 1,A02,407498,Boyle; Mary E. T.,54,0,60,6
1708246453086,COGS 1,A03,407504,Boyle; Mary E. T.,59,0,60,1
1708246453086,COGS 1,A04,407512,Boyle; Mary E. T.,57,0,60,3
1708246453086,COGS 1,A05,407513,Boyle; Mary E. T.,60,0,60,0
1708246453086,COGS 1,A06,407514,Boyle; Mary E. T.,58,0,60,2
1708246453086,COGS 1,A07,407515,Boyle; Mary E. T.,57,0,57,0
1708246453613,COGS 9,A01,407520,Shannon; Kyle Michael,54,0,60,6
1708246453613,COGS 9,A02,407521,Shannon; Kyle Michael,60,0,60,0
1708246453613,COGS 9,A03,407522,Shannon; Kyle Michael,59,0,60,1
1708246453613,COGS 9,A04,407524,Shannon; Kyle Michael,57,0,60,3
1708246453613,COGS 9,A05,407525,Shannon; Kyle Michael,59,0,60,1
1708246454139,COGS 10,A01,407527,Morgan; Eric,45,0,50,5
1708246454139,COGS 10,A02,407530,Morgan; Eric,46,0,50,4
1708246454139,COGS 10,A03,407531,Morgan; Eric,46,0,50,4
1708246454139,COGS 10,A04,407532,Morgan; Eric,47,0,50,3
1708246454139,COGS 10,A05,407534,Morgan; Eric,47,0,50,3
1708246454139,COGS 10,A06,407539,Morgan; Eric,50,0,50,0
1708246454139,COGS 10,A07,407628,Morgan; Eric,50,0,50,0
1708246454666,COGS 11,A01,407699,Boroditsky; Lera,179,0,180,1
1708246455193,COGS 12,A00,407702,Boroditsky; Lera,75,0,75,0
1708246455723,COGS 14A,A01,407706,Barrera; Steven James,51,0,57,6
1708246455723,COGS 14A,A02,407707,Barrera; Steven James,54,0,57,3
1708246455723,COGS 14A,A03,407712,Barrera; Steven James,0,0,0,1
1708246455723,COGS 14A,A04,407715,Barrera; Steven James,57,0,57,0
1708246455723,COGS 14A,A05,407717,Barrera; Steven James,55,0,56,1
1708246455723,COGS 14A,A06,407718,Barrera; Steven James,52,0,55,3
1708246455723,COGS 14A,A07,407720,Barrera; Steven James,49,0,55,6
1708246456250,COGS 14B,A01,407723,Hoffman; Drew Ellen,52,0,57,5
1708246456250,COGS 14B,A02,407726,Hoffman; Drew Ellen,48,0,55,7
1708246456250,COGS 14B,A03,407727,Hoffman; Drew Ellen,52,0,55,3
1708246456250,COGS 14B,A04,407729,Hoffman; Drew Ellen,52,0,55,3
1708246456250,COGS 14B,A05,407730,Hoffman; Drew Ellen,50,0,55,5
1708246456777,COGS 17,A01,407733,Johnson; Christine M.,50,0,50,0
1708246456777,COGS 17,A02,407734,Johnson; Christine M.,48,0,50,2
1708246456777,COGS 17,A03,407735,Johnson; Christine M.,46,0,50,4
1708246456777,COGS 17,A04,407740,Johnson; Christine M.,47,0,50,3
1708246456777,COGS 17,A05,407745,Johnson; Christine M.,48,0,50,2
1708246456777,COGS 17,A06,407824,Johnson; Christine M.,48,0,50,2
1708246456777,COGS 17,A07,407878,Johnson; Christine M.,50,0,55,5
1708246456777,COGS 17,A08,408015,Johnson; Christine M.,52,0,55,3
1708246457305,COGS 18,A01,408118,Ellis; Shannon Elizabeth,27,0,35,8
1708246457305,COGS 18,A02,408119,Ellis; Shannon Elizabeth,31,0,35,4
1708246457305,COGS 18,A03,408120,Ellis; Shannon Elizabeth,23,0,35,12
1708246457305,COGS 18,A04,408136,Ellis; Shannon Elizabeth,33,0,35,2
1708246457305,COGS 18,A05,408141,Ellis; Shannon Elizabeth,35,0,35,0
1708246457305,COGS 18,A06,408143,Ellis; Shannon Elizabeth,34,0,35,1
1708246457305,COGS 18,A07,408144,Ellis; Shannon Elizabeth,35,0,35,0
1708246457305,COGS 18,A08,408145,Ellis; Shannon Elizabeth,34,0,35,1
1708246457305,COGS 18,A09,408146,Ellis; Shannon Elizabeth,35,0,35,0
1708246457305,COGS 18,B01,408148,Ellis; Shannon Elizabeth,30,0,32,2
1708246457305,COGS 18,B02,408149,Ellis; Shannon Elizabeth,26,0,32,6
1708246457305,COGS 18,B03,408151,Ellis; Shannon Elizabeth,27,0,33,6
1708246457305,COGS 18,B04,408154,Ellis; Shannon Elizabeth,32,0,33,1
1708246457305,COGS 18,B05,408163,Ellis; Shannon Elizabeth,29,0,33,4
1708246457305,COGS 18,B06,408176,Ellis; Shannon Elizabeth,33,0,33,0
1708246457305,COGS 18,B07,408177,Ellis; Shannon Elizabeth,31,0,33,2
1708246457305,COGS 18,B08,408178,Ellis; Shannon Elizabeth,32,0,33,1
1708246457305,COGS 18,B09,408195,Ellis; Shannon Elizabeth,31,0,33,2
1708246457830,COGS 87,A00,408196,Deak; Gedeon O.,20,0,20,0
1708246457830,COGS 87,B00,479478,Fleischer; Jason G,20,0,20,0
1708246458355,COGS 100,A01,408262,Allen; Michael Gordon,54,0,56,2
1708246458355,COGS 100,A02,408263,Allen; Michael Gordon,52,0,56,4
1708246458355,COGS 100,A03,408264,Allen; Michael Gordon,55,0,56,1
1708246458355,COGS 100,A04,408265,Allen; Michael Gordon,56,0,56,0
1708246458355,COGS 100,A05,408266,Allen; Michael Gordon,56,0,56,0
1708246458355,COGS 100,A06,408349,Allen; Michael Gordon,55,0,56,1
1708246458885,COGS 101A,A01,408352,Morgan; Eric,60,0,60,0
1708246458885,COGS 101A,A02,408353,Morgan; Eric,58,0,60,2
1708246458885,COGS 101A,A03,408354,Morgan; Eric,57,0,60,3
1708246458885,COGS 101A,A04,408355,Morgan; Eric,59,0,60,1
1708246459412,COGS 101B,A01,408373,Barrera; Steven James,47,0,50,3
1708246459412,COGS 101B,A02,408380,Barrera; Steven James,46,0,50,4
1708246459412,COGS 101B,A03,408384,Barrera; Steven James,38,0,50,12
1708246459412,COGS 101B,A04,408385,Barrera; Steven James,37,0,50,13
1708246459937,COGS 101C,A01,408387,Trott; Sean Thomas,48,0,50,2
1708246459937,COGS 101C,A02,408388,Trott; Sean Thomas,43,0,50,7
1708246459937,COGS 101C,A03,408389,Trott; Sean Thomas,45,0,50,5
1708246460463,COGS 107A,A01,408396,Boyle; Mary E. T.,54,0,56,2
1708246460463,COGS 107A,A02,408397,Boyle; Mary E. T.,54,0,56,2
1708246460463,COGS 107A,A03,408399,Boyle; Mary E. T.,51,0,56,5
1708246460463,COGS 107A,A04,408409,Boyle; Mary E. T.,50,0,56,6
1708246460463,COGS 107A,A05,408410,Boyle; Mary E. T.,51,0,56,5
1708246460463,COGS 107A,A06,408411,Boyle; Mary E. T.,55,0,56,1
1708246460992,COGS 107B,A01,408413,Mooshagian; Eric Frederick,47,0,50,3
1708246460992,COGS 107B,A02,408414,Mooshagian; Eric Frederick,43,0,50,7
1708246460992,COGS 107B,A03,408428,Mooshagian; Eric Frederick,43,0,50,7
1708246460992,COGS 107B,A04,408434,Mooshagian; Eric Frederick,46,0,50,4
1708246460992,COGS 107B,A05,408435,Mooshagian; Eric Frederick,50,0,50,0
1708246460992,COGS 107B,A06,408446,Mooshagian; Eric Frederick,49,0,50,1
1708246461522,COGS 107C,A01,408500,Chiba; Andrea,51,0,60,9
1708246461522,COGS 107C,A02,408519,Chiba; Andrea,55,0,60,5
1708246461522,COGS 107C,A03,408524,Chiba; Andrea,56,0,60,4
1708246462051,COGS 108,A01,408532,Fleischer; Jason G,45,0,60,15
1708246462051,COGS 108,A02,408543,Fleischer; Jason G,58,0,60,2
1708246462051,COGS 108,A03,408544,Fleischer; Jason G,59,0,60,1
1708246462051,COGS 108,A04,408552,Fleischer; Jason G,33,0,60,27
1708246462051,COGS 108,A05,408554,Fleischer; Jason G,47,0,60,13
1708246462051,COGS 108,A06,408574,Fleischer; Jason G,43,0,60,17
1708246462051,COGS 108,A07,408576,Fleischer; Jason G,56,0,60,4
1708246462578,COGS 112,A01,408682,Hoffman; Drew Ellen,33,0,50,17
1708246462578,COGS 112,A02,408683,Hoffman; Drew Ellen,38,0,50,12
1708246462578,COGS 112,A03,408684,Hoffman; Drew Ellen,48,0,60,12
1708246463104,COGS 122,A01,408695,Dow; Steven P,21,0,50,29
1708246463633,COGS 125,A00,408697,Klemmer; Scott R,36,0,50,14
1708246464161,COGS 126,A01,408787,Hollan; James D.,44,0,50,6
1708246464691,COGS 138,A01,408866,Khosla; Meenakshi,72,0,75,3
1708246465216,COGS 142,A01,408868,Rossano; Federico,49,0,50,1
1708246465740,COGS 144,A01,408950,Rossano; Federico,48,0,50,2
1708246466270,COGS 155,A01,408993,Staff,49,0,50,1
1708246466800,COGS 157,A00,408994,Creel; Sarah,0,0,0,0
1708246467328,COGS 160,A00,409031,Deak; Gedeon O.,20,0,20,0
1708246467853,COGS 175,A01,409035,Rill; Bryan,67,0,75,8
1708246468383,COGS 178,A00,409274,Jernigan; Terry Lynne,68,0,70,2
1708246468910,COGS 179,A00,409278,Staff,40,0,40,0
1708246469439,COGS 184,A01,409317,Johnson; Christine M.,42,0,50,8
1708246469967,COGS 185,A01,409476,Tu; Zhuowen,33,0,50,17
1708246469967,COGS 185,A02,409525,Tu; Zhuowen,45,0,50,5
1708246470499,COGS 188,A01,409527,Fleischer; Jason G,46,0,75,29
1708246471026,COGS 190C,001,409528,Chiba; Andrea,9999,0,9999,0
1708246471026,COGS 190C,002,409530,Fleischer; Jason G,9999,0,9999,0
1708246471026,COGS 190C,003,409531,Boyle; Mary E. T.,9999,0,9999,0
1708246471026,COGS 190C,004,409532,Nitz; Douglas A.,9999,0,9999,0
1708246471026,COGS 190C,005,409535,Rangel; Lara M,9999,0,9999,0
1708246471026,COGS 190C,006,409536,Rossano; Federico,9999,0,9999,0
1708246471026,COGS 190C,007,409537,Deak; Gedeon O.,9999,0,9999,0
1708246471026,COGS 190C,008,409538,Trott; Sean Thomas,9999,0,9999,0
1708246471026,COGS 190C,009,409540,Creel; Sarah,9999,0,9999,0
1708246471026,COGS 190C,010,409541,Voytek; Bradley Thomas,9999,0,9999,0
1708246471026,COGS 190C,011,409542,Greene; Deanna Jacquelyn,9999,0,9999,0
1708246471026,COGS 190C,012,409543,Ellis; Shannon Elizabeth,9999,0,9999,0
1708246471026,COGS 190C,013,409546,Kirsh; David Joel,9999,0,9999,0
1708246471555,COGS 190D,A00,409547,Voytek; Bradley Thomas,20,0,20,0
1708246472084,COGS 194,A00,409548,Hill; Seth J,9999,0,9999,0
1708246472614,COGS 200,A01,406697,Creel; Sarah,0,0,0,0
1708246473139,COGS 205,A00,406698,Chiba; Andrea,20,0,20,0
1708246473664,COGS 209,A00,406699,Mukamel; Eran A,42,0,68,26
1708246474195,COGS 210C,001,406700,Kirsh; David Joel,9999,0,9999,0
1708246474195,COGS 210C,002,406701,Greene; Deanna Jacquelyn,9998,0,9999,1
1708246474195,COGS 210C,003,406702,Xia; Haijun,9999,0,9999,0
1708246474195,COGS 210C,004,406703,Nitz; Douglas A.,9998,0,9999,1
1708246474195,COGS 210C,005,406710,Hollan; James D.,9999,0,9999,0
1708246474195,COGS 210C,006,406713,De Sa; Virginia,9999,0,9999,0
1708246474195,COGS 210C,007,406714,Rossano; Federico,9999,0,9999,0
1708246474195,COGS 210C,008,406740,Kiyonaga; Anastasia,9999,0,9999,0
1708246474195,COGS 210C,009,406745,Guo; Philip J,9998,0,9999,1
1708246474195,COGS 210C,010,406746,Dow; Steven P,9999,0,9999,0
1708246474195,COGS 210C,011,406747,Bergen; Benjamin,9999,0,9999,0
1708246474195,COGS 210C,012,406758,Coulson; Seana M,9999,0,9999,0
1708246474721,COGS 211C,A00,406763,Coulson; Seana M,17,0,20,3
1708246475246,COGS 229,A00,406788,Hollan; James D. & Xia; Haijun,5,0,10,5
1708246475774,COGS 238,A00,406789,Bergen; Benjamin,17,0,20,3
1708246476301,COGS 278,A00,406794,Jernigan; Terry Lynne,18,0,20,2
1708246476829,COMM 10,A01,394711,Schmidt; Thomas Rainer,20,0,24,4
1708246476829,COMM 10,A02,394714,Schmidt; Thomas Rainer,24,0,24,0
1708246476829,COMM 10,A03,394716,Schmidt; Thomas Rainer,24,0,24,0
1708246476829,COMM 10,A04,394717,Schmidt; Thomas Rainer,22,0,24,2
1708246476829,COMM 10,A05,394731,Schmidt; Thomas Rainer,24,0,24,0
1708246476829,COMM 10,A06,394733,Schmidt; Thomas Rainer,24,0,24,0
1708246476829,COMM 10,A07,394740,Schmidt; Thomas Rainer,24,0,24,0
1708246476829,COMM 10,A08,394741,Schmidt; Thomas Rainer,24,0,24,0
1708246476829,COMM 10,A09,394751,Schmidt; Thomas Rainer,23,0,24,1
1708246476829,COMM 10,A10,394779,Schmidt; Thomas Rainer,24,0,24,0
1708246476829,COMM 10,A11,394809,Schmidt; Thomas Rainer,24,0,24,0
1708246476829,COMM 10,A12,394811,Schmidt; Thomas Rainer,24,0,24,0
1708246476829,COMM 10,A13,394818,Schmidt; Thomas Rainer,24,0,24,0
1708246476829,COMM 10,A14,394825,Schmidt; Thomas Rainer,23,0,24,1
1708246476829,COMM 10,A15,394828,Schmidt; Thomas Rainer,24,0,24,0
1708246476829,COMM 10,A16,394829,Schmidt; Thomas Rainer,0,0,0,0
1708246476829,COMM 10,A17,486828,Schmidt; Thomas Rainer,20,0,21,1
1708246477355,COMM 20,A01,394834,McKenna; Denise,69,0,70,1
1708246477886,COMM 80,A01,394849,Campbell; Robert Harold,120,0,120,0
1708246478416,COMM 100C,A01,394957,Kidman; Shawna F,24,0,25,1
1708246478416,COMM 100C,A02,394972,Kidman; Shawna F,25,0,25,0
1708246478416,COMM 100C,A03,394977,Kidman; Shawna F,22,0,25,3
1708246478416,COMM 100C,A04,394981,Kidman; Shawna F,25,0,25,0
1708246478416,COMM 100C,A05,394985,Kidman; Shawna F,24,0,25,1
1708246478416,COMM 100C,A06,394989,Kidman; Shawna F,23,0,25,2
1708246478416,COMM 100C,A07,394993,Kidman; Shawna F,24,0,25,1
1708246478416,COMM 100C,A08,394997,Kidman; Shawna F,23,0,25,2
1708246478416,COMM 100C,A09,394999,Kidman; Shawna F,25,0,25,0
1708246478416,COMM 100C,A10,395018,Kidman; Shawna F,25,0,25,0
1708246478416,COMM 100C,A11,395041,Kidman; Shawna F,24,0,25,1
1708246478416,COMM 100C,A12,395080,Kidman; Shawna F,24,0,25,1
1708246478947,COMM 101,A01,395135,Halm; Gavin Patrick,15,0,15,0
1708246478947,COMM 101,A02,395252,Halm; Gavin Patrick,15,0,15,0
1708246478947,COMM 101,A03,395253,Halm; Gavin Patrick,15,0,15,0
1708246478947,COMM 101,A04,395263,Halm; Gavin Patrick,15,0,15,0
1708246479474,COMM 101D,A00,395264,Martinico; Daniel J,13,0,16,3
1708246480003,COMM 101K,A00,395266,Ahn; Patricia Jeehyun,16,0,18,2
1708246480532,COMM 101N,A00,395267,Martinico; Daniel J,16,0,16,0
1708246481058,COMM 102C,A01,395270,Campion; Camille E,5,0,6,1
1708246481058,COMM 102C,A02,395271,Campion; Camille E,6,0,6,0
1708246481058,COMM 102C,A03,395272,Campion; Camille E,5,0,6,1
1708246481584,COMM 102M,A01,395285,Davis; Zeinabu I.,9,0,10,1
1708246481584,COMM 102M,A02,395288,Davis; Zeinabu I.,8,0,10,2
1708246482113,COMM 103D,A00,395343,Gates; Kelly,34,0,35,1
1708246482642,COMM 107,A00,395461,Serlin; David,33,0,35,2
1708246483177,COMM 109D,A00,395462,Halm; Gavin Patrick,72,0,75,3
1708246483704,COMM 110G,A00,395481,Whitworth-Smith; Andrew C,32,0,35,3
1708246484230,COMM 110M,A00,395482,Harb; Anthony Joseph,34,0,35,1
1708246484755,COMM 111A,A00,487217,Pavon Aramburu; Maria Laur,34,0,35,1
1708246485282,COMM 113T,A00,395516,Fields; Gary,35,0,35,0
1708246485810,COMM 114A,A00,395517,Zilberg; Elana,32,0,35,3
1708246486335,COMM 114B,A00,395523,Zilberg; Elana,19,0,20,1
1708246486863,COMM 114E,A00,487218,Pavon Aramburu; Maria Laur,34,0,35,1
1708246487389,COMM 114W,A00,395524,Walkover; Lillian B,17,0,18,1
1708246487914,COMM 126,A00,479341,Staff,26,0,30,4
1708246488442,COMM 132,A00,481491,Rojo Solis; Juan Jose,0,0,0,0
1708246488971,COMM 134,A00,395578,Abuelhiga; Soraya Jill,28,0,30,2
1708246489502,COMM 143,A00,395579,Rojo Solis; Juan Jose,28,0,30,2
1708246490031,COMM 146,A00,395584,Jack; Caroline Sarah,29,0,30,1
1708246490558,COMM 168,A00,395592,Harb; Anthony Joseph,29,0,30,1
1708246491084,COMM 170,A00,395608,Pavon Aramburu; Maria Laur,30,0,30,0
1708246491613,COMM 173,A00,395609,Alac; Morana,29,0,30,1
1708246492218,COMM 174,A00,395679,Alac; Morana,30,0,30,0
1708246492748,COMM 190,A00,395682,Abuelhiga; Soraya Jill,19,0,23,4
1708246492748,COMM 190,B00,395696,Staff,21,0,23,2
1708246492748,COMM 190,C00,395697,Fattal; Alexander Leor,22,0,23,1
1708246493275,CSE 8A,A50,459200,Miranda; Gregory Joseph,34,0,35,1
1708246493275,CSE 8A,A51,459205,Miranda; Gregory Joseph,34,0,35,1
1708246493275,CSE 8A,A52,459206,Miranda; Gregory Joseph,34,0,35,1
1708246493275,CSE 8A,A53,459212,Miranda; Gregory Joseph,34,0,35,1
1708246493275,CSE 8A,A54,459213,Miranda; Gregory Joseph,34,0,35,1
1708246493275,CSE 8A,A55,459232,Miranda; Gregory Joseph,34,0,35,1
1708246493806,CSE 11,A01,470735,Ochoa; Benjamin Lawrence,180,0,195,15
1708246495346,CSE 12,A01,470744,Cao; Yingjun,189,0,200,11
1708246495346,CSE 12,B01,470752,Miranda; Gregory Joseph,71,0,100,29
1708246495346,CSE 12,B02,470760,Miranda; Gregory Joseph,93,0,100,7
1708246495909,CSE 15L,A01,410174,Solares; Edwin A,6,0,10,4
1708246495909,CSE 15L,B01,410215,Solares; Edwin A,7,0,10,3
1708246495909,CSE 15L,C01,410305,Solares; Edwin A,3,0,10,7
1708246495909,CSE 15L,D01,410400,Solares; Edwin A,1,0,10,9
1708246496439,CSE 20,A01,470765,Minnes Kemp; Mor Mia,145,0,150,5
1708246496974,CSE 21,A01,470776,Jones; Miles E,68,0,73,5
1708246496974,CSE 21,A02,482889,Jones; Miles E,68,0,72,4
1708246497532,CSE 29,A01,494014,Soosai Raj; Adalbert Geral,48,0,50,2
1708246497532,CSE 29,A02,494016,Soosai Raj; Adalbert Geral,40,0,50,10
1708246497532,CSE 29,B01,494018,Shalev; Aaron D,16,0,20,4
1708246498075,CSE 30,A01,470784,Cao; Yingjun,141,0,150,9
1708246498075,CSE 30,B01,467469,Muller; P Keith,98,0,120,22
1708246498604,CSE 87,A00,410528,Moshiri; Niema,20,0,20,0
1708246499129,CSE 90,A00,486885,Minnes Kemp; Mor Mia,0,0,0,0
1708246499656,CSE 91,A00,486872,Minnes Kemp; Mor Mia,0,0,0,0
1708246499656,CSE 91,B00,486873,Minnes Kemp; Mor Mia,0,0,0,0
1708246500185,CSE 95,A00,410529,Minnes Kemp; Mor Mia,50,0,50,0
1708246500711,CSE 100,A01,470792,Sahoo; Debashis,55,0,70,15
1708246501240,CSE 100R,A01,410556,Moshiri; Niema,1,0,40,39
1708246501765,CSE 101,A01,470797,Jones; Miles E,14,0,44,30
1708246501765,CSE 101,A02,482892,Jones; Miles E,32,0,43,11
1708246502292,CSE 105,A01,470800,Micciancio; Daniele,85,0,98,13
1708246502821,CSE 107,A01,467479,Bellare; Mihir,141,0,146,5
1708246503346,CSE 109,A01,459538,Shang; Jingbo,0,0,25,25
1708246503877,CSE 110,A50,459395,Powell; Thomas Allan,49,0,50,1
1708246503877,CSE 110,A51,459512,Powell; Thomas Allan,37,0,50,13
1708246503877,CSE 110,A52,459513,Powell; Thomas Allan,46,0,50,4
1708246503877,CSE 110,A53,459514,Powell; Thomas Allan,48,0,50,2
1708246503877,CSE 110,A54,459515,Powell; Thomas Allan,48,0,50,2
1708246503877,CSE 110,A55,459516,Powell; Thomas Allan,45,0,50,5
1708246503877,CSE 110,A56,459517,Powell; Thomas Allan,47,0,48,1
1708246504404,CSE 112,A50,459518,Powell; Thomas Allan,132,0,146,14
1708246504930,CSE 120,A01,470808,Zhou; Yuan-Yuan,167,0,200,33
1708246505460,CSE 125,A00,410564,Voelker; Geoffrey M.,30,0,30,0
1708246505986,CSE 127,A01,467484,Fernandes; Earlence T,175,0,196,21
1708246506513,CSE 130,A01,467485,Polikarpova; Nadezhda,176,0,192,16
1708246508053,CSE 131,A01,459522,Ding; Yufei,36,0,50,14
1708246508579,CSE 132B,A01,470816,Deutsch; Alin Bernard,62,0,70,8
1708246509121,CSE 140,A01,410606,Orailoglu; Alex,99,0,100,1
1708246509121,CSE 140,B01,410622,Eldon; John,130,0,146,16
1708246509662,CSE 140L,A01,410655,Orailoglu; Alex,98,0,100,2
1708246509662,CSE 140L,B01,410658,Eldon; John,123,0,146,23
1708246510191,CSE 141,A01,467486,Zhao; Jishen,174,0,196,22
1708246510731,CSE 141L,A01,410685,Eldon; John,163,0,196,33
1708246511276,CSE 145,A01,410713,Kastner; Ryan Charles,25,0,25,0
1708246511806,CSE 150B,A01,470824,Gao; Sicun,311,0,362,51
1708246512334,CSE 156,A01,467487,Nakashole; Ndapandula,141,0,192,51
1708246512863,CSE 165,A01,410757,Weibel; Nadir & Schulze; Jurgen P.,41,0,50,9
1708246513388,CSE 168,A01,410759,Ramamoorthi; Ravi,24,0,25,1
1708246513388,CSE 168,A02,410761,Ramamoorthi; Ravi,24,0,25,1
1708246513914,CSE 175,A01,410764,Kumar; Rakesh,48,0,50,2
1708246514440,CSE 182,A01,455011,Bafna; Vineet,47,0,50,3
1708246514992,CSE 185,A01,410895,Gymrek; Melissa Ann,41,0,57,16
1708246514992,CSE 185,A02,479240,Gymrek; Melissa Ann,53,0,58,5
1708246515534,CSE 190,A00,410982,Grier; Daniel T,48,0,50,2
1708246515534,CSE 190,B00,410983,Riek; Laurel D,50,0,50,0
1708246515534,CSE 190,C00,410984,Staff,36,0,50,14
1708246515534,CSE 190,D00,481666,Saha; Barna & Impagliazzo; Russell,27,0,28,1
1708246516065,CSE 203A,A00,410985,Saha; Barna & Impagliazzo; Russell,0,0,0,0
1708246516594,CSE 209A,A00,410986,Grier; Daniel T,0,0,0,0
1708246517123,CSE 209B,A00,410987,Bellare; Mihir,0,0,0,0
1708246517652,CSE 217,A01,459553,Weibel; Nadir,0,0,0,0
1708246518180,CSE 218,A00,410989,Griswold; William G.,0,0,0,0
1708246518704,CSE 219,A00,410990,Hollan; James D. & Xia; Haijun,0,0,0,0
1708246519245,CSE 224,A01,470832,Snoeren; Alex C.,0,0,0,0
1708246519770,CSE 229A,A00,410993,Shalev; Aaron D,0,0,0,0
1708246520300,CSE 229C,A00,410994,Fernandes; Earlence T,0,0,0,0
1708246520829,CSE 231,A01,467488,Jhala; Ranjit,0,0,0,0
1708246521358,CSE 233,A00,410996,Vianu; Victor Dan,0,0,0,0
1708246521883,CSE 237D,A00,410998,Kastner; Ryan Charles,0,0,0,0
1708246522408,CSE 239A,A00,410999,Vianu; Victor Dan,0,0,0,0
1708246522933,CSE 239B,A00,411000,Coblenz; Michael J,0,0,0,0
1708246523462,CSE 240A,A00,411001,Chin; Bryan W.,0,0,0,0
1708246523988,CSE 252D,A00,411004,Chandraker; Manmohan Krishna,0,0,0,0
1708246524519,CSE 256,A00,411005,Nakashole; Ndapandula,0,0,0,0
1708246525046,CSE 260,A01,467491,Chin; Bryan W.,0,0,0,0
1708246525573,CSE 276B,A00,411007,Riek; Laurel D,0,0,0,0
1708246526098,CSE 276F,A01,459554,Su; Hao,0,0,0,0
1708246526643,CSE 283,A00,411009,Bafna; Vineet & Zhong; Sheng,0,0,0,0
1708246527188,CSE 290,A00,411010,Gao; Sicun,0,0,0,0
1708246527188,CSE 290,B00,411011,Chern; Albert Ren-Haur,0,0,0,0
1708246527188,CSE 290,C00,411012,Swanson; Steven James,0,0,0,0
1708246527188,CSE 290,E00,411013,Su; Hao,0,0,0,0
1708246527188,CSE 290,F00,411014,Riek; Laurel D,0,0,0,0
1708246527188,CSE 290,G00,411015,Gymrek; Melissa Ann,0,0,0,0
1708246527188,CSE 290,H00,479239,Dasgupta; Sanjoy & Gymrek; Melissa Ann,0,0,0,0
1708246527188,CSE 290,I00,481669,Bafna; Vineet,0,0,0,0
1708246527188,CSE 290,J00,494949,Paturi; Ramamohan,0,0,0,0
1708246527719,CSE 291,A00,411016,Li; Tzumao,0,0,0,0
1708246527719,CSE 291,B00,411017,Heninger; Nadia A,0,0,0,0
1708246527719,CSE 291,C00,411114,Chern; Albert Ren-Haur,0,0,0,0
1708246527719,CSE 291,D00,411115,Zhang; Yiying,0,0,0,0
1708246527719,CSE 291,E00,411116,Cheng; Chung Kuan,0,0,0,0
1708246527719,CSE 291,G00,411118,Lerner; Sorin,0,0,0,0
1708246527719,CSE 291,I00,481509,Shang; Jingbo,0,0,0,0
1708246527719,CSE 291,J00,494844,Savage; Stefan & Stefan; Deian,50,0,50,0
1708246528302,CSE 293,001,487239,Bafna; Vineet,9999,0,9999,0
1708246528302,CSE 293,002,487240,Bellare; Mihir,9999,0,9999,0
1708246528302,CSE 293,003,487241,Berg-Kirkpatrick; Taylor D,9999,0,9999,0
1708246528302,CSE 293,004,487242,Chandraker; Manmohan Krishna,9999,0,9999,0
1708246528302,CSE 293,005,487243,Cheng; Chung Kuan,9999,0,9999,0
1708246528302,CSE 293,006,487244,Christensen; Henrik I,9999,0,9999,0
1708246528302,CSE 293,007,487245,Coblenz; Michael J,9999,0,9999,0
1708246528302,CSE 293,008,487363,Cottrell; Garrison W,9999,0,9999,0
1708246528302,CSE 293,009,487366,Deutsch; Alin Bernard,9999,0,9999,0
1708246528302,CSE 293,010,487433,Esmaeilzadeh; Hadi,9999,0,9999,0
1708246528302,CSE 293,011,487434,Freund; Yoav,9999,0,9999,0
1708246528302,CSE 293,012,487455,Griswold; William G.,9999,0,9999,0
1708246528302,CSE 293,013,487469,Gymrek; Melissa Ann,9999,0,9999,0
1708246528302,CSE 293,014,487470,Heninger; Nadia A,9999,0,9999,0
1708246528302,CSE 293,015,487471,Impagliazzo; Russell,9999,0,9999,0
1708246528302,CSE 293,016,487472,Jhala; Ranjit,9999,0,9999,0
1708246528302,CSE 293,017,487473,Kahng; Andrew Byun,9999,0,9999,0
1708246528302,CSE 293,018,487474,Kane; Daniel Mertz,9999,0,9999,0
1708246528302,CSE 293,019,487475,Kriegman; David J,9999,0,9999,0
1708246528302,CSE 293,020,487476,Kumar; Arun Kumar,9999,0,9999,0
1708246528302,CSE 293,021,487477,Lerner; Sorin,9999,0,9999,0
1708246528302,CSE 293,022,487478,Lovett; Shachar,9999,0,9999,0
1708246528302,CSE 293,023,487520,McAuley; Julian John,9999,0,9999,0
1708246528302,CSE 293,024,487522,Micciancio; Daniele,9999,0,9999,0
1708246528302,CSE 293,025,487577,Orailoglu; Alex,9999,0,9999,0
1708246528302,CSE 293,026,487586,Pannuto; Patrick William,9999,0,9999,0
1708246528302,CSE 293,027,487598,Paturi; Ramamohan,9999,0,9999,0
1708246528302,CSE 293,028,487604,Polikarpova; Nadezhda,9999,0,9999,0
1708246528302,CSE 293,029,487609,Politz; Joseph Gibbs,9999,0,9999,0
1708246528302,CSE 293,030,487642,Porter; George M,9999,0,9999,0
1708246528302,CSE 293,031,487665,Porter; Leonard Emerson,9999,0,9999,0
1708246528302,CSE 293,032,487689,Ramamoorthi; Ravi,9999,0,9999,0
1708246528302,CSE 293,033,487698,Riek; Laurel D,9999,0,9999,0
1708246528302,CSE 293,034,487712,Sahoo; Debashis,9999,0,9999,0
1708246528302,CSE 293,035,487721,Saul; Lawrence,9999,0,9999,0
1708246528302,CSE 293,036,487735,Savage; Stefan,9999,0,9999,0
1708246528302,CSE 293,037,487744,Schulze; Jurgen P.,9999,0,9999,0
1708246528302,CSE 293,038,487758,Snoeren; Alex C.,9999,0,9999,0
1708246528302,CSE 293,039,487767,Shang; Jingbo,9999,0,9999,0
1708246528302,CSE 293,040,487790,Stefan; Deian,9999,0,9999,0
1708246528302,CSE 293,041,487817,Su; Hao,9999,0,9999,0
1708246528302,CSE 293,042,487827,Swanson; Steven James,9999,0,9999,0
1708246528302,CSE 293,043,487830,Tullsen; Dean Michael,9999,0,9999,0
1708246528302,CSE 293,044,487837,Vaccaro; Kristen Marie,9999,0,9999,0
1708246528302,CSE 293,045,487838,Voelker; Geoffrey M.,9999,0,9999,0
1708246528302,CSE 293,046,487842,Zhao; Jishen,9999,0,9999,0
1708246528302,CSE 293,047,487847,Zhou; Yuan-Yuan,9999,0,9999,0
1708246528302,CSE 293,048,487852,Gao; Sicun,9999,0,9999,0
1708246528302,CSE 293,049,487853,Weibel; Nadir,9999,0,9999,0
1708246528302,CSE 293,050,487854,Gupta; Rajesh K.,9999,0,9999,0
1708246528302,CSE 293,051,487855,Soosai Raj; Adalbert Geral,9999,0,9999,0
1708246528302,CSE 293,052,494373,Zhang; Hao,9999,0,9999,0
1708246528830,CSE 294,A00,411124,Voelker; Geoffrey M.,15,0,15,0
1708246529356,CSS 100,A01,396053,Trott; Sean Thomas,43,0,50,7
1708246529886,CSS 120,A01,479237,Mignozzetti; Umberto,47,0,50,3
1708246529886,CSS 120,A02,479238,Mignozzetti; Umberto,50,0,50,0
1708246530415,CSS 209,A00,396054,Styler; William Francis,21,0,35,14
1708246530944,CSS 296,001,396055,Mignozzetti; Umberto,0,0,0,1
1708246530944,CSS 296,002,396056,Styler; William Francis,0,0,0,1
1708246530944,CSS 296,003,396057,Broz; James Lawrence,0,0,0,2
1708246530944,CSS 296,004,396058,Elliott; Graham,0,0,0,5
1708246530944,CSS 296,005,396059,Sun; Feiyang,0,0,0,0
1708246530944,CSS 296,006,396060,Dewaard; Andrew Michael,0,0,0,0
1708246531470,DDPM 210,A00,400652,Ma; Joseph David,36,0,36,0
1708246531997,DDPM 211,A00,400653,Ma; Joseph David,36,0,36,0
1708246532524,DDPM 214,A00,400720,Ma; Joseph David,36,0,36,0
1708246533052,DERM 296,001,464131,Staff,50,0,50,0
1708246533052,DERM 296,002,464178,Staff,50,0,50,0
1708246533052,DERM 296,003,464181,Staff,50,0,50,0
1708246533648,DOC 3,A01,399409,Strom; Megan C.,0,0,0,0
1708246533648,DOC 3,A02,399414,Strom; Megan C.,0,0,0,0
1708246533648,DOC 3,A03,399432,Strom; Megan C.,0,0,0,0
1708246533648,DOC 3,A04,399461,Strom; Megan C.,0,0,0,0
1708246533648,DOC 3,A05,399470,Strom; Megan C.,0,0,0,0
1708246533648,DOC 3,A06,399476,Strom; Megan C.,0,0,0,0
1708246533648,DOC 3,A07,399547,Strom; Megan C.,0,0,0,0
1708246533648,DOC 3,A08,399548,Strom; Megan C.,0,0,0,0
1708246533648,DOC 3,A09,399675,Strom; Megan C.,0,0,0,0
1708246533648,DOC 3,A10,399687,Strom; Megan C.,0,0,0,0
1708246533648,DOC 3,A11,399704,Strom; Megan C.,0,0,0,0
1708246533648,DOC 3,A12,399707,Strom; Megan C.,0,0,0,0
1708246533648,DOC 3,A13,399714,Strom; Megan C.,0,0,0,0
1708246533648,DOC 3,A14,399721,Strom; Megan C.,0,0,0,0
1708246533648,DOC 3,A15,399765,Strom; Megan C.,0,0,0,0
1708246533648,DOC 3,A16,399766,Strom; Megan C.,0,0,0,0
1708246533648,DOC 3,B01,399786,Strom; Megan C.,0,0,0,0
1708246533648,DOC 3,B02,399787,Strom; Megan C.,0,0,0,0
1708246533648,DOC 3,B03,399788,Strom; Megan C.,0,0,0,0
1708246533648,DOC 3,B04,399845,Strom; Megan C.,0,0,0,0
1708246533648,DOC 3,B05,399846,Strom; Megan C.,0,0,0,0
1708246533648,DOC 3,B06,399895,Strom; Megan C.,0,0,0,0
1708246533648,DOC 3,B07,399916,Strom; Megan C.,0,0,0,0
1708246533648,DOC 3,B08,400073,Strom; Megan C.,0,0,0,0
1708246533648,DOC 3,B09,400074,Strom; Megan C.,0,0,0,0
1708246533648,DOC 3,B10,400076,Strom; Megan C.,0,0,0,0
1708246533648,DOC 3,B11,400077,Strom; Megan C.,0,0,0,0
1708246533648,DOC 3,B12,400078,Strom; Megan C.,0,0,0,0
1708246533648,DOC 3,B13,400079,Strom; Megan C.,0,0,0,0
1708246533648,DOC 3,B14,400080,Strom; Megan C.,0,0,0,0
1708246533648,DOC 3,B15,400081,Strom; Megan C.,0,0,0,0
1708246533648,DOC 3,B16,400082,Strom; Megan C.,0,0,0,0
1708246533648,DOC 3,C01,400084,Chapman; Dillon,0,0,0,0
1708246533648,DOC 3,C02,400085,Chapman; Dillon,0,0,0,0
1708246533648,DOC 3,C03,400086,Chapman; Dillon,0,0,0,0
1708246533648,DOC 3,C04,400087,Chapman; Dillon,0,0,0,0
1708246533648,DOC 3,C05,400113,Chapman; Dillon,0,0,0,0
1708246533648,DOC 3,C06,400114,Chapman; Dillon,0,0,0,0
1708246533648,DOC 3,C07,400117,Chapman; Dillon,0,0,0,0
1708246533648,DOC 3,C08,400118,Chapman; Dillon,0,0,0,0
1708246533648,DOC 3,C09,400119,Chapman; Dillon,0,0,0,0
1708246533648,DOC 3,C10,400121,Chapman; Dillon,0,0,0,0
1708246533648,DOC 3,C11,400122,Chapman; Dillon,0,0,0,0
1708246533648,DOC 3,C12,400126,Chapman; Dillon,0,0,0,0
1708246533648,DOC 3,C13,400157,Chapman; Dillon,0,0,0,0
1708246533648,DOC 3,C14,400240,Chapman; Dillon,0,0,0,0
1708246533648,DOC 3,C15,400241,Chapman; Dillon,0,0,0,0
1708246533648,DOC 3,C16,400242,Chapman; Dillon,0,0,0,0
1708246533648,DOC 3,D01,400253,Chapman; Dillon,0,0,0,0
1708246533648,DOC 3,D02,400294,Chapman; Dillon,0,0,0,0
1708246533648,DOC 3,D03,400295,Chapman; Dillon,0,0,0,0
1708246533648,DOC 3,D04,400430,Chapman; Dillon,0,0,0,0
1708246533648,DOC 3,D05,400438,Chapman; Dillon,0,0,0,0
1708246533648,DOC 3,D06,400439,Chapman; Dillon,0,0,0,0
1708246533648,DOC 3,D07,400441,Chapman; Dillon,0,0,0,0
1708246533648,DOC 3,D08,400442,Chapman; Dillon,0,0,0,0
1708246533648,DOC 3,D09,400443,Chapman; Dillon,0,0,0,0
1708246533648,DOC 3,D10,400445,Chapman; Dillon,0,0,0,0
1708246533648,DOC 3,D11,400446,Chapman; Dillon,0,0,0,0
1708246533648,DOC 3,D12,400447,Chapman; Dillon,0,0,0,0
1708246533648,DOC 3,D13,400448,Chapman; Dillon,0,0,0,0
1708246533648,DOC 3,D14,400646,Chapman; Dillon,0,0,0,0
1708246533648,DOC 3,D15,400647,Chapman; Dillon,0,0,0,0
1708246533648,DOC 3,D16,400648,Chapman; Dillon,0,0,0,0
1708246534174,DOC 100D,A00,400649,Pass; Natalye Joann,22,0,25,3
1708246534174,DOC 100D,B00,400650,Pass; Natalye Joann,25,0,25,0
1708246534707,DSC 10,A01,398041,Tiefenbruck; Janine LoBue,142,0,147,5
1708246534707,DSC 10,B01,398180,Tiefenbruck; Janine LoBue,144,0,147,3
1708246534707,DSC 10,C01,398400,Tiefenbruck; Janine LoBue,143,0,147,4
1708246535236,DSC 20,A01,398415,Langlois; Marina,200,0,200,0
1708246535766,DSC 30,A01,398436,Langlois; Marina,156,0,158,2
1708246535766,DSC 30,B01,398439,Langlois; Marina,144,0,150,6
1708246537322,DSC 40A,A01,398441,Rampure; Suraj,123,0,125,2
1708246537322,DSC 40A,B01,398443,Rampure; Suraj,125,0,125,0
1708246537853,DSC 40B,A01,398445,Staff,150,0,150,0
1708246538384,DSC 80,A01,398470,Lau; Samuel Ethan,70,0,70,0
1708246538384,DSC 80,B01,398541,Lau; Samuel Ethan,69,0,70,1
1708246538910,DSC 95,A01,398650,Rampure; Suraj,50,0,50,0
1708246539435,DSC 100,A01,398683,Salimi; Babak,147,0,150,3
1708246539976,DSC 102,A01,398708,Jin; Haojian,145,0,150,5
1708246540504,DSC 106,A01,398711,Wilber; Jared Dane,146,0,149,3
1708246541031,DSC 140A,A01,398724,Eldridge; Justin Matthew,98,0,100,2
1708246541031,DSC 140A,B01,479346,Ustun; Tevfik Berk,50,0,50,0
1708246541558,DSC 140B,A01,398726,Weng; Tsui-Wei (lily),144,0,150,6
1708246542090,DSC 190,A01,398738,Silberman; Jack,20,0,20,0
1708246542090,DSC 190,B01,479475,Ustun; Tevfik Berk,29,0,30,1
1708246542090,DSC 190,C01,481341,Rahman; Tauhidur,50,0,50,0
1708246542616,DSC 197,001,494360,Eldridge; Justin Matthew,9999,0,9999,0
1708246543144,DSC 214,A00,477322,Staff,22,0,60,38
1708246543674,DSC 231,A01,398863,Gupta; Rajesh K.,60,0,60,0
1708246544202,DSC 232R,A01,487133,Solares; Edwin A,39,0,60,21
1708246544727,DSC 240,A00,398957,Belkin; Mikhail,74,0,90,16
1708246545776,DSC 243,A00,398958,Ma; Yian,59,0,60,1
1708246546302,DSC 245,A00,398959,Huang; Biwei,42,0,60,18
1708246546827,DSC 253,A00,398960,Shang; Jingbo,0,0,30,30
1708246547352,DSC 258R,A01,398962,Shang; Jingbo,43,0,60,17
1708246547877,DSC 267R,A01,398964,Staff,56,0,60,4
1708246548420,DSC 291,A00,398965,Belkin; Mikhail,90,0,90,0
1708246548420,DSC 291,B00,398966,Weng; Tsui-Wei (lily),90,0,90,0
1708246548420,DSC 291,C00,398997,Staff,60,0,60,0
1708246548420,DSC 291,D00,398998,Zhang; Hao,40,0,40,0
1708246548420,DSC 291,E00,477386,Staff,50,0,50,0
1708246549006,DSC 293,A00,477388,Ustun; Tevfik Berk,9990,0,9999,9
1708246549534,DSC 295,A00,480826,Danks; David J,30,0,40,10
1708246550059,DSE 220,A00,398034,Dasgupta; Sanjoy,20,0,20,0
1708246550603,DSE 230,A00,398035,Nguyen; Mai Huong,20,0,20,0
1708246551131,DSE 260B,A00,398037,Altintas De Callaf; Ilkay,20,0,20,0
1708246551657,DSGN 1,A01,408210,Klemmer; Scott R,46,0,50,4
1708246551657,DSGN 1,A02,408245,Klemmer; Scott R,47,0,50,3
1708246552184,DSGN 119,A00,407467,Hollan; James D. & Xia; Haijun,76,0,90,14
1708246552711,DSGN 160,A00,494371,Aronoff-Spencer; Eliah Sea,15,0,20,5
1708246553238,DSGN 219,A00,474323,Hollan; James D. & Xia; Haijun,15,0,15,0
1708246554780,ECE 5,A01,428645,Morris; Karcher William,21,0,24,3
1708246554780,ECE 5,A02,428646,Morris; Karcher William,24,0,24,0
1708246554780,ECE 5,A03,428647,Morris; Karcher William,24,0,24,0
1708246554780,ECE 5,A04,428648,Morris; Karcher William,24,0,24,0
1708246555309,ECE 15,A01,428650,Sahay; Rajeev,119,0,120,1
1708246555837,ECE 16,A01,428652,Wang; Edward Jay,22,0,30,8
1708246556362,ECE 17,A01,428654,Sahay; Rajeev,48,0,60,12
1708246556888,ECE 25,A50,428657,Dey; Sujit,30,0,30,0
1708246556888,ECE 25,A51,428658,Dey; Sujit,30,0,30,0
1708246557415,ECE 30,A50,428674,Mir Arabbaygi; Siavash,28,0,30,2
1708246557415,ECE 30,A51,428675,Mir Arabbaygi; Siavash,28,0,30,2
1708246557415,ECE 30,A52,428676,Mir Arabbaygi; Siavash,28,0,30,2
1708246557415,ECE 30,A53,428679,Mir Arabbaygi; Siavash,29,0,30,1
1708246557415,ECE 30,A54,428680,Mir Arabbaygi; Siavash,30,0,30,0
1708246557943,ECE 35,A50,428684,Taur; Yuan,29,0,30,1
1708246557943,ECE 35,A51,428685,Taur; Yuan,30,0,30,0
1708246557943,ECE 35,A52,428686,Taur; Yuan,30,0,30,0
1708246557943,ECE 35,A53,428687,Taur; Yuan,29,0,30,1
1708246558471,ECE 45,A01,428689,Zeger; Kenneth A.,137,0,150,13
1708246558998,ECE 65,A50,428701,Baghdadchi; Saharnaz,28,0,30,2
1708246558998,ECE 65,A51,428742,Baghdadchi; Saharnaz,29,0,30,1
1708246558998,ECE 65,A52,428743,Baghdadchi; Saharnaz,30,0,30,0
1708246558998,ECE 65,A53,428754,Baghdadchi; Saharnaz,27,0,30,3
1708246558998,ECE 65,A54,428796,Baghdadchi; Saharnaz,30,0,30,0
1708246558998,ECE 65,A55,428797,Baghdadchi; Saharnaz,29,0,30,1
1708246558998,ECE 65,A56,428803,Baghdadchi; Saharnaz,30,0,30,0
1708246559545,ECE 100,A01,428978,Baghdadchi; Saharnaz,29,0,30,1
1708246559545,ECE 100,A02,428988,Baghdadchi; Saharnaz,30,0,30,0
1708246559545,ECE 100,A03,428989,Baghdadchi; Saharnaz,29,0,30,1
1708246559545,ECE 100,A04,429008,Baghdadchi; Saharnaz,29,0,30,1
1708246560071,ECE 101,A01,429017,Bharadia; Dinesh,57,0,60,3
1708246560071,ECE 101,A02,429019,Bharadia; Dinesh,60,0,60,0
1708246560600,ECE 103,A01,429027,Kuzum; Duygu,74,0,75,1
1708246561129,ECE 107,A01,429055,Fullerton; Eric E,73,0,75,2
1708246561657,ECE 108,A01,429068,Kang; Mingu,53,0,60,7
1708246562188,ECE 109,A01,429085,Orlitsky; Alon,98,0,100,2
1708246562188,ECE 109,A02,429098,Orlitsky; Alon,96,0,100,4
1708246562717,ECE 111,A01,429132,Turakhia; Yatish Girish,173,0,180,7
1708246563256,ECE 115,A01,429314,Yip; Michael,22,0,26,4
1708246563781,ECE 123,A01,429327,Sievenpiper; Daniel F.,56,0,60,4
1708246564307,ECE 125B,A50,429397,Esmaili; Gholamreza,23,0,24,1
1708246564307,ECE 125B,A51,429627,Esmaili; Gholamreza,23,0,24,1
1708246564833,ECE 134,A00,429630,Ng; Tse Nga,50,0,50,0
1708246565362,ECE 136L,A01,429634,Dayeh; Shadi Ahmad,3,0,5,2
1708246565362,ECE 136L,A02,429636,Dayeh; Shadi Ahmad,3,0,5,2
1708246565362,ECE 136L,A03,429637,Dayeh; Shadi Ahmad,5,0,5,0
1708246565362,ECE 136L,A04,429641,Dayeh; Shadi Ahmad,5,0,5,0
1708246565887,ECE 139,A00,429642,Nomura; Kenji,17,0,20,3
1708246566413,ECE 140B,A01,455349,Khoshabeh; Ramsin & Gessner; Richard K.,19,0,24,5
1708246566413,ECE 140B,A02,455351,Khoshabeh; Ramsin & Gessner; Richard K.,23,0,24,1
1708246566413,ECE 140B,A03,455354,Khoshabeh; Ramsin & Gessner; Richard K.,21,0,22,1
1708246566955,ECE 141B,A01,455355,Gessner; Richard K.,48,0,50,2
1708246567485,ECE 148,A01,492803,Silberman; Jack,0,0,0,0
1708246568013,ECE 153,A01,429655,Naghizadeh Ardabili; Parin,94,0,100,6
1708246568542,ECE 157A,A01,429657,Bharadia; Dinesh,22,0,25,3
1708246569068,ECE 158B,A01,429659,Zhang; Xinyu,14,0,20,6
1708246569594,ECE 161C,A00,429660,Cosman; Pamela C.,58,0,60,2
1708246570120,ECE 163,A00,429664,Hsueh; Tzu-Chien,95,0,100,5
1708246570646,ECE 165,A51,429672,Mercier; Patrick Philip,20,0,30,10
1708246570646,ECE 165,A52,429673,Mercier; Patrick Philip,22,0,30,8
1708246570646,ECE 165,A53,429674,Mercier; Patrick Philip,30,0,30,0
1708246570646,ECE 165,A54,429675,Mercier; Patrick Philip,30,0,30,0
1708246571172,ECE 171A,A01,429813,Zheng; Yang,96,0,100,4
1708246571702,ECE 175B,A01,429886,Xie; Pengtao,72,0,75,3
1708246572226,ECE 183,A01,430023,Mookherjea; Shayan,26,0,30,4
1708246572751,ECE 185,A01,430025,Papen; George C.,19,0,20,1
1708246573276,ECE 191,A00,430039,Zhang; Xinyu,30,0,30,0
1708246573805,ECE 196,A00,430040,Morris; Karcher William,18,0,24,6
1708246573805,ECE 196,B00,430045,Morris; Karcher William,23,0,24,1
1708246574334,ECE 198,001,430052,Nguyen; Truong Quang,9999,0,9999,0
1708246574927,ECE 200,001,438659,Atanasov; Nikolay A.,9999,0,9999,0
1708246574927,ECE 200,002,438660,Bharadia; Dinesh,9999,0,9999,0
1708246574927,ECE 200,003,438668,Cheng; Chung Kuan,9999,0,9999,0
1708246574927,ECE 200,004,438845,Cosman; Pamela C.,9999,0,9999,0
1708246574927,ECE 200,005,438846,Dayeh; Shadi Ahmad,9999,0,9999,0
1708246574927,ECE 200,006,438847,Fainman; Yeshaiahu,9999,0,9999,0
1708246574927,ECE 200,007,438848,Ford; Joseph Earl,9999,0,9999,0
1708246574927,ECE 200,008,438849,Franceschetti; Massimo,9999,0,9999,0
1708246574927,ECE 200,009,438850,Fullerton; Eric E,9999,0,9999,0
1708246574927,ECE 200,010,438851,Galton; Ian A,9999,0,9999,0
1708246574927,ECE 200,011,438852,Gilja; Vikash,9999,0,9999,0
1708246574927,ECE 200,012,438853,Hall; Drew A.,9999,0,9999,0
1708246574927,ECE 200,013,438854,Hsueh; Tzu-Chien,9999,0,9999,0
1708246574927,ECE 200,014,438855,Javidi; Tara,9999,0,9999,0
1708246574927,ECE 200,015,438865,Kahng; Andrew Byun,9999,0,9999,0
1708246574927,ECE 200,016,438866,Kim; Young-Han,9999,0,9999,0
1708246574927,ECE 200,017,438876,Koushanfar; Farinaz,9999,0,9999,0
1708246574927,ECE 200,018,438877,Kuzum; Duygu,9999,0,9999,0
1708246574927,ECE 200,019,438934,Le; Hanh-Phuc,9999,0,9999,0
1708246574927,ECE 200,020,438954,Lin; Bill,9999,0,9999,0
1708246574927,ECE 200,021,438955,Liu; Zhaowei,9999,0,9999,0
1708246574927,ECE 200,022,438957,Lo; Yu-Hwa,9999,0,9999,0
1708246574927,ECE 200,023,439086,Lomakin; Vitaliy,9999,0,9999,0
1708246574927,ECE 200,024,439087,Mercier; Patrick Philip,9999,0,9999,0
1708246574927,ECE 200,025,439088,Meyer; Florian,9999,0,9999,0
1708246574927,ECE 200,026,439090,Milstein; Laurence B.,9999,0,9999,0
1708246574927,ECE 200,027,439208,Mir Arabbaygi; Siavash,9999,0,9999,0
1708246574927,ECE 200,028,439209,Mookherjea; Shayan,9999,0,9999,0
1708246574927,ECE 200,029,439210,Morris; Karcher William,9999,0,9999,0
1708246574927,ECE 200,030,439211,Ng; Tse Nga,9999,0,9999,0
1708246574927,ECE 200,031,439219,Nguyen; Truong Quang,9999,0,9999,0
1708246574927,ECE 200,032,439220,Nomura; Kenji,9999,0,9999,0
1708246574927,ECE 200,033,439221,Orlitsky; Alon,9999,0,9999,0
1708246574927,ECE 200,034,439222,Pal; Piya,9999,0,9999,0
1708246574927,ECE 200,035,439223,Papen; George C.,9999,0,9999,0
1708246574927,ECE 200,036,439224,Radic; Stojan,9999,0,9999,0
1708246574927,ECE 200,037,439225,Rao; Bhaskar D.,9999,0,9999,0
1708246574927,ECE 200,038,439227,Rao; Ramesh R,9999,0,9999,0
1708246574927,ECE 200,039,439231,Rebeiz; Gabriel,9999,0,9999,0
1708246574927,ECE 200,040,439232,Sanford; John R,9999,0,9999,0
1708246574927,ECE 200,041,439302,Siegel; Paul H.,9999,0,9999,0
1708246574927,ECE 200,042,439303,Sievenpiper; Daniel F.,9999,0,9999,0
1708246574927,ECE 200,043,439305,Sworder; David D.,9999,0,9999,0
1708246574927,ECE 200,044,439306,Taur; Yuan,9999,0,9999,0
1708246574927,ECE 200,045,439419,Touri; Behrouz,9999,0,9999,0
1708246574927,ECE 200,046,439425,Trivedi; Mohan M.,9999,0,9999,0
1708246574927,ECE 200,047,439538,Vasconcelos; Nuno,9999,0,9999,0
1708246574927,ECE 200,048,439546,Wang; Xiaolong,9999,0,9999,0
1708246574927,ECE 200,049,439549,Xie; Pengtao,9999,0,9999,0
1708246574927,ECE 200,050,439551,Yip; Michael,9999,0,9999,0
1708246574927,ECE 200,051,439553,Zeger; Kenneth A.,9999,0,9999,0
1708246574927,ECE 200,052,439554,Zhang; Xinyu,9999,0,9999,0
1708246574927,ECE 200,053,439555,Zheng; Yang,9999,0,9999,0
1708246574927,ECE 200,054,439557,Turakhia; Yatish Girish,9999,0,9999,0
1708246574927,ECE 200,055,439558,Kang; Mingu,9999,0,9999,0
1708246574927,ECE 200,056,439560,Shi; Yuanyuan,9999,0,9999,0
1708246574927,ECE 200,057,439564,Wang; Edward Jay,9999,0,9999,0
1708246574927,ECE 200,058,439565,Antipa; Nicholas A,9999,0,9999,0
1708246574927,ECE 200,059,439566,Zheng; Yang,9999,0,9999,0
1708246574927,ECE 200,060,492991,Yu; Paul K L,9999,0,9999,0
1708246574927,ECE 200,061,492992,Ndao; Abdoulaye,9999,0,9999,0
1708246574927,ECE 200,062,493019,Naghizadeh Ardabili; Parin,9999,0,9999,0
1708246574927,ECE 200,063,493033,Sahay; Rajeev,9999,0,9999,0
1708246575456,ECE 208,A00,430053,Mir Arabbaygi; Siavash,0,0,0,0
1708246575997,ECE 212CN,A00,430054,Liu; Zhaowei,0,0,0,0
1708246576526,ECE 222C,A00,430055,Lomakin; Vitaliy,0,0,0,0
1708246577054,ECE 227,A00,430057,Franceschetti; Massimo,0,0,0,0
1708246577582,ECE 228,A00,430078,Shi; Yuanyuan,0,0,0,0
1708246578109,ECE 230C,A00,430079,Yu; Paul K L,0,0,0,0
1708246578634,ECE 235,A00,430081,Taur; Yuan,0,0,0,0
1708246579162,ECE 236B,A00,430082,Lo; Yu-Hwa,0,0,0,0
1708246579687,ECE 240C,A00,430083,Mookherjea; Shayan,0,0,0,0
1708246580215,ECE 250,A00,430115,Touri; Behrouz,0,0,0,0
1708246580740,ECE 251B,A00,430166,Vasconcelos; Manuela,0,0,0,0
1708246581264,ECE 258B,A00,430167,Milstein; Laurence B.,0,0,0,0
1708246581791,ECE 260C,A00,430168,Eldon; John,0,0,0,0
1708246582317,ECE 264B,A00,430169,Galton; Ian A,0,0,0,0
1708246582842,ECE 265B,A00,430170,Gudem; Prasad S.S.,0,0,0,0
1708246583371,ECE 266,A01,430273,Hall; Drew A.,0,0,0,0
1708246583898,ECE 271C,A00,430283,Vasconcelos; Nuno,0,0,0,0
1708246584423,ECE 272A,A01,430340,Poveda Fonseca; Jorge,0,0,0,0
1708246584952,ECE 273,A00,430352,Wang; Jun-Kun,0,0,0,0
1708246585481,ECE 276B,A00,430353,Atanasov; Nikolay A.,0,0,0,0
1708246586009,ECE 284,A00,430385,Wang; Edward,0,0,0,0
1708246586535,ECE 285,A00,430386,Wang; Xiaolong,0,0,0,0
1708246586535,ECE 285,B00,430387,Antipa; Nicholas A,0,0,0,0
1708246587060,ECON 1,A01,409576,Crane; Meredith Helen,87,0,100,13
1708246587060,ECON 1,A02,409577,Crane; Meredith Helen,96,0,100,4
1708246587060,ECON 1,A03,409578,Crane; Meredith Helen,97,0,100,3
1708246587586,ECON 2,A01,409580,Candido; Maria Teresa,70,0,75,5
1708246588110,ECON 3,A01,409582,Crane; Meredith Helen,109,0,120,11
1708246588110,ECON 3,A02,409583,Crane; Meredith Helen,114,0,115,1
1708246588110,ECON 3,A03,409584,Crane; Meredith Helen,110,0,115,5
1708246588637,ECON 4,A01,409586,Levkoff; Steven B.,88,0,92,4
1708246588637,ECON 4,A02,409587,Levkoff; Steven B.,89,0,90,1
1708246589165,ECON 5,A01,409589,Dai; Yinlin,53,0,58,5
1708246589165,ECON 5,A02,409590,Dai; Yinlin,56,0,58,2
1708246589165,ECON 5,A03,409591,Dai; Yinlin,54,0,54,0
1708246589165,ECON 5,A04,409593,Dai; Yinlin,55,0,55,0
1708246589165,ECON 5,B01,409595,Dai; Yinlin,57,0,58,1
1708246589165,ECON 5,B02,409596,Dai; Yinlin,49,0,49,0
1708246589165,ECON 5,B03,409597,Dai; Yinlin,59,0,59,0
1708246589165,ECON 5,B04,409598,Dai; Yinlin,55,0,55,0
1708246589165,ECON 5,C01,487209,Staff,40,0,45,5
1708246589709,ECON 100A,A01,409600,Famulari; Melissa,94,0,100,6
1708246589709,ECON 100A,A02,409601,Famulari; Melissa,98,0,100,2
1708246589709,ECON 100A,A03,409604,Famulari; Melissa,98,0,100,2
1708246589709,ECON 100A,B01,409610,Famulari; Melissa,76,0,80,4
1708246590250,ECON 100AH,A00,409612,Famulari; Melissa,19,0,20,1
1708246591034,ECON 100B,A01,409614,Grigoryan; Aram,109,0,120,11
1708246591034,ECON 100B,A02,409616,Grigoryan; Aram,117,0,120,3
1708246591034,ECON 100B,B01,409626,Grigoryan; Aram,47,0,50,3
1708246591034,ECON 100B,B02,409627,Grigoryan; Aram,49,0,50,1
1708246591561,ECON 100C,A01,409629,Levkoff; Steven B.,144,0,146,2
1708246591561,ECON 100C,B01,409632,Levkoff; Steven B.,143,0,146,3
1708246592090,ECON 106,A00,409633,Bowen; T. Renee,90,0,90,0
1708246592615,ECON 109T,A00,409634,Trevino; Isabel,18,0,20,2
1708246593143,ECON 110A,A01,409637,Staff,68,0,75,7
1708246593669,ECON 110B,A01,409663,Herreno Lopera; Juan,119,0,125,6
1708246593669,ECON 110B,A02,409682,Herreno Lopera; Juan,125,0,125,0
1708246593669,ECON 110B,B01,409734,Herreno Lopera; Juan,99,0,100,1
1708246594212,ECON 120A,A01,409739,Candido; Maria Teresa,84,0,90,6
1708246594212,ECON 120A,A02,409740,Candido; Maria Teresa,87,0,90,3
1708246594212,ECON 120A,B01,409742,Candido; Maria Teresa,85,0,90,5
1708246594212,ECON 120A,B02,409743,Candido; Maria Teresa,90,0,90,0
1708246594757,ECON 120B,A01,409748,Ma; Xinwei,128,0,130,2
1708246594757,ECON 120B,A02,409754,Ma; Xinwei,128,0,130,2
1708246594757,ECON 120B,B01,409756,Ma; Xinwei,26,0,40,14
1708246595298,ECON 120C,A01,409758,Sun; Yixiao,141,0,146,5
1708246595298,ECON 120C,B01,409762,Sun; Yixiao,144,0,146,2
1708246595827,ECON 129,A00,409763,Eckert; Fabian Paul,44,0,50,6
1708246596354,ECON 134,A00,409764,Gelber; Alexander Michael,45,0,50,5
1708246596354,ECON 134,B00,409765,Gelber; Alexander Michael,49,0,50,1
1708246596879,ECON 137,A00,409766,Niehaus; Paul,19,0,20,1
1708246597408,ECON 142,A00,409767,Trevino; Isabel,39,0,40,1
1708246597408,ECON 142,B00,409768,Trevino; Isabel,38,0,40,2
1708246597933,ECON 164,A00,409771,Muralidharan; Karthik,119,0,120,1
1708246598462,ECON 172A,A01,409773,Newhouse; Herbert S,67,0,75,8
1708246599007,ECON 172B,A01,409775,Newhouse; Herbert S,74,0,75,1
1708246599007,ECON 172B,B01,409777,Newhouse; Herbert S,71,0,75,4
1708246600061,ECON 191A,A00,409780,Cullen; Julie,20,0,20,0
1708246600585,ECON 200C,A00,409782,Du; Songzi,34,0,35,1
1708246601114,ECON 210C,A00,409784,Herreno Lopera; Juan & Wieland; Johannes Friedrich,35,0,35,0
1708246601640,ECON 220C,A00,409785,Sun; Yixiao,35,0,35,0
1708246602166,ECON 220F,A00,409786,Carson; Richard T,27,0,30,3
1708246602709,ECON 221,A00,409787,Zhu; Ying,25,0,25,0
1708246603249,ECON 241,A00,409788,Muralidharan; Karthik,18,0,20,2
1708246603828,ECON 243,A00,409789,Niehaus; Paul,18,0,20,2
1708246604355,ECON 248,A00,409790,Eckert; Fabian Paul,18,0,20,2
1708246604884,ECON 250C,A00,409791,Arnold; David Hall & Betts; Julian,25,0,25,0
1708246605410,ECON 268,A00,409792,Jacobsen; Mark,24,0,25,1
1708246605936,ECON 281,A00,409793,Meckel; Katherine Hunter,19,0,20,1
1708246605936,ECON 281,B00,409794,Herreno Lopera; Juan & Wieland; Johannes Friedrich,19,0,20,1
1708246605936,ECON 281,C00,477854,Herreno Lopera; Juan & Wieland; Johannes Friedrich,18,0,20,2
1708246606462,ECON 285,A00,409795,Eckert; Fabian Paul,20,0,20,0
1708246606987,ECON 286,A00,409796,Ma; Xinwei,15,0,15,0
1708246606987,ECON 286,B00,409797,Hamilton; James D.,15,0,15,0
1708246606987,ECON 286,C00,409798,Grigoryan; Aram,15,0,15,0
1708246606987,ECON 286,D00,409799,Niehaus; Paul,15,0,15,0
1708246607514,ECON 296,A00,409800,Eckert; Fabian Paul,20,0,20,0
1708246608038,EDS 31,A00,409801,Bussey; Thomas J,9,0,10,1
1708246608564,EDS 38,A01,409803,Chung; Luz Marina,25,0,25,0
1708246609092,EDS 39,A01,409805,Heinzman; Erica M.,24,0,25,1
1708246609616,EDS 102,A01,409807,Ambo; Theresa Jean,37,0,45,8
1708246610144,EDS 110R,A01,409809,Staff,42,0,50,8
1708246610144,EDS 110R,B01,481358,Staff,20,0,20,0
1708246610671,EDS 111,A00,479044,Wishard Guerra; Alison G.,56,0,60,4
1708246611198,EDS 117,A01,409818,Jones; Gabrielle Anastasia,21,0,23,2
1708246611198,EDS 117,A02,409819,Jones; Gabrielle Anastasia,23,0,23,0
1708246611198,EDS 117,A03,409820,Jones; Gabrielle Anastasia,22,0,23,1
1708246611198,EDS 117,A04,409821,Jones; Gabrielle Anastasia,21,0,21,0
1708246611723,EDS 118,A00,409828,Warstadt; Melissa Fawn,46,0,50,4
1708246612248,EDS 123,A00,409831,Bussey; Thomas J,10,0,10,0
1708246612773,EDS 124AR,A00,419352,Simon; Elizabeth A,82,0,100,18
1708246612773,EDS 124AR,B00,419377,Simon; Elizabeth A,97,0,100,3
1708246612773,EDS 124AR,C00,481485,Simon; Elizabeth A,25,0,25,0
1708246612773,EDS 124AR,D00,481490,Simon; Elizabeth A,25,0,25,0
1708246613301,EDS 124BR,A00,409838,Eguchi; Emi,53,0,75,22
1708246613301,EDS 124BR,B00,481363,Eguchi; Emi,25,0,25,0
1708246613826,EDS 125,A00,409839,Aragon; Maria Jose,48,0,50,2
1708246614354,EDS 126,A01,409843,Jones; Makeba,19,0,25,6
1708246614354,EDS 126,A02,409844,Jones; Makeba,25,0,25,0
1708246614354,EDS 126,A03,409846,Jones; Makeba,25,0,25,0
1708246614354,EDS 126,A04,409847,Jones; Makeba,25,0,25,0
1708246614880,EDS 128B,A01,409851,Pappas; Elizabeth,49,0,50,1
1708246615406,EDS 129C,A01,409906,Millstone; Rachel Diana,44,0,50,6
1708246615934,EDS 130,A01,409954,Mendez; Kathrina Mendoza,14,0,15,1
1708246615934,EDS 130,A02,409955,Mendez; Kathrina Mendoza,24,0,25,1
1708246615934,EDS 130,A03,409956,Mendez; Kathrina Mendoza,20,0,20,0
1708246616461,EDS 133,A01,409961,Bintliff; Amy S.V.,15,0,20,5
1708246616461,EDS 133,A02,409962,Bintliff; Amy S.V.,20,0,20,0
1708246616461,EDS 133,A03,489636,Bintliff; Amy S.V.,15,0,15,0
1708246616990,EDS 136,A01,409964,Chung; Luz Marina,30,0,30,0
1708246616990,EDS 136,A02,409977,Chung; Luz Marina,30,0,30,0
1708246617515,EDS 139,A00,479197,Millstone; Rachel Diana,42,0,50,8
1708246617515,EDS 139,B00,479198,Pappas; Elizabeth,49,0,50,1
1708246617515,EDS 139,C00,479199,Mendez; Kathrina Mendoza,58,0,60,2
1708246617515,EDS 139,D00,479200,Bintliff; Amy S.V.,56,0,60,4
1708246617515,EDS 139,E00,479201,Chung; Luz Marina,59,0,60,1
1708246617515,EDS 139,F00,479202,Bintliff; Amy S.V.,15,0,15,0
1708246617515,EDS 139,G00,479203,Mamas; Christoforos,27,0,30,3
1708246617515,EDS 139,H00,493997,Choi; Bailey Miyeon,28,0,30,2
1708246618040,EDS 141,A00,409979,Mamas; Christoforos,38,0,40,2
1708246618566,EDS 145,A01,409989,Choi; Bailey Miyeon,13,0,15,2
1708246618566,EDS 145,A02,409990,Choi; Bailey Miyeon,15,0,15,0
1708246619092,EDS 180,A00,409991,Chapman; Thandeka K,30,0,30,0
1708246619092,EDS 180,B00,409992,Ambo; Theresa Jean,24,0,25,1
1708246619092,EDS 180,C00,409993,Jones; Gabrielle Anastasia,20,0,20,0
1708246619092,EDS 180,D00,409994,Phuong; Andrew,24,0,24,0
1708246619616,EDS 198,001,487216,Eguchi; Emi,20,0,20,0
1708246620143,EDS 205B,A00,409995,Staff,40,0,45,5
1708246620143,EDS 205B,B00,409997,Staff,42,0,45,3
1708246620669,EDS 232,A00,409999,Hopkins; Megan Beth,9,0,12,3
1708246621194,EDS 255,A00,410001,Phuong; Andrew,14,0,15,1
1708246621720,EDS 257,A00,410003,Datnow; Amanda Lee,14,0,15,1
1708246622248,EDS 282,A00,479192,Daly; Alan J.,16,0,16,0
1708246622775,EDS 287B,A00,479193,Daly; Alan J.,16,0,16,0
1708246623300,EDS 288A,A00,410005,Staff,18,0,18,0
1708246623827,EDS 288C,A00,410007,Staff,18,0,18,0
1708246624355,EDS 289B,A01,410009,Daly; Alan J.,18,0,18,0
1708246624880,EDS 290,A00,410010,Black; Alison Michelle,30,0,30,0
1708246624880,EDS 290,B00,410012,Choi; Bailey Miyeon,29,0,30,1
1708246624880,EDS 290,C00,479205,Heinzman; Erica M.,0,0,0,0
1708246625408,EDS 291B,A01,479195,Daly; Alan J.,16,0,16,0
1708246625932,EDS 293B,A01,410016,Staff,18,0,18,0
1708246626457,EDS 294B,A00,479196,Burrell; Sade Renee,16,0,16,0
1708246626988,EDS 296,001,478927,Ambo; Theresa Jean,0,0,0,0
1708246626988,EDS 296,002,478935,Aragon; Maria Jose,0,0,0,1
1708246626988,EDS 296,003,478936,Chapman; Thandeka K,0,0,0,0
1708246626988,EDS 296,004,478942,Bintliff; Amy S.V.,0,0,0,0
1708246626988,EDS 296,005,478943,Clarke; Sherice Nicole,0,0,0,0
1708246626988,EDS 296,006,478967,Cohen; Shana R,0,0,0,1
1708246626988,EDS 296,007,478968,Datnow; Amanda Lee,0,0,0,0
1708246626988,EDS 296,008,478969,Daly; Alan J.,0,0,0,0
1708246626988,EDS 296,009,478970,Eguchi; Emi,0,0,0,0
1708246626988,EDS 296,010,478971,Fine; Sarah,0,0,0,0
1708246626988,EDS 296,011,478972,Jones; Gabrielle Anastasia,0,0,0,0
1708246626988,EDS 296,012,479020,Jones; Makeba,0,0,0,0
1708246626988,EDS 296,013,479021,Halter; Christopher P.,0,0,0,0
1708246626988,EDS 296,014,479027,Hofstetter; Carolyn,0,0,0,0
1708246626988,EDS 296,015,479028,Hopkins; Megan Beth,0,0,0,0
1708246626988,EDS 296,016,479034,Mamas; Christoforos,0,0,0,0
1708246626988,EDS 296,017,479035,Pollock; Mica,0,0,0,0
1708246626988,EDS 296,018,479036,Wishard Guerra; Alison G.,0,0,0,0
1708246626988,EDS 296,019,494549,Phuong; Andrew,0,0,0,0
1708246627516,EMED 296,001,464428,Singh; Sukhdeep,49,0,50,1
1708246627516,EMED 296,002,464438,Subramony; Rachna,49,0,50,1
1708246627516,EMED 296,003,464490,Staff,50,0,50,0
1708246628044,ENG 10,A00,399006,Evdokimenko; Ekaterina,30,0,30,0
1708246628572,ENG 100D,A00,399084,Ngo; Anh-Thu T.,33,0,50,17
1708246629097,ENG 100DR,A00,479230,Ngo; Anh-Thu T.,29,0,40,11
1708246629623,ENG 100L,A00,399163,Kleissl; Jan,6,0,6,0
1708246629623,ENG 100L,B00,399217,Bratton; Maryann,8,0,8,0
1708246629623,ENG 100L,C00,399218,Yu; Paul K L,8,0,8,0
1708246629623,ENG 100L,D00,399257,Bratton; Maryann,6,0,6,0
1708246629623,ENG 100L,E00,399258,de Oliveira; Mauricio,9,0,10,1
1708246629623,ENG 100L,F00,399314,Bratton; Maryann,7,0,7,0
1708246629623,ENG 100L,G00,399394,Boyle; Mary E. T.,14,0,15,1
1708246630154,ENVR 102,A00,400777,Daly; Heather Marie,19,0,20,1
1708246630154,ENVR 102,B00,400778,Montejo; Carolina,24,0,25,1
1708246630154,ENVR 102,C00,400791,Staff,23,0,25,2
1708246630679,ENVR 140,A01,400813,Siapno; Jacqueline A,12,0,15,3
1708246630679,ENVR 140,A02,400870,Siapno; Jacqueline A,15,0,15,0
1708246630679,ENVR 140,A03,400889,Siapno; Jacqueline A,15,0,15,0
1708246630679,ENVR 140,A04,400890,Siapno; Jacqueline A,15,0,15,0
1708246631204,ENVR 144,A01,400929,Herbst; Matthew,20,0,20,0
1708246631730,ERC 20,A00,400722,Evans; Ivan T,30,0,30,0
1708246632255,ESYS 103,A01,400931,Lerner; Amy M,32,0,34,2
1708246632255,ESYS 103,A02,400934,Lerner; Amy M,34,0,34,0
1708246632255,ESYS 103,A03,400938,Lerner; Amy M,28,0,34,6
1708246632255,ESYS 103,A04,400939,Lerner; Amy M,33,0,34,1
1708246632255,ESYS 103,A05,400940,Lerner; Amy M,34,0,34,0
1708246632255,ESYS 103,A06,400941,Lerner; Amy M,33,0,34,1
1708246632781,ESYS 187C,A01,400945,Hetherington; Elizabeth Dorsey,28,0,40,12
1708246632781,ESYS 187C,A02,400946,Hetherington; Elizabeth Dorsey,39,0,40,1
1708246633311,ETHN 3R,A01,400948,Streeby; Shelley,21,0,25,4
1708246633311,ETHN 3R,A02,401220,Streeby; Shelley,24,0,25,1
1708246633311,ETHN 3R,A03,401231,Streeby; Shelley,22,0,25,3
1708246633311,ETHN 3R,A04,401236,Streeby; Shelley,23,0,25,2
1708246633311,ETHN 3R,A05,401241,Streeby; Shelley,21,0,25,4
1708246633311,ETHN 3R,A06,401311,Streeby; Shelley,21,0,25,4
1708246633311,ETHN 3R,A07,401318,Streeby; Shelley,25,0,25,0
1708246633311,ETHN 3R,A08,401319,Streeby; Shelley,25,0,25,0
1708246633311,ETHN 3R,A09,401397,Streeby; Shelley,25,0,25,0
1708246633311,ETHN 3R,A10,401398,Streeby; Shelley,25,0,25,0
1708246633311,ETHN 3R,A11,401399,Streeby; Shelley,24,0,25,1
1708246633311,ETHN 3R,A12,401518,Streeby; Shelley,25,0,25,0
1708246633311,ETHN 3R,A13,401551,Streeby; Shelley,24,0,25,1
1708246633311,ETHN 3R,A14,401552,Streeby; Shelley,23,0,25,2
1708246633835,ETHN 30,A01,401554,Fuste; Jose Ignacio,24,0,25,1
1708246633835,ETHN 30,A02,401555,Fuste; Jose Ignacio,25,0,25,0
1708246633835,ETHN 30,A03,401556,Fuste; Jose Ignacio,25,0,25,0
1708246633835,ETHN 30,A04,401557,Fuste; Jose Ignacio,25,0,25,0
1708246634359,ETHN 100C,A00,401558,Museus; Samuel David,36,0,40,4
1708246634889,ETHN 101TV,A01,401560,Marez; Curtis F.,21,0,25,4
1708246634889,ETHN 101TV,A02,401564,Marez; Curtis F.,25,0,25,0
1708246635416,ETHN 108,A00,401584,Hankins; Sarah E.,25,0,29,4
1708246635945,ETHN 113A,A00,401657,Werner; Bradley T.,15,0,15,0
1708246636471,ETHN 114B,A00,401724,Frank; Ross H.,19,0,20,1
1708246636997,ETHN 120D,A01,401848,Alvarez; Luis A,8,0,10,2
1708246636997,ETHN 120D,A02,401853,Alvarez; Luis A,10,0,10,0
1708246637522,ETHN 125R,A00,401858,Sasaki; Christen T,39,0,50,11
1708246638047,ETHN 126,A00,401865,Tran; Ly Thi Hai,39,0,40,1
1708246638577,ETHN 127,A00,401866,Martin Sandino; Amanda Maria Yoland,24,0,25,1
1708246639102,ETHN 137,A00,401867,Martin Sandino; Amanda Maria Yoland,19,0,19,0
1708246639631,ETHN 139,A00,401992,Perreira; Christopher Michael,25,0,25,0
1708246640160,ETHN 143,A00,402059,Marez; Curtis F.,39,0,40,1
1708246640685,ETHN 144M,A00,402060,Jolivette; Andrew J,62,0,65,3
1708246641209,ETHN 150,A00,402158,Taylor-Garcia; Daphne,16,0,18,2
1708246641735,ETHN 153,A00,402160,Martinez-Matsuda; Veronica,24,0,25,1
1708246642261,ETHN 179,A00,402165,Richards; Stephanie F,23,0,25,2
1708246642790,ETHN 183,A00,402217,Steelman; Katherine Wallis,16,0,16,0
1708246643317,ETHN 186,A00,402313,Perez; Roy,15,0,15,0
1708246643841,ETHN 189,A00,479226,Museus; Samuel David,29,0,30,1
1708246644370,ETHN 196H,A00,402314,Espiritu; Yen,0,0,0,0
1708246644370,ETHN 196H,B00,402325,Perreira; Christopher Michael,0,0,0,0
1708246644370,ETHN 196H,C00,402344,Perez; Roy,0,0,0,0
1708246644370,ETHN 196H,D00,402345,Streeby; Shelley,0,0,0,0
1708246644370,ETHN 196H,E00,402346,Taylor-Garcia; Daphne,0,0,0,0
1708246644895,ETHN 200C,A00,402358,Fuste; Jose Ignacio,19,0,20,1
1708246645423,ETHN 230,A00,402359,Streeby; Shelley,16,0,20,4
1708246645951,ETHN 291,A00,402363,Perreira; Christopher Michael,16,0,20,4
1708246646479,EXPR 100,A00,477778,Staff,9999,0,9999,0
1708246647003,EXPR 105,A00,477779,Staff,9999,0,9999,0
1708246647530,EXPR 201,A00,477780,Staff,9999,0,9999,0
1708246648056,EXPR 205,A00,477781,Staff,9999,0,9999,0
1708246648581,FILM 87,A00,402794,Rahimi; Babak,19,0,20,1
1708246648581,FILM 87,B00,402796,Rahimi; Babak,20,0,20,0
1708246648581,FILM 87,C00,402821,Havis; Allan,19,0,20,1
1708246649107,FMPH 95,A00,481734,Larsen; Britta Ann,0,0,0,2
1708246649635,FMPH 101,A00,404648,Tan; Gene Brian,31,0,40,9
1708246650159,FMPH 102,A01,404692,Rana; Brinda Kanti,25,0,28,3
1708246650159,FMPH 102,A02,404714,Rana; Brinda Kanti,28,0,28,0
1708246650159,FMPH 102,B01,404739,Rana; Brinda Kanti,26,0,28,2
1708246650159,FMPH 102,B02,404746,Rana; Brinda Kanti,28,0,28,0
1708246650685,FMPH 110,A00,404747,Campbell; Chadwick Karl,52,0,55,3
1708246650685,FMPH 110,B00,404789,Zoumas-Morse; Christine E.,24,0,30,6
1708246651214,FMPH 120,A00,404792,Nguyen-Grozavu; France T.,48,0,60,12
1708246651744,FMPH 130,A00,404859,Gould; Carlos Francisco,49,0,55,6
1708246651744,FMPH 130,B00,479047,Ciborowski; Haley Minae,52,0,55,3
1708246652269,FMPH 155,A00,404864,Fielding-Miller; Rebecca,65,0,65,0
1708246652792,FMPH 161,A00,404865,Zoumas-Morse; Christine E.,27,0,35,8
1708246653319,FMPH 191,A00,404866,Eikey; Elizabeth Victoria,35,0,35,0
1708246653851,FMPH 194,A00,404938,Larsen; Britta Ann,0,0,0,0
1708246653851,FMPH 194,B00,404939,Marquez; Becky,0,0,0,0
1708246653851,FMPH 194,C00,404949,Nguyen-Grozavu; France T.,0,0,0,0
1708246653851,FMPH 194,D00,404950,Stone; Matthew David,0,0,0,0
1708246653851,FMPH 194,E00,404958,White; Anne Elizabeth Clar,0,0,0,0
1708246653851,FMPH 194,F00,404969,Zoumas-Morse; Christine E.,0,0,0,0
1708246654376,FMPH 223,A00,404977,Vaida; Florin,8,0,26,18
1708246654901,FMPH 225,A00,404978,Zou; Jingjing,0,0,0,0
1708246655430,FMPH 291,A00,404992,Salem; Rany Mansour,15,0,15,0
1708246655430,FMPH 291,C00,405005,Schwartzman; Armin,0,0,0,10
1708246655430,FMPH 291,D00,479113,Shadyab; Aladdin Hassan,0,0,0,0
1708246655430,FMPH 291,E00,479114,Shadyab; Aladdin Hassan,0,0,0,0
1708246655430,FMPH 291,F00,479115,Wynn; Adriane Michelle,0,0,0,3
1708246655430,FMPH 291,G00,479116,Xu; Ronghui,0,0,0,10
1708246655430,FMPH 291,H00,479119,Vaida; Florin,0,0,0,2
1708246655959,FPM 258C,A00,405129,Chen; Brian Hwa-Yang,11,0,15,4
1708246656488,FPM 259C,A00,405130,Nguyen; Annie Lu & Araneta; Maria Rosario Gorrez,4,0,5,1
1708246657091,FPM 278,A00,405131,Strong; David R,13,0,15,2
1708246657615,FPM 280C,A01,405133,Banegas; Matthew Patrick,10,0,10,0
1708246658140,FPM 296,001,464651,Johnson; Michelle Lee,49,0,50,1
1708246658140,FPM 296,002,464652,Staff,50,0,50,0
1708246658140,FPM 296,003,464653,Staff,50,0,50,0
1708246658668,FPM 297,001,479175,Vaida; Florin,9999,0,9999,0
1708246658668,FPM 297,002,494007,Strong; David R,9999,0,9999,0
1708246658668,FPM 297,003,494364,Bazzi; Angela Robertson,9999,0,9999,0
1708246659193,GLBH 20,A00,405134,Elwardani; Nile Regina,143,0,146,3
1708246659721,GLBH 100,A00,405135,Bhavsar; Radhika,68,0,70,2
1708246659721,GLBH 100,B00,477773,Villarino; Margarita,39,0,44,5
1708246659721,GLBH 100,C00,477855,Jenkins; Janis A.,20,0,20,0
1708246659721,GLBH 100,D00,481337,Mishra; Jyoti,40,0,40,0
1708246660249,GLBH 101,A00,405136,Sloane; Julia Kathryn,40,0,40,0
1708246660777,GLBH 107,A00,405137,Wilson; Brenda K,63,0,70,7
1708246661305,GLBH 111,A01,486865,Burgos; Jose L.,0,0,0,0
1708246661305,GLBH 111,B01,486867,Burgos; Jose L.,0,0,0,0
1708246661830,GLBH 114W,A00,405138,Walkover; Lillian B,17,0,17,0
1708246662355,GLBH 118,A00,405140,Wilson; Brenda K,31,0,32,1
1708246662881,GLBH 147,A00,405141,Stewart; Alexander B,40,0,40,0
1708246663410,GLBH 148,A00,405142,Olivas Hernandez; Olga Lid,93,0,100,7
1708246663937,GLBH 150B,A00,486855,Sanchez; Giselle,0,0,0,0
1708246664464,GLBH 181,A00,405154,Burgos; Jose L.,211,0,216,5
1708246664991,GLBH 215,A00,479241,Walkover; Lillian B,18,0,18,0
1708246665519,GLBH 260,A00,480722,Elwardani; Nile Regina,18,0,18,0
1708246666048,GSS 20,A00,405155,Siapno; Jacqueline A,25,0,30,5
1708246666573,GSS 25,A00,405156,Batarseh; Amanda Alicia,24,0,30,6
1708246667099,HDS 1,A01,405160,Reese; Clarissa Jane,25,0,25,0
1708246667099,HDS 1,A02,405168,Reese; Clarissa Jane,25,0,25,0
1708246667099,HDS 1,A03,405169,Reese; Clarissa Jane,22,0,25,3
1708246667099,HDS 1,A04,405170,Reese; Clarissa Jane,24,0,25,1
1708246667099,HDS 1,A05,405171,Reese; Clarissa Jane,23,0,25,2
1708246667099,HDS 1,A06,405172,Reese; Clarissa Jane,24,0,25,1
1708246667099,HDS 1,A07,405173,Reese; Clarissa Jane,24,0,25,1
1708246667625,HDS 60,A01,405175,Warstadt; Melissa Fawn,34,0,35,1
1708246667625,HDS 60,A02,405176,Warstadt; Melissa Fawn,33,0,35,2
1708246668149,HDS 95,A00,405177,Staff,38,0,40,2
1708246668674,HDS 120,A00,405178,Staff,0,0,0,0
1708246669198,HDS 122,A00,405179,Rodriguez; Victoria Calip,64,0,75,11
1708246669725,HDS 150,A00,405180,Staff,20,0,20,0
1708246669725,HDS 150,B00,405181,Staff,20,0,20,0
1708246669725,HDS 150,C00,405182,Staff,20,0,20,0
1708246670251,HDS 181,A01,405185,Bjorklund; Peter,30,0,30,0
1708246670777,HDS 191,A01,405187,Reese; Clarissa Jane,40,0,40,0
1708246670777,HDS 191,B01,405194,Staff,25,0,25,0
1708246671301,HIAF 113,A00,403736,Prestholdt; Jeremy,74,0,75,1
1708246671828,HIAF 114,A00,403738,Gyamfi; Bright,49,0,50,1
1708246672353,HIEA 132,A00,403740,Kletzer; Benjamin Nathan,25,0,30,5
1708246672879,HIEA 154,A00,403741,Henry; Todd A.,62,0,64,2
1708246673406,HIEU 139,A00,403742,Strasser; Ulrike,52,0,56,4
1708246673932,HIEU 171,A00,403743,Hansen; Jan Eric,62,0,64,2
1708246674456,HIEU 176,A00,403744,Hertz; Deborah,14,0,15,1
1708246674984,HIEU 183,A00,403800,Gallant; Thomas W.,15,0,15,0
1708246675508,HIEU 276,A00,403862,Hertz; Deborah,0,0,0,0
1708246676032,HIGL 127,A00,403802,Ivey; James Alexander,56,0,56,0
1708246676557,HIGR 201,A00,494372,Pineda De Avila; Nydia,9,0,10,1
1708246677087,HIGR 205,A00,403863,Strasser; Ulrike,11,0,15,4
1708246677612,HIGR 217C,A00,403864,Lu; Weijing,9,0,10,1
1708246678140,HIGR 239,A00,403865,Serlin; David,4,0,5,1
1708246678664,HIGR 240,A00,403875,Gates; Kelly,2,0,5,3
1708246679193,HILA 101,A00,403818,LeNeave; Kimiko Nicole,62,0,64,2
1708246679716,HILA 119,A00,403819,Kozameh; Sara J,47,0,50,3
1708246680242,HILA 144,A00,403821,Kozameh; Sara J,50,0,50,0
1708246680772,HILD 2C,A01,402843,Hendrickson; Gerald M.,31,0,32,1
1708246680772,HILD 2C,A02,403030,Hendrickson; Gerald M.,31,0,32,1
1708246680772,HILD 2C,A03,403042,Hendrickson; Gerald M.,32,0,32,0
1708246680772,HILD 2C,A04,403048,Hendrickson; Gerald M.,30,0,32,2
1708246680772,HILD 2C,A05,403049,Hendrickson; Gerald M.,32,0,32,0
1708246680772,HILD 2C,A06,403098,Hendrickson; Gerald M.,32,0,32,0
1708246681301,HILD 7C,A01,403501,Bermudez; Rosie Cano,27,0,32,5
1708246681301,HILD 7C,A02,403513,Bermudez; Rosie Cano,30,0,32,2
1708246681301,HILD 7C,A03,403570,Bermudez; Rosie Cano,32,0,32,0
1708246681301,HILD 7C,A04,403572,Bermudez; Rosie Cano,32,0,32,0
1708246681301,HILD 7C,A05,403587,Bermudez; Rosie Cano,32,0,32,0
1708246681301,HILD 7C,A06,403588,Bermudez; Rosie Cano,32,0,32,0
1708246681301,HILD 7C,A07,403589,Bermudez; Rosie Cano,29,0,32,3
1708246681301,HILD 7C,A08,403590,Bermudez; Rosie Cano,32,0,32,0
1708246681301,HILD 7C,A09,403601,Bermudez; Rosie Cano,30,0,32,2
1708246681301,HILD 7C,A10,403602,Bermudez; Rosie Cano,32,0,32,0
1708246681301,HILD 7C,A11,403603,Bermudez; Rosie Cano,32,0,32,0
1708246681301,HILD 7C,A12,403604,Bermudez; Rosie Cano,32,0,32,0
1708246681828,HILD 12,A01,403607,Henry; Todd A.,32,0,32,0
1708246681828,HILD 12,A02,403608,Henry; Todd A.,31,0,32,1
1708246681828,HILD 12,A03,403609,Henry; Todd A.,32,0,32,0
1708246681828,HILD 12,A04,403699,Henry; Todd A.,32,0,32,0
1708246681828,HILD 12,A05,403700,Henry; Todd A.,32,0,32,0
1708246681828,HILD 12,A06,403701,Henry; Todd A.,32,0,32,0
1708246682353,HILD 30,A01,403703,Soleiman; Matthew Teymour,29,0,32,3
1708246682353,HILD 30,A02,403704,Soleiman; Matthew Teymour,30,0,32,2
1708246682878,HINE 118,A00,403822,Kayali; Hasan,50,0,50,0
1708246683407,HISC 119,A00,403823,Golan; Tal,26,0,30,4
1708246683935,HISC 123,A00,403839,Pineda De Avila; Nydia,45,0,50,5
1708246684460,HITO 87,A00,403707,Patterson; Patrick H.,15,0,15,0
1708246684460,HITO 87,B00,403709,Patterson; Patrick H.,15,0,15,0
1708246684460,HITO 87,C00,403735,Schneewind; Sarah,15,0,15,0
1708246684985,HITO 100,B00,403841,Klann; Mary Cameron,24,0,25,1
1708246685511,HITO 170,A00,403842,Watts; Edward J.,8,0,10,2
1708246686035,HITO 193,A00,455333,Hill; Seth J,0,0,0,0
1708246686564,HIUS 114A,A00,403843,Lewandoski; Julia Mavis,52,0,56,4
1708246687120,HIUS 120D,A01,403854,Alvarez; Luis A,8,0,10,2
1708246687120,HIUS 120D,A02,403855,Alvarez; Luis A,10,0,10,0
1708246687644,HIUS 136,A00,403857,Martinez-Matsuda; Veronica,21,0,25,4
1708246688171,HIUS 144,A00,403858,Martinez-Matsuda; Veronica,55,0,56,1
1708246688171,HIUS 144,B00,403859,Vandevelde; Kenneth Joseph,54,0,56,2
1708246688171,HIUS 144,C00,403860,Klann; Mary Cameron,52,0,56,4
1708246688171,HIUS 144,D00,403861,Lewandoski; Julia Mavis,55,0,56,1
1708246688716,HUM 2,A01,422723,Watts; Edward J.,16,0,16,0
1708246688716,HUM 2,A02,422735,Watts; Edward J.,15,0,16,1
1708246688716,HUM 2,A03,422736,Watts; Edward J.,15,0,16,1
1708246688716,HUM 2,A04,422737,Watts; Edward J.,16,0,16,0
1708246688716,HUM 2,A05,422738,Watts; Edward J.,15,0,16,1
1708246688716,HUM 2,A06,422760,Watts; Edward J.,15,0,16,1
1708246688716,HUM 2,A07,422778,Watts; Edward J.,16,0,16,0
1708246688716,HUM 2,A08,422793,Watts; Edward J.,16,0,16,0
1708246688716,HUM 2,A09,422794,Watts; Edward J.,16,0,16,0
1708246688716,HUM 2,A10,422795,Watts; Edward J.,16,0,16,0
1708246688716,HUM 2,B01,422805,Markman; Kristina,13,0,16,3
1708246688716,HUM 2,B02,422806,Markman; Kristina,14,0,16,2
1708246688716,HUM 2,B03,422807,Markman; Kristina,14,0,16,2
1708246688716,HUM 2,B04,422808,Markman; Kristina,16,0,16,0
1708246688716,HUM 2,B05,422809,Markman; Kristina,16,0,16,0
1708246688716,HUM 2,B06,422842,Markman; Kristina,16,0,16,0
1708246688716,HUM 2,B07,422843,Markman; Kristina,15,0,16,1
1708246688716,HUM 2,B08,422848,Markman; Kristina,16,0,16,0
1708246688716,HUM 2,B09,422850,Markman; Kristina,15,0,16,1
1708246688716,HUM 2,B10,422851,Markman; Kristina,12,0,16,4
1708246688716,HUM 2,B11,422852,Markman; Kristina,15,0,16,1
1708246688716,HUM 2,B12,422853,Markman; Kristina,16,0,16,0
1708246688716,HUM 2,C01,422855,Rodriguez; Bretton Sigfred,15,0,16,1
1708246688716,HUM 2,C02,422856,Rodriguez; Bretton Sigfred,16,0,16,0
1708246688716,HUM 2,C03,422859,Rodriguez; Bretton Sigfred,15,0,16,1
1708246688716,HUM 2,C04,423106,Rodriguez; Bretton Sigfred,12,0,16,4
1708246688716,HUM 2,C05,423107,Rodriguez; Bretton Sigfred,15,0,16,1
1708246688716,HUM 2,C06,423108,Rodriguez; Bretton Sigfred,14,0,16,2
1708246688716,HUM 2,C07,423109,Rodriguez; Bretton Sigfred,15,0,16,1
1708246688716,HUM 2,C08,423110,Rodriguez; Bretton Sigfred,15,0,16,1
1708246688716,HUM 2,C09,423133,Rodriguez; Bretton Sigfred,14,0,16,2
1708246688716,HUM 2,C10,423134,Rodriguez; Bretton Sigfred,14,0,16,2
1708246688716,HUM 2,C11,423135,Rodriguez; Bretton Sigfred,16,0,16,0
1708246688716,HUM 2,C12,423136,Rodriguez; Bretton Sigfred,15,0,16,1
1708246688716,HUM 2,C13,423137,Rodriguez; Bretton Sigfred,16,0,16,0
1708246688716,HUM 2,C14,423138,Rodriguez; Bretton Sigfred,16,0,16,0
1708246688716,HUM 2,D01,423140,West; Geoffrey Scott,13,0,16,3
1708246688716,HUM 2,D02,423141,West; Geoffrey Scott,15,0,16,1
1708246688716,HUM 2,D03,423142,West; Geoffrey Scott,15,0,16,1
1708246688716,HUM 2,D04,423143,West; Geoffrey Scott,14,0,16,2
1708246688716,HUM 2,D05,423144,West; Geoffrey Scott,16,0,16,0
1708246688716,HUM 2,D06,423145,West; Geoffrey Scott,16,0,16,0
1708246688716,HUM 2,D07,423146,West; Geoffrey Scott,16,0,16,0
1708246688716,HUM 2,D08,423158,West; Geoffrey Scott,16,0,16,0
1708246688716,HUM 2,D09,423169,West; Geoffrey Scott,16,0,16,0
1708246688716,HUM 2,D10,423174,West; Geoffrey Scott,16,0,16,0
1708246688716,HUM 2,D11,423175,West; Geoffrey Scott,16,0,16,0
1708246688716,HUM 2,D12,423179,West; Geoffrey Scott,15,0,16,1
1708246688716,HUM 2,D13,423188,West; Geoffrey Scott,15,0,16,1
1708246688716,HUM 2,D14,423204,West; Geoffrey Scott,16,0,16,0
1708246689247,HUM 5,A01,423221,Lyon; Antony J.,26,0,30,4
1708246689247,HUM 5,A02,423232,Lyon; Antony J.,24,0,30,6
1708246689247,HUM 5,A03,423237,Lyon; Antony J.,18,0,30,12
1708246689247,HUM 5,A04,423240,Lyon; Antony J.,25,0,30,5
1708246689247,HUM 5,A05,423242,Lyon; Antony J.,28,0,30,2
1708246689247,HUM 5,A06,423244,Lyon; Antony J.,23,0,30,7
1708246689247,HUM 5,A07,423247,Lyon; Antony J.,27,0,30,3
1708246689247,HUM 5,A08,423254,Lyon; Antony J.,27,0,30,3
1708246689247,HUM 5,B01,423286,Patterson; Patrick H.,28,0,30,2
1708246689247,HUM 5,B02,423291,Patterson; Patrick H.,29,0,30,1
1708246689247,HUM 5,B03,423294,Patterson; Patrick H.,28,0,30,2
1708246689247,HUM 5,B04,423297,Patterson; Patrick H.,29,0,30,1
1708246689247,HUM 5,B05,423313,Patterson; Patrick H.,30,0,30,0
1708246689247,HUM 5,B06,423318,Patterson; Patrick H.,30,0,30,0
1708246689247,HUM 5,B07,423362,Patterson; Patrick H.,29,0,30,1
1708246689247,HUM 5,B08,423363,Patterson; Patrick H.,29,0,30,1
1708246689247,HUM 5,C01,423365,Caldwell; Michael Alan,23,0,30,7
1708246689247,HUM 5,C02,423474,Caldwell; Michael Alan,24,0,30,6
1708246689247,HUM 5,C03,423528,Caldwell; Michael Alan,30,0,30,0
1708246689247,HUM 5,C04,423529,Caldwell; Michael Alan,27,0,30,3
1708246689247,HUM 5,C05,423545,Caldwell; Michael Alan,30,0,30,0
1708246689247,HUM 5,C06,423546,Caldwell; Michael Alan,30,0,30,0
1708246689247,HUM 5,C07,423547,Caldwell; Michael Alan,29,0,30,1
1708246689247,HUM 5,C08,423548,Caldwell; Michael Alan,28,0,30,2
1708246689773,INTL 101,A01,404350,Day; Joel Keith,23,0,25,2
1708246689773,INTL 101,A02,404356,Day; Joel Keith,25,0,25,0
1708246689773,INTL 101,A03,404357,Day; Joel Keith,24,0,25,1
1708246689773,INTL 101,A04,404360,Day; Joel Keith,25,0,25,0
1708246690298,INTL 102,A01,404375,Fisk; David Lee,25,0,25,0
1708246690298,INTL 102,A02,404376,Fisk; David Lee,22,0,25,3
1708246690298,INTL 102,A03,404377,Fisk; David Lee,20,0,25,5
1708246690298,INTL 102,A04,404381,Fisk; David Lee,25,0,25,0
1708246690824,INTL 190,A00,404396,Samphantharak; Krislert,24,0,25,1
1708246690824,INTL 190,B00,404402,McIntosh; Justin Daniel,24,0,25,1
1708246690824,INTL 190,C00,404403,Vos; Stacie N.,24,0,25,1
1708246690824,INTL 190,D00,404404,Nadkarni; Vidya,24,0,25,1
1708246690824,INTL 190,E00,404407,Scott; Jeffrey F,25,0,25,0
1708246690824,INTL 190,F00,404409,Auerbach; Bradford C,25,0,25,0
1708246690824,INTL 190,G00,404442,Auerbach; Bradford C,25,0,25,0
1708246690824,INTL 190,H00,404465,Segui; Alan S,25,0,25,0
1708246690824,INTL 190,I00,404481,Segui; Alan S,25,0,25,0
1708246691357,JAPN 10C,A01,403881,Iwamoto; Naoki,15,0,15,0
1708246691357,JAPN 10C,B01,403884,McKee; Mayumi Mochizuki,15,0,15,0
1708246691357,JAPN 10C,C01,403887,Sato; Kyoko,10,0,10,0
1708246691357,JAPN 10C,C02,403888,Sato; Kyoko,10,0,10,0
1708246691357,JAPN 10C,D01,403890,Inada; Minori,8,0,10,2
1708246691357,JAPN 10C,D02,403891,Inada; Minori,10,0,10,0
1708246691357,JAPN 10C,E01,403893,Sato; Kyoko,10,0,10,0
1708246691357,JAPN 10C,E02,403894,Sato; Kyoko,10,0,10,0
1708246691357,JAPN 10C,F01,403896,McKee; Mayumi Mochizuki,10,0,10,0
1708246691357,JAPN 10C,F02,403897,McKee; Mayumi Mochizuki,10,0,10,0
1708246691357,JAPN 10C,G01,403899,Homma; Kunihiko,10,0,10,0
1708246691357,JAPN 10C,G02,403900,Homma; Kunihiko,10,0,10,0
1708246691357,JAPN 10C,H01,403902,Maruyama; Rie,10,0,10,0
1708246691357,JAPN 10C,H02,403903,Maruyama; Rie,9,0,10,1
1708246691357,JAPN 10C,I01,403905,Inada; Minori,10,0,10,0
1708246691357,JAPN 10C,I02,403906,Inada; Minori,9,0,10,1
1708246691357,JAPN 10C,J01,403915,Iwamoto; Naoki,10,0,10,0
1708246691357,JAPN 10C,J02,403916,Iwamoto; Naoki,9,0,10,1
1708246691357,JAPN 10C,K01,403918,Ross; Kayoko F,10,0,10,0
1708246691357,JAPN 10C,K02,403928,Ross; Kayoko F,10,0,10,0
1708246691357,JAPN 10C,L01,403935,Homma; Kunihiko,9,0,10,1
1708246691357,JAPN 10C,L02,403936,Homma; Kunihiko,10,0,10,0
1708246691357,JAPN 10C,M02,403939,Kamioka; Sachiko,13,0,15,2
1708246691357,JAPN 10C,N01,479041,Iwamoto; Naoki,15,0,15,0
1708246691882,JAPN 10CR,A01,403982,Inada; Minori,12,0,12,0
1708246691882,JAPN 10CR,A02,403983,Inada; Minori,12,0,12,0
1708246692410,JAPN 20C,A01,403988,Homma; Kunihiko,10,0,12,2
1708246692410,JAPN 20C,B02,404029,Kamioka; Sachiko,10,0,12,2
1708246692410,JAPN 20C,C01,404033,Takeda; Izumi,8,0,12,4
1708246692410,JAPN 20C,D02,404114,Kamioka; Sachiko,11,0,12,1
1708246692410,JAPN 20C,E01,404135,Simpson; Junko Tokuda,12,0,12,0
1708246692939,JAPN 130C,A01,404144,Maruyama; Rie,9,0,9,0
1708246692939,JAPN 130C,A02,404145,Maruyama; Rie,9,0,9,0
1708246692939,JAPN 130C,B01,404147,Simpson; Junko Tokuda,8,0,9,1
1708246692939,JAPN 130C,B02,404148,Simpson; Junko Tokuda,9,0,9,0
1708246693468,JAPN 135C,A00,404176,Ross; Kayoko F,16,0,16,0
1708246693468,JAPN 135C,B00,404253,Takeda; Izumi,14,0,16,2
1708246693994,JAPN 140C,A00,404255,Sato; Kyoko,18,0,20,2
1708246694524,JAPN 150C,A00,404258,McKee; Mayumi Mochizuki,14,0,14,0
1708246695050,JAPN 190,A00,404260,Miyao; Daisuke,17,0,20,3
1708246695576,JAPN 196B,001,487237,Turner; Christena L.,9999,0,9999,0
1708246696104,JWSP 3,A01,404485,Shuster; Alana,20,0,20,0
1708246696632,LATI 10,A01,405201,Kennemore; Amy Michelle,27,0,30,3
1708246696632,LATI 10,A02,405202,Kennemore; Amy Michelle,27,0,30,3
1708246696632,LATI 10,A03,405208,Kennemore; Amy Michelle,28,0,30,2
1708246697157,LATI 50,A01,405214,Kokinis; Troy Andreas,34,0,35,1
1708246697157,LATI 50,A02,405215,Kokinis; Troy Andreas,34,0,35,1
1708246697685,LATI 130,A01,482880,Alvarez; Camila Huerta,29,0,30,1
1708246698210,LATI 160,A01,477482,Kokinis; Troy Andreas,30,0,30,0
1708246698734,LATI 180,A00,405221,Kennemore; Amy Michelle,28,0,30,2
1708246698734,LATI 180,B00,405222,Mostajo; Lorena,30,0,30,0
1708246699259,LIAB 1C,A00,405278,Saab; Dima,13,0,14,1
1708246699259,LIAB 1C,B00,405279,Saab; Dima,11,0,14,3
1708246699782,LIAB 1CX,A00,405281,Akjeje; Abdelhak,19,0,20,1
1708246699782,LIAB 1CX,B00,405291,Akjeje; Abdelhak,20,0,20,0
1708246700312,LIAB 1F,A00,482814,El Cheddadi; Youniss,14,0,14,0
1708246700839,LIDS 19,001,492979,Goodall; Grant Todd,9999,0,9999,0
1708246700839,LIDS 19,002,492980,Goodall; Grant Todd,9999,0,9999,0
1708246700839,LIDS 19,003,492981,Goodall; Grant Todd,9999,0,9999,0
1708246700839,LIDS 19,004,492982,Goodall; Grant Todd,9999,0,9999,0
1708246700839,LIDS 19,005,492983,Goodall; Grant Todd,9999,0,9999,0
1708246700839,LIDS 19,006,492984,Goodall; Grant Todd,9999,0,9999,0
1708246700839,LIDS 19,007,492985,Goodall; Grant Todd,9999,0,9999,0
1708246700839,LIDS 19,008,492986,Goodall; Grant Todd,9999,0,9999,0
1708246700839,LIDS 19,009,492987,Goodall; Grant Todd,9999,0,9999,0
1708246700839,LIDS 19,010,492988,Goodall; Grant Todd,9999,0,9999,0
1708246700839,LIDS 19,011,492989,Goodall; Grant Todd,9999,0,9999,0
1708246700839,LIDS 19,012,492990,Goodall; Grant Todd,9999,0,9999,0
1708246701364,LIFR 1A,A00,405299,Van Moer; Vinciane G,13,0,14,1
1708246701364,LIFR 1A,B00,405300,Van Moer; Vinciane G,13,0,14,1
1708246701364,LIFR 1A,C00,405301,Van Moer; Vinciane G,13,0,14,1
1708246701364,LIFR 1A,D00,405307,Van Moer; Vinciane G,14,0,14,0
1708246701893,LIFR 1AX,A00,405308,Van Moer; Vinciane G,27,0,28,1
1708246701893,LIFR 1AX,B00,405309,Van Moer; Vinciane G,27,0,28,1
1708246702419,LIFR 1C,A00,405310,Van Moer; Vinciane G,14,0,14,0
1708246702419,LIFR 1C,B00,405311,Van Moer; Vinciane G,12,0,14,2
1708246702419,LIFR 1C,C00,405325,Van Moer; Vinciane G,13,0,14,1
1708246702419,LIFR 1C,D00,405326,Van Moer; Vinciane G,11,0,14,3
1708246702951,LIFR 1CX,A00,405332,Van Moer; Vinciane G,25,0,28,3
1708246702951,LIFR 1CX,B00,405333,Van Moer; Vinciane G,27,0,28,1
1708246703477,LIFR 1D,A00,405334,Van Moer; Vinciane G,13,0,14,1
1708246703477,LIFR 1D,B00,405335,Van Moer; Vinciane G,13,0,14,1
1708246703477,LIFR 1D,C00,405336,Van Moer; Vinciane G,13,0,14,1
1708246703477,LIFR 1D,D00,405337,Van Moer; Vinciane G,13,0,14,1
1708246704002,LIFR 1DX,A00,405338,Van Moer; Vinciane G,25,0,28,3
1708246704002,LIFR 1DX,B00,405394,Van Moer; Vinciane G,27,0,28,1
1708246704531,LIFR 11,001,405395,Goodall; Grant Todd,999,0,999,0
1708246705057,LIGM 1C,A00,405398,Fischer-Grunski; Eva K,12,0,14,2
1708246705057,LIGM 1C,B00,405400,Fischer-Grunski; Eva K,13,0,14,1
1708246705057,LIGM 1C,C00,405403,Fischer-Grunski; Eva K,13,0,14,1
1708246705057,LIGM 1C,D00,405404,Fischer-Grunski; Eva K,13,0,14,1
1708246705582,LIGM 1CX,A00,405407,Fischer-Grunski; Eva K,27,0,28,1
1708246705582,LIGM 1CX,B00,405408,Fischer-Grunski; Eva K,26,0,28,2
1708246706107,LIGM 11,001,405464,Goodall; Grant Todd,999,0,999,0
1708246706633,LIGN 8,A00,411133,McIntosh; Justin Daniel,232,0,240,8
1708246707161,LIGN 17,A00,411141,Kehler; Andrew Scott,287,0,300,13
1708246707689,LIGN 101,A01,411144,Staff,28,0,30,2
1708246707689,LIGN 101,A02,411147,Staff,29,0,30,1
1708246707689,LIGN 101,A03,411154,Staff,27,0,30,3
1708246707689,LIGN 101,A04,411163,Staff,29,0,30,1
1708246708218,LIGN 120,A01,411165,Ackerman; Farrell,28,0,30,2
1708246708218,LIGN 120,A02,411177,Ackerman; Farrell,23,0,27,4
1708246708743,LIGN 130,A01,411223,Staff,29,0,30,1
1708246708743,LIGN 130,A02,411231,Staff,30,0,30,0
1708246708743,LIGN 130,A03,411232,Staff,29,0,30,1
1708246709268,LIGN 141,A00,411276,Rose; Sharon,37,0,40,3
1708246709796,LIGN 144,A00,411277,Lott; Margaret S.,22,0,24,2
1708246710376,LIGN 148,A00,411278,Mayberry; Rachel,71,0,75,4
1708246710901,LIGN 165,A00,411279,Bergen; Leon,41,0,70,29
1708246711429,LIGN 168,A01,411281,Styler; William Francis,65,0,70,5
1708246711957,LIGN 175,A00,482816,Rodriguez Aispuro; Alejandro,35,0,40,5
1708246712484,LIGN 230,A00,411293,Caponigro; Ivano,19,0,20,1
1708246713010,LIGN 238,A00,411308,Bergen; Benjamin,20,0,20,0
1708246713536,LIGN 252,A00,411309,Bergen; Leon,28,0,30,2
1708246714061,LIGN 256,A00,411310,Nakashole; Ndapandula,0,0,5,5
1708246714591,LIGN 272,A00,482887,Kluender; Robert,10,0,10,0
1708246715116,LIHL 112P,A00,405228,Pagkalinawan; Leticia Cant,27,0,28,1
1708246715645,LIHL 114P,A00,405229,Nguyen; Hoan Thi,26,0,28,2
1708246716173,LIHL 117P,A00,405256,Sadegholvad; Elham,27,0,28,1
1708246716701,LIHL 118,A00,405257,Chen; Areana Yen,28,0,28,0
1708246717226,LIHL 124P,A00,405262,Nguyen; Hoan Thi,28,0,28,0
1708246717754,LIHL 132P,A00,405263,Pagkalinawan; Leticia Cant,28,0,28,0
1708246718279,LIHL 134P,A00,405269,Nguyen; Hoan Thi,28,0,28,0
1708246718804,LIHL 138,A00,405270,Chen; Areana Yen,27,0,28,1
1708246719332,LIIT 1C,A00,405465,Carnelos; Chiara,12,0,14,2
1708246719332,LIIT 1C,B00,405466,Carnelos; Chiara,14,0,14,0
1708246719859,LIIT 1CX,A00,405594,Carnelos; Chiara,28,0,28,0
1708246720384,LIPO 1C,A00,405595,Paladini; Denise,13,0,14,1
1708246720384,LIPO 1C,B00,405596,Paladini; Denise,14,0,14,0
1708246720913,LIPO 1CX,A00,405597,De Abreu; Cassia,28,0,28,0
1708246721439,LISL 1A,C00,405600,Lott; Margaret S.,13,0,14,1
1708246721439,LISL 1A,D00,405601,Lott; Margaret S.,10,0,14,4
1708246721439,LISL 1A,E00,405602,Lott; Margaret S.,13,0,14,1
1708246721439,LISL 1A,F00,405603,Lott; Margaret S.,13,0,14,1
1708246721968,LISL 1AR,A00,480605,Lott; Margaret S.,13,0,15,2
1708246721968,LISL 1AR,B00,480606,Lott; Margaret S.,14,0,15,1
1708246722497,LISL 1AX,A00,405754,Lott; Margaret S.,26,0,28,2
1708246722497,LISL 1AX,B00,405755,Lott; Margaret S.,23,0,28,5
1708246723023,LISL 1C,A00,405776,Lott; Margaret S.,13,0,14,1
1708246723023,LISL 1C,B00,405779,Lott; Margaret S.,14,0,14,0
1708246723023,LISL 1C,C00,405785,Lott; Margaret S.,14,0,14,0
1708246723023,LISL 1C,D00,405787,Lott; Margaret S.,9,0,14,5
1708246723023,LISL 1C,E00,405827,Lott; Margaret S.,12,0,14,2
1708246723023,LISL 1C,F00,405830,Lott; Margaret S.,13,0,14,1
1708246723549,LISL 1CX,A00,405844,Lott; Margaret S.,25,0,28,3
1708246723549,LISL 1CX,B00,405848,Lott; Margaret S.,25,0,28,3
1708246723549,LISL 1CX,C00,405849,Lott; Margaret S.,28,0,28,0
1708246724075,LISL 1D,A00,405850,Lott; Margaret S.,8,0,14,6
1708246724075,LISL 1D,B00,405851,Lott; Margaret S.,13,0,14,1
1708246724075,LISL 1D,C00,405852,Lott; Margaret S.,10,0,14,4
1708246724600,LISL 1DX,A00,405854,Lott; Margaret S.,17,0,22,5
1708246724600,LISL 1DX,B00,405855,Lott; Margaret S.,18,0,22,4
1708246725129,LISP 1A,001,405856,Munoz Sanchez; Alicia,11,0,14,3
1708246725129,LISP 1A,002,405857,Munoz Sanchez; Alicia,13,0,14,1
1708246725129,LISP 1A,003,405858,Munoz Sanchez; Alicia,14,0,14,0
1708246725129,LISP 1A,004,405861,Munoz Sanchez; Alicia,14,0,14,0
1708246725658,LISP 1AX,001,405862,Munoz Sanchez; Alicia,28,0,28,0
1708246725658,LISP 1AX,002,405863,Munoz Sanchez; Alicia,25,0,28,3
1708246726185,LISP 1C,001,405864,Munoz Sanchez; Alicia,13,0,14,1
1708246726185,LISP 1C,002,405865,Munoz Sanchez; Alicia,12,0,14,2
1708246726185,LISP 1C,003,405879,Munoz Sanchez; Alicia,12,0,14,2
1708246726185,LISP 1C,004,405880,Munoz Sanchez; Alicia,13,0,14,1
1708246726185,LISP 1C,005,405881,Munoz Sanchez; Alicia,12,0,14,2
1708246726185,LISP 1C,006,405882,Munoz Sanchez; Alicia,12,0,14,2
1708246726185,LISP 1C,007,405904,Munoz Sanchez; Alicia,14,0,14,0
1708246726185,LISP 1C,008,405905,Munoz Sanchez; Alicia,14,0,14,0
1708246726185,LISP 1C,009,405908,Munoz Sanchez; Alicia,14,0,14,0
1708246726185,LISP 1C,010,405917,Munoz Sanchez; Alicia,13,0,14,1
1708246726711,LISP 1CX,001,405922,Munoz Sanchez; Alicia,24,0,28,4
1708246726711,LISP 1CX,002,405990,Munoz Sanchez; Alicia,26,0,28,2
1708246726711,LISP 1CX,003,406007,Munoz Sanchez; Alicia,27,0,28,1
1708246726711,LISP 1CX,004,406008,Munoz Sanchez; Alicia,25,0,28,3
1708246726711,LISP 1CX,005,406015,Munoz Sanchez; Alicia,26,0,28,2
1708246727239,LISP 1D,001,406016,Munoz Sanchez; Alicia,12,0,14,2
1708246727239,LISP 1D,002,406017,Munoz Sanchez; Alicia,13,0,14,1
1708246727239,LISP 1D,003,406018,Munoz Sanchez; Alicia,14,0,14,0
1708246727239,LISP 1D,004,406019,Munoz Sanchez; Alicia,11,0,14,3
1708246727239,LISP 1D,005,406020,Munoz Sanchez; Alicia,13,0,14,1
1708246727239,LISP 1D,006,406021,Munoz Sanchez; Alicia,10,0,14,4
1708246727239,LISP 1D,007,406022,Munoz Sanchez; Alicia,13,0,14,1
1708246727239,LISP 1D,008,406023,Munoz Sanchez; Alicia,13,0,14,1
1708246727239,LISP 1D,009,406024,Munoz Sanchez; Alicia,11,0,14,3
1708246727239,LISP 1D,010,406025,Munoz Sanchez; Alicia,12,0,14,2
1708246727239,LISP 1D,011,406026,Munoz Sanchez; Alicia,13,0,14,1
1708246727239,LISP 1D,012,406027,Munoz Sanchez; Alicia,13,0,14,1
1708246727239,LISP 1D,013,406028,Munoz Sanchez; Alicia,12,0,14,2
1708246727239,LISP 1D,014,406029,Munoz Sanchez; Alicia,12,0,14,2
1708246727239,LISP 1D,015,406030,Munoz Sanchez; Alicia,10,0,14,4
1708246727239,LISP 1D,016,406031,Munoz Sanchez; Alicia,14,0,14,0
1708246727239,LISP 1D,017,406032,Munoz Sanchez; Alicia,14,0,14,0
1708246727239,LISP 1D,018,406033,Munoz Sanchez; Alicia,12,0,14,2
1708246727239,LISP 1D,019,406034,Munoz Sanchez; Alicia,13,0,14,1
1708246727239,LISP 1D,020,406035,Munoz Sanchez; Alicia,14,0,14,0
1708246727239,LISP 1D,021,406036,Munoz Sanchez; Alicia,13,0,14,1
1708246727239,LISP 1D,022,406037,Munoz Sanchez; Alicia,14,0,14,0
1708246727239,LISP 1D,023,406038,Munoz Sanchez; Alicia,14,0,14,0
1708246727239,LISP 1D,024,406039,Munoz Sanchez; Alicia,13,0,14,1
1708246727767,LISP 1DX,001,406040,Munoz Sanchez; Alicia,28,0,28,0
1708246727767,LISP 1DX,002,406041,Munoz Sanchez; Alicia,27,0,28,1
1708246727767,LISP 1DX,003,406127,Munoz Sanchez; Alicia,24,0,28,4
1708246727767,LISP 1DX,004,406128,Munoz Sanchez; Alicia,17,0,28,11
1708246727767,LISP 1DX,005,406418,Munoz Sanchez; Alicia,24,0,28,4
1708246727767,LISP 1DX,006,406536,Munoz Sanchez; Alicia,27,0,28,1
1708246727767,LISP 1DX,007,406561,Munoz Sanchez; Alicia,24,0,28,4
1708246727767,LISP 1DX,008,406576,Munoz Sanchez; Alicia,25,0,28,3
1708246727767,LISP 1DX,009,406679,Munoz Sanchez; Alicia,28,0,28,0
1708246727767,LISP 1DX,010,406691,Munoz Sanchez; Alicia,26,0,28,2
1708246727767,LISP 1DX,011,406692,Munoz Sanchez; Alicia,28,0,28,0
1708246727767,LISP 1DX,012,406693,Munoz Sanchez; Alicia,28,0,28,0
1708246728290,LISP 17,001,406694,Munoz Sanchez; Alicia,18,0,20,2
1708246728818,LISP 18,001,406695,Munoz Sanchez; Alicia,20,0,20,0
1708246729346,LTAM 105,A00,412520,Ruiz; Ariana,28,0,40,12
1708246729871,LTCH 101,A00,479214,Zhu; Ping,39,0,40,1
1708246730398,LTCS 87,A00,492906,Nguyen; Hoang Tan,20,0,20,0
1708246730398,LTCS 87,B00,492907,Nguyen; Hoang Tan,20,0,20,0
1708246730925,LTCS 150,A00,412543,Liao; Ping H,39,0,40,1
1708246731452,LTCS 225,A00,412819,Mendoza; Andrea,14,0,15,1
1708246731977,LTCS 250,A00,412821,Lee; Jin-Kyung,15,0,15,0
1708246732502,LTEA 110B,A00,412548,Liao; Ping H,60,0,60,0
1708246733030,LTEA 120A,A00,479216,Zhu; Ping,36,0,40,4
1708246733556,LTEA 120C,A00,412552,Fiss; Geraldine Anna,295,0,300,5
1708246734084,LTEA 132,A00,412561,Mendoza; Andrea,51,0,60,9
1708246734608,LTEA 141,A00,412565,Lee; Jin-Kyung,37,0,40,3
1708246735135,LTEN 23,A01,411317,Vijay; Ameeth Varma,24,0,25,1
1708246735135,LTEN 23,A02,411318,Vijay; Ameeth Varma,24,0,25,1
1708246735135,LTEN 23,A03,411371,Vijay; Ameeth Varma,25,0,25,0
1708246735135,LTEN 23,A04,411375,Vijay; Ameeth Varma,24,0,25,1
1708246735661,LTEN 28,A01,411632,Blanco; John D,25,0,25,0
1708246735661,LTEN 28,A02,411697,Blanco; John D,25,0,25,0
1708246735661,LTEN 28,A03,411698,Blanco; John D,25,0,25,0
1708246735661,LTEN 28,A04,411709,Blanco; John D,25,0,25,0
1708246735661,LTEN 28,A05,411719,Blanco; John D,25,0,25,0
1708246735661,LTEN 28,A06,411744,Blanco; John D,25,0,25,0
1708246735661,LTEN 28,A07,411780,Blanco; John D,25,0,25,0
1708246735661,LTEN 28,A08,411820,Blanco; John D,25,0,25,0
1708246736186,LTEN 110,A00,486891,Vitkus; Daniel J.,38,0,40,2
1708246736714,LTEN 144,A00,412570,Vijay; Ameeth Varma,39,0,40,1
1708246737238,LTEN 180,A00,412581,Perreira; Christopher Michael,18,0,25,7
1708246737768,LTEN 181,A00,412582,Mukherjee; Silpa,55,0,60,5
1708246738296,LTEN 245,A00,412824,Johnson; Sara E.,13,0,15,2
1708246738823,LTEN 259,A00,412825,Streeby; Shelley,13,0,15,2
1708246739346,LTEU 111,A00,412588,Kontje; Todd Curtis,38,0,40,2
1708246739872,LTEU 140,A00,480172,De Marchi Gherini; Adriana,36,0,37,1
1708246740402,LTEU 141,A00,412592,Cohen; Alain J. J.,40,0,40,0
1708246740930,LTFR 2A,A01,411996,Ploye; Catherine,25,0,25,0
1708246741460,LTFR 2C,A00,411997,Ploye; Catherine,24,0,25,1
1708246741989,LTFR 142,A00,412597,Zhiri; Oumelbanine,20,0,20,0
1708246742519,LTGK 3,A00,412001,Murray; Kourtney Kristine,30,0,30,0
1708246743049,LTGM 2C,A00,412002,Fischer-Grunski; Eva K,25,0,25,0
1708246743581,LTKO 1C,A01,412029,Cho; Hye Jin,24,0,25,1
1708246743581,LTKO 1C,B01,412164,Cho; Hye Jin,23,0,25,2
1708246743581,LTKO 1C,C01,412168,Cho; Hye Jin,25,0,25,0
1708246743581,LTKO 1C,D01,412353,Yim; Nancy,24,0,25,1
1708246743581,LTKO 1C,E01,412372,Yim; Nancy,25,0,25,0
1708246744107,LTKO 2C,A01,412374,Yim; Nancy,21,0,25,4
1708246744633,LTKO 130P,A00,412601,Lee; Jeyseon,25,0,25,0
1708246745164,LTKO 135,A00,412606,Lee; Jeyseon,25,0,25,0
1708246745691,LTLA 3,A00,412375,Murray; Kourtney Kristine,36,0,40,4
1708246746219,LTRU 1C,A01,412491,Wells; Patricia Rebecca,24,0,25,1
1708246746745,LTRU 104A,A01,412614,Wells; Patricia Rebecca,20,0,20,0
1708246747270,LTSP 2A,A01,412493,Lampell; Toni,24,0,25,1
1708246747796,LTSP 2B,A01,412497,Lampell; Toni,22,0,25,3
1708246747796,LTSP 2B,B01,479218,Lampell; Toni,24,0,25,1
1708246748323,LTSP 2C,A01,412499,Mastromartino; Alexandra L,23,0,25,2
1708246748850,LTSP 2D,A00,412500,Dominguez; Noelia,24,0,25,1
1708246749376,LTSP 2E,A00,412501,Mastromartino; Alexandra L,24,0,25,1
1708246749376,LTSP 2E,B00,412502,Mastromartino; Alexandra L,25,0,25,0
1708246749901,LTSP 87,A00,479212,Bessett; Ryan Matthew,20,0,20,0
1708246750427,LTSP 100B,A00,412619,Dominguez; Noelia,25,0,25,0
1708246750427,LTSP 100B,B00,412623,Dominguez; Noelia,24,0,25,1
1708246750952,LTSP 116,A00,412628,Blanco; John D,28,0,30,2
1708246751480,LTSP 135A,A00,412631,Parra; Max,27,0,30,3
1708246752009,LTSP 174,A00,479213,Staff,28,0,30,2
1708246752537,LTTH 115,A00,412632,Kontje; Todd Curtis,35,0,40,5
1708246753065,LTTH 210C,A00,412826,Batarseh; Amanda Alicia,14,0,15,1
1708246753594,LTTH 255,A00,412827,Ali; Mohammad Kazim,13,0,15,2
1708246754125,LTTH 260,A00,412828,Kim; Joo Ok,30,0,30,0
1708246754651,LTWL 19C,A00,412503,Kelting; Edward William,40,0,40,0
1708246755181,LTWL 101,A00,412633,Kelting; Edward William,39,0,40,1
1708246755711,LTWL 114,A00,412656,Fiss; Geraldine Anna,60,0,60,0
1708246756237,LTWL 123,A00,412674,Lampert-Weissig; Lisa,31,0,40,9
1708246756761,LTWL 172,A00,412729,De Marchi Gherini; Adriana,37,0,40,3
1708246757287,LTWL 183,A00,412731,Cohen; Alain J. J.,38,0,40,2
1708246757812,LTWL 184,A00,479219,Mukherjee; Silpa,38,0,40,2
1708246758337,LTWL 194A,A00,489635,Vijay; Ameeth Varma,27,0,31,4
1708246758864,LTWR 8A,A01,412505,Springer; Anna Joy,24,0,25,1
1708246758864,LTWR 8A,A02,412506,Springer; Anna Joy,24,0,25,1
1708246758864,LTWR 8A,A03,412507,Springer; Anna Joy,25,0,25,0
1708246758864,LTWR 8A,A04,412508,Springer; Anna Joy,23,0,25,2
1708246759391,LTWR 8C,A01,412511,Forbes; Camille,23,0,25,2
1708246759391,LTWR 8C,A02,412512,Forbes; Camille,25,0,25,0
1708246759391,LTWR 8C,A03,412514,Forbes; Camille,25,0,25,0
1708246759391,LTWR 8C,A04,412519,Forbes; Camille,24,0,25,1
1708246759919,LTWR 100,A00,412734,Forbes; Camille,7,0,15,8
1708246760446,LTWR 113,A00,412816,Carroll; Amy Sara,28,0,30,2
1708246760971,LTWR 114,A00,412817,Springer; Anna Joy,23,0,30,7
1708246761496,LTWR 126,A00,412818,Hoang; Lily Kim,25,0,30,5
1708246762020,LTWR 215,A00,412880,Carroll; Amy Sara,19,0,20,1
1708246762549,MAE 3,A01,435606,Qi; Huihui,16,0,20,4
1708246762549,MAE 3,A02,435607,Qi; Huihui,15,0,20,5
1708246762549,MAE 3,A03,435608,Qi; Huihui,19,0,20,1
1708246762549,MAE 3,B01,435618,Delson; Nathan Joseph & Mullin; Jennifer S,20,0,20,0
1708246762549,MAE 3,B02,435626,Delson; Nathan Joseph & Mullin; Jennifer S,20,0,20,0
1708246762549,MAE 3,B03,435666,Delson; Nathan Joseph & Mullin; Jennifer S,20,0,20,0
1708246762549,MAE 3,B04,435679,Delson; Nathan Joseph & Mullin; Jennifer S,20,0,20,0
1708246762549,MAE 3,B05,494545,Delson; Nathan Joseph & Mullin; Jennifer S,20,0,20,0
1708246763075,MAE 8,A01,435688,Pham; Hieu Tan,197,0,200,3
1708246763656,MAE 30B,A00,435689,Lubarda; Marko,128,0,130,2
1708246763656,MAE 30B,B00,435701,Ghazinejad; Maziar,117,0,130,13
1708246764182,MAE 101B,A00,435702,Saintillan; David,146,0,150,4
1708246764182,MAE 101B,B00,435703,Nomura; Keiko K.,138,0,146,8
1708246764709,MAE 101C,A00,435704,Sadeghizadeh; Zahra,53,0,65,12
1708246765235,MAE 101D,A00,435705,Chen; Renkun,14,0,20,6
1708246765766,MAE 105,A00,435706,Becker; Janet Maria,115,0,120,5
1708246766293,MAE 107,A00,435707,Lindsey; Stephanie,48,0,50,2
1708246766293,MAE 107,B00,435708,Davidson; Michael R,55,0,60,5
1708246766819,MAE 119,A00,435710,Hidalgo-Gonzalez; Patricia,100,0,120,20
1708246767345,MAE 120,A00,435722,Arefiev; Alexey,49,0,65,16
1708246767871,MAE 125,A00,435723,Kleissl; Jan,60,0,65,5
1708246768402,MAE 131A,A00,435724,Qi; Huihui,119,0,125,6
1708246768402,MAE 131A,B00,435725,Meyers; Marc,123,0,125,2
1708246768928,MAE 143B,A00,435726,Morimoto; Tania,114,0,120,6
1708246768928,MAE 143B,B00,435727,Herbert; Sylvia Lee,117,0,120,3
1708246768928,MAE 143B,C00,435728,Diagne; Mamadou Lamine,108,0,120,12
1708246769455,MAE 145,A00,435729,Martinez; Sonia,41,0,60,19
1708246769980,MAE 148,A01,492802,Silberman; Jack,14,0,24,10
1708246770511,MAE 150,A00,435730,Pham; Hieu Tan,52,0,60,8
1708246771039,MAE 152,A00,435731,Llewellyn Smith; Stefan G.,14,0,14,0
1708246771039,MAE 152,B00,435747,Llewellyn Smith; Stefan G.,12,0,14,2
1708246771039,MAE 152,C00,435748,Llewellyn Smith; Stefan G.,12,0,14,2
1708246771039,MAE 152,D00,435749,Llewellyn Smith; Stefan G.,8,0,14,6
1708246771039,MAE 152,E00,435750,Llewellyn Smith; Stefan G.,13,0,14,1
1708246771564,MAE 155B,A01,435752,Hwang; John T,36,0,50,14
1708246771564,MAE 155B,B01,435768,Anderson; Mark Ronald,27,0,50,23
1708246771564,MAE 155B,C01,494006,Saha; Abhishek,0,0,0,0
1708246772090,MAE 156B,A01,435770,Tustaniwskyj; Jerry I,33,0,40,7
1708246772090,MAE 156B,B01,435772,Ghazinejad; Maziar,35,0,40,5
1708246772090,MAE 156B,C01,435774,Delson; Nathan Joseph,38,0,40,2
1708246772090,MAE 156B,D01,435776,Saha; Abhishek,31,0,40,9
1708246772619,MAE 166,A00,435777,Fullerton; Eric E,44,0,50,6
1708246773147,MAE 170,A01,435779,Lubarda; Marko,30,0,32,2
1708246773147,MAE 170,A02,435780,Lubarda; Marko,27,0,32,5
1708246773147,MAE 170,A03,435781,Lubarda; Marko,32,0,32,0
1708246773147,MAE 170,A04,435782,Lubarda; Marko,31,0,32,1
1708246773147,MAE 170,A05,435783,Lubarda; Marko,29,0,32,3
1708246773147,MAE 170,A06,435784,Lubarda; Marko,30,0,32,2
1708246773147,MAE 170,B01,435786,Evdokimenko; Ekaterina,23,0,24,1
1708246773147,MAE 170,B02,435787,Evdokimenko; Ekaterina,20,0,24,4
1708246773147,MAE 170,B03,435788,Evdokimenko; Ekaterina,23,0,24,1
1708246773147,MAE 170,B04,435789,Evdokimenko; Ekaterina,23,0,24,1
1708246773147,MAE 170,B05,435790,Evdokimenko; Ekaterina,19,0,24,5
1708246773147,MAE 170,B06,435791,Evdokimenko; Ekaterina,23,0,24,1
1708246773674,MAE 180,A00,479477,Sadeghizadeh; Zahra,56,0,60,4
1708246774199,MAE 184,A00,435792,Anderson; Mark Ronald,7,0,50,43
1708246774729,MAE 190,A00,435793,Beg; Farhat N.,17,0,20,3
1708246774729,MAE 190,B00,479209,Gerardo; Hortense Flotilde,12,0,15,3
1708246775254,MAE 202,A00,435794,Bandaru; Prabhakar,32,0,70,38
1708246775780,MAE 205,A00,435804,Hwang; John T & Tynan; George Robert & Seshadri; Kalyanasundaram & Rangamani; Padmini & Bandaru; Prabhakar,9990,0,9999,9
1708246776304,MAE 207,A00,435805,Beg; Farhat N.,9,0,10,1
1708246776304,MAE 207,B00,435815,Campbell; Edward Michael,6,0,10,4
1708246776304,MAE 207,C00,477499,Gerardo; Hortense Flotilde,6,0,30,24
1708246776831,MAE 209,A00,435816,Scholtes Acevedo; Claire,25,0,30,5
1708246777361,MAE 210C,A00,435817,Becker; Janet Maria,23,0,30,7
1708246777890,MAE 211,A00,435818,Seshadri; Kalyanasundaram,20,0,30,10
1708246778415,MAE 214A,A00,435819,Sarkar; Sutanu,27,0,35,8
1708246778940,MAE 217C,A00,435820,Marinoni; Alessandro,10,0,10,0
1708246779470,MAE 221C,A00,435821,Seshadri; Kalyanasundaram,10,0,15,5
1708246780000,MAE 221D,A00,435822,Poulikakos; Lisa Voula,23,0,30,7
1708246780529,MAE 224A,A00,435823,Pawlak; Geno Ronald,5,0,10,5
1708246781058,MAE 227,A00,435824,Hidalgo-Gonzalez; Patricia,21,0,35,14
1708246781584,MAE 231A,A00,435825,Boechler; Nicholas Sebastia,14,0,30,16
1708246782110,MAE 240,A00,435826,Rosengren; Aaron,20,0,30,10
1708246782636,MAE 242,A00,435827,Martinez; Sonia,0,0,45,45
1708246783166,MAE 249,A00,435842,Tolley; Michael Thomas,0,0,35,35
1708246783691,MAE 253,A00,435891,Staff,24,0,25,1
1708246784220,MAE 256,A00,435949,Coimbra; Carlos F.,6,0,10,4
1708246784746,MAE 263,A00,435987,Rangamani; Padmini,10,0,10,0
1708246785272,MAE 266,A00,435988,Evdokimenko; Ekaterina,7,0,30,23
1708246785799,MAE 271C,A00,435990,Arzt; Eduard,10,0,10,0
1708246786328,MAE 281B,A00,435991,Cortes; Jorge,9,0,25,16
1708246786857,MAE 288A,A00,435998,McEneaney; William Michael,6,0,40,34
1708246787384,MAE 288B,A00,435999,Bitmead; Robert R.,41,0,45,4
1708246787908,MAE 290C,A00,436008,Schmidt; Oliver,26,0,30,4
1708246788434,MAE 294C,A01,436010,Young; William Roy,19,0,20,1
1708246788960,MATH 2,A01,431271,Staff,31,0,35,4
1708246788960,MATH 2,B01,431273,Staff,29,0,35,6
1708246788960,MATH 2,C01,431275,Staff,31,0,35,4
1708246789490,MATH 3C,A01,431277,Safii; Soheil,12,0,15,3
1708246789490,MATH 3C,A02,431278,Safii; Soheil,12,0,15,3
1708246789490,MATH 3C,A03,431279,Safii; Soheil,12,0,15,3
1708246789490,MATH 3C,A04,431280,Safii; Soheil,15,0,15,0
1708246789490,MATH 3C,A05,431281,Safii; Soheil,14,0,15,1
1708246789490,MATH 3C,A06,431282,Safii; Soheil,15,0,15,0
1708246790016,MATH 10A,A01,431284,Bowers; Adam R.,20,0,30,10
1708246790016,MATH 10A,A02,431285,Bowers; Adam R.,18,0,30,12
1708246790016,MATH 10A,A03,431369,Bowers; Adam R.,28,0,30,2
1708246790016,MATH 10A,A04,431395,Bowers; Adam R.,27,0,30,3
1708246790016,MATH 10A,A05,431450,Bowers; Adam R.,28,0,30,2
1708246790016,MATH 10A,A06,431508,Bowers; Adam R.,30,0,30,0
1708246790016,MATH 10A,B01,431572,Kowalenko; Ethan J,24,0,30,6
1708246790016,MATH 10A,B02,431573,Kowalenko; Ethan J,29,0,30,1
1708246790016,MATH 10A,B03,431574,Kowalenko; Ethan J,30,0,30,0
1708246790016,MATH 10A,B04,431576,Kowalenko; Ethan J,30,0,30,0
1708246790016,MATH 10A,B05,431577,Kowalenko; Ethan J,30,0,30,0
1708246790016,MATH 10A,B06,431583,Kowalenko; Ethan J,30,0,30,0
1708246790553,MATH 10B,A01,431595,Habib; Yousaf,29,0,36,7
1708246790553,MATH 10B,A02,431597,Habib; Yousaf,35,0,36,1
1708246790553,MATH 10B,A03,431669,Habib; Yousaf,37,0,37,0
1708246790553,MATH 10B,A04,431670,Habib; Yousaf,36,0,37,1
1708246790553,MATH 10B,A05,431671,Habib; Yousaf,70,0,70,0
1708246790553,MATH 10B,B01,431673,Habib; Yousaf,25,0,33,8
1708246790553,MATH 10B,B02,431712,Habib; Yousaf,33,0,33,0
1708246790553,MATH 10B,B03,431713,Habib; Yousaf,33,0,33,0
1708246790553,MATH 10B,B04,431714,Habib; Yousaf,33,0,33,0
1708246790553,MATH 10B,B05,431715,Habib; Yousaf,60,0,60,0
1708246790553,MATH 10B,C01,431717,Bach; Quang Tran,57,0,60,3
1708246790553,MATH 10B,C02,431718,Bach; Quang Tran,18,0,34,16
1708246790553,MATH 10B,C03,431719,Bach; Quang Tran,34,0,34,0
1708246790553,MATH 10B,C04,431720,Bach; Quang Tran,33,0,34,1
1708246790553,MATH 10B,C05,431721,Bach; Quang Tran,32,0,34,2
1708246790553,MATH 10B,D01,431723,Staff,28,0,34,6
1708246790553,MATH 10B,D02,431724,Staff,34,0,34,0
1708246790553,MATH 10B,D03,431725,Staff,34,0,34,0
1708246790553,MATH 10B,D04,431726,Staff,34,0,34,0
1708246790553,MATH 10B,D05,431727,Staff,57,0,60,3
1708246791084,MATH 10C,A01,431741,Staff,94,0,96,2
1708246791084,MATH 10C,A02,431742,Staff,39,0,40,1
1708246791084,MATH 10C,B01,431744,Staff,95,0,96,1
1708246791084,MATH 10C,B02,431746,Staff,27,0,40,13
1708246791084,MATH 10C,C01,431748,Pardo Guerra; Sebastian,30,0,40,10
1708246791084,MATH 10C,C02,431885,Pardo Guerra; Sebastian,40,0,40,0
1708246791084,MATH 10C,C03,431895,Pardo Guerra; Sebastian,32,0,33,1
1708246791084,MATH 10C,C04,431896,Pardo Guerra; Sebastian,32,0,32,0
1708246791615,MATH 11,A01,431933,Rava; Denise,82,0,100,18
1708246791615,MATH 11,A02,431960,Rava; Denise,66,0,70,4
1708246791615,MATH 11,A03,431971,Rava; Denise,39,0,40,1
1708246791615,MATH 11,B01,432053,Staff,99,0,100,1
1708246791615,MATH 11,B02,432064,Staff,37,0,45,8
1708246791615,MATH 11,B03,432073,Staff,44,0,45,1
1708246792146,MATH 18,A01,432082,Mackall; Eoin Travis,65,0,70,5
1708246792146,MATH 18,A02,432086,Mackall; Eoin Travis,68,0,70,2
1708246792146,MATH 18,B01,432089,Suk; Andrew Hoon,39,0,40,1
1708246792146,MATH 18,B02,432090,Suk; Andrew Hoon,35,0,40,5
1708246792146,MATH 18,B03,432091,Suk; Andrew Hoon,33,0,40,7
1708246792146,MATH 18,B04,432092,Suk; Andrew Hoon,30,0,40,10
1708246792146,MATH 18,B05,432093,Suk; Andrew Hoon,34,0,35,1
1708246792146,MATH 18,B06,432094,Suk; Andrew Hoon,33,0,35,2
1708246792146,MATH 18,B07,432095,Suk; Andrew Hoon,98,0,100,2
1708246792146,MATH 18,B08,432096,Suk; Andrew Hoon,100,0,100,0
1708246792146,MATH 18,B09,432097,Suk; Andrew Hoon,98,0,100,2
1708246792146,MATH 18,B10,432098,Suk; Andrew Hoon,69,0,70,1
1708246792677,MATH 20A,A01,432101,Briones; Jor-el Thomas Caparas,31,0,40,9
1708246792677,MATH 20A,A02,432102,Briones; Jor-el Thomas Caparas,98,0,100,2
1708246792677,MATH 20A,B01,432104,Briones; Jor-el Thomas Caparas,99,0,100,1
1708246792677,MATH 20A,B02,432105,Briones; Jor-el Thomas Caparas,40,0,40,0
1708246793204,MATH 20B,A01,432107,Quarfoot; David James,33,0,35,2
1708246793204,MATH 20B,A02,432108,Quarfoot; David James,18,0,35,17
1708246793204,MATH 20B,A03,432109,Quarfoot; David James,32,0,35,3
1708246793204,MATH 20B,A04,432110,Quarfoot; David James,34,0,35,1
1708246793204,MATH 20B,A05,432331,Quarfoot; David James,26,0,32,6
1708246793204,MATH 20B,A06,432411,Quarfoot; David James,31,0,32,1
1708246793204,MATH 20B,B01,432413,Mackall; Eoin Travis,62,0,65,3
1708246793204,MATH 20B,B02,432443,Mackall; Eoin Travis,65,0,65,0
1708246793204,MATH 20B,B03,432444,Mackall; Eoin Travis,60,0,60,0
1708246793204,MATH 20B,B04,432471,Mackall; Eoin Travis,60,0,60,0
1708246793732,MATH 20C,A01,432473,Ohm; Ko Woon,27,0,38,11
1708246793732,MATH 20C,A02,432474,Ohm; Ko Woon,36,0,38,2
1708246793732,MATH 20C,A03,432475,Ohm; Ko Woon,34,0,37,3
1708246793732,MATH 20C,A04,432546,Ohm; Ko Woon,36,0,37,1
1708246793732,MATH 20C,A05,432550,Ohm; Ko Woon,88,0,90,2
1708246793732,MATH 20C,B01,432568,Ohm; Ko Woon,43,0,45,2
1708246793732,MATH 20C,B02,432594,Ohm; Ko Woon,40,0,45,5
1708246793732,MATH 20C,B03,432609,Ohm; Ko Woon,85,0,90,5
1708246793732,MATH 20C,C01,432613,Cheng; Hsiao-Bing,67,0,70,3
1708246793732,MATH 20C,C02,432614,Cheng; Hsiao-Bing,68,0,70,2
1708246793732,MATH 20C,C03,432615,Cheng; Hsiao-Bing,70,0,70,0
1708246793732,MATH 20C,D01,432617,Cheng; Hsiao-Bing,69,0,70,1
1708246793732,MATH 20C,D02,432618,Cheng; Hsiao-Bing,68,0,70,2
1708246793732,MATH 20C,D03,432619,Cheng; Hsiao-Bing,70,0,70,0
1708246794268,MATH 20D,A01,432622,Hammock; Frances H,58,0,60,2
1708246794268,MATH 20D,A02,432623,Hammock; Frances H,58,0,60,2
1708246794268,MATH 20D,A03,432658,Hammock; Frances H,35,0,35,0
1708246794268,MATH 20D,A04,432660,Hammock; Frances H,35,0,35,0
1708246794268,MATH 20D,B01,432702,Hammock; Frances H,66,0,70,4
1708246794268,MATH 20D,B02,432703,Hammock; Frances H,70,0,70,0
1708246794268,MATH 20D,B03,432766,Hammock; Frances H,30,0,30,0
1708246794268,MATH 20D,B04,432782,Hammock; Frances H,20,0,30,10
1708246794268,MATH 20D,C01,432811,Sheng; Hongyi,60,0,60,0
1708246794268,MATH 20D,C02,432931,Sheng; Hongyi,60,0,60,0
1708246794268,MATH 20D,C03,432945,Sheng; Hongyi,28,0,30,2
1708246794268,MATH 20D,C04,432949,Sheng; Hongyi,30,0,30,0
1708246794796,MATH 20E,A01,433007,Eggers; John Dietrich,70,0,80,10
1708246794796,MATH 20E,A02,433070,Eggers; John Dietrich,77,0,80,3
1708246794796,MATH 20E,A03,433079,Eggers; John Dietrich,32,0,35,3
1708246794796,MATH 20E,B01,433092,Staff,86,0,90,4
1708246794796,MATH 20E,B02,433093,Staff,90,0,90,0
1708246794796,MATH 20E,C01,433237,Bach; Quang Tran,52,0,60,8
1708246794796,MATH 20E,C02,433238,Bach; Quang Tran,69,0,70,1
1708246794796,MATH 20E,C03,433239,Bach; Quang Tran,70,0,70,0
1708246795323,MATH 31CH,A01,433241,Rabin; Jeffrey Mark,35,0,35,0
1708246795852,MATH 95,A00,433242,Stevens; Laura Jeanne,30,0,30,0
1708246796378,MATH 100C,A01,433244,Pollack; Aaron,31,0,35,4
1708246796378,MATH 100C,A02,433245,Pollack; Aaron,35,0,35,0
1708246796909,MATH 102,A01,433298,Ophir; Amit,29,0,30,1
1708246796909,MATH 102,A02,433369,Ophir; Amit,30,0,30,0
1708246796909,MATH 102,A03,433373,Ophir; Amit,30,0,30,0
1708246796909,MATH 102,A04,433374,Ophir; Amit,29,0,30,1
1708246796909,MATH 102,B01,433572,Zhang; Ming,28,0,30,2
1708246796909,MATH 102,B02,433732,Zhang; Ming,30,0,30,0
1708246796909,MATH 102,B03,433733,Zhang; Ming,30,0,30,0
1708246796909,MATH 102,B04,433734,Zhang; Ming,29,0,30,1
1708246797434,MATH 103B,A01,433793,Lu; Yunze,23,0,30,7
1708246797434,MATH 103B,A02,433795,Lu; Yunze,30,0,30,0
1708246797434,MATH 103B,A03,433830,Lu; Yunze,28,0,30,2
1708246797434,MATH 103B,B01,433845,Lahiri; Aranya,24,0,30,6
1708246797434,MATH 103B,B02,433846,Lahiri; Aranya,28,0,30,2
1708246797434,MATH 103B,B03,433847,Lahiri; Aranya,27,0,30,3
1708246797968,MATH 109,A01,433849,Aycock; Jon Merrill,6,0,10,4
1708246797968,MATH 109,A02,433850,Aycock; Jon Merrill,9,0,10,1
1708246797968,MATH 109,B01,433852,Klevdal; Christian Sleek,10,0,10,0
1708246797968,MATH 109,B02,433859,Klevdal; Christian Sleek,10,0,10,0
1708246797968,MATH 109,C01,433861,Treuer; John N,5,0,10,5
1708246797968,MATH 109,C02,433862,Treuer; John N,10,0,10,0
1708246797968,MATH 109,D01,433864,Treuer; John N,8,0,10,2
1708246797968,MATH 109,D02,433865,Treuer; John N,8,0,10,2
1708246797968,MATH 109,E01,433868,Sheng; Hongyi,10,0,10,0
1708246797968,MATH 109,E02,433869,Sheng; Hongyi,19,0,20,1
1708246798503,MATH 110,A01,433871,Pillai; Mohandas K,24,0,35,11
1708246798503,MATH 110,A02,433872,Pillai; Mohandas K,33,0,35,2
1708246799028,MATH 112B,A01,480683,Komarova; Natalia,27,0,27,0
1708246799558,MATH 120B,A01,433885,Xiao; Ming,32,0,35,3
1708246799558,MATH 120B,A02,433886,Xiao; Ming,34,0,35,1
1708246800088,MATH 121B,A01,433888,Stevens; Laura Jeanne,29,0,30,1
1708246800614,MATH 140B,A01,433890,Seward; Brandon M.,31,0,35,4
1708246800614,MATH 140B,A02,433891,Seward; Brandon M.,35,0,35,0
1708246801142,MATH 140C,A01,433895,Spolaor; Luca,32,0,35,3
1708246801142,MATH 140C,A02,433896,Spolaor; Luca,35,0,35,0
1708246801666,MATH 142B,A01,433966,Eggers; John Dietrich,25,0,35,10
1708246801666,MATH 142B,A02,434063,Eggers; John Dietrich,32,0,35,3
1708246801666,MATH 142B,B01,434071,Sanchez; Anthony,32,0,35,3
1708246801666,MATH 142B,B02,434083,Sanchez; Anthony,34,0,35,1
1708246801666,MATH 142B,C01,434094,Kunnawalkam Elayavalli; Sr,31,0,35,4
1708246801666,MATH 142B,C02,434095,Kunnawalkam Elayavalli; Sr,34,0,35,1
1708246802194,MATH 144,A01,434097,Cloninger; Alexander,30,0,30,0
1708246802723,MATH 150B,A01,434104,Parise; Davide,33,0,35,2
1708246803248,MATH 152,A01,434107,Grier; Daniel T,20,0,40,20
1708246803778,MATH 154,A01,434109,Wesley; William J,31,0,35,4
1708246803778,MATH 154,A02,434119,Wesley; William J,35,0,35,0
1708246803778,MATH 154,A03,434120,Wesley; William J,35,0,35,0
1708246803778,MATH 154,A04,434121,Wesley; William J,34,0,35,1
1708246803778,MATH 154,B01,434126,Aliabadi Sr.; Mohsen,26,0,35,9
1708246803778,MATH 154,B02,434127,Aliabadi Sr.; Mohsen,34,0,35,1
1708246803778,MATH 154,B03,434138,Aliabadi Sr.; Mohsen,35,0,35,0
1708246803778,MATH 154,B04,434139,Aliabadi Sr.; Mohsen,35,0,35,0
1708246804308,MATH 163,A01,434144,Bowers; Adam R.,0,0,5,5
1708246804837,MATH 170A,A01,434148,Nag; Panchali,36,0,36,0
1708246804837,MATH 170A,A02,434149,Nag; Panchali,36,0,36,0
1708246804837,MATH 170A,A03,434150,Nag; Panchali,36,0,37,1
1708246804837,MATH 170A,A04,434151,Nag; Panchali,36,0,36,0
1708246805364,MATH 170B,A01,434155,Huang; Lei,31,0,35,4
1708246805364,MATH 170B,A02,434160,Huang; Lei,35,0,35,0
1708246805364,MATH 170B,A03,434161,Huang; Lei,35,0,35,0
1708246805364,MATH 170B,A04,434162,Huang; Lei,35,0,35,0
1708246805893,MATH 170C,A01,434176,Leok; Melvin,30,0,35,5
1708246805893,MATH 170C,A02,434300,Leok; Melvin,34,0,35,1
1708246806422,MATH 171B,A01,434576,Nie; Jiawang,25,0,35,10
1708246806422,MATH 171B,A02,434583,Nie; Jiawang,35,0,35,0
1708246806422,MATH 171B,A03,434584,Nie; Jiawang,35,0,35,0
1708246806422,MATH 171B,A04,434609,Nie; Jiawang,35,0,35,0
1708246806951,MATH 180A,A01,434638,Gartland; Christopher John,29,0,30,1
1708246806951,MATH 180A,A02,434821,Gartland; Christopher John,28,0,30,2
1708246806951,MATH 180A,A03,434833,Gartland; Christopher John,24,0,30,6
1708246806951,MATH 180A,A04,434839,Gartland; Christopher John,30,0,30,0
1708246806951,MATH 180A,A05,434843,Gartland; Christopher John,30,0,30,0
1708246806951,MATH 180A,A06,434895,Gartland; Christopher John,30,0,30,0
1708246807479,MATH 180B,A01,435085,Gartland; Christopher John,30,0,35,5
1708246807479,MATH 180B,A02,435086,Gartland; Christopher John,35,0,35,0
1708246807479,MATH 180B,A03,435087,Gartland; Christopher John,34,0,35,1
1708246807479,MATH 180B,A04,435088,Gartland; Christopher John,35,0,35,0
1708246808009,MATH 180C,A01,435090,Carfagnini; Marco,29,0,35,6
1708246808009,MATH 180C,A02,435091,Carfagnini; Marco,35,0,35,0
1708246808009,MATH 180C,A03,435092,Carfagnini; Marco,32,0,35,3
1708246808009,MATH 180C,A04,435113,Carfagnini; Marco,35,0,35,0
1708246808534,MATH 181A,A01,435279,Zhang; Danna,30,0,35,5
1708246808534,MATH 181A,A02,435300,Zhang; Danna,35,0,35,0
1708246808534,MATH 181A,A03,435301,Zhang; Danna,22,0,35,13
1708246808534,MATH 181A,A04,435302,Zhang; Danna,31,0,35,4
1708246809062,MATH 181B,A01,435315,Rava; Denise,33,0,35,2
1708246809062,MATH 181B,A02,435316,Rava; Denise,33,0,35,2
1708246809062,MATH 181B,A03,435317,Rava; Denise,33,0,35,2
1708246809062,MATH 181B,A04,435318,Rava; Denise,35,0,35,0
1708246809589,MATH 183,A01,435320,Quarfoot; David James,26,0,35,9
1708246809589,MATH 183,A02,435321,Quarfoot; David James,35,0,35,0
1708246809589,MATH 183,A03,435322,Quarfoot; David James,32,0,35,3
1708246809589,MATH 183,A04,435323,Quarfoot; David James,34,0,35,1
1708246809589,MATH 183,A05,435327,Quarfoot; David James,34,0,35,1
1708246809589,MATH 183,A06,435329,Quarfoot; David James,33,0,35,2
1708246810115,MATH 184,A01,435337,Verstraete; Jacques Allan,32,0,35,3
1708246810115,MATH 184,A02,435338,Verstraete; Jacques Allan,35,0,35,0
1708246810115,MATH 184,A03,435339,Verstraete; Jacques Allan,34,0,35,1
1708246810115,MATH 184,A04,435347,Verstraete; Jacques Allan,30,0,35,5
1708246810648,MATH 185,A01,435432,Arias-Castro; Ery,15,0,30,15
1708246810648,MATH 185,A02,435436,Arias-Castro; Ery,30,0,30,0
1708246810648,MATH 185,A03,435437,Arias-Castro; Ery,30,0,30,0
1708246810648,MATH 185,A04,435438,Arias-Castro; Ery,30,0,30,0
1708246811175,MATH 187A,A01,435443,Agrawal; Shishir,16,0,30,14
1708246811175,MATH 187A,A02,435444,Agrawal; Shishir,30,0,30,0
1708246811175,MATH 187A,A03,435503,Agrawal; Shishir,28,0,30,2
1708246811175,MATH 187A,A04,435507,Agrawal; Shishir,30,0,30,0
1708246811175,MATH 187A,A05,435554,Agrawal; Shishir,22,0,30,8
1708246811175,MATH 187A,A06,435558,Agrawal; Shishir,28,0,30,2
1708246811702,MATH 187B,A01,435570,Bucur; Alina Ioana,25,0,35,10
1708246811702,MATH 187B,A02,435571,Bucur; Alina Ioana,35,0,35,0
1708246812228,MATH 188,A01,435573,Kunnawalkam Elayavalli; Sr,35,0,35,0
1708246812754,MATH 189,A01,435577,Vishwanath; Siddharth,0,0,10,10
1708246812754,MATH 189,A02,435594,Vishwanath; Siddharth,0,0,10,10
1708246812754,MATH 189,A03,435595,Vishwanath; Siddharth,0,0,10,10
1708246812754,MATH 189,A04,435596,Vishwanath; Siddharth,0,0,10,10
1708246812754,MATH 189,A05,480706,Vishwanath; Siddharth,2,0,10,8
1708246812754,MATH 189,A06,481362,Vishwanath; Siddharth,6,0,10,4
1708246813281,MATH 200C,A00,430388,Bucur; Alina Ioana,15,0,15,0
1708246813811,MATH 202C,A00,430389,Rhoades; Brendon Patrick,15,0,15,0
1708246814337,MATH 203C,A00,430390,Izadi; Elham,15,0,15,0
1708246814863,MATH 204C,A00,430391,Sorensen; Claus M,15,0,15,0
1708246815388,MATH 208,A00,430392,Izadi; Elham,8,0,10,2
1708246815917,MATH 209,A00,430393,Pollack; Aaron,10,0,10,0
1708246816453,MATH 211A,A00,430394,Salehi Golsefidy; Alireza,10,0,10,0
1708246817048,MATH 211B,A00,430395,Seward; Brandon M.,10,0,10,0
1708246817580,MATH 212B,A01,480692,Komarova; Natalia,5,0,5,0
1708246818107,MATH 216C,A00,430429,Saab; Rayan,13,0,15,2
1708246818638,MATH 217,A00,430430,Li; Bo,13,0,15,2
1708246819166,MATH 218,A00,430431,Li; Bo,8,0,10,2
1708246819726,MATH 220C,A00,430432,Xiao; Ming,15,0,15,0
1708246820253,MATH 240C,A00,430433,Ebenfelt; Peter F,14,0,15,1
1708246820780,MATH 241B,A00,430434,Ioana; Adrian,14,0,15,1
1708246821305,MATH 243,A00,430435,Kunnawalkam Elayavalli; Sr,9,0,10,1
1708246821836,MATH 248,A00,430436,Bejenaru; Ioan,9,0,10,1
1708246822363,MATH 251C,A00,430437,Wenzl; Hans G,15,0,15,0
1708246822889,MATH 258,A00,430438,Spolaor; Luca,10,0,10,0
1708246823416,MATH 261C,A00,430439,Manners; Frederick,14,0,15,1
1708246823946,MATH 262A,A00,430440,Warnke; Lutz Peter,14,0,15,1
1708246824476,MATH 268,A00,430441,Buss; Samuel R,10,0,10,0
1708246825002,MATH 269,A00,430442,Rhoades; Brendon Patrick & Warnke; Lutz Peter,10,0,10,0
1708246825529,MATH 270C,A00,430445,Cheng; Li-Tien,15,0,15,0
1708246826059,MATH 273B,A00,430452,Zhu; Yuhua,15,0,15,0
1708246826590,MATH 276,A00,430458,Mc Culloch; Andrew Douglas & Amaro; Rommie E,0,0,0,0
1708246827118,MATH 277A,A00,430464,Dumitriu; Ioana,14,0,15,1
1708246827646,MATH 278A,A00,430470,Cheng; Li-Tien,9,0,10,1
1708246828171,MATH 278B,A00,430471,Cloninger; Alexander,10,0,10,0
1708246828699,MATH 278C,A00,430472,Nie; Jiawang,9,0,10,1
1708246829227,MATH 280C,A00,430485,Schweinsberg; Jason,13,0,15,2
1708246829757,MATH 281C,A00,430496,Arias-Castro; Ery,8,0,15,7
1708246830282,MATH 284,A00,430503,Xu; Ronghui,11,0,15,4
1708246830810,MATH 287C,A00,430520,Zhang; Danna,14,0,15,1
1708246831335,MATH 288,A00,430527,Carfagnini; Marco,9,0,10,1
1708246831864,MATH 289A,A00,430541,Novak; Jonathan I,14,0,15,1
1708246832389,MATH 290C,A00,430548,Roberts; Justin Deritter,13,0,15,2
1708246832914,MATH 292,A00,430660,Lu; Yunze,10,0,10,0
1708246833439,MATH 294,A00,430678,Fitzsimmons; Patrick J,11,0,15,4
1708246833968,MATH 295,A00,430692,Bejenaru; Ioan,15,0,15,0
1708246834493,MATH 297,001,430721,Gamst; Anthony Collins,0,0,0,0
1708246835021,MATS 200,A00,414457,Graeve; Olivia A,9995,0,9999,4
1708246835547,MATS 201C,A00,414465,Arzt; Eduard,38,0,50,12
1708246836077,MATS 236,A00,414466,Staff,17,0,20,3
1708246836607,MATS 252,A00,414467,Evdokimenko; Ekaterina,42,0,45,3
1708246837136,MATS 261B,A00,414468,Qiao; Yu,17,0,25,8
1708246837664,MATS 295,A00,414469,Graeve; Olivia A,9999,0,9999,0
1708246837664,MATS 295,B00,478858,Kummel; Andrew C,9999,0,9999,0
1708246838197,MCWP 40,001,414476,Montejo; Carolina,19,0,20,1
1708246838197,MCWP 40,004,414480,Wastal; Carrie King,13,0,15,2
1708246838197,MCWP 40,005,414481,Wastal; Carrie King,10,0,15,5
1708246838197,MCWP 40,006,414482,Wastal; Carrie King,12,0,15,3
1708246838197,MCWP 40,007,414483,Wastal; Carrie King,13,0,15,2
1708246838197,MCWP 40,008,414484,Wastal; Carrie King,15,0,15,0
1708246838197,MCWP 40,009,414487,Wastal; Carrie King,12,0,15,3
1708246838197,MCWP 40,014,414505,Staff,20,0,20,0
1708246838197,MCWP 40,015,494362,Wastal; Carrie King,14,0,15,1
1708246838736,MCWP 50,002,414534,Bartulis; Jason Michael,20,0,20,0
1708246838736,MCWP 50,003,414536,Bartulis; Jason Michael,20,0,20,0
1708246838736,MCWP 50,004,414538,Krone; Jarret,16,0,20,4
1708246838736,MCWP 50,005,414539,Krone; Jarret,19,0,20,1
1708246838736,MCWP 50,006,414540,Smith; Haydee Marie,16,0,20,4
1708246838736,MCWP 50,007,414544,Compas; Sean Matthew,14,0,20,6
1708246838736,MCWP 50,008,414549,Redela; Pamela Morgan,20,0,20,0
1708246838736,MCWP 50,011,414557,Carter; Andrea L,16,0,20,4
1708246838736,MCWP 50,012,414592,Silva; Kelly B,20,0,20,0
1708246838736,MCWP 50,013,414593,Silva; Kelly B,19,0,20,1
1708246838736,MCWP 50,014,414594,Carter; Andrea L,20,0,20,0
1708246838736,MCWP 50,016,414596,Morshed; Michael James,14,0,20,6
1708246838736,MCWP 50,017,414598,Morshed; Michael James,17,0,20,3
1708246838736,MCWP 50,019,414601,Redela; Pamela Morgan,17,0,20,3
1708246838736,MCWP 50,020,414606,Carter; Jennifer A,20,0,20,0
1708246838736,MCWP 50,021,414607,Carter; Jennifer A,19,0,20,1
1708246838736,MCWP 50,022,414649,Compas; Sean Matthew,11,0,20,9
1708246838736,MCWP 50,023,414650,Smith; Haydee Marie,20,0,20,0
1708246838736,MCWP 50,024,414651,Nies; Laurie Elizabeth,19,0,20,1
1708246838736,MCWP 50,025,414655,Nies; Laurie Elizabeth,18,0,20,2
1708246838736,MCWP 50,026,414656,Pham; Vincent Minhduc,19,0,20,1
1708246838736,MCWP 50,027,414657,Pham; Vincent Minhduc,20,0,20,0
1708246838736,MCWP 50,028,414668,Morshed; Michael James,16,0,20,4
1708246838736,MCWP 50,029,414669,Morshed; Michael James,19,0,20,1
1708246839262,MCWP 50R,A00,486838,Miller; Elizabeth Deen,19,0,20,1
1708246839262,MCWP 50R,B00,486843,Miller; Elizabeth Deen,16,0,20,4
1708246839262,MCWP 50R,C00,486844,Miller; Elizabeth Deen,19,0,20,1
1708246839793,MCWP 125,A00,414670,Wilson; Marion E.,20,0,20,0
1708246839793,MCWP 125,B00,414674,Guillen; Melinda,20,0,20,0
1708246839793,MCWP 125,C00,414678,Guillen; Melinda,20,0,20,0
1708246839793,MCWP 125,D00,414682,Guillen; Melinda,20,0,20,0
1708246840322,MED 231,A00,476440,Hurst; Samantha,7,0,7,0
1708246840852,MED 246,A00,492785,Gordts; Philip & Varki; Ajit P & Lewis; Amanda Lark & Godula; Kamil & Gagneux; Pascal & Esko; Jeffrey D. & Bode; Lars,10,0,10,0
1708246841380,MED 262,A00,492942,Koola; Jejo David,28,0,30,2
1708246841905,MED 267,A01,492789,Hogarth; Michael Andrew,25,0,30,5
1708246842432,MED 275,A00,464684,Liu; George Yenhsi,10,0,10,0
1708246842958,MED 276,A00,492786,Sitapati; Amy,23,0,25,2
1708246843487,MED 278,A00,492787,Carter; Hannah Kathryn & Mesirov; Jill P. & Curtius; Kathleen Mary,20,0,20,0
1708246844017,MED 296,001,464685,Chi; Neil C.,48,0,50,2
1708246844017,MED 296,002,464686,Hong; Kimberly N,49,0,50,1
1708246844017,MED 296,003,464687,Staff,50,0,50,0
1708246844542,MGT 3,A00,442429,Wagner; Timothy Ryan,95,0,98,3
1708246845073,MGT 4,A01,442443,Levkoff; Steven B.,0,0,5,5
1708246845073,MGT 4,A02,442444,Levkoff; Steven B.,4,0,5,1
1708246845601,MGT 5,A00,442446,Molloie Jr.; William H,184,0,196,12
1708246846126,MGT 12,A00,442447,Lindenberger; Wade Douglas,83,0,100,17
1708246846126,MGT 12,B00,442448,Lindenberger; Wade Douglas,72,0,100,28
1708246846126,MGT 12,C00,442449,Pecore; Joseph P.,88,0,100,12
1708246846657,MGT 16,A00,442452,Buchanan; Harold G,97,0,100,3
1708246846657,MGT 16,B00,442459,Buchanan; Harold G,92,0,100,8
1708246846657,MGT 16,C00,442461,Campbell; Robert Harold,113,0,120,7
1708246846657,MGT 16,D00,442475,Campbell; Robert Harold,118,0,120,2
1708246847184,MGT 18,A00,442477,McKay; Michael J,98,0,98,0
1708246847184,MGT 18,B00,442491,McKay; Michael J,96,0,98,2
1708246847184,MGT 18,C00,442493,McKay; Michael J,98,0,98,0
1708246847184,MGT 18,D00,442503,Chamberlain; Travis Dean,98,0,98,0
1708246847711,MGT 45,A00,442508,Pecore; Joseph P.,147,0,150,3
1708246847711,MGT 45,B00,442510,Pecore; Joseph P.,142,0,150,8
1708246848237,MGT 71,A00,442524,Lee; Hyun Seok,77,0,98,21
1708246848766,MGT 71R,A00,442526,Phiroz; Zal Navroze,77,0,98,21
1708246849292,MGT 100,A00,442541,Wilbur; Kenneth C,82,0,98,16
1708246849292,MGT 100,B00,442542,Wilbur; Kenneth C,89,0,98,9
1708246849818,MGT 103,A00,442543,Eberhard; Craig A,98,0,98,0
1708246849818,MGT 103,B00,442544,Eberhard; Craig A,95,0,98,3
1708246849818,MGT 103,C00,442545,Ehrich; Kristine R,90,0,98,8
1708246849818,MGT 103,D00,442547,Ehrich; Kristine R,96,0,98,2
1708246849818,MGT 103,E00,442548,Ehrich; Kristine R,97,0,98,1
1708246849818,MGT 103,F00,442549,Demill; Burritt,92,0,98,6
1708246849818,MGT 103,G00,442550,Bates; Kenneth Walter,97,0,98,1
1708246850347,MGT 105,A00,442558,Bates; Kenneth Walter,86,0,98,12
1708246850877,MGT 106,A00,442560,Eberhard; Craig A,95,0,98,3
1708246851404,MGT 109,A00,442574,Campbell; Colin Leslie,90,0,98,8
1708246851930,MGT 112,A00,442576,Somasundaram; Tyagarajan,96,0,98,2
1708246851930,MGT 112,B00,442590,Somasundaram; Tyagarajan,94,0,98,4
1708246851930,MGT 112,C00,442592,Zimmermann; Carsten,87,0,98,11
1708246852458,MGT 119,A00,442602,Staff,97,0,98,1
1708246852458,MGT 119,B00,442603,Anderson; Jon Marcus,96,0,98,2
1708246852987,MGT 121B,A00,442606,Klaas; Jeffrey David,94,0,98,4
1708246853513,MGT 128R,A00,442607,Krishnan; Viswanathan,85,0,98,13
1708246854039,MGT 131A,A00,442608,Houskeeper; Robert,148,0,150,2
1708246854568,MGT 131B,A00,442609,Houskeeper; Robert,100,0,100,0
1708246855094,MGT 132,A00,442610,Blakley; Bruce,97,0,98,1
1708246855618,MGT 137,A00,442611,Lindenberger; Wade Douglas,86,0,98,12
1708246856147,MGT 147,A00,442612,Anderson; John Charles,32,0,40,8
1708246856673,MGT 151R,A00,442613,Phiroz; Zal Navroze,92,0,98,6
1708246857203,MGT 153,A00,442650,Perols; Johan Lars,55,0,80,25
1708246857733,MGT 162,A00,442652,Demill; Burritt,82,0,98,16
1708246857733,MGT 162,B00,442654,Demill; Burritt,88,0,98,10
1708246857733,MGT 162,C00,442776,Staff,95,0,98,3
1708246857733,MGT 162,D00,442778,Staff,96,0,98,2
1708246858259,MGT 164,A00,442780,McKay; Mary A,97,0,98,1
1708246858259,MGT 164,B00,442849,McKay; Mary A,96,0,98,2
1708246858259,MGT 164,C00,442917,McKay; Mary A,97,0,98,1
1708246858259,MGT 164,D00,442949,Meyer; Alison Bloomfield,90,0,98,8
1708246858784,MGT 166,A00,443017,Moran; Cathleen L.,95,0,98,3
1708246858784,MGT 166,B00,443045,Moran; Cathleen L.,97,0,98,1
1708246858784,MGT 166,C00,443046,Moran; Cathleen L.,98,0,98,0
1708246859315,MGT 167,A00,443047,Klaas; Jeffrey David,93,0,98,5
1708246859844,MGT 171R,A00,443048,Phiroz; Zal Navroze,86,0,98,12
1708246860373,MGT 172,A00,443049,Hedges; Kathleen & Royal; Rebecca,116,0,120,4
1708246860373,MGT 172,B00,443050,Hedges; Kathleen,95,0,98,3
1708246860373,MGT 172,C00,443051,Zimmermann; Carsten,96,0,98,2
1708246860900,MGT 173,A00,443052,Hayes; Sherry Lorine,92,0,100,8
1708246861425,MGT 175,A00,443053,Gopal; Christopher S.,98,0,98,0
1708246861949,MGT 180,A00,443055,Bliss; Barbara Ann,139,0,150,11
1708246861949,MGT 180,B00,443069,Bliss; Barbara Ann,145,0,150,5
1708246862479,MGT 181,A00,443120,Buchanan; Harold G,147,0,150,3
1708246863004,MGT 183,A00,443121,Banerjee; Snehal,88,0,98,10
1708246863530,MGT 185,A00,443122,Dunn; Louis Jean,90,0,98,8
1708246864056,MGT 187,A00,443133,Dunn; Louis Jean,95,0,100,5
1708246864583,MGT 189,A00,443134,Avenancio-Leon; Carlos,98,0,98,0
1708246865110,MGT 227,A00,479242,Serra Garcia; Marta,19,0,20,1
1708246865637,MGT 259,A00,443135,Oveis; Christopher S,19,0,20,1
1708246866165,MGT 296,001,481416,Gneezy; Ayelet,3,0,3,0
1708246866165,MGT 296,002,481420,Amir; On,3,0,3,0
1708246866165,MGT 296,003,481466,Amir; On & Karmarkar; Uma R,3,0,3,0
1708246866165,MGT 296,004,481468,Liu; Jun,3,0,3,0
1708246866165,MGT 296,005,481469,Misra; Kanishka,3,0,3,0
1708246866165,MGT 296,006,481470,Erat; Sanjiv,3,0,3,0
1708246866165,MGT 296,007,481473,Timmermann; Allan,3,0,3,0
1708246866165,MGT 296,008,481474,Smith; Pamela Karen,3,0,3,0
1708246866165,MGT 296,009,481477,Zhang; Zhe,3,0,3,0
1708246866165,MGT 296,010,481478,Oveis; Christopher S,3,0,3,0
1708246866165,MGT 296,011,481479,Amir; On & Gneezy; Ayelet,3,0,3,0
1708246866165,MGT 296,012,481481,Wilbur; Kenneth C,3,0,3,0
1708246866702,MMW 13,A01,412918,Chang; Edmond Yi-Teh,15,0,16,1
1708246866702,MMW 13,A02,412928,Chang; Edmond Yi-Teh,16,0,16,0
1708246866702,MMW 13,A03,413017,Chang; Edmond Yi-Teh,16,0,16,0
1708246866702,MMW 13,A04,413018,Chang; Edmond Yi-Teh,16,0,16,0
1708246866702,MMW 13,A05,413019,Chang; Edmond Yi-Teh,15,0,16,1
1708246866702,MMW 13,A06,413020,Chang; Edmond Yi-Teh,16,0,16,0
1708246866702,MMW 13,A07,413021,Chang; Edmond Yi-Teh,15,0,16,1
1708246866702,MMW 13,A08,413023,Chang; Edmond Yi-Teh,16,0,16,0
1708246866702,MMW 13,A09,413024,Chang; Edmond Yi-Teh,16,0,16,0
1708246866702,MMW 13,A10,413025,Chang; Edmond Yi-Teh,16,0,16,0
1708246866702,MMW 13,A11,413026,Chang; Edmond Yi-Teh,16,0,16,0
1708246866702,MMW 13,A12,413027,Chang; Edmond Yi-Teh,16,0,16,0
1708246866702,MMW 13,A13,413028,Chang; Edmond Yi-Teh,0,0,0,0
1708246866702,MMW 13,A14,413029,Chang; Edmond Yi-Teh,0,0,0,0
1708246866702,MMW 13,A15,413030,Chang; Edmond Yi-Teh,14,0,16,2
1708246866702,MMW 13,A16,413031,Chang; Edmond Yi-Teh,15,0,16,1
1708246866702,MMW 13,A17,413032,Chang; Edmond Yi-Teh,16,0,16,0
1708246866702,MMW 13,A18,413034,Chang; Edmond Yi-Teh,14,0,16,2
1708246866702,MMW 13,A19,413035,Chang; Edmond Yi-Teh,16,0,16,0
1708246866702,MMW 13,A20,413036,Chang; Edmond Yi-Teh,16,0,16,0
1708246866702,MMW 13,A21,413037,Chang; Edmond Yi-Teh,0,0,0,0
1708246866702,MMW 13,A22,413038,Chang; Edmond Yi-Teh,0,0,0,0
1708246866702,MMW 13,B01,413290,Zhiri; Oumelbanine,15,0,16,1
1708246866702,MMW 13,B02,413291,Zhiri; Oumelbanine,15,0,16,1
1708246866702,MMW 13,B03,413308,Zhiri; Oumelbanine,14,0,16,2
1708246866702,MMW 13,B04,413322,Zhiri; Oumelbanine,14,0,16,2
1708246866702,MMW 13,B05,413343,Zhiri; Oumelbanine,12,0,16,4
1708246866702,MMW 13,B06,413344,Zhiri; Oumelbanine,14,0,16,2
1708246866702,MMW 13,B07,413524,Zhiri; Oumelbanine,16,0,16,0
1708246866702,MMW 13,B08,413584,Zhiri; Oumelbanine,16,0,16,0
1708246866702,MMW 13,B09,413588,Zhiri; Oumelbanine,15,0,16,1
1708246866702,MMW 13,B10,413590,Zhiri; Oumelbanine,16,0,16,0
1708246866702,MMW 13,B11,413779,Zhiri; Oumelbanine,12,0,16,4
1708246866702,MMW 13,B12,413780,Zhiri; Oumelbanine,9,0,16,7
1708246866702,MMW 13,B13,413781,Zhiri; Oumelbanine,0,0,0,0
1708246866702,MMW 13,B14,413782,Zhiri; Oumelbanine,0,0,0,0
1708246866702,MMW 13,B15,413808,Zhiri; Oumelbanine,16,0,16,0
1708246866702,MMW 13,B16,413815,Zhiri; Oumelbanine,15,0,16,1
1708246866702,MMW 13,B17,413816,Zhiri; Oumelbanine,15,0,16,1
1708246866702,MMW 13,B18,413817,Zhiri; Oumelbanine,12,0,16,4
1708246866702,MMW 13,B19,413822,Zhiri; Oumelbanine,16,0,16,0
1708246866702,MMW 13,B20,413823,Zhiri; Oumelbanine,14,0,16,2
1708246866702,MMW 13,B21,413825,Zhiri; Oumelbanine,0,0,0,0
1708246866702,MMW 13,B22,413826,Zhiri; Oumelbanine,0,0,0,0
1708246866702,MMW 13,B23,413827,Zhiri; Oumelbanine,16,0,16,0
1708246866702,MMW 13,B24,413834,Zhiri; Oumelbanine,15,0,16,1
1708246866702,MMW 13,C01,413859,Vitkus; Daniel J.,16,0,16,0
1708246866702,MMW 13,C02,413860,Vitkus; Daniel J.,16,0,16,0
1708246866702,MMW 13,C04,413868,Vitkus; Daniel J.,0,0,0,0
1708246866702,MMW 13,C05,413869,Vitkus; Daniel J.,16,0,16,0
1708246866702,MMW 13,C06,413871,Vitkus; Daniel J.,16,0,16,0
1708246866702,MMW 13,C07,413886,Vitkus; Daniel J.,16,0,16,0
1708246866702,MMW 13,C08,413908,Vitkus; Daniel J.,16,0,16,0
1708246866702,MMW 13,C09,413930,Vitkus; Daniel J.,16,0,16,0
1708246866702,MMW 13,C10,413952,Vitkus; Daniel J.,15,0,16,1
1708246866702,MMW 13,C11,413972,Vitkus; Daniel J.,16,0,16,0
1708246866702,MMW 13,C12,413991,Vitkus; Daniel J.,16,0,16,0
1708246866702,MMW 13,C13,414007,Vitkus; Daniel J.,0,0,0,0
1708246866702,MMW 13,C14,414017,Vitkus; Daniel J.,0,0,0,0
1708246866702,MMW 13,C15,414030,Vitkus; Daniel J.,16,0,16,0
1708246866702,MMW 13,C16,414032,Vitkus; Daniel J.,16,0,16,0
1708246866702,MMW 13,C17,414033,Vitkus; Daniel J.,15,0,16,1
1708246866702,MMW 13,C18,414034,Vitkus; Daniel J.,16,0,16,0
1708246866702,MMW 13,C19,414041,Vitkus; Daniel J.,16,0,16,0
1708246866702,MMW 13,C20,414056,Vitkus; Daniel J.,16,0,16,0
1708246866702,MMW 13,C21,414057,Vitkus; Daniel J.,15,0,16,1
1708246866702,MMW 13,C22,414059,Vitkus; Daniel J.,16,0,16,0
1708246867272,MMW 15,A01,414065,Chang; Edmond Yi-Teh,28,0,28,0
1708246867272,MMW 15,A02,414067,Chang; Edmond Yi-Teh,27,0,28,1
1708246867272,MMW 15,A03,414092,Chang; Edmond Yi-Teh,26,0,28,2
1708246867272,MMW 15,A04,414104,Chang; Edmond Yi-Teh,28,0,28,0
1708246867272,MMW 15,A05,414121,Chang; Edmond Yi-Teh,0,0,0,0
1708246867272,MMW 15,A06,414122,Chang; Edmond Yi-Teh,0,0,0,0
1708246867272,MMW 15,A07,414123,Chang; Edmond Yi-Teh,28,0,28,0
1708246867272,MMW 15,A08,414124,Chang; Edmond Yi-Teh,28,0,28,0
1708246867272,MMW 15,A09,414125,Chang; Edmond Yi-Teh,0,0,0,0
1708246867272,MMW 15,A10,414130,Chang; Edmond Yi-Teh,0,0,0,0
1708246867272,MMW 15,B01,414132,Radcliff; Pamela B.,27,0,28,1
1708246867272,MMW 15,B02,414134,Radcliff; Pamela B.,27,0,28,1
1708246867272,MMW 15,B03,414135,Radcliff; Pamela B.,26,0,28,2
1708246867272,MMW 15,B04,414136,Radcliff; Pamela B.,27,0,28,1
1708246867272,MMW 15,B05,414137,Radcliff; Pamela B.,28,0,28,0
1708246867272,MMW 15,B06,414138,Radcliff; Pamela B.,27,0,28,1
1708246867272,MMW 15,B07,414140,Radcliff; Pamela B.,26,0,28,2
1708246867272,MMW 15,B08,414141,Radcliff; Pamela B.,28,0,28,0
1708246867272,MMW 15,C01,414143,Prestholdt; Jeremy,0,0,0,0
1708246867272,MMW 15,C02,414144,Prestholdt; Jeremy,0,0,0,0
1708246867272,MMW 15,C03,414145,Prestholdt; Jeremy,24,0,28,4
1708246867272,MMW 15,C04,414147,Prestholdt; Jeremy,17,0,28,11
1708246867272,MMW 15,C05,414148,Prestholdt; Jeremy,28,0,28,0
1708246867272,MMW 15,C06,414149,Prestholdt; Jeremy,26,0,28,2
1708246867272,MMW 15,C07,414152,Prestholdt; Jeremy,25,0,28,3
1708246867272,MMW 15,C08,414153,Prestholdt; Jeremy,23,0,28,5
1708246867800,MSED 295,A00,477850,Rabin; Jeffrey Mark,5,0,5,0
1708246867800,MSED 295,B00,477852,Lo; Stanley M.,5,0,5,0
1708246868326,MSED 296C,A00,477853,Staff,14,0,15,1
1708246868858,MUS 1C,A01,416488,Ishov; Alexander Alexandrovich,24,0,25,1
1708246868858,MUS 1C,A02,416502,Ishov; Alexander Alexandrovich,25,0,25,0
1708246868858,MUS 1C,A03,416519,Ishov; Alexander Alexandrovich,25,0,25,0
1708246868858,MUS 1C,A04,416520,Ishov; Alexander Alexandrovich,25,0,25,0
1708246868858,MUS 1C,A05,416521,Ishov; Alexander Alexandrovich,25,0,25,0
1708246869386,MUS 2C,A01,416523,Richards; Stephanie F,30,0,30,0
1708246869913,MUS 2CK,A00,416524,Ohnishi; Takae,15,0,15,0
1708246869913,MUS 2CK,B00,416547,Ohnishi; Takae,15,0,15,0
1708246870514,MUS 2JK,A00,416548,Kenyatta; Kamau,15,0,15,0
1708246871042,MUS 4,A01,416562,Staff,25,0,25,0
1708246871042,MUS 4,A02,416634,Staff,24,0,25,1
1708246871042,MUS 4,A03,416644,Staff,25,0,25,0
1708246871042,MUS 4,A04,416659,Staff,24,0,25,1
1708246871042,MUS 4,A05,416667,Staff,25,0,25,0
1708246871042,MUS 4,A06,416757,Staff,25,0,25,0
1708246871042,MUS 4,A07,416830,Staff,25,0,25,0
1708246871042,MUS 4,A08,416953,Staff,23,0,25,2
1708246871042,MUS 4,A09,417005,Staff,25,0,25,0
1708246871042,MUS 4,A10,417007,Staff,24,0,25,1
1708246871574,MUS 7,A01,417048,Staff,23,0,24,1
1708246871574,MUS 7,A02,417102,Staff,23,0,24,1
1708246871574,MUS 7,A03,417103,Staff,23,0,24,1
1708246871574,MUS 7,A04,417114,Staff,21,0,24,3
1708246872099,MUS 8,A01,417119,Staff,14,0,20,6
1708246872099,MUS 8,A02,417163,Staff,16,0,20,4
1708246872099,MUS 8,A03,417164,Staff,16,0,20,4
1708246872099,MUS 8,A04,417165,Staff,17,0,20,3
1708246872099,MUS 8,A05,417194,Staff,18,0,20,2
1708246872099,MUS 8,A06,417198,Staff,20,0,20,0
1708246872630,MUS 11,A01,417201,Terrazas Perez; Wilfrido D,21,0,25,4
1708246872630,MUS 11,A02,417219,Terrazas Perez; Wilfrido D,23,0,25,2
1708246872630,MUS 11,A03,417220,Terrazas Perez; Wilfrido D,25,0,25,0
1708246872630,MUS 11,A04,417222,Terrazas Perez; Wilfrido D,25,0,25,0
1708246872630,MUS 11,A05,417223,Terrazas Perez; Wilfrido D,24,0,25,1
1708246872630,MUS 11,A06,417295,Terrazas Perez; Wilfrido D,23,0,25,2
1708246872630,MUS 11,A07,417297,Terrazas Perez; Wilfrido D,24,0,25,1
1708246872630,MUS 11,A08,417298,Terrazas Perez; Wilfrido D,25,0,25,0
1708246873160,MUS 12,A01,417300,Guy; Nancy,25,0,25,0
1708246873160,MUS 12,A02,417301,Guy; Nancy,25,0,25,0
1708246873160,MUS 12,A03,417302,Guy; Nancy,25,0,25,0
1708246873160,MUS 12,A04,417303,Guy; Nancy,25,0,25,0
1708246873685,MUS 13,A01,417305,Leslie Santana; Myrta,25,0,25,0
1708246873685,MUS 13,A02,417306,Leslie Santana; Myrta,25,0,25,0
1708246873685,MUS 13,A03,417307,Leslie Santana; Myrta,25,0,25,0
1708246873685,MUS 13,A04,417308,Leslie Santana; Myrta,25,0,25,0
1708246874212,MUS 15,A01,417327,Schaffer; Max Benjamin,18,0,20,2
1708246874212,MUS 15,A02,417331,Schaffer; Max Benjamin,19,0,20,1
1708246874212,MUS 15,A03,417358,Schaffer; Max Benjamin,19,0,20,1
1708246874212,MUS 15,A04,417359,Schaffer; Max Benjamin,17,0,20,3
1708246874212,MUS 15,A05,417360,Schaffer; Max Benjamin,20,0,20,0
1708246874212,MUS 15,A06,417370,Schaffer; Max Benjamin,20,0,20,0
1708246874212,MUS 15,A07,417371,Schaffer; Max Benjamin,17,0,20,3
1708246874212,MUS 15,A08,417372,Schaffer; Max Benjamin,18,0,20,2
1708246874212,MUS 15,A09,417378,Schaffer; Max Benjamin,19,0,20,1
1708246874212,MUS 15,A10,417379,Schaffer; Max Benjamin,19,0,20,1
1708246874753,MUS 17,A01,417381,Staff,22,0,25,3
1708246874753,MUS 17,A02,417406,Staff,24,0,25,1
1708246874753,MUS 17,A03,417420,Staff,24,0,25,1
1708246874753,MUS 17,A04,417594,Staff,24,0,25,1
1708246874753,MUS 17,A05,417595,Staff,25,0,25,0
1708246874753,MUS 17,A06,417605,Staff,21,0,25,4
1708246874753,MUS 17,A07,417606,Staff,25,0,25,0
1708246874753,MUS 17,A08,417627,Staff,25,0,25,0
1708246874753,MUS 17,A09,417628,Staff,21,0,25,4
1708246874753,MUS 17,A10,417629,Staff,24,0,25,1
1708246874753,MUS 17,A11,417630,Staff,25,0,25,0
1708246874753,MUS 17,A12,417631,Staff,24,0,25,1
1708246874753,MUS 17,A13,417632,Staff,25,0,25,0
1708246874753,MUS 17,A14,417633,Staff,25,0,25,0
1708246875300,MUS 32,001,418855,Dresser; Mark Stuart,10,0,10,0
1708246875300,MUS 32,002,418856,Kenyatta; Kamau,9,0,10,1
1708246875300,MUS 32,003,418864,Curtis; Charles Rector,10,0,10,0
1708246875300,MUS 32,004,418865,Carlstrom; Mitchell Kraig,9,0,10,1
1708246875300,MUS 32,005,418868,Terrazas Perez; Wilfrido D,10,0,10,0
1708246875300,MUS 32,006,418869,Ohnishi; Takae,10,0,10,0
1708246875300,MUS 32,007,418872,Burr; Anthony I,10,0,10,0
1708246875300,MUS 32,008,418873,Carlson; Erik Norman,10,0,10,0
1708246875300,MUS 32,009,418874,Blair; Kyle Adam,10,0,10,0
1708246875300,MUS 32,010,418875,Richards; Stephanie F,10,0,10,0
1708246875826,MUS 32V,A00,417634,Narucki; Susan M,10,0,10,0
1708246875826,MUS 32V,B00,417635,Staff,10,0,10,0
1708246876355,MUS 32VM,A00,417636,Staff,15,0,15,0
1708246876882,MUS 33C,A00,417637,Taylor; Alexander Lawther,20,0,20,0
1708246877411,MUS 43,A00,417647,Burr; Anthony I,83,0,90,7
1708246877939,MUS 95D,A00,417919,Staff,40,0,40,0
1708246878472,MUS 95E,A00,417933,Henson; Matthew Alexander,55,0,55,0
1708246879002,MUS 95G,A00,417935,Anderson; Kenneth,387,0,395,8
1708246879002,MUS 95G,B00,417937,Anderson; Kenneth,394,0,395,1
1708246879528,MUS 95JC,A00,417939,Kenyatta; Kamau,30,0,30,0
1708246880073,MUS 95L,A00,417940,Jones; Michael David,50,0,50,0
1708246880597,MUS 95W,A00,417946,Seshadri; Kartik,29,0,30,1
1708246880597,MUS 95W,B00,417948,Seshadri; Kartik,30,0,30,0
1708246881122,MUS 101C,A01,417951,Burr; Anthony I,33,0,35,2
1708246881651,MUS 103C,A00,417952,Davis; Anthony Curtis,14,0,15,1
1708246882177,MUS 103F,A00,417959,Obermueller; Karola,1,0,1,0
1708246882705,MUS 113,A00,418015,Narucki; Susan M,14,0,15,1
1708246883231,MUS 120C,A01,418032,Leslie Santana; Myrta,25,0,25,0
1708246883756,MUS 127,A00,418037,Richards; Stephanie F,92,0,100,8
1708246884285,MUS 130,A00,418047,Ohnishi; Takae,30,0,30,0
1708246884811,MUS 131,A00,418065,Roberts; Matana,30,0,30,0
1708246885342,MUS 132,001,418883,Dresser; Mark Stuart,10,0,10,0
1708246885342,MUS 132,002,418885,Kenyatta; Kamau,10,0,10,0
1708246885342,MUS 132,003,418886,Curtis; Charles Rector,10,0,10,0
1708246885342,MUS 132,004,418887,Carlstrom; Mitchell Kraig,10,0,10,0
1708246885342,MUS 132,005,418888,Jones; Michael David,10,0,10,0
1708246885342,MUS 132,006,418889,Terrazas Perez; Wilfrido D,10,0,10,0
1708246885342,MUS 132,007,418893,Ohnishi; Takae,10,0,10,0
1708246885342,MUS 132,008,418894,Burr; Anthony I,10,0,10,0
1708246885342,MUS 132,009,418896,Carlson; Erik Norman,10,0,10,0
1708246885342,MUS 132,010,418900,Blair; Kyle Adam,10,0,10,0
1708246885342,MUS 132,011,418932,Richards; Stephanie F,10,0,10,0
1708246885342,MUS 132,012,418933,Nourai; Keyarash,10,0,10,0
1708246885869,MUS 132R,A00,418067,Burr; Anthony I,5,0,5,0
1708246885869,MUS 132R,B00,418078,Jones; Michael David,5,0,5,0
1708246886399,MUS 132V,A00,418092,Narucki; Susan M,15,0,15,0
1708246886399,MUS 132V,B00,418096,Staff,15,0,15,0
1708246886925,MUS 134,A00,418098,Staff,40,0,40,0
1708246887453,MUS 137C,A00,418109,Kenyatta; Kamau,25,0,25,0
1708246887995,MUS 143,A00,418123,Burr; Anthony I,33,0,40,7
1708246888523,MUS 150,A00,418127,Davis; Anthony Curtis,28,0,30,2
1708246889053,MUS 151,A00,418129,Hankins; Sarah E.,21,0,30,9
1708246889581,MUS 160B,A00,418172,Staff,11,0,15,4
1708246889581,MUS 160B,B00,418175,Dubnov; Shlomo,14,0,15,1
1708246890108,MUS 172,A01,418178,Staff,36,0,40,4
1708246890633,MUS 174C,A00,418179,Erbe; Tom,24,0,27,3
1708246891160,MUS 175,A00,418247,Smyth; Tamara R.,28,0,30,2
1708246891926,MUS 177,A00,418265,Erbe; Tom,11,0,15,4
1708246892458,MUS 201A,A00,418267,Narucki; Susan M,15,0,15,0
1708246892458,MUS 201A,B00,418268,Dresser; Mark Stuart,13,0,15,2
1708246892989,MUS 203C,A00,418269,Lou; Michelle Siulai,15,0,15,0
1708246893520,MUS 203D,A00,418272,Davis; Anthony Curtis,4,0,5,1
1708246893520,MUS 203D,B00,418275,Obermueller; Karola,5,0,5,0
1708246893520,MUS 203D,C00,418277,Liang; Lei,5,0,5,0
1708246893520,MUS 203D,D00,418323,Lou; Michelle Siulai,5,0,5,0
1708246894050,MUS 204,A00,418324,Obermueller; Karola,24,0,25,1
1708246894578,MUS 205,A00,418325,Cimini; Amy Marie,22,0,25,3
1708246895109,MUS 206,A00,418326,Liang; Lei,13,0,15,2
1708246895109,MUS 206,B00,418327,Roberts; Matana,13,0,15,2
1708246895634,MUS 215C,A00,418328,Cimini; Amy Marie,14,0,15,1
1708246896161,MUS 232,001,418937,Dresser; Mark Stuart,9,0,10,1
1708246896161,MUS 232,002,418969,Kenyatta; Kamau,10,0,10,0
1708246896161,MUS 232,003,418971,Curtis; Charles Rector,10,0,10,0
1708246896161,MUS 232,004,418974,Terrazas Perez; Wilfrido D,10,0,10,0
1708246896161,MUS 232,005,418979,Ohnishi; Takae,10,0,10,0
1708246896161,MUS 232,006,418980,Burr; Anthony I,10,0,10,0
1708246896161,MUS 232,007,418981,Carlson; Erik Norman,10,0,10,0
1708246896161,MUS 232,008,418982,Richards; Stephanie F,10,0,10,0
1708246896161,MUS 232,009,418985,Narucki; Susan M,10,0,10,0
1708246896690,MUS 234,A00,418329,Staff,15,0,15,0
1708246897215,MUS 245,A00,418330,Carlson; Erik Norman,14,0,15,1
1708246897744,MUS 267,A00,418331,Erbe; Tom,15,0,15,0
1708246898271,MUS 270B,A00,418332,Staff,15,0,15,0
1708246898799,MUS 270D,A00,479231,Smyth; Tamara R.,15,0,15,0
1708246899328,NANO 103,A00,414714,Jahed Motlagh; Zeinab,40,0,40,0
1708246899858,NANO 108,A00,414740,Lubarda; Vlado,70,0,70,0
1708246900387,NANO 112,A01,414825,Vazquez Mena; Oscar,70,0,70,0
1708246900913,NANO 115L,A01,414830,Yang; Kesong,37,0,38,1
1708246900913,NANO 115L,B01,414832,Xu; Sheng,35,0,38,3
1708246901438,NANO 120B,A01,414835,Vecchio; Kenneth S,33,0,35,2
1708246901438,NANO 120B,B01,414841,Fenning; David,30,0,35,5
1708246901968,NANO 156,A00,414843,Fullerton; Eric E,24,0,30,6
1708246902494,NANO 158,A00,414844,Luo; Jian,29,0,30,1
1708246903024,NANO 175,A00,414850,Steinmetz; Nicole F,30,0,35,5
1708246903550,NANO 200,A00,414852,Jahed Motlagh; Zeinab,118,0,120,2
1708246904076,NANO 241,A00,414854,Pokorski; Jonathan Kyle,18,0,25,7
1708246904619,NANO 262,A00,414858,Wang; Joseph,50,0,50,0
1708246905144,NANO 271,A00,414862,Cubukcu; Ertugrul,22,0,25,3
1708246905670,NANO 272,A00,414877,Xu; Sheng,42,0,50,8
1708246906198,NANO 279,A00,414878,Liu; Ping,32,0,40,8
1708246906725,NANO 282,A00,414879,Steinmetz; Nicole F,30,0,30,0
1708246907257,NEU 200C,A00,455013,Staff,0,0,0,1
1708246907783,NEU 276,A01,479489,Staff,35,0,36,1
1708246908307,NEU 277,A00,479492,Risbrough; Victoria Blythe,0,0,0,0
1708246908832,NEU 296,001,464921,Evans; Sean Jeffrey,48,0,50,2
1708246908832,NEU 296,002,464922,Staff,50,0,50,0
1708246908832,NEU 296,003,464925,Staff,50,0,50,0
1708246909374,NEUG 221,A00,479490,Zheng; Binhai,15,0,15,0
1708246909905,NEUG 280,A00,479491,Chen; Xu,0,0,0,0
1708246910431,NEUG 296,A00,479493,Bloodgood; Brenda Laurie,9998,0,9999,1
1708246910957,OPTH 296,001,465054,Baxter; Sally Liu,49,0,50,1
1708246910957,OPTH 296,002,465068,Afshari; Natalie,49,0,50,1
1708246910957,OPTH 296,003,465074,Staff,50,0,50,0
1708246911482,ORTH 296,A00,465104,Staff,50,0,50,0
1708246911482,ORTH 296,001,465111,Staff,50,0,50,0
1708246911482,ORTH 296,002,465120,Staff,50,0,50,0
1708246912009,PATH 224,A01,494386,Ross; Camille,11,0,12,1
1708246912535,PATH 296,001,465373,Calcutt; Nigel A,49,0,50,1
1708246912535,PATH 296,002,465374,Staff,50,0,50,0
1708246912535,PATH 296,003,465375,Staff,50,0,50,0
1708246913061,PEDS 296,001,465527,Weiss; Katherine Jean,49,0,50,1
1708246913061,PEDS 296,002,465528,Staff,50,0,50,0
1708246913061,PEDS 296,003,465529,Staff,50,0,50,0
1708246913587,PH 196BH,A01,405158,Binkin; Nancy Jeanne,20,0,20,0
1708246914117,PHAR 219,A00,415016,Ross; Camille,1,0,1,0
1708246914643,PHAR 231,A00,415017,Furnari; Frank,20,0,20,0
1708246914643,PHAR 231,B00,415018,Lopez Ramirez; Miguel Alej,20,0,20,0
1708246915169,PHAR 276,A00,415020,Mc Culloch; Andrew Douglas & Amaro; Rommie E,1,0,1,0
1708246915694,PHAR 295,A00,415022,Brown; Joan Heller,15,0,15,0
1708246916218,PHIL 1,A00,415023,Harrell; Maralee Mae,58,0,60,2
1708246916746,PHIL 10,A01,415026,Grush; Rick Scott,40,0,44,4
1708246916746,PHIL 10,A02,415028,Grush; Rick Scott,42,0,44,2
1708246916746,PHIL 10,A03,415029,Grush; Rick Scott,0,0,0,0
1708246916746,PHIL 10,A04,415031,Grush; Rick Scott,0,0,0,0
1708246916746,PHIL 10,A05,415113,Grush; Rick Scott,43,0,44,1
1708246916746,PHIL 10,A06,415114,Grush; Rick Scott,43,0,44,1
1708246916746,PHIL 10,A07,415116,Grush; Rick Scott,44,0,44,0
1708246916746,PHIL 10,A08,415118,Grush; Rick Scott,43,0,44,1
1708246917271,PHIL 12,A01,415120,McKenzie; Kerry V.,28,0,30,2
1708246917271,PHIL 12,A02,415136,McKenzie; Kerry V.,30,0,30,0
1708246917271,PHIL 12,A03,415137,McKenzie; Kerry V.,27,0,30,3
1708246917271,PHIL 12,A04,415142,McKenzie; Kerry V.,30,0,30,0
1708246917817,PHIL 13,A01,415165,Brink; David O.,25,0,25,0
1708246917817,PHIL 13,A02,415179,Brink; David O.,22,0,25,3
1708246917817,PHIL 13,A03,415185,Brink; David O.,24,0,25,1
1708246917817,PHIL 13,A04,415201,Brink; David O.,25,0,25,0
1708246917817,PHIL 13,A05,415204,Brink; David O.,25,0,25,0
1708246917817,PHIL 13,A06,415220,Brink; David O.,25,0,25,0
1708246919358,PHIL 15,A01,415250,Fulkerson; Matthew Todd,27,0,30,3
1708246919358,PHIL 15,A02,415281,Fulkerson; Matthew Todd,29,0,30,1
1708246919916,PHIL 27,A01,415293,Brandt; Reuven A,20,0,25,5
1708246919916,PHIL 27,A02,415296,Brandt; Reuven A,0,0,0,0
1708246919916,PHIL 27,A03,415332,Brandt; Reuven A,22,0,25,3
1708246919916,PHIL 27,A04,415333,Brandt; Reuven A,22,0,25,3
1708246919916,PHIL 27,A05,415342,Brandt; Reuven A,20,0,25,5
1708246919916,PHIL 27,A06,415384,Brandt; Reuven A,24,0,25,1
1708246919916,PHIL 27,A07,415385,Brandt; Reuven A,25,0,25,0
1708246919916,PHIL 27,A08,415391,Brandt; Reuven A,0,0,0,0
1708246919916,PHIL 27,A09,415406,Brandt; Reuven A,0,0,0,0
1708246919916,PHIL 27,A10,415407,Brandt; Reuven A,0,0,0,0
1708246920464,PHIL 28,A01,415412,Lamey; Andy M.,24,0,25,1
1708246920464,PHIL 28,A02,415470,Lamey; Andy M.,20,0,25,5
1708246920464,PHIL 28,A03,415474,Lamey; Andy M.,0,0,0,0
1708246920464,PHIL 28,A04,415475,Lamey; Andy M.,22,0,25,3
1708246920464,PHIL 28,A05,415487,Lamey; Andy M.,24,0,25,1
1708246920464,PHIL 28,A06,415506,Lamey; Andy M.,21,0,25,4
1708246920464,PHIL 28,A07,415507,Lamey; Andy M.,25,0,25,0
1708246920464,PHIL 28,A08,415508,Lamey; Andy M.,24,0,25,1
1708246920464,PHIL 28,A09,415509,Lamey; Andy M.,25,0,25,0
1708246920464,PHIL 28,A10,415510,Lamey; Andy M.,0,0,0,0
1708246920990,PHIL 33,A01,415521,Hardimon; Michael O.,35,0,35,0
1708246920990,PHIL 33,A02,415522,Hardimon; Michael O.,35,0,35,0
1708246921520,PHIL 60,A00,415523,Marechal; Patricia,55,0,60,5
1708246922061,PHIL 102,A00,415524,Johnson; Monte,37,0,40,3
1708246922590,PHIL 106,A00,415544,Watkins; Eric,40,0,40,0
1708246923117,PHIL 112,A00,415545,Watkins; Eric,34,0,40,6
1708246923659,PHIL 115,A00,415548,Nelkin; Dana Kay,20,0,20,0
1708246924185,PHIL 120,A00,415549,Carr; Jennifer Rose,64,0,65,1
1708246924717,PHIL 134,A00,415552,Carr; Jennifer Rose,40,0,40,0
1708246925299,PHIL 150,A00,415553,Cohen; Jonathan David,38,0,40,2
1708246925826,PHIL 171,A00,415561,Brink; David O.,39,0,40,1
1708246926351,PHIL 172,A00,415563,Lamey; Andy M.,40,0,40,0
1708246926882,PHIL 174,A01,415576,Danks; David J,21,0,25,4
1708246926882,PHIL 174,A02,415582,Danks; David J,22,0,25,3
1708246926882,PHIL 174,A03,415583,Danks; David J,24,0,25,1
1708246926882,PHIL 174,A04,415584,Danks; David J,25,0,25,0
1708246927408,PHIL 175,A00,415585,Shields; Christopher John,40,0,40,0
1708246927934,PHIL 181,A00,415601,Tolley; Clinton,34,0,40,6
1708246928472,PHIL 209B,A00,415655,Serlin; David,4,0,5,1
1708246928997,PHIL 209C,A00,415658,Gates; Kelly,5,0,5,0
1708246929525,PHIL 210,A00,415659,Marechal; Patricia,20,0,20,0
1708246930050,PHIL 230,A00,415661,Grush; Rick Scott,20,0,20,0
1708246930580,PHIL 232,A00,415662,Sher; Gila,20,0,20,0
1708246931106,PHIL 260,A00,415675,Bazargan-Forward; Saba,20,0,20,0
1708246931634,PHIL 277,A00,479176,Tolley; Clinton,9,0,10,1
1708246932162,PHIL 285,A00,415685,Kovaka; Karenc,20,0,20,0
1708246932688,PHIL 287,A00,415697,Marechal; Patricia,5,0,5,0
1708246933214,PHIL 290,001,415701,Nelkin; Dana Kay,9999,0,9999,0
1708246933214,PHIL 290,002,415721,Bazargan-Forward; Saba,9999,0,9999,0
1708246933214,PHIL 290,003,415731,Brandt; Reuven A,9999,0,9999,0
1708246933214,PHIL 290,004,415743,Brink; David O.,9999,0,9999,0
1708246933214,PHIL 290,005,415747,Callender; Craig Adam,9999,0,9999,0
1708246933214,PHIL 290,006,415779,Carr; Jennifer Rose,9999,0,9999,0
1708246933214,PHIL 290,007,415780,Cartwright; Nancy D.,9999,0,9999,0
1708246933214,PHIL 290,008,415781,Cohen; Jonathan David,9999,0,9999,0
1708246933214,PHIL 290,009,415782,Danks; David J,9999,0,9999,0
1708246933214,PHIL 290,010,415783,Fulkerson; Matthew Todd,9999,0,9999,0
1708246933214,PHIL 290,011,415784,Grush; Rick Scott,9999,0,9999,0
1708246933214,PHIL 290,012,415785,Hardimon; Michael O.,9999,0,9999,0
1708246933214,PHIL 290,013,415786,Harrell; Maralee Mae,9999,0,9999,0
1708246933214,PHIL 290,014,415787,Johnson; Monte,9999,0,9999,0
1708246933214,PHIL 290,015,415788,Kovaka; Karenc,9999,0,9999,0
1708246933214,PHIL 290,016,415789,Lamey; Andy M.,9999,0,9999,0
1708246933214,PHIL 290,017,415790,Marechal; Patricia,9999,0,9999,0
1708246933214,PHIL 290,018,415791,McKenzie; Kerry V.,9999,0,9999,0
1708246933214,PHIL 290,019,415792,Rickless; Samuel Charles,9999,0,9999,0
1708246933214,PHIL 290,020,415793,Sher; Gila,9999,0,9999,0
1708246933214,PHIL 290,021,415794,Shields; Christopher John,9999,0,9999,0
1708246933214,PHIL 290,022,415805,Tolley; Clinton,9999,0,9999,0
1708246933214,PHIL 290,023,415806,Vargas; Manuel Rogelio,9999,0,9999,0
1708246933214,PHIL 290,024,415807,Watkins; Eric,9999,0,9999,0
1708246933214,PHIL 290,025,415815,Chen; Keming,9999,0,9999,0
1708246934765,PHIL 295,001,415816,Bazargan-Forward; Saba,9999,0,9999,0
1708246934765,PHIL 295,002,415857,Brandt; Reuven A,9999,0,9999,0
1708246934765,PHIL 295,003,415858,Brink; David O.,9999,0,9999,0
1708246934765,PHIL 295,004,415877,Callender; Craig Adam,9999,0,9999,0
1708246934765,PHIL 295,005,415878,Carr; Jennifer Rose,9999,0,9999,0
1708246934765,PHIL 295,006,415884,Cartwright; Nancy D.,9999,0,9999,0
1708246934765,PHIL 295,007,415885,Chen; Keming,9999,0,9999,0
1708246934765,PHIL 295,008,415891,Cohen; Jonathan David,9999,0,9999,0
1708246934765,PHIL 295,009,415892,Danks; David J,9999,0,9999,0
1708246934765,PHIL 295,010,415937,Fulkerson; Matthew Todd,9999,0,9999,0
1708246934765,PHIL 295,011,415940,Grush; Rick Scott,9999,0,9999,0
1708246934765,PHIL 295,012,415945,Hardimon; Michael O.,9999,0,9999,0
1708246934765,PHIL 295,013,415946,Harrell; Maralee Mae,9999,0,9999,0
1708246934765,PHIL 295,014,415953,Johnson; Monte,9999,0,9999,0
1708246934765,PHIL 295,015,415954,Kovaka; Karenc,9999,0,9999,0
1708246934765,PHIL 295,016,415957,Lamey; Andy M.,9999,0,9999,0
1708246934765,PHIL 295,017,415958,Marechal; Patricia,9999,0,9999,0
1708246934765,PHIL 295,018,415959,McKenzie; Kerry V.,9999,0,9999,0
1708246934765,PHIL 295,019,415960,Nelkin; Dana Kay,9999,0,9999,0
1708246934765,PHIL 295,020,415961,Rickless; Samuel Charles,9999,0,9999,0
1708246934765,PHIL 295,021,415987,Sher; Gila,9999,0,9999,0
1708246934765,PHIL 295,022,416027,Shields; Christopher John,9999,0,9999,0
1708246934765,PHIL 295,023,416030,Tolley; Clinton,9999,0,9999,0
1708246934765,PHIL 295,024,416033,Vargas; Manuel Rogelio,9999,0,9999,0
1708246934765,PHIL 295,025,416034,Watkins; Eric,9999,0,9999,0
1708246935290,PHYA 224,A00,442106,Sandstrom; Karin Marie,30,0,30,0
1708246935821,PHYS 1A,A00,441607,Gilbert; Dylan Paul,346,0,362,16
1708246936379,PHYS 1AL,001,441608,Arlett; Jessica Lynn & Yagil; Avi,30,0,30,0
1708246936379,PHYS 1AL,002,441609,Arlett; Jessica Lynn & Yagil; Avi,28,0,30,2
1708246936379,PHYS 1AL,003,441610,Arlett; Jessica Lynn & Yagil; Avi,26,0,30,4
1708246936379,PHYS 1AL,004,441611,Arlett; Jessica Lynn & Yagil; Avi,29,0,30,1
1708246936379,PHYS 1AL,005,441612,Arlett; Jessica Lynn & Yagil; Avi,28,0,30,2
1708246936379,PHYS 1AL,006,441616,Arlett; Jessica Lynn & Yagil; Avi,28,0,30,2
1708246936379,PHYS 1AL,007,441618,Arlett; Jessica Lynn & Yagil; Avi,26,0,30,4
1708246936379,PHYS 1AL,008,441620,Arlett; Jessica Lynn & Yagil; Avi,29,0,30,1
1708246936379,PHYS 1AL,009,441623,Arlett; Jessica Lynn & Yagil; Avi,29,0,30,1
1708246936379,PHYS 1AL,010,441625,Arlett; Jessica Lynn & Yagil; Avi,29,0,30,1
1708246936379,PHYS 1AL,011,441626,Arlett; Jessica Lynn & Yagil; Avi,29,0,30,1
1708246936379,PHYS 1AL,012,441627,Arlett; Jessica Lynn & Yagil; Avi,29,0,30,1
1708246936904,PHYS 1B,A00,441630,Groisman; Alexander,351,0,362,11
1708246937446,PHYS 1BL,001,441632,Arlett; Jessica Lynn & Yagil; Avi,28,0,30,2
1708246937446,PHYS 1BL,002,441634,Arlett; Jessica Lynn & Yagil; Avi,29,0,30,1
1708246937446,PHYS 1BL,003,441636,Arlett; Jessica Lynn & Yagil; Avi,29,0,30,1
1708246937446,PHYS 1BL,004,441637,Arlett; Jessica Lynn & Yagil; Avi,29,0,30,1
1708246937446,PHYS 1BL,005,441639,Arlett; Jessica Lynn & Yagil; Avi,29,0,30,1
1708246937446,PHYS 1BL,006,441641,Arlett; Jessica Lynn & Yagil; Avi,26,0,30,4
1708246937446,PHYS 1BL,007,441642,Arlett; Jessica Lynn & Yagil; Avi,23,0,30,7
1708246937446,PHYS 1BL,008,441643,Arlett; Jessica Lynn & Yagil; Avi,30,0,30,0
1708246937446,PHYS 1BL,009,441646,Arlett; Jessica Lynn & Yagil; Avi,29,0,30,1
1708246937446,PHYS 1BL,010,441648,Arlett; Jessica Lynn & Yagil; Avi,29,0,30,1
1708246937446,PHYS 1BL,011,441652,Arlett; Jessica Lynn & Yagil; Avi,29,0,30,1
1708246937446,PHYS 1BL,012,441654,Arlett; Jessica Lynn & Yagil; Avi,30,0,30,0
1708246937972,PHYS 1C,A00,441658,Popmintchev; Tenio,588,0,600,12
1708246937972,PHYS 1C,B00,441662,Popmintchev; Tenio,559,0,600,41
1708246938576,PHYS 1CL,001,441664,Arlett; Jessica Lynn & Yagil; Avi,29,0,30,1
1708246938576,PHYS 1CL,002,441665,Arlett; Jessica Lynn & Yagil; Avi,27,0,30,3
1708246938576,PHYS 1CL,003,441666,Arlett; Jessica Lynn & Yagil; Avi,25,0,30,5
1708246938576,PHYS 1CL,004,441667,Arlett; Jessica Lynn & Yagil; Avi,30,0,30,0
1708246938576,PHYS 1CL,005,441668,Arlett; Jessica Lynn & Yagil; Avi,28,0,30,2
1708246938576,PHYS 1CL,006,441669,Arlett; Jessica Lynn & Yagil; Avi,25,0,30,5
1708246938576,PHYS 1CL,007,441671,Arlett; Jessica Lynn & Yagil; Avi,27,0,30,3
1708246938576,PHYS 1CL,008,441673,Arlett; Jessica Lynn & Yagil; Avi,30,0,30,0
1708246938576,PHYS 1CL,009,441674,Arlett; Jessica Lynn & Yagil; Avi,26,0,30,4
1708246938576,PHYS 1CL,010,441676,Arlett; Jessica Lynn & Yagil; Avi,30,0,30,0
1708246938576,PHYS 1CL,011,441677,Arlett; Jessica Lynn & Yagil; Avi,30,0,30,0
1708246938576,PHYS 1CL,012,441683,Arlett; Jessica Lynn & Yagil; Avi,30,0,30,0
1708246938576,PHYS 1CL,013,441685,Arlett; Jessica Lynn & Yagil; Avi,28,0,30,2
1708246938576,PHYS 1CL,014,441687,Arlett; Jessica Lynn & Yagil; Avi,30,0,30,0
1708246938576,PHYS 1CL,015,441689,Arlett; Jessica Lynn & Yagil; Avi,17,0,30,13
1708246938576,PHYS 1CL,016,441692,Arlett; Jessica Lynn & Yagil; Avi,29,0,30,1
1708246938576,PHYS 1CL,017,441696,Arlett; Jessica Lynn & Yagil; Avi,25,0,30,5
1708246938576,PHYS 1CL,018,441698,Arlett; Jessica Lynn & Yagil; Avi,25,0,30,5
1708246938576,PHYS 1CL,019,441702,Arlett; Jessica Lynn & Yagil; Avi,25,0,30,5
1708246938576,PHYS 1CL,020,441705,Arlett; Jessica Lynn & Yagil; Avi,29,0,30,1
1708246938576,PHYS 1CL,021,441706,Arlett; Jessica Lynn & Yagil; Avi,30,0,30,0
1708246938576,PHYS 1CL,022,441707,Arlett; Jessica Lynn & Yagil; Avi,30,0,30,0
1708246938576,PHYS 1CL,023,441708,Arlett; Jessica Lynn & Yagil; Avi,27,0,30,3
1708246938576,PHYS 1CL,024,441710,Arlett; Jessica Lynn & Yagil; Avi,29,0,30,1
1708246938576,PHYS 1CL,025,441711,Arlett; Jessica Lynn & Yagil; Avi,28,0,30,2
1708246938576,PHYS 1CL,026,441712,Arlett; Jessica Lynn & Yagil; Avi,29,0,30,1
1708246938576,PHYS 1CL,027,441713,Arlett; Jessica Lynn & Yagil; Avi,26,0,30,4
1708246938576,PHYS 1CL,028,441714,Arlett; Jessica Lynn & Yagil; Avi,29,0,30,1
1708246938576,PHYS 1CL,029,441715,Arlett; Jessica Lynn & Yagil; Avi,25,0,30,5
1708246938576,PHYS 1CL,030,441717,Arlett; Jessica Lynn & Yagil; Avi,29,0,30,1
1708246938576,PHYS 1CL,031,441718,Arlett; Jessica Lynn & Yagil; Avi,27,0,30,3
1708246938576,PHYS 1CL,032,441721,Arlett; Jessica Lynn & Yagil; Avi,30,0,30,0
1708246938576,PHYS 1CL,033,441724,Arlett; Jessica Lynn & Yagil; Avi,28,0,30,2
1708246938576,PHYS 1CL,034,441726,Arlett; Jessica Lynn & Yagil; Avi,29,0,30,1
1708246938576,PHYS 1CL,035,441728,Arlett; Jessica Lynn & Yagil; Avi,29,0,30,1
1708246938576,PHYS 1CL,036,441729,Arlett; Jessica Lynn & Yagil; Avi,30,0,30,0
1708246938576,PHYS 1CL,037,441730,Arlett; Jessica Lynn & Yagil; Avi,27,0,30,3
1708246938576,PHYS 1CL,038,441732,Arlett; Jessica Lynn & Yagil; Avi,29,0,30,1
1708246938576,PHYS 1CL,039,441733,Arlett; Jessica Lynn & Yagil; Avi,27,0,30,3
1708246938576,PHYS 1CL,040,441734,Arlett; Jessica Lynn & Yagil; Avi,30,0,30,0
1708246938576,PHYS 1CL,041,441735,Arlett; Jessica Lynn & Yagil; Avi,29,0,30,1
1708246938576,PHYS 1CL,042,441766,Arlett; Jessica Lynn & Yagil; Avi,30,0,30,0
1708246938576,PHYS 1CL,043,441768,Arlett; Jessica Lynn & Yagil; Avi,29,0,30,1
1708246938576,PHYS 1CL,044,441770,Arlett; Jessica Lynn & Yagil; Avi,30,0,30,0
1708246939121,PHYS 2A,A01,460308,Bal; Gurleen K,28,0,30,2
1708246939121,PHYS 2A,A02,460320,Bal; Gurleen K,30,0,30,0
1708246939121,PHYS 2A,A03,460321,Bal; Gurleen K,29,0,30,1
1708246939121,PHYS 2A,A04,460325,Bal; Gurleen K,28,0,30,2
1708246939121,PHYS 2A,A05,460326,Bal; Gurleen K,29,0,30,1
1708246939121,PHYS 2A,A06,460327,Bal; Gurleen K,30,0,30,0
1708246939121,PHYS 2A,A07,460495,Bal; Gurleen K,28,0,30,2
1708246939121,PHYS 2A,A08,460535,Bal; Gurleen K,27,0,30,3
1708246939121,PHYS 2A,A09,460536,Bal; Gurleen K,30,0,30,0
1708246939121,PHYS 2A,A10,460537,Bal; Gurleen K,30,0,30,0
1708246939121,PHYS 2A,A11,460538,Bal; Gurleen K,30,0,30,0
1708246939121,PHYS 2A,A12,460539,Bal; Gurleen K,30,0,30,0
1708246939696,PHYS 2B,A01,460620,Barreiro Guerrero; Julio,30,0,30,0
1708246939696,PHYS 2B,A02,460625,Barreiro Guerrero; Julio,30,0,30,0
1708246939696,PHYS 2B,A03,460626,Barreiro Guerrero; Julio,29,0,30,1
1708246939696,PHYS 2B,A04,460716,Barreiro Guerrero; Julio,26,0,30,4
1708246939696,PHYS 2B,A05,460756,Barreiro Guerrero; Julio,29,0,30,1
1708246939696,PHYS 2B,A06,460837,Barreiro Guerrero; Julio,30,0,30,0
1708246939696,PHYS 2B,A07,460865,Barreiro Guerrero; Julio,30,0,30,0
1708246939696,PHYS 2B,A08,460866,Barreiro Guerrero; Julio,30,0,30,0
1708246939696,PHYS 2B,A09,460867,Barreiro Guerrero; Julio,29,0,30,1
1708246939696,PHYS 2B,A10,460868,Barreiro Guerrero; Julio,30,0,30,0
1708246939696,PHYS 2B,A11,460869,Barreiro Guerrero; Julio,30,0,30,0
1708246939696,PHYS 2B,A12,460874,Barreiro Guerrero; Julio,30,0,30,0
1708246939696,PHYS 2B,B01,469381,Barreiro Guerrero; Julio,30,0,30,0
1708246939696,PHYS 2B,B02,469382,Barreiro Guerrero; Julio,29,0,30,1
1708246939696,PHYS 2B,B03,469402,Barreiro Guerrero; Julio,27,0,30,3
1708246939696,PHYS 2B,B04,469403,Barreiro Guerrero; Julio,28,0,30,2
1708246939696,PHYS 2B,B05,469442,Barreiro Guerrero; Julio,30,0,30,0
1708246939696,PHYS 2B,B06,469449,Barreiro Guerrero; Julio,30,0,30,0
1708246939696,PHYS 2B,B07,469450,Barreiro Guerrero; Julio,29,0,30,1
1708246939696,PHYS 2B,B08,469451,Barreiro Guerrero; Julio,30,0,30,0
1708246939696,PHYS 2B,B09,469457,Barreiro Guerrero; Julio,29,0,30,1
1708246939696,PHYS 2B,B10,469460,Barreiro Guerrero; Julio,30,0,30,0
1708246939696,PHYS 2B,B11,469468,Barreiro Guerrero; Julio,30,0,30,0
1708246939696,PHYS 2B,B12,469475,Barreiro Guerrero; Julio,30,0,30,0
1708246940253,PHYS 2BL,A01,441779,Meyertholen; Andrew D.,21,0,24,3
1708246940253,PHYS 2BL,A02,441780,Meyertholen; Andrew D.,17,0,24,7
1708246940253,PHYS 2BL,A03,441781,Meyertholen; Andrew D.,21,0,24,3
1708246940253,PHYS 2BL,A04,441782,Meyertholen; Andrew D.,21,0,24,3
1708246940253,PHYS 2BL,A05,441784,Meyertholen; Andrew D.,23,0,24,1
1708246940253,PHYS 2BL,A06,441786,Meyertholen; Andrew D.,23,0,24,1
1708246940253,PHYS 2BL,A07,441788,Meyertholen; Andrew D.,23,0,24,1
1708246940253,PHYS 2BL,A08,441790,Meyertholen; Andrew D.,24,0,24,0
1708246940253,PHYS 2BL,A09,441792,Meyertholen; Andrew D.,24,0,24,0
1708246940253,PHYS 2BL,A10,441794,Meyertholen; Andrew D.,23,0,24,1
1708246940253,PHYS 2BL,A11,441796,Meyertholen; Andrew D.,22,0,24,2
1708246940253,PHYS 2BL,A12,441798,Meyertholen; Andrew D.,24,0,24,0
1708246940253,PHYS 2BL,A13,441800,Meyertholen; Andrew D.,24,0,24,0
1708246940253,PHYS 2BL,A14,441802,Meyertholen; Andrew D.,24,0,24,0
1708246940253,PHYS 2BL,A15,441804,Meyertholen; Andrew D.,23,0,24,1
1708246940817,PHYS 2C,A01,460540,Tan; Tzer Han,30,0,30,0
1708246940817,PHYS 2C,A02,460541,Tan; Tzer Han,28,0,30,2
1708246940817,PHYS 2C,A03,460542,Tan; Tzer Han,28,0,30,2
1708246940817,PHYS 2C,A04,460543,Tan; Tzer Han,28,0,30,2
1708246940817,PHYS 2C,A05,460544,Tan; Tzer Han,28,0,30,2
1708246940817,PHYS 2C,A06,460545,Tan; Tzer Han,29,0,30,1
1708246940817,PHYS 2C,A07,460553,Tan; Tzer Han,30,0,30,0
1708246940817,PHYS 2C,A08,460561,Tan; Tzer Han,30,0,30,0
1708246940817,PHYS 2C,A09,460562,Tan; Tzer Han,28,0,30,2
1708246940817,PHYS 2C,A10,460563,Tan; Tzer Han,29,0,30,1
1708246940817,PHYS 2C,A11,460567,Tan; Tzer Han,30,0,30,0
1708246940817,PHYS 2C,A12,460568,Tan; Tzer Han,28,0,30,2
1708246941343,PHYS 2CL,A01,441809,Ni; Kaixuan,25,0,28,3
1708246941343,PHYS 2CL,A02,441811,Ni; Kaixuan,27,0,28,1
1708246941343,PHYS 2CL,A03,441814,Ni; Kaixuan,23,0,28,5
1708246941343,PHYS 2CL,A04,441817,Ni; Kaixuan,28,0,28,0
1708246941343,PHYS 2CL,A05,441819,Ni; Kaixuan,26,0,28,2
1708246941343,PHYS 2CL,A06,441820,Ni; Kaixuan,27,0,28,1
1708246941869,PHYS 2D,A01,460569,Sharma; Vivek A.,24,0,25,1
1708246941869,PHYS 2D,A02,460574,Sharma; Vivek A.,24,0,25,1
1708246941869,PHYS 2D,A03,460575,Sharma; Vivek A.,25,0,25,0
1708246942393,PHYS 4B,A01,441829,Grinstein; Benjamin,34,0,38,4
1708246942393,PHYS 4B,A02,441831,Grinstein; Benjamin,30,0,32,2
1708246942393,PHYS 4B,A03,441832,Grinstein; Benjamin,30,0,30,0
1708246942393,PHYS 4B,A04,441833,Grinstein; Benjamin,30,0,30,0
1708246942926,PHYS 4E,A01,441907,Frano Pereira; Alex M,33,0,34,1
1708246942926,PHYS 4E,A02,441958,Frano Pereira; Alex M,34,0,34,0
1708246943451,PHYS 10,A01,441971,Burgasser; Adam Jonathan,118,0,120,2
1708246943982,PHYS 13,A01,441974,Wright; Shelley Adams,61,0,65,4
1708246944510,PHYS 87,A00,486898,Grinstein; Benjamin,19,0,20,1
1708246945040,PHYS 100C,A01,441978,Averitt; Richard Douglas,58,0,60,2
1708246945570,PHYS 105B,A01,441985,Green; Daniel Richard,37,0,40,3
1708246946095,PHYS 120,A01,441995,Arnold; Kam S,40,0,44,4
1708246946095,PHYS 120,A02,442011,Arnold; Kam S,41,0,44,3
1708246946626,PHYS 130A,A01,442032,Parker; Daniel E,74,0,75,1
1708246947155,PHYS 130B,A01,442056,Branson; James G,47,0,50,3
1708246947680,PHYS 139,A00,442057,Jun; Suckjoon,30,0,30,0
1708246947680,PHYS 139,B00,442059,Duarte; Javier Mauricio & Li; Aobo,42,0,50,8
1708246948221,PHYS 140A,A01,442065,Shotwell; Brian,49,0,50,1
1708246948748,PHYS 152B,A01,442067,Hirsch; Jorge Eduardo,17,0,20,3
1708246949276,PHYS 154,A01,442069,Jenkins; Elizabeth,29,0,30,1
1708246949852,PHYS 162,A01,442096,Keating; Brian,64,0,65,1
1708246950381,PHYS 170,A01,486870,Oh; Seungeun,39,0,40,1
1708246950911,PHYS 177,A00,442103,Dudko; Olga,20,0,20,0
1708246951435,PHYS 203B,A01,442132,Fogler; Michael M.,20,0,20,0
1708246951966,PHYS 210A,A01,442143,Hwa; Terence T.,20,0,20,0
1708246952494,PHYS 212C,A01,442200,Chivukula; Raja S,18,0,20,2
1708246953021,PHYS 215C,A00,442201,Intriligator; Kenneth Arthur,19,0,20,1
1708246953546,PHYS 225C,A01,442203,Flauger; Raphael M,19,0,20,1
1708246954075,PHYS 227,A00,442204,Tytler; David Robert,29,0,30,1
1708246954612,PHYS 230,A01,442206,McGreevy; John A.,20,0,20,0
1708246955142,PHYS 239,A00,442207,Goldenfeld; Nigel,20,0,20,0
1708246955142,PHYS 239,B00,442208,Duarte; Javier Mauricio & Li; Aobo,5,0,5,0
1708246955667,PHYS 244,A01,442280,Norman; Michael L,12,0,20,8
1708246956191,PHYS 250,A00,442300,Fogler; Michael M.,50,0,50,0
1708246956716,PHYS 251,A00,442307,Grinstein; Benjamin,20,0,20,0
1708246957241,PHYS 252,A00,442348,Diamond; Patrick H,10,0,10,0
1708246957766,PHYS 253,A00,442349,Theissen; Christopher Alexander,30,0,30,0
1708246958292,PHYS 254,A00,442352,Hwa; Terence T.,30,0,30,0
1708246958836,PHYS 255,A00,442423,Hwa; Terence T.,30,0,30,0
1708246959365,PHYS 258,A00,442426,Theissen; Christopher Alexander,30,0,30,0
1708246959892,PHYS 260,A00,442427,Frano Pereira; Alex M,50,0,50,0
1708246960424,PHYS 277,A00,442428,Dudko; Olga,20,0,20,0
1708246960988,POLI 5D,A01,419010,Dai; Yinlin,5,0,7,2
1708246960988,POLI 5D,A02,419020,Dai; Yinlin,7,0,7,0
1708246960988,POLI 5D,A03,419022,Dai; Yinlin,4,0,6,2
1708246960988,POLI 5D,A04,419040,Dai; Yinlin,5,0,5,0
1708246960988,POLI 5D,B01,419065,Dai; Yinlin,7,0,7,0
1708246960988,POLI 5D,B02,419068,Dai; Yinlin,7,0,7,0
1708246960988,POLI 5D,B03,419069,Dai; Yinlin,6,0,6,0
1708246960988,POLI 5D,B04,419070,Dai; Yinlin,5,0,5,0
1708246960988,POLI 5D,C01,487211,Staff,3,0,5,2
1708246961529,POLI 11D,A01,419072,Desposato; Scott,32,0,34,2
1708246961529,POLI 11D,A02,419073,Desposato; Scott,33,0,34,1
1708246961529,POLI 11D,A03,419082,Desposato; Scott,32,0,34,2
1708246961529,POLI 11D,A04,419123,Desposato; Scott,34,0,34,0
1708246961529,POLI 11D,A05,419124,Desposato; Scott,34,0,34,0
1708246961529,POLI 11D,A06,419125,Desposato; Scott,34,0,34,0
1708246962060,POLI 12D,A01,419127,Gartzke; Erik,29,0,34,5
1708246962060,POLI 12D,A02,419128,Gartzke; Erik,34,0,34,0
1708246962060,POLI 12D,A03,419129,Gartzke; Erik,34,0,34,0
1708246962060,POLI 12D,A04,419130,Gartzke; Erik,34,0,34,0
1708246962060,POLI 12D,A05,419131,Gartzke; Erik,32,0,34,2
1708246962060,POLI 12D,A06,419168,Gartzke; Erik,34,0,34,0
1708246962587,POLI 13DR,A01,477733,Draper; Matthew William,28,0,34,6
1708246962587,POLI 13DR,A02,477734,Draper; Matthew William,32,0,34,2
1708246962587,POLI 13DR,A03,477736,Draper; Matthew William,33,0,34,1
1708246962587,POLI 13DR,A04,477737,Draper; Matthew William,32,0,34,2
1708246962587,POLI 13DR,A05,477739,Draper; Matthew William,31,0,34,3
1708246962587,POLI 13DR,A06,477740,Draper; Matthew William,34,0,34,0
1708246963114,POLI 30D,A01,419179,Desposato; Scott,19,0,28,9
1708246963114,POLI 30D,A02,419180,Desposato; Scott,25,0,28,3
1708246963114,POLI 30D,A03,419181,Desposato; Scott,27,0,28,1
1708246963114,POLI 30D,A04,419182,Desposato; Scott,28,0,28,0
1708246963114,POLI 30D,A05,419187,Desposato; Scott,24,0,28,4
1708246963114,POLI 30D,A06,419189,Desposato; Scott,28,0,28,0
1708246963639,POLI 100E,A00,419191,Pitcher; Kennedy Anell,105,0,115,10
1708246964165,POLI 104P,A00,419192,Orfield; Michael Bennett,183,0,196,13
1708246964693,POLI 104U,A00,419193,Nichter; Maysa,90,0,115,25
1708246965221,POLI 108,A00,419194,Adida; Claire,293,0,295,2
1708246965747,POLI 110C,A00,419195,Soon; Valerie,47,0,50,3
1708246966276,POLI 120D,A00,419207,Hansen; Jan Eric,48,0,50,2
1708246966805,POLI 124A,A00,419209,Fortunato; David,48,0,50,2
1708246967330,POLI 131CR,A00,419211,Hoston; Germaine,41,0,50,9
1708246967330,POLI 131CR,B00,481592,Hoston; Germaine,10,0,10,0
1708246967860,POLI 136A,A00,419212,Roeder; Philip G,111,0,115,4
1708246968390,POLI 140D,A00,419213,Wong; Tak Kei,184,0,192,8
1708246968917,POLI 142D,A00,419214,Gartzke; Erik,227,0,230,3
1708246969447,POLI 145C,A00,419222,Fisk; David Lee,101,0,115,14
1708246969988,POLI 150A,A00,419225,Wong; Tak Kei,219,0,230,11
1708246970513,POLI 170A,A00,419226,Skillman; Rachel Diane,115,0,115,0
1708246971042,POLI 179,A00,419238,Staff,95,0,104,9
1708246971572,POLI 194,A00,455332,Hill; Seth J,0,0,0,0
1708246972101,POLI 194SD,A00,419248,Nichter; Maysa,999,0,999,0
1708246972629,POLI 197SD,001,419258,Nichter; Maysa,999,0,999,0
1708246973157,POLI 203B,A00,419265,Slantchev; Branislav,21,0,25,4
1708246973687,POLI 214R,A00,419275,Hoston; Germaine,23,0,25,2
1708246974215,POLI 219,A00,419289,Soon; Valerie,24,0,25,1
1708246974747,POLI 220A,A00,419299,Ferree; Karen E,21,0,25,4
1708246975272,POLI 233,A00,419333,Adida; Claire,23,0,25,2
1708246975798,POLI 243,A00,479118,Joseph; Michael F,23,0,25,2
1708246976325,POLI 251,A00,419334,Ban; Pamela M,23,0,25,2
1708246976851,POLI 257,A00,419335,Hill; Seth J,25,0,25,0
1708246977378,POLI 273,A00,419336,Mignozzetti; Umberto,16,0,25,9
1708246977904,POLI 280,A00,419337,Hafner-Burton; Emilie,18,0,25,7
1708246978429,POLI 281,A00,419338,Ban; Pamela M,21,0,25,4
1708246978954,POLI 282,A00,419339,Ferree; Karen E,19,0,25,6
1708246979539,POLI 283,A00,419340,Naoi; Megumi,23,0,25,2
1708246980135,POLI 285,A00,419341,Ingham; Sean,25,0,25,0
1708246980666,POLI 286,A00,419342,Mignozzetti; Umberto,23,0,25,2
1708246981195,POLI 288,A00,479174,Fowler; James,13,0,15,2
1708246981727,PSY 296,001,465760,Besterman; Aaron David,49,0,50,1
1708246981727,PSY 296,002,465765,Eyler; Lisa T.,49,0,50,1
1708246981727,PSY 296,003,465767,Patel; Ekta Himanshu,49,0,50,1
1708246982253,PSYC 3R,A00,419378,Pilegard; Celeste Cristine,314,0,325,11
1708246982779,PSYC 7,A00,419384,Powell; Lindsey Jane,288,0,295,7
1708246983316,PSYC 60,A01,460208,Lowe; Angela Beth,31,0,35,4
1708246983316,PSYC 60,A02,460209,Lowe; Angela Beth,28,0,35,7
1708246983316,PSYC 60,A03,460210,Lowe; Angela Beth,35,0,35,0
1708246983316,PSYC 60,A04,460211,Lowe; Angela Beth,33,0,35,2
1708246983316,PSYC 60,A05,460212,Lowe; Angela Beth,34,0,35,1
1708246983316,PSYC 60,A06,460213,Lowe; Angela Beth,35,0,35,0
1708246983316,PSYC 60,A07,460214,Lowe; Angela Beth,33,0,35,2
1708246983316,PSYC 60,B01,460215,Rose; Fred E.,35,0,35,0
1708246983316,PSYC 60,B02,460216,Rose; Fred E.,35,0,35,0
1708246983316,PSYC 60,B03,460218,Rose; Fred E.,35,0,35,0
1708246983316,PSYC 60,B04,460219,Rose; Fred E.,35,0,35,0
1708246983316,PSYC 60,B05,460220,Rose; Fred E.,32,0,35,3
1708246983316,PSYC 60,B06,460221,Rose; Fred E.,35,0,35,0
1708246983316,PSYC 60,B07,460222,Rose; Fred E.,35,0,35,0
1708246983843,PSYC 70,A01,460223,Pilegard; Celeste Cristine,29,0,35,6
1708246983843,PSYC 70,A02,460224,Pilegard; Celeste Cristine,32,0,35,3
1708246983843,PSYC 70,A03,460225,Pilegard; Celeste Cristine,34,0,35,1
1708246983843,PSYC 70,A04,460266,Pilegard; Celeste Cristine,33,0,35,2
1708246983843,PSYC 70,A05,460267,Pilegard; Celeste Cristine,35,0,35,0
1708246983843,PSYC 70,A06,460277,Pilegard; Celeste Cristine,34,0,35,1
1708246984370,PSYC 71,A01,419620,Staff,19,0,21,2
1708246984370,PSYC 71,A02,419662,Staff,20,0,21,1
1708246984370,PSYC 71,B01,419682,Geller; Emma Harlan,24,0,25,1
1708246984370,PSYC 71,B02,419732,Geller; Emma Harlan,26,0,26,0
1708246984899,PSYC 88,A00,419733,Dobkins; Karen R.,47,0,65,18
1708246985425,PSYC 100,A00,419734,Chapman; Eddie Nathaniel,388,0,410,22
1708246985951,PSYC 101,A00,419735,Walker; Caren Michelle,272,0,295,23
1708246986480,PSYC 102,A00,419779,Moranton; Nirelia Melbina-,292,0,295,3
1708246987009,PSYC 104,A00,419880,Fine; Rachel,267,0,295,28
1708246987534,PSYC 105,A00,419946,Lowe; Angela Beth,276,0,295,19
1708246988060,PSYC 111B,A01,419948,Geller; Emma Harlan,35,0,35,0
1708246988589,PSYC 116C,A01,420046,Lang; Ariel,25,0,25,0
1708246989116,PSYC 117,A01,420092,Bajic; Daniel Andrew,25,0,25,0
1708246989641,PSYC 118,A01,420095,Miller; Cory T.,37,0,45,8
1708246990171,PSYC 124,A00,420096,Chapman; Eddie Nathaniel,381,0,410,29
1708246990700,PSYC 127,A00,420097,Dickenson; Janna Alene,14,0,20,6
1708246991226,PSYC 132,A00,420121,Staff,114,0,120,6
1708246991752,PSYC 133R,A01,420172,Golden; Susan S. & Gorman; Michael R.,10,0,16,6
1708246991752,PSYC 133R,A02,420173,Golden; Susan S. & Gorman; Michael R.,16,0,16,0
1708246991752,PSYC 133R,A03,420175,Golden; Susan S. & Gorman; Michael R.,16,0,16,0
1708246991752,PSYC 133R,A04,420249,Golden; Susan S. & Gorman; Michael R.,13,0,16,3
1708246992281,PSYC 134,A00,420311,Kaye; Walter H.,296,0,300,4
1708246992810,PSYC 137,A00,420312,Lin; Chujun,292,0,295,3
1708246993339,PSYC 144,A00,420313,Wixted; John T,287,0,295,8
1708246993865,PSYC 147,A00,420315,Wong; Lauren Hitomi,120,0,146,26
1708246994392,PSYC 164,A00,420328,Kaplan; Paul,259,0,295,36
1708246994917,PSYC 172,A00,420336,Dickenson; Janna Alene,294,0,300,6
1708246995448,PSYC 178,A00,420337,Glaser; Dale,131,0,146,15
1708246995979,PSYC 179,A00,420338,Lacefield; Katharine I,257,0,328,71
1708246996505,PSYC 181,A00,420339,Anagnostaras; Stephan,333,0,350,17
1708246997031,PSYC 184,A00,420367,Wilson; Brent M,276,0,295,19
1708246997557,PSYC 188,A00,420368,Lacefield; Katharine I,234,0,300,66
1708246998087,PSYC 190,A00,420378,Barner; David A.,374,0,395,21
1708246998613,PSYC 193,B00,420626,Brashier; Nadia Marie,215,0,216,1
1708246998613,PSYC 193,C00,420643,Gremel; Christina M,33,0,35,2
1708246999141,PSYC 193L,A01,420817,Brown; Sandra A,65,0,65,0
1708246999141,PSYC 193L,B01,420830,Staff,26,0,30,4
1708246999141,PSYC 193L,C01,420832,Staff,49,0,49,0
1708246999141,PSYC 193L,D01,420834,Staff,27,0,30,3
1708246999141,PSYC 193L,E01,493996,Aron; Adam,24,0,24,0
1708246999672,PSYC 194C,A01,420905,Heyman; Gail D.,1,0,1,0
1708247000198,PSYC 205,A00,420906,Harris; Christine Renee,17,0,20,3
1708247000727,PSYC 218,A00,420907,Brady; Timothy Francis,11,0,20,9
1708247001253,PSYC 224,A00,420908,Gremel; Christina M,30,0,30,0
1708247001780,PSYC 242,A00,421469,Walker; Caren Michelle,27,0,30,3
1708247002306,PSYC 247,A00,421473,Walker; Caren Michelle,14,0,20,6
1708247002832,PSYC 270C,A00,421554,Dobkins; Karen R.,13,0,20,7
1708247003362,PSYC 272,A00,421561,Gentner; Tim,20,0,20,0
1708247003890,PSYC 274,A00,421564,McCullough; Michael E,29,0,30,1
1708247004415,PSYC 275,A00,421620,Staff,23,0,30,7
1708247004944,PSYC 276,A00,421622,McCullough; Michael E,14,0,20,6
1708247005469,PSYC 280,A00,421623,Serences; John Thomas,76,0,85,9
1708247006007,PSYC 296,001,421667,Anagnostaras; Stephan,9999,0,9999,0
1708247006007,PSYC 296,002,421773,Aron; Adam,9999,0,9999,0
1708247006007,PSYC 296,003,421794,Mukku; Dhananjaya,9999,0,9999,0
1708247006007,PSYC 296,004,421795,Barner; David A.,9998,0,9999,1
1708247006007,PSYC 296,005,421796,Schachner; Adena,9999,0,9999,0
1708247006007,PSYC 296,006,421797,Brown; Sandra A,9999,0,9999,0
1708247006007,PSYC 296,007,421798,Chapman; Eddie Nathaniel,9999,0,9999,0
1708247006007,PSYC 296,008,421799,Dickenson; Janna Alene,9999,0,9999,0
1708247006007,PSYC 296,009,421800,Dobkins; Karen R.,9998,0,9999,1
1708247006007,PSYC 296,010,421801,Fan; Judith Ellen,9999,0,9999,0
1708247006007,PSYC 296,011,421803,Ferreira; Victor,9999,0,9999,0
1708247006007,PSYC 296,012,421814,Geller; Emma Harlan,9998,0,9999,1
1708247006007,PSYC 296,013,422102,Gentner; Tim,9999,0,9999,0
1708247006007,PSYC 296,014,422103,Gorman; Michael R.,9999,0,9999,0
1708247006007,PSYC 296,015,422104,Gremel; Christina M,9999,0,9999,0
1708247006007,PSYC 296,016,422106,Harris; Christine Renee,9999,0,9999,0
1708247006007,PSYC 296,017,422107,Heyman; Gail D.,9999,0,9999,0
1708247006007,PSYC 296,018,422108,McCullough; Michael E,9999,0,9999,0
1708247006007,PSYC 296,019,422109,Mc Kenzie; Craig R.M.,9999,0,9999,0
1708247006007,PSYC 296,020,422122,Miller; Cory T.,9999,0,9999,0
1708247006007,PSYC 296,021,422123,Pashler; Harold E,9999,0,9999,0
1708247006007,PSYC 296,022,422124,Pilegard; Celeste Cristine,9999,0,9999,0
1708247006007,PSYC 296,023,422125,Powell; Lindsey Jane,9999,0,9999,0
1708247006007,PSYC 296,025,422127,Rickard; Timothy C.,9998,0,9999,1
1708247006007,PSYC 296,026,422128,Serences; John Thomas,9998,0,9999,1
1708247006007,PSYC 296,027,422130,Walker; Caren Michelle,9998,0,9999,1
1708247006007,PSYC 296,028,422132,Winkielman; Piotr,9999,0,9999,0
1708247006007,PSYC 296,029,422134,Wixted; John T,9996,0,9999,3
1708247006007,PSYC 296,030,422146,Brady; Timothy Francis,9998,0,9999,1
1708247006007,PSYC 296,031,422154,Carver; Leslie J.,9999,0,9999,0
1708247006007,PSYC 296,032,422161,Lin; Chujun,9999,0,9999,0
1708247006007,PSYC 296,033,422169,Brashier; Nadia Marie,9998,0,9999,1
1708247006007,PSYC 296,034,422177,Oesch; Nicholas W,9999,0,9999,0
1708247006537,RAD 296,001,465795,Staff,50,0,50,0
1708247006537,RAD 296,002,465796,Staff,50,0,50,0
1708247006537,RAD 296,003,465797,Staff,50,0,50,0
1708247007064,RELI 150,A00,419353,Rahimi; Babak,37,0,40,3
1708247007590,REV 87,A00,422721,Lyon; Antony J.,19,0,20,1
1708247008116,RMAS 296,001,465827,Murphy; James D,49,0,50,1
1708247008116,RMAS 296,002,465828,Staff,50,0,50,0
1708247008116,RMAS 296,003,465831,Staff,50,0,50,0
1708247008640,RMED 296,001,466791,Staff,50,0,50,0
1708247008640,RMED 296,002,466792,Staff,50,0,50,0
1708247008640,RMED 296,003,466793,Staff,50,0,50,0
1708247009166,SE 3,A01,446938,Van Den Einde; Yael Dahlia,50,0,52,2
1708247009166,SE 3,A02,446942,Van Den Einde; Yael Dahlia,49,0,52,3
1708247009166,SE 3,A03,446948,Van Den Einde; Yael Dahlia,52,0,53,1
1708247009166,SE 3,A04,446965,Van Den Einde; Yael Dahlia,53,0,53,0
1708247009695,SE 9,A01,447015,Kuester; Falko,30,0,34,4
1708247009695,SE 9,A02,447017,Kuester; Falko,33,0,33,0
1708247009695,SE 9,A03,447022,Kuester; Falko,31,0,33,2
1708247010223,SE 101B,A01,447040,Kosmatka; John B,55,0,56,1
1708247010746,SE 105,A01,447042,Qiao; Yu,118,0,120,2
1708247011271,SE 110A,A01,467467,Asaro; Robert J,56,0,56,0
1708247011801,SE 110B,A00,447045,Zhu; Qiang,122,0,125,3
1708247012332,SE 130B,A01,447049,Chadha; Mayank,92,0,100,8
1708247012862,SE 131A,A01,447059,Krysl; Petr,102,0,110,8
1708247013388,SE 132,A01,447078,Chen; Jiun-Shyan,48,0,50,2
1708247013917,SE 140B,A01,447086,Restrepo; Jose,29,0,34,5
1708247013917,SE 140B,A02,447123,Restrepo; Jose,21,0,33,12
1708247013917,SE 140B,A03,447124,Restrepo; Jose,30,0,33,3
1708247014446,SE 143B,A01,447133,Tehrani; Mehran,11,0,15,4
1708247014446,SE 143B,A02,447134,Tehrani; Mehran,13,0,15,2
1708247014973,SE 150A,A01,447136,Uang; Chia-Ming,94,0,100,6
1708247015499,SE 150B,A01,447214,Morrison; Machel Leigh,49,0,50,1
1708247016026,SE 151B,A00,447215,Shing; P. Benson,71,0,75,4
1708247016550,SE 160B,A01,467468,Kim; Hyunsun Alicia,91,0,100,9
1708247017077,SE 165,A00,447238,Farrar; Charles R.,9,0,10,1
1708247017607,SE 184,A00,447253,Hutchinson; Tara,20,0,20,0
1708247018133,SE 202,A00,447392,Kosmatka; John B,25,0,30,5
1708247018658,SE 204,A00,447482,Todd; Michael,12,0,20,8
1708247019183,SE 206,A00,447483,Conte; Joel P,30,0,30,0
1708247019712,SE 213,A00,447499,Palermo; Alessandro,17,0,30,13
1708247020239,SE 215,A00,447500,Zhu; Qiang,34,0,45,11
1708247020767,SE 222,A00,447507,Elgamal; Ahmed,30,0,30,0
1708247021297,SE 227,A00,447576,Hutchinson; Tara,20,0,25,5
1708247021826,SE 244,A00,447577,Elgamal; Ahmed,29,0,30,1
1708247022352,SE 247,A00,447580,Hutchinson; Tara,0,0,5,5
1708247022884,SE 251B,A00,447612,Qiao; Yu,15,0,25,10
1708247023411,SE 253B,A00,447613,Kim; Hyonny,28,0,30,2
1708247023940,SE 260B,A00,447614,Kim; Hyunsun Alicia,10,0,10,0
1708247024480,SE 265,A00,447615,Farrar; Charles R.,20,0,25,5
1708247025005,SE 266,A00,447616,Loh; Chin Hsiung,23,0,25,2
1708247026060,SE 280,A00,447650,Krysl; Petr,22,0,25,3
1708247026586,SE 281,A01,447658,Kuester; Falko,12,0,30,18
1708247027115,SE 290,A00,447659,Qiao; Yu,78,0,100,22
1708247027649,SE 296,001,447666,Asaro; Robert J,9999,0,9999,0
1708247027649,SE 296,002,447669,Chen; Jiun-Shyan,9999,0,9999,0
1708247027649,SE 296,003,447689,Conte; Joel P,9999,0,9999,0
1708247027649,SE 296,004,447690,Elgamal; Ahmed,9999,0,9999,0
1708247027649,SE 296,005,447728,Hutchinson; Tara,9999,0,9999,0
1708247027649,SE 296,006,447733,Jandaghi Semnani; Shabnam,9999,0,9999,0
1708247027649,SE 296,007,447734,Kim; Hyonny,9999,0,9999,0
1708247027649,SE 296,008,447737,Kim; Hyunsun Alicia,9999,0,9999,0
1708247027649,SE 296,009,447738,Kosmatka; John B,9999,0,9999,0
1708247027649,SE 296,010,447739,Krysl; Petr,9999,0,9999,0
1708247027649,SE 296,011,447740,Kuester; Falko,9999,0,9999,0
1708247027649,SE 296,012,447741,Lanza Di Scalea; Francesco,9999,0,9999,0
1708247027649,SE 296,013,447742,Loh; Kenneth J. H.,9999,0,9999,0
1708247027649,SE 296,014,447745,McCartney; John Scott,9999,0,9999,0
1708247027649,SE 296,015,447747,Morrison; Machel Leigh,9999,0,9999,0
1708247027649,SE 296,016,447749,Mosqueda; Gilberto,9999,0,9999,0
1708247027649,SE 296,017,447874,Qiao; Yu,9999,0,9999,0
1708247027649,SE 296,018,447875,Restrepo; Jose,9999,0,9999,0
1708247027649,SE 296,019,447886,Shing; P. Benson,9999,0,9999,0
1708247027649,SE 296,020,447887,Todd; Michael,9999,0,9999,0
1708247027649,SE 296,021,447888,Tomac; Ingrid,9999,0,9999,0
1708247027649,SE 296,022,447889,Tsampras; Georgios,9999,0,9999,0
1708247027649,SE 296,023,447890,Uang; Chia-Ming,9999,0,9999,0
1708247027649,SE 296,024,447931,Van Den Einde; Yael Dahlia,9999,0,9999,0
1708247027649,SE 296,025,447932,Zhu; Qiang,9999,0,9999,0
1708247027649,SE 296,026,448007,Tehrani; Mehran,9999,0,9999,0
1708247027649,SE 296,027,448008,Palermo; Alessandro,9999,0,9999,0
1708247027649,SE 296,028,492941,Farrar; Charles R.,9998,0,9999,1
1708247028174,SIO 10,A00,446025,Borsa; Adrian Antal,573,0,590,17
1708247028704,SIO 16,A00,446031,Gee; Jeffrey S,119,0,120,1
1708247029228,SIO 50,A01,446057,Cook; Geoffrey W,19,0,22,3
1708247029228,SIO 50,A02,446058,Cook; Geoffrey W,21,0,22,1
1708247029758,SIO 75,A00,446060,Norris; Richard D.,32,0,35,3
1708247030284,SIO 87,A00,479215,Feddersen; Falk & Morzfeld; Matthias,20,0,20,0
1708247030284,SIO 87,B00,489613,Cook; Geoffrey W,19,0,20,1
1708247030284,SIO 87,C00,489620,Cook; Geoffrey W,20,0,20,0
1708247030809,SIO 90,A00,446061,Staff,61,0,70,9
1708247031337,SIO 113,A01,446064,May; David Alexander,27,0,30,3
1708247032389,SIO 128,A00,446115,Bartlett; Douglas H,110,0,120,10
1708247032916,SIO 135,A01,446153,Fricker; Helen A.,16,0,17,1
1708247032916,SIO 135,A02,446156,Fricker; Helen A.,14,0,18,4
1708247033497,SIO 136,A01,446159,Kacev; David & Wegner; Nicholas Craig & Bartlett; Douglas H,31,0,33,2
1708247033497,SIO 136,A02,446160,Kacev; David & Wegner; Nicholas Craig & Bartlett; Douglas H,33,0,33,0
1708247034023,SIO 139,A00,446164,Kacev; David,66,0,70,4
1708247034553,SIO 141,A01,446173,Pomeroy; Robert S.,11,0,12,1
1708247035079,SIO 143,A01,446175,Andersson; Andreas Jerry,21,0,30,9
1708247035605,SIO 145,A01,446181,Choy; Carolyn Anela,6,0,18,12
1708247036132,SIO 152,A01,446184,Van Allen; Emily Joyce,8,0,10,2
1708247036132,SIO 152,A02,479204,Van Allen; Emily Joyce,10,0,10,0
1708247036660,SIO 153,A01,446188,Capaldi; Tomas,24,0,26,2
1708247037184,SIO 160,A00,446189,Stegman; David,21,0,25,4
1708247037710,SIO 164,A00,446193,Staff,28,0,35,7
1708247038237,SIO 173,A00,446194,Lutsko; Nicholas J.,28,0,30,2
1708247038768,SIO 174,A00,446197,Aluwihare; Lihini & Russell; Lynn M.,26,0,30,4
1708247039299,SIO 181,A01,446200,Tresguerres; Martin,18,0,25,7
1708247039299,SIO 181,A02,446201,Tresguerres; Martin,23,0,25,2
1708247039299,SIO 181,A03,446209,Tresguerres; Martin,24,0,25,1
1708247039299,SIO 181,A04,446211,Tresguerres; Martin,24,0,25,1
1708247039299,SIO 181,A05,446223,Tresguerres; Martin,24,0,25,1
1708247039299,SIO 181,A06,446236,Tresguerres; Martin,24,0,25,1
1708247039824,SIO 192,A00,479211,Gerwick; William Henry,20,0,20,0
1708247040347,SIO 194,A00,455340,Hill; Seth J,0,0,0,0
1708247040876,SIOB 262,A00,446243,Gerwick; William Henry,23,0,25,2
1708247041400,SIOB 269,A00,446244,Staff,19,0,20,1
1708247041925,SIOB 270,A01,446261,Allen; Andrew Ellis & Petrik; Colleen Mary,18,0,20,2
1708247042452,SIOB 278,A00,446273,Arcila; Dahiana K,13,0,15,2
1708247042452,SIOB 278,B00,481742,Aburto Oropeza; Marco Octavio,18,0,20,2
1708247042979,SIOB 279,A00,446286,Franks; Peter,31,0,35,4
1708247043505,SIOB 291,A00,446292,Hechinger; Ryan F.,20,0,20,0
1708247044036,SIOB 296,A00,446293,Mongiardino Koch; Nicolas,16,0,20,4
1708247044566,SIOB 297,A00,446294,Allen; Eric,66,0,70,4
1708247045097,SIOC 202B,A00,446312,Stramski; Dariusz & Gabriel; Anne Alice-Agnes,17,0,20,3
1708247045625,SIOC 203C,A01,446314,Young; William Roy,5,0,5,0
1708247046152,SIOC 207C,A00,492798,Vasconcelos; Manuela,5,0,5,0
1708247046679,SIOC 208,A00,446315,Merrifield; Mark A,16,0,20,4
1708247047210,SIOC 209,A00,478924,Werner; Bradley T.,11,0,15,4
1708247047210,SIOC 209,B00,479224,Watson-Parris; Duncan,15,0,25,10
1708247047210,SIOC 209,C00,480739,Ricke; Katharine L,24,0,24,0
1708247047736,SIOC 212B,A01,446324,Cessi; Paola,40,0,40,0
1708247048262,SIOC 217C,A00,446325,Lutsko; Nicholas J.,25,0,25,0
1708247048788,SIOC 220,A00,446326,Rudnick; Daniel Lars,13,0,15,2
1708247049316,SIOC 224,A00,446327,Eisenman; Ian,20,0,25,5
1708247049842,SIOC 228,A00,446328,Shi; Yuanyuan,1,0,10,9
1708247050370,SIOC 235,A00,446342,Xie; Shang-Ping,14,0,15,1
1708247050900,SIOC 251,A00,446343,Evan; Amato Tomas,19,0,20,1
1708247051428,SIOG 200B,A00,446344,Gabriel; Anne Alice-Agnes,9,0,10,1
1708247051962,SIOG 221,A00,446354,Parnell-Turner; Ross Ernes,29,0,30,1
1708247052487,SIOG 227B,A00,446355,Laske; Gabi & Shearer; Peter M,19,0,20,1
1708247053017,SIOG 228,A00,446356,Van Allen; Emily Joyce,7,0,20,13
1708247053543,SIOG 230,A00,446359,Constable; Catherine G,25,0,25,0
1708247054070,SIOG 232,A00,446360,Constable; Catherine G & Constable; Steven C,37,0,40,3
1708247054599,SIOG 234,A00,446361,Sandwell; David T,15,0,15,0
1708247055126,SIOG 236,A01,477658,Fricker; Helen A.,5,0,5,0
1708247055126,SIOG 236,A02,477685,Fricker; Helen A.,3,0,5,2
1708247055652,SIOG 239,A00,446362,Gabriel; Anne Alice-Agnes,19,0,20,1
1708247055652,SIOG 239,B00,481507,May; David Alexander,6,0,6,0
1708247055652,SIOG 239,C00,486863,Fialko; Yuri A.,15,0,15,0
1708247056178,SIOG 268,A00,446364,Barbeau; Katherine,12,0,15,3
1708247056704,SOCE 194,A00,455341,Hill; Seth J,0,0,0,0
1708247057230,SOCG 204,A00,446551,Ng; Kwai,0,0,8,8
1708247057756,SOCG 206,A00,446552,Alvarez; Camila Huerta,4,0,8,4
1708247058282,SOCG 214,A00,446553,Raudenbush; Danielle,3,0,8,5
1708247058808,SOCG 255B,A00,446602,Serlin; David,2,0,5,3
1708247059337,SOCG 255C,A00,446813,Gates; Kelly,3,0,5,2
1708247059867,SOCG 290,A00,446910,Thorpe; Charles Robert,0,0,10,10
1708247059867,SOCG 290,B00,446911,Goldman; Harvey Stern,1,0,10,9
1708247059867,SOCG 290,C00,446914,Lampland; Martha,5,0,10,5
1708247060398,SOCI 2,A01,446373,Rogers; Julia Ellen,28,0,30,2
1708247060398,SOCI 2,A02,446374,Rogers; Julia Ellen,29,0,30,1
1708247060398,SOCI 2,A03,446382,Rogers; Julia Ellen,29,0,30,1
1708247060398,SOCI 2,A04,446384,Rogers; Julia Ellen,30,0,30,0
1708247060398,SOCI 2,A05,446389,Rogers; Julia Ellen,30,0,30,0
1708247060398,SOCI 2,A06,446393,Rogers; Julia Ellen,29,0,30,1
1708247060925,SOCI 20,A01,446396,Calderon-Zaks; Michael Aar,33,0,34,1
1708247060925,SOCI 20,A02,446409,Calderon-Zaks; Michael Aar,34,0,34,0
1708247061455,SOCI 40,A01,446417,Raudenbush; Danielle,30,0,32,2
1708247061455,SOCI 40,A02,446419,Raudenbush; Danielle,31,0,32,1
1708247061455,SOCI 40,A03,446434,Raudenbush; Danielle,31,0,32,1
1708247061455,SOCI 40,A04,446436,Raudenbush; Danielle,28,0,32,4
1708247061455,SOCI 40,A05,446441,Raudenbush; Danielle,29,0,32,3
1708247061455,SOCI 40,A06,446445,Raudenbush; Danielle,32,0,32,0
1708247061984,SOCI 60,A01,446461,Sutton; April Marie,30,0,32,2
1708247061984,SOCI 60,A02,446468,Sutton; April Marie,30,0,32,2
1708247061984,SOCI 60,A03,446469,Sutton; April Marie,26,0,32,6
1708247061984,SOCI 60,A04,446471,Sutton; April Marie,31,0,32,1
1708247062509,SOCI 100,A01,446480,Payne; Christine Anna,28,0,30,2
1708247062509,SOCI 100,A02,446491,Payne; Christine Anna,29,0,30,1
1708247062509,SOCI 100,A03,446492,Payne; Christine Anna,28,0,30,2
1708247062509,SOCI 100,A04,446493,Payne; Christine Anna,27,0,30,3
1708247063038,SOCI 103M,A00,481672,Kilpatrick; Kevin,27,0,28,1
1708247063563,SOCI 104,A00,446494,Turner; Christena L.,28,0,30,2
1708247064088,SOCI 104Q,A00,446495,Rogers; Julia Ellen,27,0,30,3
1708247064614,SOCI 106,A00,446496,Payne; Christine Anna,25,0,30,5
1708247065140,SOCI 107,A00,446497,Staff,30,0,30,0
1708247065668,SOCI 109,A00,446498,Rona-Tas; Akos,20,0,25,5
1708247066195,SOCI 111,A00,446499,Ribas Norris; Janet Vanesa,54,0,56,2
1708247066721,SOCI 114,A00,446500,Lampland; Martha,73,0,75,2
1708247067249,SOCI 117,A01,446502,Jones; Gabrielle Anastasia,14,0,17,3
1708247067249,SOCI 117,A02,446516,Jones; Gabrielle Anastasia,17,0,17,0
1708247067249,SOCI 117,A03,458787,Jones; Gabrielle Anastasia,17,0,17,0
1708247067249,SOCI 117,A04,458835,Jones; Gabrielle Anastasia,19,0,19,0
1708247067774,SOCI 120T,A00,446518,Staff,56,0,56,0
1708247068304,SOCI 123,A00,446519,Staff,79,0,80,1
1708247068832,SOCI 125,A00,487186,Calderon-Zaks; Michael Aar,55,0,56,1
1708247069357,SOCI 126,A01,446532,Jones; Makeba,15,0,15,0
1708247069357,SOCI 126,A02,446533,Jones; Makeba,15,0,15,0
1708247069357,SOCI 126,A03,458839,Jones; Makeba,15,0,15,0
1708247069357,SOCI 126,A04,458840,Jones; Makeba,15,0,15,0
1708247069884,SOCI 133,A00,446534,Calderon-Zaks; Michael Aar,53,0,56,3
1708247070413,SOCI 135,A00,486886,Ruiz; Jonathan Joseph,55,0,56,1
1708247070943,SOCI 136,A00,486887,Ruiz; Jonathan Joseph,56,0,56,0
1708247071468,SOCI 139,A00,446535,Ribas Norris; Janet Vanesa,78,0,80,2
1708247071998,SOCI 140J,A00,446537,Estefan; Michel,76,0,100,24
1708247072529,SOCI 142,A00,477639,Crofts; Christine,43,0,50,7
1708247073055,SOCI 146,A00,446538,Summers; Valerie R.,113,0,120,7
1708247073582,SOCI 151,A00,446540,Goldman; Harvey Stern,56,0,56,0
1708247074116,SOCI 156,A00,446541,Ostovany; Khashayar,55,0,56,1
1708247074643,SOCI 157,A00,446542,Jules-Rosette; Bennetta W.,28,0,28,0
1708247075167,SOCI 159,A00,494493,Estefan; Michel,93,0,96,3
1708247075696,SOCI 161,A00,477638,Staff,45,0,45,0
1708247076225,SOCI 162,A00,477642,Staff,54,0,55,1
1708247076750,SOCI 165,A00,446543,Rona-Tas; Akos,49,0,56,7
1708247077276,SOCI 171,A00,446544,Thorpe; Charles Robert,56,0,56,0
1708247077803,SOCI 173,A00,482888,Crofts; Christine,92,0,100,8
1708247078332,SOCI 180,A00,446545,Ostovany; Khashayar,55,0,56,1
1708247078858,SOCI 183,A00,446546,Sutton; April Marie,43,0,45,2
1708247079388,SOCI 185,A00,494495,Staff,30,0,30,0
1708247079918,SOCI 188D,A00,446549,Kokinis; Troy Andreas,24,0,25,1
1708247080447,SOCI 198RA,001,446550,Ng; Kwai,30,0,30,0
1708247080976,SOMC 224C,A00,466928,Bhakta; Savita Ganapathi,160,0,160,0
1708247081503,SOMC 229,A00,466925,Hoang; Mai Phuong,160,0,160,0
1708247082030,SOMC 240,A00,466937,Coyne; Christopher John,150,0,150,0
1708247082559,SOMC 242,A00,466931,Kline; Ahnika Sarah,160,0,160,0
1708247083087,SOMC 244,A00,466939,Mandel; Jess,150,0,150,0
1708247083612,SOMC 245C,A01,466935,Noel; Geoffroy Pierre Jean,160,0,160,0
1708247084141,SOMC 246C,A00,487163,Eyler; Lisa T.,160,0,160,0
1708247084668,SOMC 247C,A50,466950,Calcutt; Nigel A,160,0,160,0
1708247085197,SOMC 248C,A00,466936,Joshi; Weena Erin,160,0,160,0
1708247085723,SOMC 255C,A00,466951,Allison; Matthew,160,0,160,0
1708247086250,SPPH 161R,A01,476600,Chambers; Christina D,99,0,100,1
1708247086828,SPPH 263B,A01,460901,Hook; Vivian Yuan-Ho,25,0,25,0
1708247087357,SPPS 200A,A00,460907,Luli; Alex J,99,0,99,0
1708247087886,SPPS 200B,A00,460928,Luli; Alex J,99,0,99,0
1708247088412,SPPS 200C,A00,460934,Luli; Alex J,95,0,99,4
1708247088940,SPPS 203,A00,460955,Painter; Nathan A.,83,0,99,16
1708247089466,SPPS 205,A01,460978,Bandeira; Nuno Filipe Cabrita,64,0,80,16
1708247089995,SPPS 209,A00,460979,Bounthavong; Mark,94,0,99,5
1708247090520,SPPS 210,001,460980,Gustafsson; Asa Birgitta,99,0,99,0
1708247091049,SPPS 211A,A00,460987,Ferguson; Fleur,85,0,99,14
1708247091575,SPPS 211B,A00,460991,Ferguson; Fleur,97,0,99,2
1708247092101,SPPS 211C,A00,460992,Ferguson; Fleur,95,0,99,4
1708247092626,SPPS 211D,A00,460993,Tsunoda; Shirley M.,99,0,99,0
1708247093152,SPPS 212C,A01,460995,Saunders; Ila Maewal,95,0,99,4
1708247093678,SPPS 213C,A00,460996,Awdishu; Linda,95,0,99,4
1708247094205,SPPS 218B,A00,460997,Mandyam; Chitra,95,0,99,4
1708247094734,SPPS 225,A01,460999,Reed; Chantal,83,0,99,16
1708247095260,SPPS 236,A00,461000,Reid; Erin G.,97,0,99,2
1708247095786,SPPS 237,A00,461002,Mimoto; Mizuho Stacy,97,0,99,2
1708247096312,SPPS 238,A00,461041,Beyhan; Sinem,97,0,99,2
1708247096839,SPPS 241,A01,461122,Tsunoda; Shirley M.,83,0,99,16
1708247097364,SPPS 249,A00,461123,Brandl; Katharina,97,0,99,2
1708247097893,SPPS 250,A00,461126,Tsunoda; Shirley M.,45,0,50,5
1708247098422,SPPS 251,A00,461127,Chen; Timothy,99,0,99,0
1708247098951,SPPS 252,A00,461128,Abdul-Mutakabbir; Jacinda,74,0,80,6
1708247099476,SPPS 254,A00,481670,Shapiro; Desiree Nicolette,77,0,80,3
1708247100006,SPPS 261,A00,461129,Chambers; Christina D,93,0,99,6
1708247100532,SPPS 278,A00,459983,Fricovsky; Eduardo Santiago,98,0,99,1
1708247101059,SPPS 280,A00,461259,Fricovsky; Eduardo Santiago,19,0,20,1
1708247101588,SPPS 283,A00,461283,Tsunoda; Shirley M.,96,0,99,3
1708247102115,SURG 261,A00,466973,Staff,50,0,50,0
1708247102640,SURG 296,001,467004,Agha Hosseini; Ava,49,0,50,1
1708247102640,SURG 296,002,467005,Hinchcliff; Katharine Moss,49,0,50,1
1708247102640,SURG 296,003,467006,Eliceiri; Brian,49,0,50,1
1708247103169,SYN 1,001,448577,Bishop; Graham,19,0,20,1
1708247103169,SYN 1,002,448578,Iatarola; Briana Marie,19,0,20,1
1708247103169,SYN 1,003,448579,Browne; Emily,20,0,20,0
1708247103169,SYN 1,004,448580,Vega; Adrian,20,0,20,0
1708247103169,SYN 1,005,448581,Browne; Emily,20,0,20,0
1708247103169,SYN 1,006,448582,Rock; Martin,20,0,20,0
1708247103169,SYN 1,007,448583,Rock; Martin,20,0,20,0
1708247103169,SYN 1,008,448584,Iatarola; Briana Marie,19,0,20,1
1708247103169,SYN 1,009,448585,Bishop; Graham,20,0,20,0
1708247103169,SYN 1,010,448586,Bishop; Graham,20,0,20,0
1708247103169,SYN 1,011,448587,Gladstein; Jill M,15,0,15,0
1708247103169,SYN 1,012,448588,Meyer; Leslie Rose,20,0,20,0
1708247103169,SYN 1,013,448589,Rosenberg; Ryan Glenn,20,0,20,0
1708247103169,SYN 1,014,448627,Rosenberg; Ryan Glenn,19,0,20,1
1708247103169,SYN 1,015,448630,Atkinson; Arthur Laird,20,0,20,0
1708247103169,SYN 1,016,448651,Hom; Kirstyn Courtney,20,0,20,0
1708247103169,SYN 1,017,448652,Difruscio; Mark,20,0,20,0
1708247103169,SYN 1,018,448669,Hom; Kirstyn Courtney,20,0,20,0
1708247103169,SYN 1,019,448674,Hom; Kirstyn Courtney,18,0,20,2
1708247103169,SYN 1,020,448675,Atkinson; Arthur Laird,20,0,20,0
1708247103169,SYN 1,021,448678,Gladstein; Jill M,15,0,15,0
1708247103169,SYN 1,022,448682,Iatarola; Briana Marie,20,0,20,0
1708247103169,SYN 1,023,448691,Birberick; Brittany Celest,20,0,20,0
1708247103169,SYN 1,024,448751,Birberick; Brittany Celest,20,0,20,0
1708247103169,SYN 1,027,448766,Deavenport; James Cary,19,0,20,1
1708247103169,SYN 1,028,448767,Meyer; Leslie Rose,20,0,20,0
1708247103169,SYN 1,029,448775,Tawater; Hanna Jean,20,0,20,0
1708247103169,SYN 1,030,448777,Tawater; Hanna Jean,20,0,20,0
1708247103169,SYN 1,031,448792,Deavenport; James Cary,20,0,20,0
1708247103169,SYN 1,032,480169,Tawater; Hanna Jean,18,0,20,2
1708247103695,SYN 1R,001,448793,Difruscio; Mark,20,0,20,0
1708247103695,SYN 1R,004,449146,Difruscio; Mark,20,0,20,0
1708247104232,SYN 100,A01,449148,Staff,11,0,15,4
1708247104232,SYN 100,A02,449149,Staff,15,0,15,0
1708247104232,SYN 100,B01,449164,Gladstein; Jill M,0,0,0,0
1708247104232,SYN 100,B02,449166,Gladstein; Jill M,0,0,0,1
1708247104232,SYN 100,C01,449244,Staff,7,0,15,8
1708247104232,SYN 100,C02,449274,Staff,13,0,15,2
1708247104232,SYN 100,D01,449278,Staff,20,0,20,0
1708247104232,SYN 100,D02,449279,Staff,20,0,20,0
1708247104232,SYN 100,E01,449281,Rock; Martin,9,0,15,6
1708247104232,SYN 100,E02,449282,Rock; Martin,14,0,15,1
1708247104232,SYN 100,F01,449304,Browne; Emily,12,0,15,3
1708247104232,SYN 100,F02,449306,Browne; Emily,14,0,15,1
1708247104232,SYN 100,I01,449390,Gormally; Brenna,0,0,0,0
1708247104232,SYN 100,I02,449391,Gormally; Brenna,0,0,0,0
1708247104232,SYN 100,J01,449401,Atkinson; Arthur Laird,11,0,15,4
1708247104232,SYN 100,J02,449402,Atkinson; Arthur Laird,14,0,15,1
1708247104232,SYN 100,K01,449404,Deavenport; James Cary,11,0,15,4
1708247104232,SYN 100,K02,449405,Deavenport; James Cary,14,0,15,1
1708247104232,SYN 100,L01,449408,Rosenberg; Ryan Glenn,10,0,15,5
1708247104232,SYN 100,L02,449420,Rosenberg; Ryan Glenn,15,0,15,0
1708247104758,SYN 150,001,450016,Vega; Adrian,19,0,19,0
1708247104758,SYN 150,003,450031,Birberick; Brittany Celest,20,0,20,0
1708247105284,SYN 150R,001,494950,Vega; Adrian,20,0,20,0
1708247105811,SYN 198,001,494388,Staff,9999,0,9999,0
1708247106342,TDAC 1,A00,450042,Walsh; Kim C.,14,0,20,6
1708247106342,TDAC 1,B00,450043,Walsh; Kim C.,11,0,20,9
1708247106342,TDAC 1,C00,450044,Walsh; Kim C.,15,0,20,5
1708247106342,TDAC 1,D00,486830,Basso; Beatrice,20,0,20,0
1708247106342,TDAC 1,E00,492912,Walsh; Kim C.,15,0,20,5
1708247106342,TDAC 1,F00,492936,Walsh; Kim C.,18,0,20,2
1708247106871,TDAC 101,A00,450895,Celik; Aysan Karagasli,18,0,20,2
1708247107400,TDAC 102,A00,450904,Walsh; Kim C.,20,0,20,0
1708247107400,TDAC 102,B00,450916,Harting; Carla Kelso,20,0,20,0
1708247107925,TDAC 108,A00,450917,Buescher; Stephen W.,18,0,20,2
1708247108452,TDAC 109,A00,450924,Blair; Kyle Adam,20,0,20,0
1708247108982,TDAC 122,A00,451025,Perry; Lamar,30,0,30,0
1708247108982,TDAC 122,B00,480845,Perry; Lamar,30,0,30,0
1708247109510,TDAC 123,A00,451026,Buescher; Stephen W.,30,0,30,0
1708247109510,TDAC 123,B00,451028,Celik; Aysan Karagasli,30,0,30,0
1708247109510,TDAC 123,C00,480851,Perry; Lamar,30,0,30,0
1708247110036,TDDE 101,A00,451030,Guirguis; Mark C,18,0,20,2
1708247110565,TDDE 112,A00,451032,Staff,20,0,20,0
1708247111091,TDDE 130,A00,451033,Guirguis; Mark C,19,0,20,1
1708247111622,TDDE 132,A00,451034,Guirguis; Mark C,20,0,20,0
1708247112152,TDDE 169A,A00,481304,Petrovich; Victoria A.,19,0,20,1
1708247112681,TDDM 1,A00,450045,Weinberg; Sadie,27,0,30,3
1708247113209,TDDM 101,A00,451067,Staff,29,0,30,1
1708247113737,TDDR 101,A00,451068,Powell; Lora,29,0,34,5
1708247114267,TDDR 102,A00,451069,Powell; Lora,19,0,20,1
1708247114792,TDDR 111,A00,451070,Castro; Robert Jess,15,0,16,1
1708247114792,TDDR 111,B00,451071,Castro; Robert Jess,15,0,16,1
1708247115321,TDDR 190,A00,451073,Perry; Lamar,1,0,1,0
1708247115854,TDGE 1,A01,450047,Salovey; Todd,20,0,20,0
1708247115854,TDGE 1,A02,450048,Salovey; Todd,20,0,20,0
1708247115854,TDGE 1,A03,450085,Salovey; Todd,18,0,20,2
1708247115854,TDGE 1,A04,450093,Salovey; Todd,20,0,20,0
1708247115854,TDGE 1,A05,450096,Salovey; Todd,19,0,20,1
1708247115854,TDGE 1,A06,450132,Salovey; Todd,16,0,20,4
1708247116380,TDGE 25,A00,450236,Harting; Carla Kelso,12,0,20,8
1708247116380,TDGE 25,B00,450240,Harting; Carla Kelso,16,0,20,4
1708247116380,TDGE 25,C00,450243,Harting; Carla Kelso,14,0,20,6
1708247116380,TDGE 25,D00,450388,Harting; Carla Kelso,16,0,20,4
1708247116906,TDGE 100,A01,451098,Salovey; Todd,24,0,25,1
1708247116906,TDGE 100,A02,451099,Salovey; Todd,24,0,25,1
1708247117434,TDGE 124,A00,451122,Fulton; Julia,169,0,200,31
1708247117960,TDGE 125,A00,480853,Havis; Allan,198,0,200,2
1708247117960,TDGE 125,B00,480886,Staff,216,0,220,4
1708247118500,TDGE 133,A00,481097,Brill; Robert L.,20,0,20,0
1708247119028,TDGE 196B,A00,493144,Barricelli; Marc Alexander,1,0,1,0
1708247119028,TDGE 196B,B00,493148,Buescher; Stephen W.,2,0,2,0
1708247119028,TDGE 196B,C00,493151,Burelle; Julie Sara Veronique,1,0,1,0
1708247119028,TDGE 196B,D00,493189,Castro; Robert Jess,2,0,2,0
1708247119028,TDGE 196B,E00,493190,Guirguis; Mark C,1,0,1,0
1708247119028,TDGE 196B,F00,493240,Iizuka; Naomi Hisako,1,0,1,0
1708247119028,TDGE 196B,G00,493241,Perry; Lamar,1,0,1,0
1708247119028,TDGE 196B,H00,493249,Powell; Lora,1,0,1,0
1708247119028,TDGE 196B,I00,493296,Stein; Deborah Isobel,6,0,6,0
1708247119553,TDGR 213C,A00,451385,Buescher; Stephen W.,10,0,10,0
1708247120079,TDGR 220A,A00,451386,Barricelli; Marc Alexander,10,0,10,0
1708247120605,TDGR 239,A00,451387,Blair; Kyle Adam,10,0,10,0
1708247121134,TDGR 240,A00,481306,Portes; Elizabeth Marie,5,0,5,0
1708247121663,TDGR 245,A00,451388,Perry; Lamar,7,0,7,0
1708247122188,TDGR 250,A00,451395,Iizuka; Naomi Hisako,8,0,10,2
1708247122717,TDGR 251,A00,451397,Iizuka; Naomi Hisako,9,0,10,1
1708247122717,TDGR 251,B00,451398,Stein; Deborah Isobel,9,0,10,1
1708247123242,TDGR 257B,A00,451399,Finch; Michael S,8,0,10,2
1708247123768,TDGR 278,A00,481307,Petrovich; Victoria A.,4,0,5,1
1708247124293,TDGR 279,A00,451400,Bokovikova; Alina V,9,0,10,1
1708247124293,TDGR 279,B00,451401,Brill; Robert L.,10,0,10,0
1708247124293,TDGR 279,C00,451402,Petrovich; Victoria A.,10,0,10,0
1708247124293,TDGR 279,D00,451403,McElver; Robert Harrison,10,0,10,0
1708247124293,TDGR 279,E00,451404,Kuhl; Christopher August,10,0,10,0
1708247124820,TDGR 286,A00,451405,Knox; Leila Elizabeth,9,0,10,1
1708247125349,TDGR 288,A00,451406,Powell; Lora,6,0,7,1
1708247125876,TDGR 292,A00,451407,Power; Jade Yukana,10,0,10,0
1708247125876,TDGR 292,B00,451408,Mehrishi; Rishika,10,0,10,0
1708247126401,TDGR 293,001,451417,Power; Jade Yukana,7,0,7,0
1708247126401,TDGR 293,002,451418,Burelle; Julie Sara Veronique,7,0,7,0
1708247126401,TDGR 293,003,451419,Yapp; Hentyle T,7,0,7,0
1708247126401,TDGR 293,005,451421,Anderson; Mysia Anyse,7,0,7,0
1708247126926,TDGR 294,001,451429,Burelle; Julie Sara Veronique,7,0,7,0
1708247126926,TDGR 294,002,451431,Power; Jade Yukana,7,0,7,0
1708247126926,TDGR 294,003,451432,Yapp; Hentyle T,7,0,7,0
1708247127452,TDGR 295,A00,451433,Barricelli; Marc Alexander,10,0,10,0
1708247127981,TDGR 296,A00,451489,Powell; Lora,6,0,7,1
1708247127981,TDGR 296,B00,451497,Porter; Lisa,6,0,7,1
1708247128507,TDHD 175,A00,451123,Jun; Grace Shin Hae,40,0,40,0
1708247129034,TDHD 176,A00,451124,Caligagan; Maria T.,40,0,40,0
1708247129572,TDHT 10,A00,450409,Power; Jade Yukana,20,0,20,0
1708247129572,TDHT 10,B00,450450,Power; Jade Yukana,19,0,20,1
1708247130103,TDHT 23,A01,450546,Salimi; Rana,24,0,24,0
1708247130103,TDHT 23,A02,450549,Salimi; Rana,22,0,24,2
1708247130103,TDHT 23,A03,450553,Salimi; Rana,24,0,24,0
1708247130630,TDHT 101,A00,451125,Anderson; Mysia Anyse,25,0,25,0
1708247130630,TDHT 101,B00,451126,Mehrishi; Rishika,23,0,25,2
1708247131155,TDHT 104,A00,451225,Basso; Beatrice,22,0,25,3
1708247131679,TDHT 109,A01,451227,Anderson; Mysia Anyse,25,0,25,0
1708247132205,TDHT 122,A00,451228,Power; Jade Yukana,21,0,25,4
1708247132736,TDMV 1,A00,450558,Caligagan; Maria T.,15,0,30,15
1708247133261,TDMV 2,A00,450627,Anabo; Cherry,24,0,30,6
1708247133789,TDMV 3,A00,450630,Arcidiacono; Kristin,37,0,40,3
1708247134318,TDMV 11,A00,481244,Fyall; DauntÉ Edward,30,0,30,0
1708247134845,TDMV 20,A00,450789,Smith; Alison D,38,0,40,2
1708247135377,TDMV 110,A00,451229,Caligagan; Maria T.,28,0,30,2
1708247135904,TDMV 111,A00,451234,Smith; Alison D,28,0,30,2
1708247136429,TDMV 120,A00,451260,Weinberg; Sadie,30,0,30,0
1708247136429,TDMV 120,B00,451261,Sammartano; Tonnie,30,0,30,0
1708247136953,TDMV 122,A00,451262,Staff,28,0,30,2
1708247137479,TDMV 123,A00,451263,Duran; Marcos Antonio,28,0,30,2
1708247138006,TDMV 130,A00,451272,Mack; Kara Shanai',30,0,30,0
1708247138536,TDMV 138,A00,451275,Jun; Grace Shin Hae,4,0,30,26
1708247139069,TDMV 140,A00,451276,Lima; Paulo Henrique,40,0,40,0
1708247139069,TDMV 140,B00,451308,Power; Jade Yukana,39,0,40,1
1708247139069,TDMV 140,C00,451371,Caligagan; Tony,40,0,40,0
1708247139069,TDMV 140,D00,451373,Corrales; Joseph Bernales,28,0,30,2
1708247139596,TDMV 141,A00,451374,Caligagan; Tony,26,0,30,4
1708247140185,TDMV 142,A00,451375,Blanco; Juan Carlos,26,0,40,14
1708247140711,TDMV 143,A00,451376,Fyall; DauntÉ Edward,39,0,40,1
1708247141238,TDMV 144,A00,451377,Anabo; Cherry,39,0,40,1
1708247141768,TDMV 149,A00,451378,Jun; Grace Shin Hae,36,0,40,4
1708247142294,TDPF 162,A00,451379,Alvarez; Ana Maria,40,0,40,0
1708247142825,TDPR 6,A01,450799,Guirguis; Mark C,50,0,50,0
1708247142825,TDPR 6,A02,450801,Guirguis; Mark C,50,0,50,0
1708247143351,TDPR 102,A00,451380,Guirguis; Mark C,20,0,20,0
1708247143877,TDPR 104,A00,451381,Powell; Lora,15,0,15,0
1708247144407,TDPW 1,A00,450808,Stein; Deborah Isobel,14,0,15,1
1708247144407,TDPW 1,B00,450864,Stein; Deborah Isobel,13,0,15,2
1708247144407,TDPW 1,C00,450865,Stein; Deborah Isobel,15,0,15,0
1708247144407,TDPW 1,D00,450868,Stein; Deborah Isobel,13,0,15,2
1708247144407,TDPW 1,E00,450874,Stein; Deborah Isobel,14,0,15,1
1708247144933,TDPW 102,A00,451382,Staff,18,0,20,2
1708247145458,TDPW 104,A00,481182,Staff,17,0,20,3
1708247145996,TDTR 10,A00,450881,Wilson; Terry A.,28,0,30,2
1708247146522,TDTR 15,A00,450882,Smith; Alison D,30,0,30,0
1708247147048,TMC 15,A00,479039,Hemans; Patricia Ann Benitez,25,0,25,0
1708247147576,TMC 87,A00,479049,Solomon; Amanda Lee Albaniel,20,0,20,0
1708247148103,UROL 296,001,467060,Anger; Jennifer Tash,49,0,50,1
1708247148103,UROL 296,002,467061,Staff,50,0,50,0
1708247148639,USP 3,A01,458852,Martin; Isaac,34,0,35,1
1708247148639,USP 3,A02,458853,Martin; Isaac,35,0,35,0
1708247148639,USP 3,A03,458861,Martin; Isaac,34,0,35,1
1708247148639,USP 3,A04,458862,Martin; Isaac,32,0,35,3
1708247149165,USP 4,A00,451772,Schwaller; Nora Louise,19,0,25,6
1708247149695,USP 5,A01,458863,Shenkman; Michael Thomas,33,0,35,2
1708247149695,USP 5,A02,458864,Shenkman; Michael Thomas,31,0,35,4
1708247150221,USP 15,A01,458931,Staff,33,0,35,2
1708247150221,USP 15,A02,459024,Staff,31,0,35,4
1708247150750,USP 25,A00,451786,Sun; Feiyang,57,0,60,3
1708247151283,USP 100,A00,451787,Moses; Kelema Lee,55,0,60,5
1708247151810,USP 108,A00,477594,Martin; Isaac,25,0,25,0
1708247152335,USP 119,A00,477595,Schwaller; Nora Louise,23,0,25,2
1708247152864,USP 124,A00,451790,Hinds; Juli Beth,62,0,70,8
1708247153391,USP 128B,A01,451910,Lewis; Leslie R,12,0,13,1
1708247153917,USP 142B,A01,451954,Lewis; Leslie R,24,0,25,1
1708247154446,USP 142C,A00,451977,Lerner; Amy M,0,0,0,0
1708247154973,USP 145,A00,451999,Yaghmaee; Saman,140,0,146,6
1708247155499,USP 150,A00,452165,Staff,44,0,50,6
1708247156028,USP 151,A00,452166,Staff,49,0,50,1
1708247156556,USP 152A,A01,459025,Weaver; Todd D,25,0,25,0
1708247156556,USP 152A,A02,459074,Weaver; Todd D,24,0,25,1
1708247157080,USP 152B,A00,452224,Moeder; Nathan L,21,0,25,4
1708247157611,USP 153,A00,452339,Shenkman; Michael Thomas,50,0,50,0
1708247158141,USP 158A,A00,452410,Sun; Feiyang,25,0,25,0
1708247158667,USP 159B,A00,452411,Gherini; Paul Pier-Carlo,6,0,8,2
1708247159193,USP 160,A00,452412,Wartell; Julie Dara,25,0,25,0
1708247159717,USP 164,A00,452413,Moses; Kelema Lee,22,0,25,3
1708247160241,USP 165C,A00,452442,Frank; Lawrence Douglas,20,0,20,0
1708247160768,USP 169,A00,452598,Bajaj; Ravi Siddharth,32,0,35,3
1708247161293,USP 170,A00,477593,Entezam; Maryam,60,0,60,0
1708247161821,USP 172,A00,452676,Peerson; Susan,19,0,25,6
1708247162347,USP 175,A00,452848,Velasco; Diego,18,0,20,2
1708247162873,USP 177A,A00,453084,Velasco; Diego,21,0,25,4
1708247163404,USP 177B,A00,453127,Peerson; Susan,22,0,25,3
1708247163930,USP 183,A00,453128,Sutton; April Marie,19,0,20,1
1708247164456,USP 188B,A00,453187,Pezzoli; Keith,30,0,30,0
1708247164982,USP 190,A00,453234,Pezzoli; Keith,0,0,0,1
1708247165513,USP 191B,A00,453240,Polat; Soydan Alihan,18,0,20,2
1708247166039,USP 193,A00,453251,Bussell; Mirle Rabinowitz,24,0,25,1
1708247166569,USP 194,A00,455342,Hill; Seth J,0,0,0,0
1708247167098,USP 265C,A00,453264,Frank; Lawrence Douglas,10,0,10,0
1708247167625,VIS 3,A01,453427,Staff,25,0,25,0
1708247167625,VIS 3,A02,453428,Staff,15,0,25,10
1708247167625,VIS 3,A03,453429,Staff,25,0,25,0
1708247167625,VIS 3,A04,453430,Staff,21,0,25,4
1708247167625,VIS 3,A05,453431,Staff,25,0,25,0
1708247167625,VIS 3,A06,453432,Staff,23,0,25,2
1708247167625,VIS 3,A07,453433,Staff,17,0,25,8
1708247167625,VIS 3,A08,453434,Staff,23,0,25,2
1708247167625,VIS 3,A09,453435,Staff,21,0,25,4
1708247167625,VIS 3,A10,453436,Staff,23,0,25,2
1708247168155,VIS 9,A00,453437,Camargo; William,116,0,146,30
1708247168681,VIS 10,A00,453438,Kiratli; Solen,189,0,200,11
1708247169211,VIS 21B,A01,453440,Shen; Kuiyi,31,0,32,1
1708247169211,VIS 21B,A02,453441,Shen; Kuiyi,31,0,32,1
1708247169211,VIS 21B,A03,453442,Shen; Kuiyi,31,0,32,1
1708247169211,VIS 21B,A04,453443,Shen; Kuiyi,32,0,32,0
1708247169211,VIS 21B,A05,453444,Shen; Kuiyi,32,0,32,0
1708247169211,VIS 21B,A06,453452,Shen; Kuiyi,32,0,32,0
1708247169211,VIS 21B,A07,453468,Shen; Kuiyi,30,0,32,2
1708247169211,VIS 21B,A08,453587,Shen; Kuiyi,32,0,32,0
1708247169740,VIS 22,A01,453589,Rose; Jordan M,32,0,32,0
1708247169740,VIS 22,A02,453590,Rose; Jordan M,32,0,32,0
1708247169740,VIS 22,A03,453615,Rose; Jordan M,31,0,32,1
1708247169740,VIS 22,A04,453616,Rose; Jordan M,32,0,32,0
1708247169740,VIS 22,A05,453617,Rose; Jordan M,30,0,32,2
1708247169740,VIS 22,A06,453618,Rose; Jordan M,30,0,32,2
1708247169740,VIS 22,A07,453620,Rose; Jordan M,32,0,32,0
1708247169740,VIS 22,A08,453621,Rose; Jordan M,32,0,32,0
1708247169740,VIS 22,A09,453635,Rose; Jordan M,32,0,32,0
1708247169740,VIS 22,A10,453636,Rose; Jordan M,32,0,32,0
1708247170267,VIS 31,A00,453637,Dominguez; Ricardo,133,0,146,13
1708247170797,VIS 41,A01,453644,D'Elena-Tweed; Jessica Erin,23,0,25,2
1708247170797,VIS 41,A02,453645,D'Elena-Tweed; Jessica Erin,22,0,25,3
1708247170797,VIS 41,A03,453646,D'Elena-Tweed; Jessica Erin,25,0,25,0
1708247170797,VIS 41,A04,453647,D'Elena-Tweed; Jessica Erin,18,0,25,7
1708247170797,VIS 41,A05,453648,D'Elena-Tweed; Jessica Erin,25,0,25,0
1708247170797,VIS 41,A06,453650,D'Elena-Tweed; Jessica Erin,24,0,25,1
1708247171325,VIS 70N,A01,453652,Garnett; Mariah J,21,0,22,1
1708247171325,VIS 70N,A02,453653,Garnett; Mariah J,21,0,22,1
1708247171325,VIS 70N,A03,453654,Garnett; Mariah J,22,0,22,0
1708247171325,VIS 70N,A04,453657,Garnett; Mariah J,22,0,22,0
1708247171325,VIS 70N,A05,453662,Garnett; Mariah J,20,0,22,2
1708247171325,VIS 70N,A06,453663,Garnett; Mariah J,22,0,22,0
1708247171859,VIS 83,A00,453664,Kester; Grant,137,0,146,9
1708247172386,VIS 101A,A00,453666,Cruz; Edwin Teddy,10,0,15,5
1708247172914,VIS 102,A00,453668,Cruz; Edwin Teddy,81,0,85,4
1708247173448,VIS 105A,A00,453669,Adler; Amy,29,0,30,1
1708247173977,VIS 105B,A00,453738,Herc-Balaszek; Malgorzata,25,0,30,5
1708247173977,VIS 105B,B00,453739,Staff,27,0,30,3
1708247174507,VIS 106A,A00,453740,Staff,22,0,25,3
1708247175037,VIS 106B,A00,453741,De Luca; Mara Julia,20,0,25,5
1708247175563,VIS 106C,A00,453746,Vangenderen; Monique Luise,11,0,15,4
1708247176089,VIS 107A,A00,453747,Gregoire; Mathieu,19,0,25,6
1708247176615,VIS 107B,A00,453748,Dean; Danielle Adobi,23,0,25,2
1708247177143,VIS 110A,A00,453749,Adler; Amy,13,0,15,2
1708247177669,VIS 110E,A00,453798,Gregoire; Mathieu,14,0,15,1
1708247178197,VIS 110F,A00,453799,Staff,15,0,15,0
1708247178723,VIS 110N,A00,453803,Dean; Danielle Adobi,15,0,15,0
1708247179249,VIS 123B,A00,453804,Gaines; Malik Julian,75,0,75,0
1708247179779,VIS 125BN,A00,453813,Welchman; John C.,75,0,75,0
1708247180305,VIS 126P,A00,453814,Wardwell; Mariana Razo,74,0,75,1
1708247180835,VIS 128E,A00,453815,Staff,75,0,75,0
1708247181363,VIS 129E,A00,453855,Shen; Kuiyi,12,0,15,3
1708247181891,VIS 131,A00,453859,Trigilio; Michael,12,0,15,3
1708247181891,VIS 131,B00,479342,Mangolte; Babette,15,0,15,0
1708247182421,VIS 133A,A00,454231,Barbosa; Erika Katrina,13,0,15,2
1708247182950,VIS 134,A00,454232,Yoldas; Pinar,59,0,75,16
1708247183477,VIS 141B,A00,454233,Stalbaum; Brett,12,0,15,3
1708247184004,VIS 145B,A00,454234,Alexander; Amy J,14,0,15,1
1708247184004,VIS 145B,B00,454235,Kiratli; Solen,8,0,15,7
1708247184534,VIS 147A,A01,454237,Stalbaum; Brett,20,0,22,2
1708247184534,VIS 147A,A02,454238,Stalbaum; Brett,18,0,22,4
1708247185064,VIS 157,A01,454240,Cartwright; Lisa,32,0,34,2
1708247185064,VIS 157,A02,454241,Cartwright; Lisa,32,0,34,2
1708247185592,VIS 159,A01,454243,Akten; Mehmet,34,0,34,0
1708247185592,VIS 159,A02,454244,Akten; Mehmet,32,0,34,2
1708247185592,VIS 159,A03,454300,Akten; Mehmet,30,0,34,4
1708247185592,VIS 159,A04,454301,Akten; Mehmet,33,0,34,1
1708247185592,VIS 159,A05,454302,Akten; Mehmet,30,0,34,4
1708247185592,VIS 159,A06,454307,Akten; Mehmet,33,0,34,1
1708247185592,VIS 159,A07,454308,Akten; Mehmet,34,0,34,0
1708247185592,VIS 159,A08,454309,Akten; Mehmet,33,0,34,1
1708247186119,VIS 160B,A00,454310,Alexander; Amy J,13,0,15,2
1708247186119,VIS 160B,B00,454311,Akten; Mehmet,14,0,15,1
1708247186119,VIS 160B,C00,454312,Stone; Patricia,12,0,15,3
1708247186647,VIS 164,A00,454313,Cross; Brian R,19,0,22,3
1708247186647,VIS 164,B00,454314,Camargo; William,22,0,22,0
1708247187177,VIS 165,A00,454315,Erdmann; Dean,22,0,22,0
1708247187706,VIS 167,A00,454316,Staff,18,0,22,4
1708247188229,VIS 169A,A00,454317,Mostajo; Lorena,21,0,22,1
1708247188757,VIS 171,A00,454318,Nakayama; Yue,21,0,22,1
1708247189287,VIS 174,A00,454319,Staff,19,0,22,3
1708247189812,VIS 177,A00,454320,Cho; Erica,21,0,22,1
1708247190336,VIS 178,A00,454321,Staff,0,0,0,0
1708247190861,VIS 179,A00,454322,Erdmann; Dean,22,0,22,0
1708247191389,VIS 180A,A00,454323,Nakayama; Yue,21,0,22,1
1708247191914,VIS 180B,A00,454341,Cross; Brian R,20,0,22,2
1708247192443,VIS 183A,A00,454342,Cho; Erica,17,0,22,5
1708247192971,VIS 185,A00,454343,Miller; Nicole L,18,0,22,4
1708247193554,VIS 190,A00,454360,Crandall; Jordan,15,0,15,0
1708247193554,VIS 190,B00,454361,D'Elena-Tweed; Jessica Erin,10,0,15,5
1708247194083,VIS 202,A00,454369,Miller; Nicole L,12,0,15,3
1708247194613,VIS 203,A00,454370,Garnett; Mariah J,8,0,15,7
1708247195144,VIS 206,A00,454376,Kester; Grant,10,0,15,5
1708247195671,VIS 208,A00,454377,Moss; Ceci,15,0,15,0
1708247196201,VIS 211,A00,454413,Segade; Alexandro Abraham,0,0,0,2
1708247196729,VIS 243,A00,454429,Rose; Jordan M,5,0,15,10
1708247197254,VIS 255,A00,454430,Welchman; John C.,8,0,15,7
1708247197783,VIS 262,A00,454431,Yoldas; Pinar,11,0,15,4
1708247198311,WCWP 10A,001,454442,Uriarte; Emma,17,0,20,3
1708247198311,WCWP 10A,002,454443,Uriarte; Emma,15,0,20,5
1708247198311,WCWP 10A,003,454479,Uriarte; Emma,19,0,20,1
1708247198311,WCWP 10A,004,454480,Staff,0,0,0,0
1708247198311,WCWP 10A,005,454484,Staff,0,0,0,0
1708247198311,WCWP 10A,006,454485,Staff,0,0,0,0
1708247198311,WCWP 10A,007,454487,Staff,0,0,0,0
1708247198311,WCWP 10A,008,454488,Susi; Natalie,14,0,20,6
1708247198311,WCWP 10A,009,454489,Staff,0,0,0,0
1708247198311,WCWP 10A,010,454490,Staff,0,0,0,0
1708247198843,WCWP 10B,001,454492,Ornelas; Tricia,20,0,20,0
1708247198843,WCWP 10B,002,454501,Ornelas; Tricia,20,0,20,0
1708247198843,WCWP 10B,003,454565,Gagnon; Jeffrey C,2,0,20,18
1708247198843,WCWP 10B,004,454604,Ornelas; Tricia,16,0,20,4
1708247198843,WCWP 10B,005,454668,Staff,16,0,16,0
1708247198843,WCWP 10B,006,454724,Staff,16,0,16,0
1708247198843,WCWP 10B,007,454725,Staff,14,0,16,2
1708247198843,WCWP 10B,008,454768,Staff,0,0,0,0
1708247198843,WCWP 10B,009,454769,Staff,0,0,0,0
1708247198843,WCWP 10B,010,454770,Staff,0,0,0,0
1708247198843,WCWP 10B,011,454771,Dhir; Simrita,16,0,20,4
1708247198843,WCWP 10B,012,454772,Dhir; Simrita,16,0,20,4
1708247198843,WCWP 10B,013,454773,Merryman; Walter,17,0,20,3
1708247198843,WCWP 10B,014,454774,Dhir; Simrita,18,0,20,2
1708247198843,WCWP 10B,015,454775,Merryman; Walter,17,0,20,3
1708247198843,WCWP 10B,016,454776,Merryman; Walter,18,0,20,2
1708247198843,WCWP 10B,017,454777,Welji; Haleema Nazir,14,0,16,2
1708247198843,WCWP 10B,018,478868,Staff,16,0,16,0
1708247198843,WCWP 10B,019,478869,Staff,0,0,0,0
1708247198843,WCWP 10B,020,478876,Staff,0,0,0,0
1708247198843,WCWP 10B,021,478877,Staff,0,0,0,0
1708247198843,WCWP 10B,022,478887,Staff,0,0,0,0
1708247198843,WCWP 10B,023,478889,Staff,16,0,16,0
1708247198843,WCWP 10B,024,478892,Staff,0,0,0,0
1708247198843,WCWP 10B,025,478907,Staff,0,0,0,0
1708247199373,WCWP 100,A00,454800,McCleary; Keith Long,20,0,20,0
1708247199373,WCWP 100,B00,454804,McCleary; Keith Long,20,0,20,0
1708247199373,WCWP 100,C00,454822,Twohig; Niall Ivan,19,0,20,1
1708247199373,WCWP 100,D00,454855,Young; Mark T,20,0,20,0
1708247199373,WCWP 100,E00,454860,Twohig; Niall Ivan,20,0,20,0
1708247199373,WCWP 100,F00,454932,Young; Mark T,20,0,20,0
1708247199373,WCWP 100,G00,454933,Young; Mark T,20,0,20,0
1708247199899,WES 207,A00,454941,Kastner; Ryan Charles,20,0,20,0
1708247200423,WES 265,A00,454942,Staff,19,0,20,1
1708247202241,AAS 10,A01,392963,Butler; Elizabeth Annette,34,0,34,0
1708247202241,AAS 10,A02,392965,Butler; Elizabeth Annette,33,0,34,1
1708247202767,AAS 170,A00,392977,Butler; Elizabeth Annette,31,0,32,1
1708247203294,AAS 198,001,479182,Childs; Dennis R.,20,0,20,0
1708247203820,AESE 261,A00,387945,Staff,33,0,33,0
1708247204348,AESE 278D,A00,387953,Staff,33,0,33,0
1708247204879,AESE 278E,A00,387954,Staff,33,0,33,0
1708247205408,AESE 279A,A00,387956,Staff,33,0,33,0
1708247205933,AIP 197P,001,494494,Goldfarb; Brian,9999,0,9999,0
1708247206460,ANAR 100,A00,387884,Shtienberg; Gilad,15,0,16,1
1708247206986,ANAR 104,A01,387886,Tamberino; Anthony Thomas,21,0,25,4
1708247207515,ANAR 111,A00,387888,Staff,36,0,36,0
1708247208040,ANAR 115,A00,387889,Shtienberg; Gilad,36,0,36,0
1708247208570,ANAR 120,A00,387890,Staff,36,0,36,0
1708247209095,ANAR 155,A00,387891,Braswell; Geoffrey E.,15,0,25,10
1708247209626,ANAR 164,A00,387892,Staff,32,0,35,3
1708247210152,ANBI 100,A00,489626,Fox; Patrick Keolu Ozer,39,0,40,1
1708247210678,ANBI 111,A00,387893,Hrvoj Mihic; Branka,37,0,40,3
1708247211733,ANBI 144,A00,387896,Wilder; Linnea Lorene,72,0,75,3
1708247212262,ANBI 149,A00,489628,Non; Amy L,0,0,0,0
1708247212788,ANBI 173,A00,387897,Wilder; Linnea Lorene,74,0,75,1
1708247213312,ANBI 174,A00,489627,Strum; Shirley C.,13,0,15,2
1708247213839,ANES 296,001,463968,Gabriel; Rodney A,49,0,50,1
1708247213839,ANES 296,002,463969,Staff,50,0,50,0
1708247213839,ANES 296,003,463970,Staff,50,0,50,0
1708247214364,ANSC 100,A00,387898,Bialecki; Jon Anthony,40,0,40,0
1708247214900,ANSC 101,A00,387900,Sloane; Julia Kathryn,34,0,40,6
1708247215431,ANSC 117,A00,387901,Martin Sandino; Amanda Maria Yoland,13,0,15,2
1708247215956,ANSC 134,A00,387902,Staff,38,0,40,2
1708247216483,ANSC 137,A00,387903,Stewart; Alexander B,80,0,80,0
1708247217014,ANSC 138,A00,387904,Parish; Steven Martin,14,0,15,1
1708247217539,ANSC 142,A00,387905,Stone; Annika Britt,34,0,40,6
1708247218067,ANSC 147,A00,387906,Stewart; Alexander B,40,0,40,0
1708247218596,ANSC 148,A00,387907,Olivas Hernandez; Olga Lid,92,0,92,0
1708247219123,ANSC 186,A00,387910,Hankins; Joseph D.,28,0,30,2
1708247219657,ANTH 2,A01,387863,Marchetto; Maria Carolina,37,0,40,3
1708247219657,ANTH 2,A02,387864,Marchetto; Maria Carolina,40,0,40,0
1708247219657,ANTH 2,A03,387865,Marchetto; Maria Carolina,36,0,40,4
1708247219657,ANTH 2,A04,387866,Marchetto; Maria Carolina,39,0,40,1
1708247220188,ANTH 3,A01,387868,Stroth; Luke Reyneri,28,0,30,2
1708247220188,ANTH 3,A02,387869,Stroth; Luke Reyneri,29,0,30,1
1708247220188,ANTH 3,A03,387870,Stroth; Luke Reyneri,30,0,30,0
1708247220188,ANTH 3,A04,387871,Stroth; Luke Reyneri,29,0,30,1
1708247220714,ANTH 10,A00,387872,Stewart; Alexander B,80,0,80,0
1708247221240,ANTH 21,A01,387874,Stone; Annika Britt,40,0,40,0
1708247221240,ANTH 21,A02,387875,Stone; Annika Britt,40,0,40,0
1708247221240,ANTH 21,A03,387876,Stone; Annika Britt,40,0,40,0
1708247221240,ANTH 21,A04,387877,Stone; Annika Britt,39,0,40,1
1708247221765,ANTH 23,A01,387879,Staff,40,0,40,0
1708247221765,ANTH 23,A02,387880,Staff,40,0,40,0
1708247221765,ANTH 23,A03,387881,Staff,40,0,40,0
1708247221765,ANTH 23,A04,387882,Staff,40,0,40,0
1708247222291,ANTH 24,A00,387883,Pedersen; David,40,0,40,0
1708247222819,ANTH 103,A00,387911,Staff,343,0,350,7
1708247223348,ANTH 105,A00,387912,Staff,73,0,75,2
1708247223874,ANTH 112,A00,387913,Staff,23,0,25,2
1708247224400,ANTH 120,A00,479486,Parish; Steven Martin,28,0,30,2
1708247224926,ANTH 128B,A01,387923,Lewis; Leslie R,12,0,12,0
1708247225452,ANTH 192,A00,387925,Varma; Saiba,20,0,20,0
1708247225978,ANTH 196C,A00,387927,Varma; Saiba,15,0,15,0
1708247226505,ANTH 212,A00,387931,Marchetto; Maria Carolina,25,0,25,0
1708247226505,ANTH 212,B00,479487,Semendeferi; Ekaterini,25,0,25,0
1708247227035,ANTH 220,A00,387932,Csordas; Thomas J.,9,0,12,3
1708247227564,ANTH 230,001,493297,Goldstein; Paul S,18,0,20,2
1708247228091,ANTH 260,A00,479223,Jenkins; Janis A.,25,0,25,0
1708247228617,ANTH 272,A00,387936,Serlin; David,5,0,5,0
1708247229146,ANTH 273,A00,387938,Gates; Kelly,5,0,5,0
1708247229675,ANTH 288,A00,387940,Braswell; Geoffrey E.,25,0,25,0
1708247230213,ANTH 295,001,493298,Algaze; Guillermo,3,0,3,0
1708247230213,ANTH 295,002,493299,Brenner; Suzanne A,3,0,3,0
1708247230213,ANTH 295,003,493300,Csordas; Thomas J.,3,0,3,0
1708247230213,ANTH 295,004,493422,Fox; Patrick Keolu Ozer,3,0,3,0
1708247230213,ANTH 295,005,493472,Gagneux; Pascal,3,0,3,0
1708247230213,ANTH 295,006,493515,Goldstein; Paul S,3,0,3,0
1708247230213,ANTH 295,007,493592,Hankins; Joseph D.,3,0,3,0
1708247230213,ANTH 295,008,493631,Jassal; Aftab,3,0,3,0
1708247230213,ANTH 295,009,493639,Jenkins; Janis A.,3,0,3,0
1708247230213,ANTH 295,010,493657,Kaiser; Bronwyn Nicole,3,0,3,0
1708247230213,ANTH 295,011,493692,Kang; Byung Chu,3,0,3,0
1708247230213,ANTH 295,012,493758,Marchetto; Maria Carolina,3,0,3,0
1708247230213,ANTH 295,013,493761,Non; Amy L,3,0,3,0
1708247230213,ANTH 295,014,493762,Pedersen; David,3,0,3,0
1708247230213,ANTH 295,015,493825,Rivera-Collazo; Isabel C,3,0,3,0
1708247230213,ANTH 295,016,493826,Varma; Saiba,3,0,3,0
1708247230213,ANTH 295,017,493828,Yeh; Rihan Wen Xin,3,0,3,0
1708247230748,ANTH 296,001,493830,Braswell; Geoffrey E.,3,0,3,0
1708247230748,ANTH 296,002,493836,Marchetto; Maria Carolina,3,0,3,0
1708247230748,ANTH 296,003,493838,Rivera-Collazo; Isabel C,3,0,3,0
1708247230748,ANTH 296,004,493840,Varma; Saiba,3,0,3,0
1708247230748,ANTH 296,005,493842,Algaze; Guillermo,3,0,3,0
1708247230748,ANTH 296,006,493845,Brenner; Suzanne A,3,0,3,0
1708247230748,ANTH 296,007,493846,Csordas; Thomas J.,3,0,3,0
1708247230748,ANTH 296,008,493907,Fox; Patrick Keolu Ozer,3,0,3,0
1708247230748,ANTH 296,009,493949,Gagneux; Pascal,3,0,3,0
1708247230748,ANTH 296,010,493960,Goldstein; Paul S,3,0,3,0
1708247230748,ANTH 296,011,493961,Hankins; Joseph D.,3,0,3,0
1708247230748,ANTH 296,012,493962,Jassal; Aftab,3,0,3,0
1708247230748,ANTH 296,013,493963,Jenkins; Janis A.,3,0,3,0
1708247230748,ANTH 296,014,493964,Kaiser; Bronwyn Nicole,3,0,3,0
1708247230748,ANTH 296,015,493965,Kang; Byung Chu,3,0,3,0
1708247230748,ANTH 296,016,493966,Levy; Thomas E,3,0,3,0
1708247230748,ANTH 296,017,493967,Non; Amy L,3,0,3,0
1708247230748,ANTH 296,018,493968,Pedersen; David,3,0,3,0
1708247230748,ANTH 296,019,493969,Postero; Nancy Grey,3,0,3,0
1708247230748,ANTH 296,020,493970,Semendeferi; Ekaterini,3,0,3,0
1708247230748,ANTH 296,021,493971,Yeh; Rihan Wen Xin,3,0,3,0
1708247231280,AUD 236,A00,480192,Harris; Jeffrey Paul,12,0,12,0
1708247231809,AUD 260,A00,480227,Spriggs; Meghan K,12,0,12,0
1708247232334,AUD 272,A00,480367,Zettner; Erika,12,0,12,0
1708247232862,AUD 275,A00,480369,Zettner; Erika,12,0,12,0
1708247233401,AUD 284,A00,480370,Zettner; Erika,12,0,12,0
1708247233401,AUD 284,B00,480372,Spriggs; Meghan K,12,0,12,0
1708247233926,AUD 291,A00,480374,Zettner; Erika,12,0,12,0
1708247234452,AUD 296,A00,480375,Zettner; Erika,12,0,12,0
1708247234452,AUD 296,B00,480376,Harris; Jeffrey Paul,12,0,12,0
1708247234452,AUD 296,C00,480377,Ryan; Allen F.,12,0,12,0
1708247234991,AWP 3,002,387672,Given; William Allan,9,0,9,0
1708247234991,AWP 3,003,387678,Staff,5,0,5,0
1708247234991,AWP 3,004,387681,Staff,0,0,0,0
1708247234991,AWP 3,007,387784,West; Geoffrey Scott,4,0,5,1
1708247234991,AWP 3,009,387786,Kolodezh; Samuel,5,0,5,0
1708247234991,AWP 3,010,387787,Gilbert; Peter W,5,0,5,0
1708247235516,AWP 4A,001,387791,Staff,12,0,12,0
1708247235516,AWP 4A,002,387792,Staff,0,0,0,0
1708247236077,AWP 4B,001,387793,Bolin; Jillian,0,0,0,0
1708247236077,AWP 4B,002,387794,Bolin; Jillian,0,0,0,0
1708247236077,AWP 4B,003,387795,Bauer; Holly Jean,0,0,0,0
1708247236077,AWP 4B,004,387796,Vaughn; Kelsey Sara,0,0,0,0
1708247236077,AWP 4B,005,387797,Vaughn; Kelsey Sara,0,0,0,0
1708247236077,AWP 4B,007,387799,Ajo; Frances Margaret,0,0,0,0
1708247236077,AWP 4B,008,387800,Ajo; Frances Margaret,0,0,0,0
1708247236077,AWP 4B,009,387801,Hall; Graham T,0,0,0,0
1708247236077,AWP 4B,010,387802,Hall; Graham T,0,0,0,0
1708247236077,AWP 4B,011,387803,Heiser; Jerrod A,0,0,0,0
1708247236077,AWP 4B,012,387804,Heiser; Jerrod A,0,0,0,0
1708247236077,AWP 4B,013,387805,Jones; William Jadie,0,0,0,0
1708247236077,AWP 4B,014,387806,Jones; William Jadie,0,0,0,0
1708247236077,AWP 4B,015,387807,Christie; Veronica Ann,0,0,0,0
1708247236077,AWP 4B,016,387808,Christie; Veronica Ann,0,0,0,0
1708247236077,AWP 4B,019,387820,Falcon; Jennifer A,0,0,0,0
1708247236077,AWP 4B,020,387821,Falcon; Jennifer A,0,0,0,0
1708247236077,AWP 4B,021,387822,Eastin; Schuyler E.,0,0,0,0
1708247236077,AWP 4B,023,387824,Coulter; Jane Elisabeth,0,0,0,0
1708247236077,AWP 4B,025,387826,O'Neil; Courtney L,0,0,0,0
1708247236077,AWP 4B,026,387827,O'Neil; Courtney L,0,0,0,0
1708247236077,AWP 4B,027,387828,Tsurska Svetina; Olena,0,0,0,0
1708247236077,AWP 4B,028,387829,Tsurska Svetina; Olena,0,0,0,0
1708247236077,AWP 4B,029,387830,Spicer; Jacqueline,0,0,0,0
1708247236077,AWP 4B,030,387831,Spicer; Jacqueline,0,0,0,0
1708247236077,AWP 4B,031,387832,Steinberg; Stacy A,0,0,0,0
1708247236077,AWP 4B,032,387833,Steinberg; Stacy A,0,0,0,0
1708247236077,AWP 4B,033,387834,Chandler; Bailee Daniele,0,0,0,0
1708247236077,AWP 4B,034,387835,Chandler; Bailee Daniele,0,0,0,0
1708247236077,AWP 4B,035,387836,Tiernan; Christa Michelle,0,0,0,0
1708247236077,AWP 4B,036,387837,Tiernan; Christa Michelle,0,0,0,0
1708247236077,AWP 4B,037,387840,Gardella; Alexander Drew,0,0,0,0
1708247236077,AWP 4B,038,387841,Gardella; Alexander Drew,0,0,0,0
1708247236077,AWP 4B,039,387857,Zimmerman; Guy,0,0,0,0
1708247236077,AWP 4B,040,387858,Zimmerman; Guy,0,0,0,0
1708247236077,AWP 4B,041,387859,Zroka; Amy Liane,0,0,0,0
1708247236077,AWP 4B,042,387860,Zroka; Amy Liane,0,0,0,0
1708247236613,BENG 87,A00,489656,Sah; Robert Lie-Yuan,20,0,20,0
1708247236613,BENG 87,B00,489657,Sah; Robert Lie-Yuan,20,0,20,0
1708247236613,BENG 87,C00,494754,Omens; Jeffrey Howard,20,0,20,0
1708247237146,BENG 100,A01,387959,Alexandrov; Ludmil B,26,0,28,2
1708247237146,BENG 100,A02,387960,Alexandrov; Ludmil B,26,0,28,2
1708247237146,BENG 100,A03,387984,Alexandrov; Ludmil B,26,0,28,2
1708247237146,BENG 100,A04,387985,Alexandrov; Ludmil B,25,0,28,3
1708247237146,BENG 100,A05,387986,Alexandrov; Ludmil B,27,0,28,1
1708247237672,BENG 102,A00,387987,Chapelin; Fanny,55,0,56,1
1708247238198,BENG 103B,A00,387993,Fraley; Stephanie I.,116,0,120,4
1708247238725,BENG 112B,A01,388053,Shi; Lingyan,26,0,30,4
1708247238725,BENG 112B,A02,388054,Shi; Lingyan,29,0,30,1
1708247239251,BENG 125,A00,388055,Hasty; Jeff M,120,0,160,40
1708247239781,BENG 133,A01,388866,Mali; Prashant Gulab Ram,36,0,40,4
1708247240312,BENG 140B,A01,388884,Cabrales; Pedro,28,0,30,2
1708247240312,BENG 140B,A02,388885,Cabrales; Pedro,30,0,30,0
1708247240312,BENG 140B,A03,388886,Cabrales; Pedro,26,0,30,4
1708247240841,BENG 160,A50,388889,Aguado; Brian Alberto,23,0,25,2
1708247240841,BENG 160,A51,388919,Aguado; Brian Alberto,25,0,25,0
1708247240841,BENG 160,A52,388920,Aguado; Brian Alberto,25,0,25,0
1708247241370,BENG 168,A01,388961,Khojah; Reem I,30,0,30,0
1708247241902,BENG 172,A50,389087,Omens; Jeffrey Howard & Cabrales; Pedro,15,0,20,5
1708247241902,BENG 172,A51,389088,Omens; Jeffrey Howard & Cabrales; Pedro,14,0,20,6
1708247242428,BENG 182,A01,389128,Bafna; Vineet,28,0,30,2
1708247242961,BENG 186A,A00,389130,Kwon; Ester Jihae,105,0,120,15
1708247243487,BENG 187A,A00,389289,Taylor Amos; Alyssa C,157,0,170,13
1708247244016,BENG 187D,A00,389290,Taylor Amos; Alyssa C,33,0,60,27
1708247244016,BENG 187D,B00,389300,Taylor Amos; Alyssa C,51,0,60,9
1708247244016,BENG 187D,C00,389302,Taylor Amos; Alyssa C,35,0,60,25
1708247244542,BENG 189,A00,389303,Contijoch; Francisco,26,0,30,4
1708247245068,BENG 193,A00,389328,Engler; Adam J.,0,0,0,0
1708247245595,BENG 196,A00,436038,Engler; Adam J.,9999,0,9999,0
1708247246121,BENG 197,A00,436081,Engler; Adam J.,9999,0,9999,0
1708247246648,BENG 203,A00,389385,Bafna; Vineet & Zhong; Sheng,20,0,20,0
1708247247175,BENG 207,A00,389386,Kwon; Ester Jihae,10,0,40,30
1708247247175,BENG 207,B00,389400,Taylor Amos; Alyssa C,8,0,30,22
1708247247175,BENG 207,C00,389432,Khojah; Reem I,20,0,40,20
1708247247757,BENG 209,A00,389456,Scholtes Acevedo; Claire,30,0,30,0
1708247248284,BENG 213,A00,389496,Palsson; Bernhard O.,16,0,20,4
1708247249337,BENG 224,A00,389515,Staff,0,0,0,0
1708247249868,BENG 226,A01,479043,Schmid-Schoenbein; Geert W,7,0,30,23
1708247250392,BENG 227,A00,389591,Fraley; Stephanie I.,56,0,120,64
1708247250922,BENG 230C,A00,389810,Mc Culloch; Andrew Douglas,43,0,90,47
1708247251451,BENG 232,A01,390161,Sah; Robert Lie-Yuan,6,0,50,44
1708247251981,BENG 233,A00,390290,Shah; Sameer B,33,0,50,17
1708247252507,BENG 234,A00,390291,Silva; Gabriel,21,0,56,35
1708247253036,BENG 235,A00,390318,Bintu; Bogdan,16,0,40,24
1708247253567,BENG 276,A00,390357,Mc Culloch; Andrew Douglas & Amaro; Rommie E,0,0,0,0
1708247254094,BENG 280C,A01,390443,McVeigh; Elliot R.,45,0,56,11
1708247254619,BENG 281,A00,390444,Kravets; Vira V.,50,0,110,60
1708247255146,BENG 283,A00,390445,Komives; Elizabeth A,4,0,4,0
1708247255675,BENG 292,A01,390623,Ross; Camille,20,0,20,0
1708247256491,BENG 294C,A00,390709,Engler; Adam J.,17,0,20,3
1708247257017,BENG 295,A00,436300,Watson; John Thomas,9999,0,9999,0
1708247257543,BGGN 205,A00,423656,Daugherty; Matthew Dorton,47,0,60,13
1708247258069,BGGN 207,A01,423703,Ross; Camille,0,0,0,0
1708247258595,BGGN 215,A00,423704,Petrie; Katherine Lynn,22,0,30,8
1708247259121,BGGN 216,A01,423855,Mueller; Liam O'Connor,37,0,50,13
1708247259650,BGGN 218,A00,423861,David; Michael,19,0,30,11
1708247260175,BGGN 223,A00,423862,Bier; Ethan,17,0,35,18
1708247260702,BGGN 230,A00,423863,Taylor; Susan S.,8,0,15,7
1708247261232,BGGN 232,A00,423864,Briggs; Steven & Troemel; Emily Ruth,25,0,30,5
1708247261758,BGGN 239,A01,424014,Kronenberg; Mitchell E.,30,0,30,0
1708247262282,BGGN 240,A01,424016,Juavinett; Ashley Lauren,0,0,6,6
1708247262811,BGGN 248,A00,424017,Halpain; Shelley,26,0,30,4
1708247263337,BGGN 249C,A00,424052,Staff,33,0,33,0
1708247263862,BGGN 250,A01,424091,Zou; Yimin,7,0,8,1
1708247264388,BGGN 252,A01,424093,Sejnowski; Terrence J,4,0,6,2
1708247264917,BGGN 255,A00,424094,Root; Cory Matthew,29,0,30,1
1708247265448,BGGN 262,A01,424096,Villa Rodriguez; Elizabeth,30,0,30,0
1708247265973,BGGN 267,A01,424099,Benna; Marcus K & Aljadeff; Johnatan,5,0,6,1
1708247266501,BGGN 270,A00,477483,Juavinett; Ashley Lauren,67,0,75,8
1708247267091,BGGN 271,001,481745,Ackerman; Susan,9998,0,9999,1
1708247267091,BGGN 271,002,481746,Akbari; Omar Sultan,9999,0,9999,0
1708247267091,BGGN 271,003,481747,Allen; Nicola J,9999,0,9999,0
1708247267091,BGGN 271,004,481748,Banegas; Matthew Patrick,9999,0,9999,0
1708247267091,BGGN 271,005,481749,Breen; Ellen C.,9998,0,9999,1
1708247267091,BGGN 271,006,481750,Briggs; Steven,9998,0,9999,1
1708247267091,BGGN 271,007,481751,Bui; Jack D,9999,0,9999,0
1708247267091,BGGN 271,008,481762,Busch; Wolfgang,9999,0,9999,0
1708247267091,BGGN 271,009,481763,Castle; Michael James,9999,0,9999,0
1708247267091,BGGN 271,010,481764,Chang; John Tzu-yu,9999,0,9999,0
1708247267091,BGGN 271,011,481765,Chen; Ju,9998,0,9999,1
1708247267091,BGGN 271,012,481766,Chen; Xu,9999,0,9999,0
1708247267091,BGGN 271,013,481767,Cheng; Christine Shiang-Ling,9999,0,9999,0
1708247267091,BGGN 271,014,481768,Cherqui; Stephanie,9999,0,9999,0
1708247267091,BGGN 271,015,481769,Cho; Yoshitake,9999,0,9999,0
1708247267091,BGGN 271,016,481770,Church; Kellie Breen,9998,0,9999,1
1708247267091,BGGN 271,017,481771,Cleland; Elsa Eleanor,9999,0,9999,0
1708247267091,BGGN 271,018,481779,Cohen; Shiran,9998,0,9999,1
1708247267091,BGGN 271,019,481814,Cook-Andersen; Heidi Leigh,9999,0,9999,0
1708247267091,BGGN 271,020,481815,Cooke; James Edward,9999,0,9999,0
1708247267091,BGGN 271,021,481816,Coufal; Nicole Gabriele,9998,0,9999,1
1708247267091,BGGN 271,022,481818,Crotty Alexander; Laura E,9999,0,9999,0
1708247267091,BGGN 271,023,481819,Daugherty; Matthew Dorton,9998,0,9999,1
1708247267091,BGGN 271,024,481820,De Guglielmo; Giordano,9998,0,9999,1
1708247267091,BGGN 271,025,481821,Doherty; Taylor Alan,9998,0,9999,1
1708247267091,BGGN 271,026,481822,Dulawa; Stephanie Carole,9999,0,9999,0
1708247267091,BGGN 271,027,481823,Esko; Jeffrey D.,9998,0,9999,1
1708247267091,BGGN 271,028,481824,Feldstein; Ariel E,9998,0,9999,1
1708247267091,BGGN 271,029,481825,Friedman; Rick Adam,9999,0,9999,0
1708247267091,BGGN 271,030,481826,Furnari; Frank,9999,0,9999,0
1708247267091,BGGN 271,031,481829,Ghosh; Pradipta,9998,0,9999,1
1708247267091,BGGN 271,032,481830,Gleeson; Joseph Gerard,9999,0,9999,0
1708247267091,BGGN 271,033,481831,Golden; Susan S.,9998,0,9999,1
1708247267091,BGGN 271,034,481832,Goren; Alon M,9998,0,9999,1
1708247267091,BGGN 271,035,481834,Gustafsson; Asa Birgitta,9999,0,9999,0
1708247267091,BGGN 271,036,481836,Hamdoun; Amr,9999,0,9999,0
1708247267091,BGGN 271,037,481837,Hao; Nan,9999,0,9999,0
1708247267091,BGGN 271,038,481840,Holway; David A.,9998,0,9999,1
1708247267091,BGGN 271,039,481841,Huffaker; Alisa,9998,0,9999,1
1708247267091,BGGN 271,040,481843,Sebat; Lilia Mikhailovna,9998,0,9999,1
1708247267091,BGGN 271,041,481889,Ideker; Trey,9999,0,9999,0
1708247267091,BGGN 271,042,481890,Jiang; Qingfei,9998,0,9999,1
1708247267091,BGGN 271,043,482311,Jin; Yishi,9999,0,9999,0
1708247267091,BGGN 271,044,482334,Joiner; William J.,9999,0,9999,0
1708247267091,BGGN 271,045,482353,Kaech; Susan Michelle,9998,0,9999,1
1708247267091,BGGN 271,046,482378,Karin; Michael,9999,0,9999,0
1708247267091,BGGN 271,047,482379,Kleinfeld; David,9999,0,9999,0
1708247267091,BGGN 271,048,482413,Koffler; Yacov,9999,0,9999,0
1708247267091,BGGN 271,049,482414,Komiyama; Takaki,9999,0,9999,0
1708247267091,BGGN 271,050,482415,Kryazhimskiy; Sergey A,9999,0,9999,0
1708247267091,BGGN 271,051,482416,Lawson; Mark Andrew,9999,0,9999,0
1708247267091,BGGN 271,052,482417,Lee; Yun Sok,9999,0,9999,0
1708247267091,BGGN 271,053,482451,Leutgeb; Stefan,9998,0,9999,1
1708247267091,BGGN 271,054,482452,Lo; Stanley M.,9999,0,9999,0
1708247267091,BGGN 271,055,482453,Lu; Pengzhe,9998,0,9999,1
1708247267091,BGGN 271,056,482454,Lykke-Andersen; Jens,9998,0,9999,1
1708247267091,BGGN 271,057,482456,McDonnell; Lisa Marie,9999,0,9999,0
1708247267091,BGGN 271,058,482461,McHugh; Colleen A,9998,0,9999,1
1708247267091,BGGN 271,059,482478,Meharena; Hiruy Sibhatu,9999,0,9999,0
1708247267091,BGGN 271,060,482497,Morris; Gerald P,9999,0,9999,0
1708247267091,BGGN 271,061,482499,Mukamel; Eran A,9998,0,9999,1
1708247267091,BGGN 271,062,482535,Muotri; Alysson,9999,0,9999,0
1708247267091,BGGN 271,063,482551,Muroyama; Andrew David,9999,0,9999,0
1708247267091,BGGN 271,064,482552,Neal; Sonya E,9999,0,9999,0
1708247267091,BGGN 271,065,482618,Nieh; James Charles,9999,0,9999,0
1708247267091,BGGN 271,066,482619,O'Donoghue; Anthony John,9999,0,9999,0
1708247267091,BGGN 271,067,482626,Pantham; Priyadarshini,9999,0,9999,0
1708247267091,BGGN 271,068,482633,Parast; Mana,9999,0,9999,0
1708247267091,BGGN 271,069,482634,Perry; Michael William,9999,0,9999,0
1708247267091,BGGN 271,070,482639,Pride; David Tevis,9999,0,9999,0
1708247267091,BGGN 271,071,482645,Pruneda-Paz; Jose L.,9999,0,9999,0
1708247267091,BGGN 271,072,482648,Rana; Tariq,9999,0,9999,0
1708247267091,BGGN 271,073,482650,Risbrough; Victoria Blythe,9999,0,9999,0
1708247267091,BGGN 271,074,482655,Rissman; Robert Andrew,9999,0,9999,0
1708247267091,BGGN 271,075,482656,Rosenfeld; Michael G,9999,0,9999,0
1708247267091,BGGN 271,076,482657,Saier; Milton H.,9999,0,9999,0
1708247267091,BGGN 271,077,482663,Sander; Maike,9999,0,9999,0
1708247267091,BGGN 271,078,482664,Schenk; Simon,9999,0,9999,0
1708247267091,BGGN 271,079,482665,Schoeneberg; Johannes,9998,0,9999,1
1708247267091,BGGN 271,080,482666,Schroeder; Julian I,9998,0,9999,1
1708247267091,BGGN 271,081,482667,Shaner; Nathan C.,9999,0,9999,0
1708247267091,BGGN 271,082,482668,Sheikh; Farah,9999,0,9999,0
1708247267091,BGGN 271,083,482669,Shurin; Jonathan,9999,0,9999,0
1708247267091,BGGN 271,084,482675,Sigurdson; Christina,9999,0,9999,0
1708247267091,BGGN 271,085,482676,Smith; David M.,9999,0,9999,0
1708247267091,BGGN 271,086,482677,Steinmetz; Nicole F,9999,0,9999,0
1708247267091,BGGN 271,087,482692,Su; Chih-Ying,9999,0,9999,0
1708247267091,BGGN 271,088,482694,Suel; Gurol Mehmet,9999,0,9999,0
1708247267091,BGGN 271,089,482695,Telese; Francesca,9999,0,9999,0
1708247267091,BGGN 271,090,482745,Thackray; Varykina G.,9999,0,9999,0
1708247267091,BGGN 271,091,482746,Towers; Christina Garlingt,9999,0,9999,0
1708247267091,BGGN 271,092,482747,Troemel; Emily Ruth,9997,0,9999,2
1708247267091,BGGN 271,093,482748,Tye; Kay M,9999,0,9999,0
1708247267091,BGGN 271,094,482749,Valdez-Jasso; Daniela,9998,0,9999,1
1708247267091,BGGN 271,095,482750,Wahlin; Karl Jonas,9997,0,9999,2
1708247267091,BGGN 271,096,482751,Welsbie; Derek,9999,0,9999,0
1708247267091,BGGN 271,097,482752,Wilkinson; Miles Frome,9999,0,9999,0
1708247267091,BGGN 271,098,482754,Yaksh; Tony L.,9999,0,9999,0
1708247267091,BGGN 271,099,482760,Yang; Jing,9999,0,9999,0
1708247267091,BGGN 271,100,482761,Yeo; Eugene Wei-Ming,9998,0,9999,1
1708247267091,BGGN 271,101,482763,Ying; Wei,9999,0,9999,0
1708247267091,BGGN 271,102,482764,Zarrinpar; Amir,9999,0,9999,0
1708247267091,BGGN 271,103,482765,Zengler; Karsten B,9999,0,9999,0
1708247267091,BGGN 271,104,482766,Zhang; Dong-Er,9999,0,9999,0
1708247267091,BGGN 271,105,482768,Zhao; Yunde,9999,0,9999,0
1708247267091,BGGN 271,106,482776,Zheng; Binhai,9999,0,9999,0
1708247267091,BGGN 271,107,482777,Zheng; Ye,9998,0,9999,1
1708247267091,BGGN 271,108,482806,Zuniga; Elina I,9999,0,9999,0
1708247267619,BGGN 273,A01,424101,Mueller; Liam O'Connor,43,0,50,7
1708247268148,BGGN 280,A00,424102,Ernst; Andreas,3,0,5,2
1708247268148,BGGN 280,C00,481361,Amaro; Rommie E,2,0,5,3
1708247268674,BGGN 281,A00,424103,Desai; Arshad & Oegema; Karen,0,0,5,5
1708247269201,BGGN 283,A00,424104,Rivera; Fabian Chavez,0,0,5,5
1708247269201,BGGN 283,B00,424105,Russell; Alistair B,4,0,5,1
1708247269201,BGGN 283,D00,424107,Wildonger; Jill Cathleen,1,0,5,4
1708247269726,BGGN 284,A00,424108,Glasgow; Stacey Marie,2,0,5,3
1708247270252,BGGN 285,A00,424109,Chisholm; Andrew D.,1,0,5,4
1708247270252,BGGN 285,B00,424110,Farley; Emma Kristen,2,0,5,3
1708247270781,BGGN 295,A00,424120,Tour; Ella,10,0,30,20
1708247271310,BGJC 204,A00,424138,Lu; Li-Fan & Chang; John Tzu-yu,9998,0,9999,1
1708247271835,BGJC 215,A00,424139,Cooke; James Edward & Lo; Stanley M.,10,0,10,0
1708247272451,BGRD 200,001,485528,Ackerman; Susan,9998,0,9999,1
1708247272451,BGRD 200,002,485529,Akbari; Omar Sultan,9999,0,9999,0
1708247272451,BGRD 200,003,485530,Allen; Eric,9999,0,9999,0
1708247272451,BGRD 200,004,485531,Allen; Nicola J,9999,0,9999,0
1708247272451,BGRD 200,005,485533,Amaro; Rommie E,9999,0,9999,0
1708247272451,BGRD 200,006,485535,Augustine; Vineet,9999,0,9999,0
1708247272451,BGRD 200,007,485536,Ayres; Janelle Samantha,9999,0,9999,0
1708247272451,BGRD 200,008,485538,Banegas; Matthew Patrick,9999,0,9999,0
1708247272451,BGRD 200,009,485539,Banghart; Matthew Ryan,9999,0,9999,0
1708247272451,BGRD 200,010,485542,Benna; Marcus K,9999,0,9999,0
1708247272451,BGRD 200,011,485543,Bennett; Eric J,9999,0,9999,0
1708247272451,BGRD 200,012,485545,Bloodgood; Brenda Laurie,9999,0,9999,0
1708247272451,BGRD 200,013,485546,Breen; Ellen C.,9998,0,9999,1
1708247272451,BGRD 200,014,485548,Briggs; Steven,9998,0,9999,1
1708247272451,BGRD 200,015,485549,Bui; Jack D,9999,0,9999,0
1708247272451,BGRD 200,016,485552,Busch; Wolfgang,9999,0,9999,0
1708247272451,BGRD 200,017,485621,Callaway; Edward M,9999,0,9999,0
1708247272451,BGRD 200,018,485622,Castle; Michael James,9999,0,9999,0
1708247272451,BGRD 200,019,485623,Chaim; Isaac,9999,0,9999,0
1708247272451,BGRD 200,020,485624,Chang; John Tzu-yu,9999,0,9999,0
1708247272451,BGRD 200,021,485625,Chen; Ju,9999,0,9999,0
1708247272451,BGRD 200,022,485626,Chen; Xu,9999,0,9999,0
1708247272451,BGRD 200,023,485627,Cheng; Christine Shiang-Ling,9999,0,9999,0
1708247272451,BGRD 200,024,485632,Cherqui; Stephanie,9999,0,9999,0
1708247272451,BGRD 200,025,485633,Cho; Yoshitake,9999,0,9999,0
1708247272451,BGRD 200,026,485634,Church; Kellie Breen,9999,0,9999,0
1708247272451,BGRD 200,027,485635,Cleland; Elsa Eleanor,9999,0,9999,0
1708247272451,BGRD 200,028,485636,Cohen; Shiran,9998,0,9999,1
1708247272451,BGRD 200,029,485639,Cook-Andersen; Heidi Leigh,9999,0,9999,0
1708247272451,BGRD 200,030,485686,Cooke; James Edward,9999,0,9999,0
1708247272451,BGRD 200,031,485688,Cooper; Kimberly Lynn,9999,0,9999,0
1708247272451,BGRD 200,032,485689,Coufal; Nicole Gabriele,9998,0,9999,1
1708247272451,BGRD 200,033,485690,Crotty Alexander; Laura E,9999,0,9999,0
1708247272451,BGRD 200,034,485691,Staff,9999,0,9999,0
1708247272451,BGRD 200,035,485692,De Guglielmo; Giordano,9999,0,9999,0
1708247272451,BGRD 200,036,485693,De Silva; Shermin,9999,0,9999,0
1708247272451,BGRD 200,037,485694,Desai; Arshad,9999,0,9999,0
1708247272451,BGRD 200,038,485695,Dickinson; Alexandra Jazz,9999,0,9999,0
1708247272451,BGRD 200,039,485717,Doherty; Taylor Alan,9998,0,9999,1
1708247272451,BGRD 200,040,485720,Dulawa; Stephanie Carole,9999,0,9999,0
1708247272451,BGRD 200,041,485721,Ecker; Joseph R,9999,0,9999,0
1708247272451,BGRD 200,042,485760,Engle; Dannielle D,9999,0,9999,0
1708247272451,BGRD 200,043,485761,Ernst; Andreas,9998,0,9999,1
1708247272451,BGRD 200,044,485766,Esko; Jeffrey D.,9998,0,9999,1
1708247272451,BGRD 200,045,485905,Evans; Ronald M,9999,0,9999,0
1708247272451,BGRD 200,046,485907,Staff,9999,0,9999,0
1708247272451,BGRD 200,047,485918,Feldstein; Ariel E,9998,0,9999,1
1708247272451,BGRD 200,048,485938,Friedman; Rick Adam,9999,0,9999,0
1708247272451,BGRD 200,049,485986,Furnari; Frank,9999,0,9999,0
1708247272451,BGRD 200,050,486018,Gage; Fred H,9999,0,9999,0
1708247272451,BGRD 200,051,486139,George; Monique Leana,9999,0,9999,0
1708247272451,BGRD 200,052,486140,Ghosh; Pradipta,9998,0,9999,1
1708247272451,BGRD 200,053,486141,Glass; Christopher,9998,0,9999,1
1708247272451,BGRD 200,054,486142,Gleeson; Joseph Gerard,9999,0,9999,0
1708247272451,BGRD 200,055,486143,Golden; Susan S.,9999,0,9999,0
1708247272451,BGRD 200,056,486144,Goldrath; Ananda,9999,0,9999,0
1708247272451,BGRD 200,057,486145,Goren; Alon M,9998,0,9999,1
1708247272451,BGRD 200,058,486146,Gustafsson; Asa Birgitta,9999,0,9999,0
1708247272451,BGRD 200,059,486164,Gutkind; Jorge Silvio,9999,0,9999,0
1708247272451,BGRD 200,060,486203,Hamdoun; Amr,9999,0,9999,0
1708247272451,BGRD 200,061,486204,Hampton; Randolph Y.,9999,0,9999,0
1708247272451,BGRD 200,062,486205,Hao; Nan,9999,0,9999,0
1708247272451,BGRD 200,063,486206,Staff,9999,0,9999,0
1708247272451,BGRD 200,064,486207,Hasty; Jeff M,9999,0,9999,0
1708247272451,BGRD 200,065,486208,Hollern; Daniel Patrick,9999,0,9999,0
1708247272451,BGRD 200,066,486209,Holway; David A.,9997,0,9999,2
1708247272451,BGRD 200,067,486214,Huffaker; Alisa,9998,0,9999,1
1708247272451,BGRD 200,068,486215,Hui; Enfu,9999,0,9999,0
1708247272451,BGRD 200,069,486216,Hwa; Terence T.,9999,0,9999,0
1708247272451,BGRD 200,070,486217,Sebat; Lilia Mikhailovna,9998,0,9999,1
1708247272451,BGRD 200,071,486218,Ideker; Trey,9999,0,9999,0
1708247272451,BGRD 200,072,486219,Jackrel; Sara,9998,0,9999,1
1708247272451,BGRD 200,073,486224,Jiang; Qingfei,9998,0,9999,1
1708247272451,BGRD 200,074,486225,Jin; Yishi,9999,0,9999,0
1708247272451,BGRD 200,075,486226,Joiner; William J.,9999,0,9999,0
1708247272451,BGRD 200,076,486227,Jun; Suckjoon,9999,0,9999,0
1708247272451,BGRD 200,077,486228,Kadonaga; James T,9998,0,9999,1
1708247272451,BGRD 200,078,486229,Kaech; Susan Michelle,9997,0,9999,2
1708247272451,BGRD 200,079,486237,Karin; Michael,9999,0,9999,0
1708247272451,BGRD 200,080,486238,Kleinfeld; David,9999,0,9999,0
1708247272451,BGRD 200,081,486239,Knight; Robin,9999,0,9999,0
1708247272451,BGRD 200,082,486335,Koffler; Yacov,9999,0,9999,0
1708247272451,BGRD 200,083,486336,Komiyama; Takaki,9999,0,9999,0
1708247272451,BGRD 200,084,486337,Kosuri; Pallav,9999,0,9999,0
1708247272451,BGRD 200,085,486353,Kryazhimskiy; Sergey A,9999,0,9999,0
1708247272451,BGRD 200,086,486354,Kurle; Carolyn M.,9999,0,9999,0
1708247272451,BGRD 200,087,486355,Law; Julie A,9999,0,9999,0
1708247272451,BGRD 200,088,486356,Lawson; Mark Andrew,9999,0,9999,0
1708247272451,BGRD 200,089,486357,Lee; Kuo Fen,9999,0,9999,0
1708247272451,BGRD 200,090,486376,Lee; Yun Sok,9999,0,9999,0
1708247272451,BGRD 200,091,486413,Leutgeb; Jill K.,9999,0,9999,0
1708247272451,BGRD 200,092,486414,Leutgeb; Stefan,9998,0,9999,1
1708247272451,BGRD 200,093,486415,Lim; Byungkook,9999,0,9999,0
1708247272451,BGRD 200,094,486419,Lo; Stanley M.,9999,0,9999,0
1708247272451,BGRD 200,095,486420,Looger; Loren Lee,9999,0,9999,0
1708247272451,BGRD 200,096,486422,Lovett-Barron; Matthew Rod,9999,0,9999,0
1708247272451,BGRD 200,097,486423,Lu; Li-Fan,9998,0,9999,1
1708247272451,BGRD 200,098,486424,Lu; Pengzhe,9998,0,9999,1
1708247272451,BGRD 200,099,486425,Lykke-Andersen; Jens,9998,0,9999,1
1708247272451,BGRD 200,100,486426,Lyumkis; Dmitry Evgenievich,9999,0,9999,0
1708247272451,BGRD 200,101,486427,Madigan; Cressida Ariana,9999,0,9999,0
1708247272451,BGRD 200,102,486428,Staff,9999,0,9999,0
1708247272451,BGRD 200,103,486429,Mayfield; Stephen P.,9998,0,9999,1
1708247272451,BGRD 200,104,486430,McDonnell; Lisa Marie,9999,0,9999,0
1708247272451,BGRD 200,105,486620,McHugh; Colleen A,9998,0,9999,1
1708247272451,BGRD 200,106,486621,Meharena; Hiruy Sibhatu,9999,0,9999,0
1708247272451,BGRD 200,107,486622,Staff,9999,0,9999,0
1708247272451,BGRD 200,108,486681,Morris; Gerald P,9999,0,9999,0
1708247272451,BGRD 200,109,486682,Mukamel; Eran A,9998,0,9999,1
1708247272451,BGRD 200,110,486683,Muotri; Alysson,9999,0,9999,0
1708247272451,BGRD 200,111,486684,Muroyama; Andrew David,9999,0,9999,0
1708247272451,BGRD 200,112,486687,Murre; Cornelis,9999,0,9999,0
1708247272451,BGRD 200,113,486691,Neal; Sonya E,9999,0,9999,0
1708247272451,BGRD 200,114,486692,Nieh; James Charles,9998,0,9999,1
1708247272451,BGRD 200,115,486693,Nimmerjahn; Axel,9999,0,9999,0
1708247272451,BGRD 200,116,486694,Nizet; Victor F.,9999,0,9999,0
1708247272451,BGRD 200,117,486695,O'Donoghue; Anthony John,9999,0,9999,0
1708247272451,BGRD 200,118,486706,Oegema; Karen,9999,0,9999,0
1708247272451,BGRD 200,119,486708,O'Shea; Clodagh,9999,0,9999,0
1708247272451,BGRD 200,120,486709,Pantham; Priyadarshini,9999,0,9999,0
1708247272451,BGRD 200,121,486715,Parast; Mana,9999,0,9999,0
1708247272451,BGRD 200,122,486716,Pasquinelli; Amy,9998,0,9999,1
1708247272451,BGRD 200,123,486718,Pekkurnaz Banghart; Gulcin,9999,0,9999,0
1708247272451,BGRD 200,124,486720,Perry; Michael William,9999,0,9999,0
1708247272451,BGRD 200,125,486721,Pfaff; Samuel,9999,0,9999,0
1708247272451,BGRD 200,126,486723,Pogliano; Joseph,9999,0,9999,0
1708247272451,BGRD 200,127,486724,Pogliano; Kit J.,9999,0,9999,0
1708247272451,BGRD 200,128,486727,Pride; David Tevis,9999,0,9999,0
1708247272451,BGRD 200,129,486728,Pruneda-Paz; Jose L.,9999,0,9999,0
1708247272451,BGRD 200,130,486733,Staff,9999,0,9999,0
1708247272451,BGRD 200,131,486734,Rana; Tariq,9999,0,9999,0
1708247272451,BGRD 200,132,486736,Reck-Peterson; Samara L,9999,0,9999,0
1708247272451,BGRD 200,133,486738,Rennison; Diana,9999,0,9999,0
1708247272451,BGRD 200,134,486741,Rifkin; Scott,9999,0,9999,0
1708247272451,BGRD 200,135,486743,Risbrough; Victoria Blythe,9999,0,9999,0
1708247272451,BGRD 200,136,486749,Rissman; Robert Andrew,9999,0,9999,0
1708247272451,BGRD 200,137,486750,Rivera; Fabian Chavez,9999,0,9999,0
1708247272451,BGRD 200,138,486753,Root; Cory Matthew,9999,0,9999,0
1708247272451,BGRD 200,139,486760,Rosenfeld; Michael G,9998,0,9999,1
1708247272451,BGRD 200,140,486763,Russell; Alistair B,9999,0,9999,0
1708247272451,BGRD 200,141,486766,Saier; Milton H.,9999,0,9999,0
1708247272451,BGRD 200,142,486768,Sander; Maike,9999,0,9999,0
1708247272451,BGRD 200,143,486770,Saphire; Erica Ollmann,9999,0,9999,0
1708247272451,BGRD 200,144,486771,Schenk; Simon,9999,0,9999,0
1708247272451,BGRD 200,145,486774,Schoeneberg; Johannes,9999,0,9999,0
1708247272451,BGRD 200,146,486777,Schroeder; Julian I,9998,0,9999,1
1708247272451,BGRD 200,147,486783,Shah; Sameer B,9999,0,9999,0
1708247272451,BGRD 200,148,486784,Shaner; Nathan C.,9999,0,9999,0
1708247272451,BGRD 200,149,486785,Shaw; Reuben,9999,0,9999,0
1708247272451,BGRD 200,150,486786,Sheikh; Farah,9999,0,9999,0
1708247272451,BGRD 200,151,486787,Staff,9999,0,9999,0
1708247272451,BGRD 200,152,486788,Signer; Robert,9999,0,9999,0
1708247272451,BGRD 200,153,486789,Sigurdson; Christina,9999,0,9999,0
1708247272451,BGRD 200,154,486790,Smith; David M.,9999,0,9999,0
1708247272451,BGRD 200,155,486791,Soncin; Francesca,9999,0,9999,0
1708247272451,BGRD 200,156,486792,Steinmetz; Nicole F,9999,0,9999,0
1708247272451,BGRD 200,157,486793,Su; Chih-Ying,9999,0,9999,0
1708247272451,BGRD 200,158,486794,Suel; Gurol Mehmet,9999,0,9999,0
1708247272451,BGRD 200,159,486795,Sun; Xin,9999,0,9999,0
1708247272451,BGRD 200,160,486796,Telese; Francesca,9999,0,9999,0
1708247272451,BGRD 200,161,486797,Thackray; Varykina G.,9999,0,9999,0
1708247272451,BGRD 200,162,486798,Towers; Christina Garlingt,9999,0,9999,0
1708247272451,BGRD 200,163,486799,Traver; David,9999,0,9999,0
1708247272451,BGRD 200,164,486800,Troemel; Emily Ruth,9998,0,9999,1
1708247272451,BGRD 200,165,486801,Tye; Kay M,9999,0,9999,0
1708247272451,BGRD 200,166,486802,Valdez-Jasso; Daniela,9998,0,9999,1
1708247272451,BGRD 200,167,486803,Vijayanand; Pandurangan,9999,0,9999,0
1708247272451,BGRD 200,168,486804,Villa Rodriguez; Elizabeth,9999,0,9999,0
1708247272451,BGRD 200,169,486805,Wahlin; Karl Jonas,9997,0,9999,2
1708247272451,BGRD 200,170,486806,Wang; Jean Yin Jen,9999,0,9999,0
1708247272451,BGRD 200,171,486807,Welsbie; Derek,9999,0,9999,0
1708247272451,BGRD 200,172,486808,Wildonger; Jill Cathleen,9998,0,9999,1
1708247272451,BGRD 200,173,486809,Wilkinson; Miles Frome,9999,0,9999,0
1708247272451,BGRD 200,174,486810,Winzeler; Elizabeth A,9999,0,9999,0
1708247272451,BGRD 200,175,486811,Yaksh; Tony L.,9999,0,9999,0
1708247272451,BGRD 200,176,486812,Yang; Jing,9999,0,9999,0
1708247272451,BGRD 200,177,486813,Staff,9999,0,9999,0
1708247272451,BGRD 200,178,486814,Yeo; Eugene Wei-Ming,9998,0,9999,1
1708247272451,BGRD 200,179,486815,Ying; Wei,9999,0,9999,0
1708247272451,BGRD 200,180,486816,Zarrinpar; Amir,9999,0,9999,0
1708247272451,BGRD 200,181,486817,Zengler; Karsten B,9999,0,9999,0
1708247272451,BGRD 200,182,486818,Zhang; Dong-Er,9999,0,9999,0
1708247272451,BGRD 200,183,486819,Zhao; Yunde,9999,0,9999,0
1708247272451,BGRD 200,184,486820,Zheng; Binhai,9999,0,9999,0
1708247272451,BGRD 200,185,486821,Zheng; Ye,9998,0,9999,1
1708247272451,BGRD 200,186,486822,Zuniga; Elina I,9999,0,9999,0
1708247272980,BGSE 200,A00,424140,Tour; Ella & Petrie; Katherine Lynn,9995,0,9999,4
1708247273509,BGSE 205,A00,424177,Bennett; Eric J,49,0,50,1
1708247273509,BGSE 205,B00,424179,Bennett; Eric J,48,0,50,2
1708247273509,BGSE 205,C00,424182,Bennett; Eric J,47,0,50,3
1708247273509,BGSE 205,D00,424184,Bennett; Eric J,46,0,50,4
1708247273509,BGSE 205,E00,424185,Bennett; Eric J,50,0,50,0
1708247274041,BIBC 100,A01,425401,Corbett; Kevin Daniel,150,0,158,8
1708247274041,BIBC 100,B01,477769,Amaro; Rommie E,156,0,158,2
1708247274569,BIBC 102,A01,425425,Bozinovic; Goran,255,0,256,1
1708247274569,BIBC 102,B01,425440,Hampton; Randolph Y.,250,0,256,6
1708247274569,BIBC 102,C01,486849,Flagg; Matthew Paul,63,0,120,57
1708247275097,BIBC 103,A01,425476,Grossman; Emily N,17,0,24,7
1708247275097,BIBC 103,A02,425509,Grossman; Emily N,21,0,24,3
1708247275097,BIBC 103,A03,425530,Grossman; Emily N,18,0,24,6
1708247275097,BIBC 103,A04,425536,Grossman; Emily N,22,0,24,2
1708247275097,BIBC 103,B01,425538,Boumechache; Miyyada,20,0,24,4
1708247275097,BIBC 103,B02,425539,Boumechache; Miyyada,24,0,24,0
1708247275097,BIBC 103,B03,425548,Boumechache; Miyyada,24,0,24,0
1708247275097,BIBC 103,B04,425549,Boumechache; Miyyada,24,0,24,0
1708247275623,BIBC 120,A01,425592,Coleman; Aaron B.,242,0,256,14
1708247276149,BIBC 194,A00,425609,Ernst; Andreas,21,0,27,6
1708247276149,BIBC 194,B00,477632,Saier; Milton H.,26,0,27,1
1708247276149,BIBC 194,C00,481360,Amaro; Rommie E,23,0,27,4
1708247276149,BIBC 194,D00,486852,Flagg; Matthew Paul,21,0,32,11
1708247276678,BICD 100,A01,470377,Troemel; Emily Ruth,127,0,128,1
1708247276678,BICD 100,A02,470378,Troemel; Emily Ruth,126,0,128,2
1708247276678,BICD 100,B01,470409,Reinagel; Pam,59,0,64,5
1708247276678,BICD 100,B02,470413,Reinagel; Pam,62,0,64,2
1708247276678,BICD 100,B03,470464,Reinagel; Pam,64,0,64,0
1708247276678,BICD 100,B04,470468,Reinagel; Pam,63,0,64,1
1708247276678,BICD 100,C01,470469,Beyhan; Sinem,51,0,64,13
1708247276678,BICD 100,C02,470605,Beyhan; Sinem,58,0,64,6
1708247276678,BICD 100,C03,470606,Beyhan; Sinem,60,0,64,4
1708247276678,BICD 100,C04,470607,Beyhan; Sinem,63,0,64,1
1708247276678,BICD 100,D01,477465,Nguyen; Vu Quang,158,0,160,2
1708247277203,BICD 100R,A01,425674,Smith; Laurie,29,0,34,5
1708247277203,BICD 100R,A02,425675,Smith; Laurie,30,0,34,4
1708247277203,BICD 100R,A03,425676,Smith; Laurie,30,0,34,4
1708247277732,BICD 104,A01,425696,Greenspan; Ralph J.,60,0,64,4
1708247278258,BICD 110,A01,470608,Muroyama; Andrew David,264,0,275,11
1708247278258,BICD 110,B01,425721,Ernst; Andreas,246,0,275,29
1708247278788,BICD 112,A01,458177,Cooper; Kimberly Lynn & Traver; David,10,0,32,22
1708247278788,BICD 112,A02,458180,Cooper; Kimberly Lynn & Traver; David,28,0,32,4
1708247279313,BICD 123,A01,425725,Zhao; Yunde,24,0,32,8
1708247279841,BICD 140,A01,425728,Lu; Li-Fan,228,0,240,12
1708247280382,BICD 158,A01,425730,Bier; Ethan,136,0,145,9
1708247280924,BICD 194,A00,425731,Desai; Arshad & Oegema; Karen,18,0,27,9
1708247280924,BICD 194,B00,481735,Wilhelm; James E.,29,0,32,3
1708247281450,BIEB 121,A00,425732,Butler; Shannon Rhey,21,0,32,11
1708247281450,BIEB 121,B00,425733,Butler; Shannon Rhey,24,0,32,8
1708247281976,BIEB 130,A01,425735,Kurle; Carolyn M.,243,0,295,52
1708247282501,BIEB 146,A01,425737,Petrie; Katherine Lynn,367,0,395,28
1708247283029,BIEB 148,A01,470637,Rose; Noah Hartmann,59,0,63,4
1708247283029,BIEB 148,A02,470638,Rose; Noah Hartmann,61,0,63,2
1708247283554,BIEB 154,A01,458184,Stockwell; Sarah R,29,0,30,1
1708247283554,BIEB 154,A02,458186,Stockwell; Sarah R,29,0,30,1
1708247284080,BIEB 176,A01,425741,De Silva; Shermin,56,0,64,8
1708247284604,BIEB 182,A01,458194,Roy; Kaustuv,25,0,32,7
1708247284604,BIEB 182,A02,458215,Roy; Kaustuv,31,0,32,1
1708247285137,BILD 1,A01,424267,Patrick; Gentry,249,0,250,1
1708247285137,BILD 1,B01,424272,Burg; Michael,231,0,250,19
1708247285137,BILD 1,C01,424293,Pickett; Brooke Elizabeth,245,0,250,5
1708247285137,BILD 1,D01,458292,Gonzalez Gamboa; Ivonne,48,0,50,2
1708247285137,BILD 1,D02,458295,Gonzalez Gamboa; Ivonne,50,0,50,0
1708247285137,BILD 1,D03,458296,Gonzalez Gamboa; Ivonne,50,0,50,0
1708247285137,BILD 1,D04,458297,Gonzalez Gamboa; Ivonne,49,0,50,1
1708247285137,BILD 1,D05,458303,Gonzalez Gamboa; Ivonne,50,0,50,0
1708247285687,BILD 2,A01,458304,Reyes Gonzalez; Catalina,53,0,56,3
1708247285687,BILD 2,A02,458307,Reyes Gonzalez; Catalina,55,0,56,1
1708247285687,BILD 2,A03,458313,Reyes Gonzalez; Catalina,55,0,56,1
1708247285687,BILD 2,A04,458320,Reyes Gonzalez; Catalina,56,0,56,0
1708247285687,BILD 2,B01,458324,Reyes Gonzalez; Catalina,47,0,56,9
1708247285687,BILD 2,B02,458327,Reyes Gonzalez; Catalina,54,0,56,2
1708247285687,BILD 2,B03,458339,Reyes Gonzalez; Catalina,56,0,56,0
1708247285687,BILD 2,B04,458340,Reyes Gonzalez; Catalina,56,0,56,0
1708247285687,BILD 2,C01,458387,Park; Ji Young,44,0,49,5
1708247285687,BILD 2,C02,458544,Park; Ji Young,46,0,49,3
1708247285687,BILD 2,C03,458557,Park; Ji Young,47,0,49,2
1708247285687,BILD 2,C04,458563,Park; Ji Young,46,0,49,3
1708247286234,BILD 3,A01,424312,Hammond; LaTisha Marie,331,0,350,19
1708247286234,BILD 3,B01,470107,Stockwell; Sarah R,66,0,70,4
1708247286234,BILD 3,B02,470110,Stockwell; Sarah R,70,0,70,0
1708247286234,BILD 3,B03,470116,Stockwell; Sarah R,70,0,70,0
1708247286234,BILD 3,B04,470123,Stockwell; Sarah R,67,0,70,3
1708247286234,BILD 3,B05,470150,Stockwell; Sarah R,70,0,70,0
1708247286234,BILD 3,C01,470159,Cooper; Kimberly Lynn,67,0,70,3
1708247286234,BILD 3,C02,470160,Cooper; Kimberly Lynn,69,0,70,1
1708247286234,BILD 3,C03,470164,Cooper; Kimberly Lynn,70,0,70,0
1708247286234,BILD 3,C04,470165,Cooper; Kimberly Lynn,69,0,70,1
1708247286234,BILD 3,C05,470374,Cooper; Kimberly Lynn,68,0,70,2
1708247286776,BILD 4,A01,424318,Staff,22,0,24,2
1708247286776,BILD 4,A02,424324,Staff,24,0,24,0
1708247286776,BILD 4,A03,424325,Staff,24,0,24,0
1708247286776,BILD 4,A04,424326,Staff,22,0,24,2
1708247286776,BILD 4,A05,424327,Staff,24,0,24,0
1708247286776,BILD 4,A06,424330,Staff,24,0,24,0
1708247286776,BILD 4,A07,424331,Staff,24,0,24,0
1708247286776,BILD 4,A08,424342,Staff,24,0,24,0
1708247286776,BILD 4,B01,424462,Pickett; Brooke Elizabeth,23,0,24,1
1708247286776,BILD 4,B02,424466,Pickett; Brooke Elizabeth,24,0,24,0
1708247286776,BILD 4,B03,424469,Pickett; Brooke Elizabeth,23,0,24,1
1708247286776,BILD 4,B04,424470,Pickett; Brooke Elizabeth,22,0,24,2
1708247286776,BILD 4,B05,424700,Pickett; Brooke Elizabeth,23,0,24,1
1708247286776,BILD 4,B06,424723,Pickett; Brooke Elizabeth,24,0,24,0
1708247286776,BILD 4,B07,424730,Pickett; Brooke Elizabeth,24,0,24,0
1708247286776,BILD 4,B08,424929,Pickett; Brooke Elizabeth,22,0,24,2
1708247286776,BILD 4,C01,424947,Gonzalez Gamboa; Ivonne,22,0,24,2
1708247286776,BILD 4,C02,424951,Gonzalez Gamboa; Ivonne,23,0,24,1
1708247286776,BILD 4,C03,424991,Gonzalez Gamboa; Ivonne,23,0,24,1
1708247286776,BILD 4,C04,424993,Gonzalez Gamboa; Ivonne,24,0,24,0
1708247286776,BILD 4,C05,424994,Gonzalez Gamboa; Ivonne,24,0,24,0
1708247286776,BILD 4,C06,425209,Gonzalez Gamboa; Ivonne,24,0,24,0
1708247286776,BILD 4,C07,425233,Gonzalez Gamboa; Ivonne,24,0,24,0
1708247286776,BILD 4,C08,425247,Gonzalez Gamboa; Ivonne,24,0,24,0
1708247287300,BILD 60,A01,425326,Hammond; LaTisha Marie,62,0,64,2
1708247287825,BILD 83,A00,425347,Pogliano; Joseph,25,0,30,5
1708247288351,BILD 87,A00,425368,Saier; Milton H.,20,0,20,0
1708247288877,BIMM 100,A01,425744,Cooper; Andrew Michael,303,0,320,17
1708247288877,BIMM 100,B01,425746,Cooper; Andrew Michael,315,0,320,5
1708247289408,BIMM 101,A01,425748,McDonnell; Lisa Marie,8,0,24,16
1708247289408,BIMM 101,A02,425749,McDonnell; Lisa Marie,23,0,24,1
1708247289408,BIMM 101,B01,425751,Day; Christopher D,22,0,24,2
1708247289408,BIMM 101,B02,425752,Day; Christopher D,24,0,24,0
1708247289408,BIMM 101,B03,425753,Day; Christopher D,22,0,24,2
1708247289408,BIMM 101,B04,425754,Day; Christopher D,24,0,24,0
1708247289408,BIMM 101,C01,425756,Rusert; Jessica Marie,17,0,24,7
1708247289408,BIMM 101,C02,425757,Rusert; Jessica Marie,23,0,24,1
1708247289408,BIMM 101,C03,425758,Rusert; Jessica Marie,23,0,24,1
1708247289408,BIMM 101,C04,425759,Rusert; Jessica Marie,23,0,24,1
1708247289953,BIMM 110,A01,425764,Niwa; Maho,55,0,56,1
1708247289953,BIMM 110,A02,425765,Niwa; Maho,56,0,56,0
1708247289953,BIMM 110,A03,425766,Niwa; Maho,56,0,56,0
1708247289953,BIMM 110,A04,425767,Niwa; Maho,55,0,56,1
1708247290484,BIMM 116R,A01,425771,Golden; Susan S. & Gorman; Michael R.,55,0,72,17
1708247290484,BIMM 116R,A02,425772,Golden; Susan S. & Gorman; Michael R.,54,0,72,18
1708247290484,BIMM 116R,A03,425773,Golden; Susan S. & Gorman; Michael R.,66,0,72,6
1708247290484,BIMM 116R,A04,425774,Golden; Susan S. & Gorman; Michael R.,70,0,72,2
1708247291010,BIMM 118,A01,425779,David; Michael,83,0,96,13
1708247291558,BIMM 120,A01,425792,Pirino; Giorgia,203,0,216,13
1708247291558,BIMM 120,B01,470639,Saier; Milton H.,201,0,216,15
1708247292115,BIMM 121,A01,425830,Gustafson-Brown; Cindy,18,0,24,6
1708247292115,BIMM 121,A02,425831,Gustafson-Brown; Cindy,21,0,24,3
1708247292115,BIMM 121,A03,425832,Gustafson-Brown; Cindy,24,0,24,0
1708247292115,BIMM 121,A04,425833,Gustafson-Brown; Cindy,23,0,24,1
1708247292115,BIMM 121,B01,425835,Pirino; Giorgia,18,0,24,6
1708247292115,BIMM 121,B02,425836,Pirino; Giorgia,24,0,24,0
1708247292115,BIMM 121,C01,425838,Park; Ji Young,6,0,24,18
1708247292115,BIMM 121,C02,425839,Park; Ji Young,20,0,24,4
1708247292644,BIMM 134,A01,425841,Burg; Michael,393,0,416,23
1708247293173,BIMM 143,A01,425843,Grant; Barry J,17,0,40,23
1708247293173,BIMM 143,B01,425845,Bozinovic; Goran,33,0,40,7
1708247293700,BIMM 182,A01,455012,Bafna; Vineet,28,0,50,22
1708247294225,BIMM 194,A00,425847,Rivera; Fabian Chavez,24,0,27,3
1708247294225,BIMM 194,B00,425868,Russell; Alistair B,16,0,27,11
1708247294225,BIMM 194,D00,425870,Wildonger; Jill Cathleen,14,0,27,13
1708247294758,BIOM 202,A00,390710,Corbett; Kevin Daniel,93,0,100,7
1708247295283,BIOM 219,A00,390713,Ross; Camille,0,0,0,7
1708247295809,BIOM 231,A00,455099,Furnari; Frank,0,0,0,0
1708247295809,BIOM 231,B00,455100,Lopez Ramirez; Miguel Alej,0,0,0,0
1708247296338,BIOM 242,A00,390714,Hamilton; Bruce Alan,20,0,20,0
1708247296871,BIOM 246,A00,492784,Gordts; Philip & Varki; Ajit P & Lewis; Amanda Lark & Godula; Kamil & Gagneux; Pascal & Esko; Jeffrey D. & Bode; Lars,0,0,0,0
1708247297398,BIOM 252,A00,390715,Ayyagari; Radha,27,0,28,1
1708247297925,BIOM 254,A00,390718,Corbett; Kevin Daniel,14,0,20,6
1708247298451,BIOM 272,A00,390722,Hangauer; Matthew John,16,0,20,4
1708247298979,BIOM 274,A00,390725,Sun; Bryan Kee-Hong,7,0,15,8
1708247299506,BIOM 283,A00,390728,Komives; Elizabeth A,2,0,2,0
1708247300032,BIOM 285,A00,390730,Gaulton; Kyle J,10,0,20,10
1708247300558,BIOM 295,A00,455083,Brown; Joan Heller,0,0,0,0
1708247301106,BIPN 100,A01,425872,Augustine; Vineet,240,0,245,5
1708247301106,BIPN 100,B01,425874,George; Monique Leana,240,0,245,5
1708247301106,BIPN 100,C01,458640,Maita; Isabella Vincenza,44,0,49,5
1708247301106,BIPN 100,C02,458646,Maita; Isabella Vincenza,48,0,49,1
1708247301106,BIPN 100,C03,458714,Maita; Isabella Vincenza,48,0,49,1
1708247301106,BIPN 100,C04,458716,Maita; Isabella Vincenza,48,0,49,1
1708247301106,BIPN 100,C05,458717,Maita; Isabella Vincenza,46,0,49,3
1708247301687,BIPN 105,A01,425877,Armour; Jon Christopher,13,0,21,8
1708247301687,BIPN 105,A02,425878,Armour; Jon Christopher,21,0,21,0
1708247301687,BIPN 105,A03,425879,Armour; Jon Christopher,9,0,21,12
1708247301687,BIPN 105,A04,425880,Armour; Jon Christopher,20,0,21,1
1708247302213,BIPN 120,A01,425882,Cooke; James Edward,371,0,395,24
1708247302756,BIPN 140,A01,425884,Hibbs; Ryan E.,183,0,192,9
1708247303286,BIPN 144,A01,425886,Zou; Yimin,153,0,158,5
1708247304837,BIPN 145,A01,425888,Maita; Isabella Vincenza,41,0,42,1
1708247304837,BIPN 145,B01,425918,Marino; Marc J,37,0,42,5
1708247304837,BIPN 145,B02,425954,Marino; Marc J,40,0,42,2
1708247305420,BIPN 147,A01,426086,Sejnowski; Terrence J,53,0,64,11
1708247305947,BIPN 152,A01,426112,Halpain; Shelley,97,0,128,31
1708247306473,BIPN 162,A01,426120,Juavinett; Ashley Lauren,17,0,30,13
1708247307001,BIPN 164,A01,455010,Benna; Marcus K & Aljadeff; Johnatan,120,0,120,0
1708247307536,BIPN 194,A00,426122,Glasgow; Stacey Marie,20,0,27,7
1708247308066,BISP 170,A00,426158,French; Kathleen Ann,26,0,30,4
1708247308595,BISP 182,A00,426168,Pogliano; Joseph,9999,0,9999,0
1708247309120,BISP 194,A00,426240,Chisholm; Andrew D.,11,0,27,16
1708247309120,BISP 194,B00,426241,Farley; Emma Kristen,25,0,27,2
1708247309647,BNFO 281,A00,427175,Gaasterland; Theresa,85,0,100,15
1708247310181,BNFO 283,A00,427211,Carter; Hannah Kathryn & Chavez; Alejandro,39,0,50,11
1708247310181,BNFO 283,B00,480483,Amariuta-Bartell; Tiffany & Dorrestein; Pieter,21,0,30,9
1708247310707,BNFO 294,B01,427269,Ross; Camille,47,0,50,3
1708247311262,CAT 3,A01,396994,Glaser; Amelia,15,0,15,0
1708247311262,CAT 3,A02,396995,Glaser; Amelia,15,0,15,0
1708247311262,CAT 3,A03,396996,Glaser; Amelia,7,0,15,8
1708247311262,CAT 3,A04,396997,Glaser; Amelia,12,0,15,3
1708247311262,CAT 3,A05,397004,Glaser; Amelia,15,0,15,0
1708247311262,CAT 3,A06,397039,Glaser; Amelia,11,0,15,4
1708247311262,CAT 3,A07,397040,Glaser; Amelia,13,0,15,2
1708247311262,CAT 3,A08,397084,Glaser; Amelia,15,0,15,0
1708247311262,CAT 3,A09,397269,Glaser; Amelia,13,0,15,2
1708247311262,CAT 3,A10,397270,Glaser; Amelia,0,0,15,15
1708247311262,CAT 3,A11,397271,Glaser; Amelia,9,0,15,6
1708247311262,CAT 3,A12,397272,Glaser; Amelia,12,0,15,3
1708247311262,CAT 3,A13,397273,Glaser; Amelia,15,0,15,0
1708247311262,CAT 3,A14,397274,Glaser; Amelia,14,0,15,1
1708247311262,CAT 3,B01,397276,Porter; Lisa,15,0,15,0
1708247311262,CAT 3,B02,397277,Porter; Lisa,15,0,15,0
1708247311262,CAT 3,B03,397278,Porter; Lisa,14,0,15,1
1708247311262,CAT 3,B04,397279,Porter; Lisa,15,0,15,0
1708247311262,CAT 3,B06,397281,Porter; Lisa,15,0,15,0
1708247311262,CAT 3,B07,397291,Porter; Lisa,15,0,15,0
1708247311262,CAT 3,B09,397293,Porter; Lisa,15,0,15,0
1708247311262,CAT 3,B10,397294,Porter; Lisa,15,0,15,0
1708247311262,CAT 3,B11,397295,Porter; Lisa,12,0,15,3
1708247311262,CAT 3,B12,397296,Porter; Lisa,14,0,15,1
1708247311262,CAT 3,B13,397297,Porter; Lisa,11,0,15,4
1708247311262,CAT 3,B14,397298,Porter; Lisa,15,0,15,0
1708247311262,CAT 3,B15,397299,Porter; Lisa,15,0,15,0
1708247311262,CAT 3,B16,397300,Porter; Lisa,15,0,15,0
1708247311262,CAT 3,C01,397302,Marchisotto; Jennifer Anne,13,0,15,2
1708247311262,CAT 3,C02,397308,Marchisotto; Jennifer Anne,9,0,15,6
1708247311262,CAT 3,C03,397309,Marchisotto; Jennifer Anne,9,0,15,6
1708247311262,CAT 3,C04,397315,Marchisotto; Jennifer Anne,11,0,15,4
1708247311262,CAT 3,C05,397316,Marchisotto; Jennifer Anne,14,0,15,1
1708247311262,CAT 3,C06,397322,Marchisotto; Jennifer Anne,15,0,15,0
1708247311262,CAT 3,C07,397323,Marchisotto; Jennifer Anne,15,0,15,0
1708247311262,CAT 3,C08,397329,Marchisotto; Jennifer Anne,15,0,15,0
1708247311262,CAT 3,C09,397333,Marchisotto; Jennifer Anne,15,0,15,0
1708247311262,CAT 3,C10,397336,Marchisotto; Jennifer Anne,15,0,15,0
1708247311262,CAT 3,C11,397354,Marchisotto; Jennifer Anne,13,0,15,2
1708247311262,CAT 3,C12,397357,Marchisotto; Jennifer Anne,15,0,15,0
1708247311262,CAT 3,C13,397364,Marchisotto; Jennifer Anne,14,0,15,1
1708247311262,CAT 3,C14,397367,Marchisotto; Jennifer Anne,14,0,15,1
1708247311262,CAT 3,C15,397369,Marchisotto; Jennifer Anne,15,0,15,0
1708247311262,CAT 3,C16,397373,Marchisotto; Jennifer Anne,15,0,15,0
1708247311262,CAT 3,C17,397374,Marchisotto; Jennifer Anne,15,0,15,0
1708247311262,CAT 3,C18,397380,Marchisotto; Jennifer Anne,14,0,15,1
1708247311262,CAT 3,D02,397405,Rahimi; Babak,13,0,15,2
1708247311262,CAT 3,D03,397408,Rahimi; Babak,14,0,15,1
1708247311262,CAT 3,D04,397415,Rahimi; Babak,15,0,15,0
1708247311262,CAT 3,D05,397416,Rahimi; Babak,15,0,15,0
1708247311262,CAT 3,D06,397422,Rahimi; Babak,15,0,15,0
1708247311262,CAT 3,D07,397426,Rahimi; Babak,14,0,15,1
1708247311262,CAT 3,D09,397447,Rahimi; Babak,11,0,15,4
1708247311262,CAT 3,D10,397450,Rahimi; Babak,13,0,15,2
1708247311262,CAT 3,D11,397625,Rahimi; Babak,13,0,15,2
1708247311262,CAT 3,D12,397630,Rahimi; Babak,15,0,15,0
1708247311262,CAT 3,D13,397631,Rahimi; Babak,14,0,15,1
1708247311262,CAT 3,D14,397635,Rahimi; Babak,14,0,15,1
1708247311787,CAT 3CE,A01,397642,Bronstein; Phoebe Malan,25,0,25,0
1708247312316,CAT 87,A00,397645,Bronstein; Phoebe Malan,19,0,20,1
1708247312844,CAT 90,A00,480731,Bronstein; Phoebe Malan,20,0,20,0
1708247313376,CAT 124,A01,397662,Knight; Amy,5,0,5,0
1708247313376,CAT 124,A02,397722,Knight; Amy,5,0,5,0
1708247313376,CAT 124,A03,397726,Knight; Amy,5,0,5,0
1708247313376,CAT 124,A04,397829,Knight; Amy,4,0,5,1
1708247313908,CAT 125,001,397832,Popko; Elizabeth Ashley,20,0,20,0
1708247313908,CAT 125,002,397833,Delaville; Romain,20,0,20,0
1708247313908,CAT 125,003,397834,Marchisotto; Jennifer Anne,18,0,20,2
1708247313908,CAT 125,004,397835,Bigham; David Joseph,20,0,20,0
1708247313908,CAT 125,005,397836,Bigham; David Joseph,19,0,20,1
1708247313908,CAT 125,006,397837,Bigham; David Joseph,16,0,20,4
1708247313908,CAT 125,007,397838,Vanderschuit; Maya Alysia,20,0,20,0
1708247313908,CAT 125,008,397839,Vanderschuit; Maya Alysia,20,0,20,0
1708247313908,CAT 125,009,397840,Vanderschuit; Maya Alysia,20,0,20,0
1708247313908,CAT 125,010,397841,Morales; Celeste Georgianna,15,0,16,1
1708247313908,CAT 125,011,397842,Morales; Celeste Georgianna,16,0,16,0
1708247313908,CAT 125,012,397881,Morales; Celeste Georgianna,19,0,20,1
1708247313908,CAT 125,013,397954,Rose; Becca Rae,18,0,20,2
1708247313908,CAT 125,014,397956,Rose; Becca Rae,20,0,20,0
1708247313908,CAT 125,015,397998,Rose; Becca Rae,19,0,20,1
1708247313908,CAT 125,016,397999,Tosun; Adriana,20,0,20,0
1708247313908,CAT 125,017,398001,Tosun; Adriana,20,0,20,0
1708247313908,CAT 125,018,398009,Irwin; Matthew Joseph,19,0,20,1
1708247313908,CAT 125,019,398010,Irwin; Matthew Joseph,18,0,20,2
1708247313908,CAT 125,020,398014,Irwin; Matthew Joseph,20,0,20,0
1708247314434,CAT 125R,A00,398015,Smith; Lauryn Alissa,19,0,20,1
1708247314434,CAT 125R,B00,398016,Smith; Lauryn Alissa,17,0,20,3
1708247314434,CAT 125R,C00,398017,Smith; Lauryn Alissa,19,0,20,1
1708247314434,CAT 125R,D00,398019,Tosun; Adriana,19,0,20,1
1708247314434,CAT 125R,E00,398020,Hyland; Tina Mae,12,0,20,8
1708247314434,CAT 125R,F00,398027,Hyland; Tina Mae,18,0,20,2
1708247314434,CAT 125R,G00,398028,Hyland; Tina Mae,18,0,20,2
1708247314989,CCE 1,A01,396087,Kenley Grounds; Nicole,40,0,40,0
1708247314989,CCE 1,B01,396142,Quijada; David,39,0,40,1
1708247314989,CCE 1,C01,396159,Bigley; Michele Heather,39,0,40,1
1708247314989,CCE 1,D01,396164,Bigley; Michele Heather,40,0,40,0
1708247314989,CCE 1,E01,396166,Lee; Kassandra,40,0,40,0
1708247314989,CCE 1,F01,396168,Lee; Kassandra,40,0,40,0
1708247314989,CCE 1,G01,396170,Staff,40,0,40,0
1708247314989,CCE 1,H01,396172,Staff,40,0,40,0
1708247315515,CENG 101B,A00,392993,Chen; Shaochen,44,0,45,1
1708247316061,CENG 101C,A00,392997,Li; Yanran,148,0,150,2
1708247316589,CENG 113,A00,393000,Chen; Zheng,69,0,70,1
1708247316589,CENG 113,B00,393001,Li; Wan-Lu,69,0,70,1
1708247317118,CENG 124B,A00,393036,Powell; Alyssa & Russ; Benjamin Edward,113,0,120,7
1708247317650,CENG 157,A00,393220,Opatkiewicz; Justin Paul,50,0,57,7
1708247318182,CENG 160,A00,393231,Powell; Alyssa,70,0,80,10
1708247318710,CENG 170,A01,393238,Drews; Aaron,27,0,30,3
1708247319235,CENG 175,A00,393239,Steinmetz; Nicole F,34,0,35,1
1708247319762,CENG 176B,A01,393285,Opatkiewicz; Justin Paul,46,0,52,6
1708247319762,CENG 176B,B01,393629,Zhang; Liangfang,40,0,49,9
1708247320287,CENG 205,A00,393681,Jahed Motlagh; Zeinab,53,0,60,7
1708247320817,CENG 257,A00,393682,Opatkiewicz; Justin Paul,10,0,13,3
1708247321344,CGS 87,A00,489609,Wesling; Megan E.,20,0,20,0
1708247321875,CGS 100B,A00,396181,Whitley; Leila Marie,28,0,30,2
1708247322404,CGS 109,A00,396194,Whitley; Leila Marie,19,0,20,1
1708247322930,CGS 112,A00,396220,Martin Sandino; Amanda Maria Yoland,22,0,25,3
1708247323457,CGS 114,A00,396223,Steelman; Katherine Wallis,14,0,16,2
1708247324001,CGS 116,A00,396295,Staff,19,0,20,1
1708247324528,CGS 117,A00,396306,Martin Sandino; Amanda Maria Yoland,14,0,15,1
1708247325055,CGS 118,A00,396314,Hankins; Joseph D.,28,0,29,1
1708247325583,CGS 128,A00,396366,Whitley; Leila Marie,14,0,15,1
1708247326125,CGS 137,A00,396865,Martin Sandino; Amanda Maria Yoland,16,0,19,3
1708247326653,CGS 150,A00,396901,Taylor-Garcia; Daphne,18,0,18,0
1708247327179,CGS 196B,A00,396904,Lo; Stanley M.,7,0,7,0
1708247327179,CGS 196B,B00,396973,Brenner; Suzanne A,7,0,7,0
1708247327179,CGS 196B,C00,396985,Jones; Makeba,7,0,7,0
1708247327710,CGS 198,001,396987,Anderson; Patrick W.,0,0,0,0
1708247327710,CGS 198,002,396988,Anderson; Patrick W.,0,0,0,0
1708247327710,CGS 198,003,396989,Anderson; Patrick W.,0,0,0,0
1708247327710,CGS 198,004,396990,Anderson; Patrick W.,0,0,0,0
1708247328237,CGS 200,A00,396991,Perez; Roy,0,0,0,3
1708247328802,CHEM 6A,A01,459563,Deshmukh; Lalit,40,0,40,0
1708247328802,CHEM 6A,A02,459564,Deshmukh; Lalit,35,0,40,5
1708247328802,CHEM 6A,A03,459565,Deshmukh; Lalit,31,0,40,9
1708247328802,CHEM 6A,A04,459566,Deshmukh; Lalit,30,0,38,8
1708247328802,CHEM 6A,A05,459567,Deshmukh; Lalit,40,0,40,0
1708247328802,CHEM 6A,A06,459568,Deshmukh; Lalit,37,0,40,3
1708247328802,CHEM 6A,A07,459569,Deshmukh; Lalit,37,0,40,3
1708247328802,CHEM 6A,A08,459570,Deshmukh; Lalit,0,0,0,0
1708247329408,CHEM 6B,A01,467314,Ortony; Julia Helen,39,0,40,1
1708247329408,CHEM 6B,A02,467322,Ortony; Julia Helen,32,0,40,8
1708247329408,CHEM 6B,A03,467323,Ortony; Julia Helen,40,0,40,0
1708247329408,CHEM 6B,A04,467325,Ortony; Julia Helen,32,0,40,8
1708247329408,CHEM 6B,A05,467326,Ortony; Julia Helen,39,0,40,1
1708247329408,CHEM 6B,A06,467346,Ortony; Julia Helen,40,0,40,0
1708247329408,CHEM 6B,B01,467360,Hopkins; Patrycja Anna,35,0,40,5
1708247329408,CHEM 6B,B02,467363,Hopkins; Patrycja Anna,37,0,40,3
1708247329408,CHEM 6B,B03,467364,Hopkins; Patrycja Anna,35,0,40,5
1708247329408,CHEM 6B,B04,467380,Hopkins; Patrycja Anna,40,0,40,0
1708247329408,CHEM 6B,B05,467381,Hopkins; Patrycja Anna,40,0,40,0
1708247329408,CHEM 6B,B06,467382,Hopkins; Patrycja Anna,39,0,40,1
1708247330026,CHEM 6C,A01,468994,Ternansky; Robert J.,39,0,40,1
1708247330026,CHEM 6C,A02,469054,Ternansky; Robert J.,38,0,40,2
1708247330026,CHEM 6C,A03,469065,Ternansky; Robert J.,39,0,40,1
1708247330026,CHEM 6C,A04,469069,Ternansky; Robert J.,40,0,40,0
1708247330026,CHEM 6C,A05,469080,Ternansky; Robert J.,40,0,40,0
1708247330026,CHEM 6C,B01,469318,Ternansky; Robert J.,39,0,40,1
1708247330026,CHEM 6C,B02,469319,Ternansky; Robert J.,40,0,40,0
1708247330026,CHEM 6C,B03,469320,Ternansky; Robert J.,39,0,40,1
1708247330026,CHEM 6C,B04,469321,Ternansky; Robert J.,40,0,40,0
1708247330026,CHEM 6C,B05,469322,Ternansky; Robert J.,40,0,40,0
1708247330026,CHEM 6C,C01,469323,Schurmeier; Kimberly,38,0,40,2
1708247330026,CHEM 6C,C02,469324,Schurmeier; Kimberly,36,0,40,4
1708247330026,CHEM 6C,C03,469325,Schurmeier; Kimberly,38,0,40,2
1708247330026,CHEM 6C,C04,469326,Schurmeier; Kimberly,36,0,40,4
1708247330026,CHEM 6C,C05,469327,Schurmeier; Kimberly,40,0,40,0
1708247330026,CHEM 6C,D01,460183,Schurmeier; Kimberly,39,0,40,1
1708247330026,CHEM 6C,D02,460184,Schurmeier; Kimberly,32,0,40,8
1708247330026,CHEM 6C,D03,460185,Schurmeier; Kimberly,26,0,40,14
1708247330026,CHEM 6C,D04,460186,Schurmeier; Kimberly,38,0,40,2
1708247330026,CHEM 6C,D05,460187,Schurmeier; Kimberly,40,0,40,0
1708247330026,CHEM 6C,E01,460188,Stallings; Dontarie M,24,0,40,16
1708247330026,CHEM 6C,E02,460190,Stallings; Dontarie M,25,0,40,15
1708247330026,CHEM 6C,E03,460191,Stallings; Dontarie M,3,0,20,17
1708247330026,CHEM 6C,E04,460192,Stallings; Dontarie M,36,0,40,4
1708247330026,CHEM 6C,E05,460193,Stallings; Dontarie M,37,0,40,3
1708247330553,CHEM 6CH,A01,459630,Tezcan; Faik,40,0,40,0
1708247331123,CHEM 7L,A01,393998,Jazzar; Rodolphe,0,0,0,3
1708247331123,CHEM 7L,A02,393999,Jazzar; Rodolphe,10,0,24,14
1708247331123,CHEM 7L,A03,394000,Jazzar; Rodolphe,21,0,24,3
1708247331123,CHEM 7L,A04,394001,Jazzar; Rodolphe,22,0,24,2
1708247331123,CHEM 7L,A05,394002,Jazzar; Rodolphe,18,0,24,6
1708247331123,CHEM 7L,A06,394003,Jazzar; Rodolphe,22,0,24,2
1708247331123,CHEM 7L,A07,394004,Jazzar; Rodolphe,18,0,21,3
1708247331123,CHEM 7L,A08,394005,Jazzar; Rodolphe,0,0,0,0
1708247331123,CHEM 7L,A09,394006,Jazzar; Rodolphe,20,0,24,4
1708247331123,CHEM 7L,A10,394007,Jazzar; Rodolphe,24,0,24,0
1708247331123,CHEM 7L,B01,394009,Jazzar; Rodolphe,0,0,0,1
1708247331123,CHEM 7L,B02,394010,Jazzar; Rodolphe,1,0,6,5
1708247331123,CHEM 7L,B03,394011,Jazzar; Rodolphe,15,0,24,9
1708247331123,CHEM 7L,B04,394012,Jazzar; Rodolphe,18,0,21,3
1708247331123,CHEM 7L,B05,394013,Jazzar; Rodolphe,0,0,0,0
1708247331123,CHEM 7L,B06,394014,Jazzar; Rodolphe,15,0,24,9
1708247331123,CHEM 7L,B07,394015,Jazzar; Rodolphe,18,0,24,6
1708247331123,CHEM 7L,B08,394016,Jazzar; Rodolphe,23,0,24,1
1708247331123,CHEM 7L,B09,394017,Jazzar; Rodolphe,24,0,24,0
1708247331123,CHEM 7L,B10,394018,Jazzar; Rodolphe,24,0,24,0
1708247331123,CHEM 7L,C01,394020,Staff,0,0,0,0
1708247331123,CHEM 7L,C02,394021,Staff,21,0,24,3
1708247331123,CHEM 7L,C03,394022,Staff,23,0,24,1
1708247331123,CHEM 7L,C04,394023,Staff,24,0,24,0
1708247331123,CHEM 7L,C05,394024,Staff,0,0,0,0
1708247331123,CHEM 7L,C06,394025,Staff,20,0,24,4
1708247331123,CHEM 7L,C07,394026,Staff,22,0,24,2
1708247331123,CHEM 7L,C08,394027,Staff,23,0,24,1
1708247331123,CHEM 7L,C09,394028,Staff,24,0,24,0
1708247331123,CHEM 7L,C10,394029,Staff,23,0,24,1
1708247331670,CHEM 11,A01,459661,Staff,42,0,44,2
1708247331670,CHEM 11,A02,459664,Staff,44,0,44,0
1708247331670,CHEM 11,A03,459702,Staff,42,0,44,2
1708247331670,CHEM 11,A04,459707,Staff,44,0,44,0
1708247331670,CHEM 11,A05,459708,Staff,43,0,44,1
1708247331670,CHEM 11,A06,459711,Staff,41,0,44,3
1708247332218,CHEM 40A,A01,459576,Albizati; Kim F.,36,0,40,4
1708247332218,CHEM 40A,A02,459577,Albizati; Kim F.,33,0,40,7
1708247332218,CHEM 40A,A03,459578,Albizati; Kim F.,37,0,40,3
1708247332218,CHEM 40A,A04,459579,Albizati; Kim F.,38,0,40,2
1708247332218,CHEM 40A,A05,459580,Albizati; Kim F.,40,0,40,0
1708247332218,CHEM 40A,A06,459581,Albizati; Kim F.,37,0,40,3
1708247332218,CHEM 40A,A07,459582,Albizati; Kim F.,38,0,40,2
1708247332218,CHEM 40A,A08,459588,Albizati; Kim F.,39,0,40,1
1708247333776,CHEM 40B,A01,467442,Weizman; Haim,29,0,40,11
1708247333776,CHEM 40B,A02,467443,Weizman; Haim,33,0,40,7
1708247333776,CHEM 40B,A03,467444,Weizman; Haim,39,0,40,1
1708247333776,CHEM 40B,A04,467445,Weizman; Haim,38,0,40,2
1708247333776,CHEM 40B,A05,467446,Weizman; Haim,39,0,40,1
1708247333776,CHEM 40B,A06,467447,Weizman; Haim,37,0,40,3
1708247333776,CHEM 40B,A07,467448,Weizman; Haim,31,0,40,9
1708247333776,CHEM 40B,A08,467449,Weizman; Haim,40,0,40,0
1708247333776,CHEM 40B,B01,467383,Molinski; Tadeusz,40,0,40,0
1708247333776,CHEM 40B,B02,467384,Molinski; Tadeusz,40,0,40,0
1708247333776,CHEM 40B,B03,467385,Molinski; Tadeusz,40,0,40,0
1708247333776,CHEM 40B,B04,467399,Molinski; Tadeusz,40,0,40,0
1708247333776,CHEM 40B,B05,467400,Molinski; Tadeusz,40,0,40,0
1708247333776,CHEM 40B,B06,467401,Molinski; Tadeusz,40,0,40,0
1708247333776,CHEM 40B,B07,467402,Molinski; Tadeusz,40,0,40,0
1708247333776,CHEM 40B,B08,467404,Molinski; Tadeusz,39,0,40,1
1708247334338,CHEM 41B,A01,459571,Klosterman; Jeremy K,40,0,40,0
1708247334338,CHEM 41B,A02,459572,Klosterman; Jeremy K,36,0,37,1
1708247334338,CHEM 41B,A03,459573,Klosterman; Jeremy K,40,0,40,0
1708247334879,CHEM 41C,A01,459589,Tor; Yitzhak,40,0,40,0
1708247334879,CHEM 41C,A02,459624,Tor; Yitzhak,38,0,40,2
1708247334879,CHEM 41C,A03,459625,Tor; Yitzhak,40,0,40,0
1708247334879,CHEM 41C,A04,459626,Tor; Yitzhak,40,0,40,0
1708247334879,CHEM 41C,A05,459627,Tor; Yitzhak,29,0,29,0
1708247334879,CHEM 41C,A06,459628,Tor; Yitzhak,38,0,40,2
1708247334879,CHEM 41C,A07,459629,Tor; Yitzhak,40,0,40,0
1708247335456,CHEM 43A,A01,394068,Lam; Tin Yiu,12,0,24,12
1708247335456,CHEM 43A,A02,394088,Lam; Tin Yiu,23,0,24,1
1708247335456,CHEM 43A,A03,394092,Lam; Tin Yiu,23,0,24,1
1708247335456,CHEM 43A,A04,394093,Lam; Tin Yiu,21,0,24,3
1708247335456,CHEM 43A,A05,394094,Lam; Tin Yiu,23,0,24,1
1708247335456,CHEM 43A,A06,394096,Lam; Tin Yiu,15,0,24,9
1708247335456,CHEM 43A,A07,394115,Lam; Tin Yiu,20,0,24,4
1708247335456,CHEM 43A,A08,394116,Lam; Tin Yiu,22,0,24,2
1708247335456,CHEM 43A,A09,394117,Lam; Tin Yiu,22,0,24,2
1708247335456,CHEM 43A,A10,394118,Lam; Tin Yiu,20,0,24,4
1708247335456,CHEM 43A,A11,394119,Lam; Tin Yiu,8,0,13,5
1708247335456,CHEM 43A,A12,394120,Lam; Tin Yiu,24,0,24,0
1708247335456,CHEM 43A,A13,394132,Lam; Tin Yiu,24,0,24,0
1708247335456,CHEM 43A,B01,394134,Lam; Tin Yiu,24,0,24,0
1708247335456,CHEM 43A,B02,394135,Lam; Tin Yiu,16,0,24,8
1708247335456,CHEM 43A,B03,394136,Lam; Tin Yiu,14,0,24,10
1708247335456,CHEM 43A,B04,394137,Lam; Tin Yiu,17,0,24,7
1708247335456,CHEM 43A,B05,394138,Lam; Tin Yiu,20,0,24,4
1708247335456,CHEM 43A,B06,394139,Lam; Tin Yiu,19,0,24,5
1708247335456,CHEM 43A,B07,394140,Lam; Tin Yiu,20,0,24,4
1708247335456,CHEM 43A,B08,394141,Lam; Tin Yiu,24,0,24,0
1708247335456,CHEM 43A,B09,394142,Lam; Tin Yiu,20,0,24,4
1708247335456,CHEM 43A,B10,394143,Lam; Tin Yiu,24,0,24,0
1708247335456,CHEM 43A,B11,394145,Lam; Tin Yiu,22,0,24,2
1708247335456,CHEM 43A,B12,394146,Lam; Tin Yiu,23,0,24,1
1708247335987,CHEM 96,A00,394159,Bussey; Thomas J,24,0,25,1
1708247336529,CHEM 100A,A01,394161,Li; Shaowei,16,0,22,6
1708247336529,CHEM 100A,A02,394162,Li; Shaowei,20,0,24,4
1708247336529,CHEM 100A,A03,394163,Li; Shaowei,22,0,24,2
1708247336529,CHEM 100A,A04,394164,Li; Shaowei,24,0,24,0
1708247336529,CHEM 100A,A05,394165,Li; Shaowei,24,0,24,0
1708247336529,CHEM 100A,A06,394166,Li; Shaowei,20,0,22,2
1708247337056,CHEM 100B,A01,394175,Pomeroy; Robert S.,19,0,25,6
1708247337587,CHEM 105A,A01,394177,Young; Mark,31,0,39,8
1708247337587,CHEM 105A,B01,394179,Young; Mark,0,0,0,0
1708247338119,CHEM 108,A01,394181,Staff,14,0,20,6
1708247338119,CHEM 108,A02,394182,Staff,23,0,24,1
1708247338119,CHEM 108,B01,394184,Staff,4,0,20,16
1708247338119,CHEM 108,B02,394185,Staff,23,0,24,1
1708247338647,CHEM 109,A01,394187,Piercy; Marc Anthony,17,0,20,3
1708247338647,CHEM 109,A02,394188,Piercy; Marc Anthony,22,0,24,2
1708247338647,CHEM 109,B01,394193,Piercy; Marc Anthony,12,0,20,8
1708247338647,CHEM 109,B02,394194,Piercy; Marc Anthony,23,0,24,1
1708247339192,CHEM 111,A00,394195,Thiemens; Mark H,97,0,100,3
1708247339718,CHEM 114B,A01,459574,Piercy; Marc Anthony,40,0,45,5
1708247339718,CHEM 114B,A02,459575,Piercy; Marc Anthony,40,0,45,5
1708247340248,CHEM 114C,A01,467286,Komives; Elizabeth A,32,0,44,12
1708247340248,CHEM 114C,A02,467287,Komives; Elizabeth A,43,0,44,1
1708247340248,CHEM 114C,A03,467290,Komives; Elizabeth A,42,0,44,2
1708247340248,CHEM 114C,A04,467295,Komives; Elizabeth A,43,0,44,1
1708247340774,CHEM 114D,A00,394198,Ghosh; Gourisankar,29,0,30,1
1708247341301,CHEM 118,A01,459788,Donoghue; Daniel J.,37,0,40,3
1708247341301,CHEM 118,A02,459800,Donoghue; Daniel J.,37,0,40,3
1708247341301,CHEM 118,A03,459807,Donoghue; Daniel J.,36,0,40,4
1708247341301,CHEM 118,A04,459809,Donoghue; Daniel J.,38,0,40,2
1708247341301,CHEM 118,A05,459811,Donoghue; Daniel J.,37,0,40,3
1708247341301,CHEM 118,A06,459826,Donoghue; Daniel J.,39,0,40,1
1708247341831,CHEM 119,A01,467427,Joseph; Simpson,35,0,40,5
1708247341831,CHEM 119,A02,467441,Joseph; Simpson,0,0,0,0
1708247342357,CHEM 120B,A01,467450,Griffith; Kent,37,0,40,3
1708247342357,CHEM 120B,A02,467451,Griffith; Kent,34,0,40,6
1708247342357,CHEM 120B,A03,467452,Griffith; Kent,35,0,40,5
1708247342885,CHEM 123,A00,394211,Schimpf; Alina M,0,0,0,1
1708247343651,CHEM 125,A00,394217,Tezcan; Faik,18,0,20,2
1708247344177,CHEM 126A,A01,459715,Yong; Haiwang,39,0,40,1
1708247344177,CHEM 126A,A02,459725,Yong; Haiwang,36,0,40,4
1708247344707,CHEM 126B,A01,467405,Tauber; Michael,36,0,40,4
1708247344707,CHEM 126B,A02,467406,Tauber; Michael,39,0,40,1
1708247344707,CHEM 126B,A03,467426,Tauber; Michael,39,0,40,1
1708247345233,CHEM 132,A01,460181,Galperin; Michael,42,0,45,3
1708247345233,CHEM 132,A02,460182,Galperin; Michael,37,0,45,8
1708247345763,CHEM 135,A01,394222,Tauber; Michael,15,0,15,0
1708247346287,CHEM 143B,A01,394229,Klosterman; Jeremy K,16,0,24,8
1708247346287,CHEM 143B,A02,394230,Klosterman; Jeremy K,21,0,24,3
1708247346817,CHEM 156,A00,394231,Romero; Erik Anthony,30,0,30,0
1708247347345,CHEM 157,A00,394232,Tor; Yitzhak,74,0,80,6
1708247347872,CHEM 165,A01,460194,Herzik; Mark Anthony,21,0,25,4
1708247348398,CHEM 167,A01,467296,Deshmukh; Lalit,39,0,40,1
1708247348398,CHEM 167,A02,467297,Deshmukh; Lalit,33,0,40,7
1708247348398,CHEM 167,A03,467298,Deshmukh; Lalit,37,0,40,3
1708247348398,CHEM 167,A04,467312,Deshmukh; Lalit,37,0,40,3
1708247348927,CHEM 173,A00,394284,Young; Mark,48,0,50,2
1708247349452,CHEM 174,A01,455015,Pomeroy; Robert S.,45,0,50,5
1708247349999,CHEM 186,A00,477716,Paesani; Francesco & Gilson; Michael K.,6,0,12,6
1708247350524,CHEM 188,A00,394294,Bussey; Thomas J,19,0,20,1
1708247351054,CHEM 214,A00,394336,Ghosh; Gourisankar,12,0,20,8
1708247351584,CHEM 217,A00,394341,Joseph; Simpson,25,0,30,5
1708247352113,CHEM 221,A00,394425,Taylor; Susan S.,10,0,20,10
1708247352642,CHEM 225,A00,394429,Tezcan; Faik,4,0,10,6
1708247353167,CHEM 227,A00,394430,Schimpf; Alina M,26,0,30,4
1708247353693,CHEM 229,A00,394431,Stauber; Julia Megan,13,0,20,7
1708247354224,CHEM 235,A01,394433,Tauber; Michael,20,0,20,0
1708247354754,CHEM 236,A00,394434,Kummel; Andrew C,14,0,15,1
1708247355279,CHEM 241,A00,394435,Pokorski; Jonathan Kyle,14,0,15,1
1708247355806,CHEM 250,A00,394436,Weizman; Haim,0,0,0,16
1708247356332,CHEM 256,A00,394437,Romero; Erik Anthony,15,0,20,5
1708247356861,CHEM 257,A00,394438,Tor; Yitzhak,23,0,30,7
1708247357387,CHEM 265,A01,460195,Herzik; Mark Anthony,13,0,20,7
1708247357970,CHEM 273,A00,394440,Young; Mark,13,0,20,7
1708247358504,CHEM 276,A00,394441,Mc Culloch; Andrew Douglas & Amaro; Rommie E,0,0,0,0
1708247359031,CHEM 283,A00,394443,Komives; Elizabeth A,2,0,4,2
1708247359557,CHEM 286,A00,477693,Paesani; Francesco & Gilson; Michael K.,26,0,34,8
1708247360084,CHEM 291,A00,394446,Komives; Elizabeth A,20,0,20,0
1708247360613,CHEM 294,A00,394447,Romero; Erik Anthony,50,0,50,0
1708247361156,CHIN 10CD,A01,394453,Liu; Mingming,17,0,17,0
1708247361156,CHIN 10CD,A02,394457,Liu; Mingming,18,0,18,0
1708247361685,CHIN 10CM,A01,394465,Chen; Pei-Chia,11,0,12,1
1708247361685,CHIN 10CM,A02,394466,Chen; Pei-Chia,12,0,12,0
1708247361685,CHIN 10CM,B01,394468,Liu; Mingming,11,0,13,2
1708247361685,CHIN 10CM,B02,394469,Liu; Mingming,13,0,13,0
1708247362211,CHIN 10CN,A01,394581,Xu; Li,14,0,14,0
1708247362211,CHIN 10CN,A02,394582,Xu; Li,14,0,14,0
1708247362211,CHIN 10CN,B01,394585,Xu; Li,14,0,14,0
1708247362211,CHIN 10CN,B02,394586,Xu; Li,13,0,14,1
1708247362737,CHIN 20CD,A01,394591,Wang; Xiao,11,0,12,1
1708247362737,CHIN 20CD,A02,394592,Wang; Xiao,11,0,12,1
1708247363279,CHIN 20CN,A01,394597,Anderson; Qin-Hong,7,0,8,1
1708247363279,CHIN 20CN,A02,394599,Anderson; Qin-Hong,8,0,8,0
1708247363279,CHIN 20CN,B01,394601,Anderson; Qin-Hong,14,0,15,1
1708247363805,CHIN 100CM,A00,394602,Anderson; Qin-Hong,19,0,20,1
1708247364330,CHIN 100CN,A00,394603,Chen; Pei-Chia,24,0,24,0
1708247364859,CHIN 169B,A00,394623,Wang; Xiao,19,0,20,1
1708247365384,CLAS 87,A00,394669,Herbst; Matthew,19,0,20,1
1708247366926,CLAS 121R,A01,394671,Herbst; Matthew,11,0,12,1
1708247366926,CLAS 121R,B01,486854,Herbst; Matthew,8,0,8,0
1708247367473,CLIN 294C,A00,476856,Wierenga; Christina E & Banks; Sarah Jane,20,0,20,0
1708247368002,CLIN 296,001,476768,Brookman; Lauren Irene,94,0,100,6
1708247368002,CLIN 296,002,476855,Brookman; Lauren Irene,10,0,10,0
1708247368529,CLRE 238R,A00,394675,Mehta; Ravindra L.,9998,0,9999,1
1708247369055,CLRE 254,A00,394678,Vaida; Florin,9999,0,9999,0
1708247369581,CLRE 256,A00,394685,Morris; Sheldon,9999,0,9999,0
1708247370126,CLRE 258,A00,394692,Mehta; Ravindra L.,9999,0,9999,0
1708247370652,CLRE 260,A00,394693,Cuomo; Raphael Eduardo,9999,0,9999,0
1708247371181,CLRE 264,A00,394696,Mehta; Ravindra L.,9999,0,9999,0
1708247371708,CLRE 267,A00,394703,Vaida; Florin,9999,0,9999,0
1708247372232,CLRE 297,001,394705,Cuomo; Raphael Eduardo,9999,0,9999,0
1708247372764,CMM 246,A00,492783,Gordts; Philip & Varki; Ajit P & Lewis; Amanda Lark & Godula; Kamil & Gagneux; Pascal & Esko; Jeffrey D. & Bode; Lars,9,0,10,1
1708247373290,CMM 250,A00,492943,Willert; Karl Heinrich,31,0,40,9
1708247373814,COGR 200B,A00,395746,Jack; Caroline Sarah,2,0,5,3
1708247374340,COGR 225B,A00,395750,Serlin; David,1,0,5,4
1708247374866,COGR 225C,A00,395753,Gates; Kelly,1,0,5,4
1708247375395,COGR 275,A00,395943,Goldfarb; Brian,6,0,10,4
1708247375395,COGR 275,B00,396046,Fattal; Alexander Leor,4,0,10,6
1708247375395,COGR 275,C00,396047,Kidman; Shawna F,4,0,10,6
1708247375920,COGR 280,A00,396048,Ahn; Patricia Jeehyun,6,0,10,4
1708247376466,COGS 1,A01,407484,Boyle; Mary E. T.,52,0,60,8
1708247376466,COGS 1,A02,407498,Boyle; Mary E. T.,54,0,60,6
1708247376466,COGS 1,A03,407504,Boyle; Mary E. T.,59,0,60,1
1708247376466,COGS 1,A04,407512,Boyle; Mary E. T.,57,0,60,3
1708247376466,COGS 1,A05,407513,Boyle; Mary E. T.,60,0,60,0
1708247376466,COGS 1,A06,407514,Boyle; Mary E. T.,58,0,60,2
1708247376466,COGS 1,A07,407515,Boyle; Mary E. T.,57,0,57,0
1708247377008,COGS 9,A01,407520,Shannon; Kyle Michael,54,0,60,6
1708247377008,COGS 9,A02,407521,Shannon; Kyle Michael,60,0,60,0
1708247377008,COGS 9,A03,407522,Shannon; Kyle Michael,59,0,60,1
1708247377008,COGS 9,A04,407524,Shannon; Kyle Michael,57,0,60,3
1708247377008,COGS 9,A05,407525,Shannon; Kyle Michael,59,0,60,1
1708247377550,COGS 10,A01,407527,Morgan; Eric,45,0,50,5
1708247377550,COGS 10,A02,407530,Morgan; Eric,46,0,50,4
1708247377550,COGS 10,A03,407531,Morgan; Eric,46,0,50,4
1708247377550,COGS 10,A04,407532,Morgan; Eric,47,0,50,3
1708247377550,COGS 10,A05,407534,Morgan; Eric,47,0,50,3
1708247377550,COGS 10,A06,407539,Morgan; Eric,50,0,50,0
1708247377550,COGS 10,A07,407628,Morgan; Eric,50,0,50,0
1708247378076,COGS 11,A01,407699,Boroditsky; Lera,179,0,180,1
1708247378602,COGS 12,A00,407702,Boroditsky; Lera,75,0,75,0
1708247379131,COGS 14A,A01,407706,Barrera; Steven James,51,0,57,6
1708247379131,COGS 14A,A02,407707,Barrera; Steven James,54,0,57,3
1708247379131,COGS 14A,A03,407712,Barrera; Steven James,0,0,0,1
1708247379131,COGS 14A,A04,407715,Barrera; Steven James,57,0,57,0
1708247379131,COGS 14A,A05,407717,Barrera; Steven James,55,0,56,1
1708247379131,COGS 14A,A06,407718,Barrera; Steven James,52,0,55,3
1708247379131,COGS 14A,A07,407720,Barrera; Steven James,49,0,55,6
1708247379676,COGS 14B,A01,407723,Hoffman; Drew Ellen,52,0,57,5
1708247379676,COGS 14B,A02,407726,Hoffman; Drew Ellen,48,0,55,7
1708247379676,COGS 14B,A03,407727,Hoffman; Drew Ellen,52,0,55,3
1708247379676,COGS 14B,A04,407729,Hoffman; Drew Ellen,52,0,55,3
1708247379676,COGS 14B,A05,407730,Hoffman; Drew Ellen,50,0,55,5
1708247380220,COGS 17,A01,407733,Johnson; Christine M.,50,0,50,0
1708247380220,COGS 17,A02,407734,Johnson; Christine M.,48,0,50,2
1708247380220,COGS 17,A03,407735,Johnson; Christine M.,46,0,50,4
1708247380220,COGS 17,A04,407740,Johnson; Christine M.,47,0,50,3
1708247380220,COGS 17,A05,407745,Johnson; Christine M.,48,0,50,2
1708247380220,COGS 17,A06,407824,Johnson; Christine M.,48,0,50,2
1708247380220,COGS 17,A07,407878,Johnson; Christine M.,50,0,55,5
1708247380220,COGS 17,A08,408015,Johnson; Christine M.,52,0,55,3
1708247380769,COGS 18,A01,408118,Ellis; Shannon Elizabeth,27,0,35,8
1708247380769,COGS 18,A02,408119,Ellis; Shannon Elizabeth,31,0,35,4
1708247380769,COGS 18,A03,408120,Ellis; Shannon Elizabeth,23,0,35,12
1708247380769,COGS 18,A04,408136,Ellis; Shannon Elizabeth,33,0,35,2
1708247380769,COGS 18,A05,408141,Ellis; Shannon Elizabeth,35,0,35,0
1708247380769,COGS 18,A06,408143,Ellis; Shannon Elizabeth,34,0,35,1
1708247380769,COGS 18,A07,408144,Ellis; Shannon Elizabeth,35,0,35,0
1708247380769,COGS 18,A08,408145,Ellis; Shannon Elizabeth,34,0,35,1
1708247380769,COGS 18,A09,408146,Ellis; Shannon Elizabeth,35,0,35,0
1708247380769,COGS 18,B01,408148,Ellis; Shannon Elizabeth,30,0,32,2
1708247380769,COGS 18,B02,408149,Ellis; Shannon Elizabeth,26,0,32,6
1708247380769,COGS 18,B03,408151,Ellis; Shannon Elizabeth,27,0,33,6
1708247380769,COGS 18,B04,408154,Ellis; Shannon Elizabeth,32,0,33,1
1708247380769,COGS 18,B05,408163,Ellis; Shannon Elizabeth,29,0,33,4
1708247380769,COGS 18,B06,408176,Ellis; Shannon Elizabeth,33,0,33,0
1708247380769,COGS 18,B07,408177,Ellis; Shannon Elizabeth,31,0,33,2
1708247380769,COGS 18,B08,408178,Ellis; Shannon Elizabeth,32,0,33,1
1708247380769,COGS 18,B09,408195,Ellis; Shannon Elizabeth,31,0,33,2
1708247381297,COGS 87,A00,408196,Deak; Gedeon O.,20,0,20,0
1708247381297,COGS 87,B00,479478,Fleischer; Jason G,20,0,20,0
1708247381824,COGS 100,A01,408262,Allen; Michael Gordon,54,0,56,2
1708247381824,COGS 100,A02,408263,Allen; Michael Gordon,52,0,56,4
1708247381824,COGS 100,A03,408264,Allen; Michael Gordon,55,0,56,1
1708247381824,COGS 100,A04,408265,Allen; Michael Gordon,56,0,56,0
1708247381824,COGS 100,A05,408266,Allen; Michael Gordon,56,0,56,0
1708247381824,COGS 100,A06,408349,Allen; Michael Gordon,55,0,56,1
1708247382352,COGS 101A,A01,408352,Morgan; Eric,60,0,60,0
1708247382352,COGS 101A,A02,408353,Morgan; Eric,58,0,60,2
1708247382352,COGS 101A,A03,408354,Morgan; Eric,57,0,60,3
1708247382352,COGS 101A,A04,408355,Morgan; Eric,59,0,60,1
1708247382877,COGS 101B,A01,408373,Barrera; Steven James,47,0,50,3
1708247382877,COGS 101B,A02,408380,Barrera; Steven James,46,0,50,4
1708247382877,COGS 101B,A03,408384,Barrera; Steven James,38,0,50,12
1708247382877,COGS 101B,A04,408385,Barrera; Steven James,37,0,50,13
1708247383404,COGS 101C,A01,408387,Trott; Sean Thomas,48,0,50,2
1708247383404,COGS 101C,A02,408388,Trott; Sean Thomas,43,0,50,7
1708247383404,COGS 101C,A03,408389,Trott; Sean Thomas,45,0,50,5
1708247383935,COGS 107A,A01,408396,Boyle; Mary E. T.,54,0,56,2
1708247383935,COGS 107A,A02,408397,Boyle; Mary E. T.,54,0,56,2
1708247383935,COGS 107A,A03,408399,Boyle; Mary E. T.,51,0,56,5
1708247383935,COGS 107A,A04,408409,Boyle; Mary E. T.,50,0,56,6
1708247383935,COGS 107A,A05,408410,Boyle; Mary E. T.,51,0,56,5
1708247383935,COGS 107A,A06,408411,Boyle; Mary E. T.,55,0,56,1
1708247384480,COGS 107B,A01,408413,Mooshagian; Eric Frederick,47,0,50,3
1708247384480,COGS 107B,A02,408414,Mooshagian; Eric Frederick,43,0,50,7
1708247384480,COGS 107B,A03,408428,Mooshagian; Eric Frederick,43,0,50,7
1708247384480,COGS 107B,A04,408434,Mooshagian; Eric Frederick,46,0,50,4
1708247384480,COGS 107B,A05,408435,Mooshagian; Eric Frederick,50,0,50,0
1708247384480,COGS 107B,A06,408446,Mooshagian; Eric Frederick,49,0,50,1
1708247385007,COGS 107C,A01,408500,Chiba; Andrea,51,0,60,9
1708247385007,COGS 107C,A02,408519,Chiba; Andrea,55,0,60,5
1708247385007,COGS 107C,A03,408524,Chiba; Andrea,56,0,60,4
1708247385548,COGS 108,A01,408532,Fleischer; Jason G,45,0,60,15
1708247385548,COGS 108,A02,408543,Fleischer; Jason G,58,0,60,2
1708247385548,COGS 108,A03,408544,Fleischer; Jason G,59,0,60,1
1708247385548,COGS 108,A04,408552,Fleischer; Jason G,32,0,60,28
1708247385548,COGS 108,A05,408554,Fleischer; Jason G,47,0,60,13
1708247385548,COGS 108,A06,408574,Fleischer; Jason G,43,0,60,17
1708247385548,COGS 108,A07,408576,Fleischer; Jason G,56,0,60,4
1708247386080,COGS 112,A01,408682,Hoffman; Drew Ellen,33,0,50,17
1708247386080,COGS 112,A02,408683,Hoffman; Drew Ellen,38,0,50,12
1708247386080,COGS 112,A03,408684,Hoffman; Drew Ellen,48,0,60,12
1708247386606,COGS 122,A01,408695,Dow; Steven P,21,0,50,29
1708247387132,COGS 125,A00,408697,Klemmer; Scott R,36,0,50,14
1708247387658,COGS 126,A01,408787,Hollan; James D.,44,0,50,6
1708247388188,COGS 138,A01,408866,Khosla; Meenakshi,72,0,75,3
1708247388715,COGS 142,A01,408868,Rossano; Federico,49,0,50,1
1708247389245,COGS 144,A01,408950,Rossano; Federico,48,0,50,2
1708247389771,COGS 155,A01,408993,Staff,49,0,50,1
1708247390300,COGS 157,A00,408994,Creel; Sarah,0,0,0,0
1708247390827,COGS 160,A00,409031,Deak; Gedeon O.,20,0,20,0
1708247391358,COGS 175,A01,409035,Rill; Bryan,67,0,75,8
1708247391888,COGS 178,A00,409274,Jernigan; Terry Lynne,68,0,70,2
1708247392413,COGS 179,A00,409278,Staff,40,0,40,0
1708247392937,COGS 184,A01,409317,Johnson; Christine M.,42,0,50,8
1708247393468,COGS 185,A01,409476,Tu; Zhuowen,33,0,50,17
1708247393468,COGS 185,A02,409525,Tu; Zhuowen,45,0,50,5
1708247393995,COGS 188,A01,409527,Fleischer; Jason G,46,0,75,29
1708247394530,COGS 190C,001,409528,Chiba; Andrea,9999,0,9999,0
1708247394530,COGS 190C,002,409530,Fleischer; Jason G,9999,0,9999,0
1708247394530,COGS 190C,003,409531,Boyle; Mary E. T.,9999,0,9999,0
1708247394530,COGS 190C,004,409532,Nitz; Douglas A.,9999,0,9999,0
1708247394530,COGS 190C,005,409535,Rangel; Lara M,9999,0,9999,0
1708247394530,COGS 190C,006,409536,Rossano; Federico,9999,0,9999,0
1708247394530,COGS 190C,007,409537,Deak; Gedeon O.,9999,0,9999,0
1708247394530,COGS 190C,008,409538,Trott; Sean Thomas,9999,0,9999,0
1708247394530,COGS 190C,009,409540,Creel; Sarah,9999,0,9999,0
1708247394530,COGS 190C,010,409541,Voytek; Bradley Thomas,9999,0,9999,0
1708247394530,COGS 190C,011,409542,Greene; Deanna Jacquelyn,9999,0,9999,0
1708247394530,COGS 190C,012,409543,Ellis; Shannon Elizabeth,9999,0,9999,0
1708247394530,COGS 190C,013,409546,Kirsh; David Joel,9999,0,9999,0
1708247395058,COGS 190D,A00,409547,Voytek; Bradley Thomas,20,0,20,0
1708247395584,COGS 194,A00,409548,Hill; Seth J,9999,0,9999,0
1708247396113,COGS 200,A01,406697,Creel; Sarah,0,0,0,0
1708247396654,COGS 205,A00,406698,Chiba; Andrea,20,0,20,0
1708247397183,COGS 209,A00,406699,Mukamel; Eran A,42,0,68,26
1708247397710,COGS 210C,001,406700,Kirsh; David Joel,9999,0,9999,0
1708247397710,COGS 210C,002,406701,Greene; Deanna Jacquelyn,9998,0,9999,1
1708247397710,COGS 210C,003,406702,Xia; Haijun,9999,0,9999,0
1708247397710,COGS 210C,004,406703,Nitz; Douglas A.,9998,0,9999,1
1708247397710,COGS 210C,005,406710,Hollan; James D.,9999,0,9999,0
1708247397710,COGS 210C,006,406713,De Sa; Virginia,9999,0,9999,0
1708247397710,COGS 210C,007,406714,Rossano; Federico,9999,0,9999,0
1708247397710,COGS 210C,008,406740,Kiyonaga; Anastasia,9999,0,9999,0
1708247397710,COGS 210C,009,406745,Guo; Philip J,9998,0,9999,1
1708247397710,COGS 210C,010,406746,Dow; Steven P,9999,0,9999,0
1708247397710,COGS 210C,011,406747,Bergen; Benjamin,9999,0,9999,0
1708247397710,COGS 210C,012,406758,Coulson; Seana M,9999,0,9999,0
1708247398238,COGS 211C,A00,406763,Coulson; Seana M,17,0,20,3
1708247398765,COGS 229,A00,406788,Hollan; James D. & Xia; Haijun,5,0,10,5
1708247399291,COGS 238,A00,406789,Bergen; Benjamin,17,0,20,3
1708247399818,COGS 278,A00,406794,Jernigan; Terry Lynne,18,0,20,2
1708247400381,COMM 10,A01,394711,Schmidt; Thomas Rainer,20,0,24,4
1708247400381,COMM 10,A02,394714,Schmidt; Thomas Rainer,24,0,24,0
1708247400381,COMM 10,A03,394716,Schmidt; Thomas Rainer,24,0,24,0
1708247400381,COMM 10,A04,394717,Schmidt; Thomas Rainer,22,0,24,2
1708247400381,COMM 10,A05,394731,Schmidt; Thomas Rainer,24,0,24,0
1708247400381,COMM 10,A06,394733,Schmidt; Thomas Rainer,24,0,24,0
1708247400381,COMM 10,A07,394740,Schmidt; Thomas Rainer,24,0,24,0
1708247400381,COMM 10,A08,394741,Schmidt; Thomas Rainer,24,0,24,0
1708247400381,COMM 10,A09,394751,Schmidt; Thomas Rainer,23,0,24,1
1708247400381,COMM 10,A10,394779,Schmidt; Thomas Rainer,24,0,24,0
1708247400381,COMM 10,A11,394809,Schmidt; Thomas Rainer,24,0,24,0
1708247400381,COMM 10,A12,394811,Schmidt; Thomas Rainer,24,0,24,0
1708247400381,COMM 10,A13,394818,Schmidt; Thomas Rainer,24,0,24,0
1708247400381,COMM 10,A14,394825,Schmidt; Thomas Rainer,23,0,24,1
1708247400381,COMM 10,A15,394828,Schmidt; Thomas Rainer,24,0,24,0
1708247400381,COMM 10,A16,394829,Schmidt; Thomas Rainer,0,0,0,0
1708247400381,COMM 10,A17,486828,Schmidt; Thomas Rainer,20,0,21,1
1708247400913,COMM 20,A01,394834,McKenna; Denise,69,0,70,1
1708247401443,COMM 80,A01,394849,Campbell; Robert Harold,120,0,120,0
1708247401989,COMM 100C,A01,394957,Kidman; Shawna F,24,0,25,1
1708247401989,COMM 100C,A02,394972,Kidman; Shawna F,25,0,25,0
1708247401989,COMM 100C,A03,394977,Kidman; Shawna F,22,0,25,3
1708247401989,COMM 100C,A04,394981,Kidman; Shawna F,25,0,25,0
1708247401989,COMM 100C,A05,394985,Kidman; Shawna F,24,0,25,1
1708247401989,COMM 100C,A06,394989,Kidman; Shawna F,23,0,25,2
1708247401989,COMM 100C,A07,394993,Kidman; Shawna F,24,0,25,1
1708247401989,COMM 100C,A08,394997,Kidman; Shawna F,23,0,25,2
1708247401989,COMM 100C,A09,394999,Kidman; Shawna F,25,0,25,0
1708247401989,COMM 100C,A10,395018,Kidman; Shawna F,25,0,25,0
1708247401989,COMM 100C,A11,395041,Kidman; Shawna F,24,0,25,1
1708247401989,COMM 100C,A12,395080,Kidman; Shawna F,24,0,25,1
1708247402514,COMM 101,A01,395135,Halm; Gavin Patrick,15,0,15,0
1708247402514,COMM 101,A02,395252,Halm; Gavin Patrick,15,0,15,0
1708247402514,COMM 101,A03,395253,Halm; Gavin Patrick,15,0,15,0
1708247402514,COMM 101,A04,395263,Halm; Gavin Patrick,15,0,15,0
1708247403040,COMM 101D,A00,395264,Martinico; Daniel J,13,0,16,3
1708247403567,COMM 101K,A00,395266,Ahn; Patricia Jeehyun,16,0,18,2
1708247404094,COMM 101N,A00,395267,Martinico; Daniel J,16,0,16,0
1708247404623,COMM 102C,A01,395270,Campion; Camille E,5,0,6,1
1708247404623,COMM 102C,A02,395271,Campion; Camille E,6,0,6,0
1708247404623,COMM 102C,A03,395272,Campion; Camille E,5,0,6,1
1708247405147,COMM 102M,A01,395285,Davis; Zeinabu I.,9,0,10,1
1708247405147,COMM 102M,A02,395288,Davis; Zeinabu I.,8,0,10,2
1708247405676,COMM 103D,A00,395343,Gates; Kelly,34,0,35,1
1708247406204,COMM 107,A00,395461,Serlin; David,33,0,35,2
1708247406729,COMM 109D,A00,395462,Halm; Gavin Patrick,72,0,75,3
1708247407257,COMM 110G,A00,395481,Whitworth-Smith; Andrew C,32,0,35,3
1708247407788,COMM 110M,A00,395482,Harb; Anthony Joseph,34,0,35,1
1708247408314,COMM 111A,A00,487217,Pavon Aramburu; Maria Laur,34,0,35,1
1708247408842,COMM 113T,A00,395516,Fields; Gary,35,0,35,0
1708247409371,COMM 114A,A00,395517,Zilberg; Elana,32,0,35,3
1708247409899,COMM 114B,A00,395523,Zilberg; Elana,19,0,20,1
1708247410425,COMM 114E,A00,487218,Pavon Aramburu; Maria Laur,34,0,35,1
1708247410951,COMM 114W,A00,395524,Walkover; Lillian B,17,0,18,1
1708247411477,COMM 126,A00,479341,Staff,26,0,30,4
1708247412019,COMM 132,A00,481491,Rojo Solis; Juan Jose,0,0,0,0
1708247412599,COMM 134,A00,395578,Abuelhiga; Soraya Jill,28,0,30,2
1708247413125,COMM 143,A00,395579,Rojo Solis; Juan Jose,28,0,30,2
1708247413651,COMM 146,A00,395584,Jack; Caroline Sarah,29,0,30,1
1708247414181,COMM 168,A00,395592,Harb; Anthony Joseph,29,0,30,1
1708247414709,COMM 170,A00,395608,Pavon Aramburu; Maria Laur,30,0,30,0
1708247415236,COMM 173,A00,395609,Alac; Morana,29,0,30,1
1708247415761,COMM 174,A00,395679,Alac; Morana,30,0,30,0
1708247416287,COMM 190,A00,395682,Abuelhiga; Soraya Jill,19,0,23,4
1708247416287,COMM 190,B00,395696,Staff,21,0,23,2
1708247416287,COMM 190,C00,395697,Fattal; Alexander Leor,22,0,23,1
1708247416814,CSE 8A,A50,459200,Miranda; Gregory Joseph,34,0,35,1
1708247416814,CSE 8A,A51,459205,Miranda; Gregory Joseph,34,0,35,1
1708247416814,CSE 8A,A52,459206,Miranda; Gregory Joseph,34,0,35,1
1708247416814,CSE 8A,A53,459212,Miranda; Gregory Joseph,34,0,35,1
1708247416814,CSE 8A,A54,459213,Miranda; Gregory Joseph,34,0,35,1
1708247416814,CSE 8A,A55,459232,Miranda; Gregory Joseph,34,0,35,1
1708247417340,CSE 11,A01,470735,Ochoa; Benjamin Lawrence,180,0,195,15
1708247417870,CSE 12,A01,470744,Cao; Yingjun,189,0,200,11
1708247417870,CSE 12,B01,470752,Miranda; Gregory Joseph,71,0,100,29
1708247417870,CSE 12,B02,470760,Miranda; Gregory Joseph,93,0,100,7
1708247418400,CSE 15L,A01,410174,Solares; Edwin A,6,0,10,4
1708247418400,CSE 15L,B01,410215,Solares; Edwin A,7,0,10,3
1708247418400,CSE 15L,C01,410305,Solares; Edwin A,3,0,10,7
1708247418400,CSE 15L,D01,410400,Solares; Edwin A,1,0,10,9
1708247418927,CSE 20,A01,470765,Minnes Kemp; Mor Mia,145,0,150,5
1708247419453,CSE 21,A01,470776,Jones; Miles E,68,0,73,5
1708247419453,CSE 21,A02,482889,Jones; Miles E,68,0,72,4
1708247419983,CSE 29,A01,494014,Soosai Raj; Adalbert Geral,48,0,50,2
1708247419983,CSE 29,A02,494016,Soosai Raj; Adalbert Geral,40,0,50,10
1708247419983,CSE 29,B01,494018,Shalev; Aaron D,16,0,20,4
1708247420511,CSE 30,A01,470784,Cao; Yingjun,141,0,150,9
1708247420511,CSE 30,B01,467469,Muller; P Keith,98,0,120,22
1708247421038,CSE 87,A00,410528,Moshiri; Niema,20,0,20,0
1708247421565,CSE 90,A00,486885,Minnes Kemp; Mor Mia,0,0,0,0
1708247422092,CSE 91,A00,486872,Minnes Kemp; Mor Mia,0,0,0,0
1708247422092,CSE 91,B00,486873,Minnes Kemp; Mor Mia,0,0,0,0
1708247422621,CSE 95,A00,410529,Minnes Kemp; Mor Mia,50,0,50,0
1708247423150,CSE 100,A01,470792,Sahoo; Debashis,55,0,70,15
1708247423676,CSE 100R,A01,410556,Moshiri; Niema,1,0,40,39
1708247424202,CSE 101,A01,470797,Jones; Miles E,14,0,44,30
1708247424202,CSE 101,A02,482892,Jones; Miles E,32,0,43,11
1708247424729,CSE 105,A01,470800,Micciancio; Daniele,85,0,98,13
1708247425259,CSE 107,A01,467479,Bellare; Mihir,141,0,146,5
1708247425789,CSE 109,A01,459538,Shang; Jingbo,0,0,25,25
1708247426321,CSE 110,A50,459395,Powell; Thomas Allan,49,0,50,1
1708247426321,CSE 110,A51,459512,Powell; Thomas Allan,37,0,50,13
1708247426321,CSE 110,A52,459513,Powell; Thomas Allan,46,0,50,4
1708247426321,CSE 110,A53,459514,Powell; Thomas Allan,48,0,50,2
1708247426321,CSE 110,A54,459515,Powell; Thomas Allan,48,0,50,2
1708247426321,CSE 110,A55,459516,Powell; Thomas Allan,45,0,50,5
1708247426321,CSE 110,A56,459517,Powell; Thomas Allan,47,0,48,1
1708247426846,CSE 112,A50,459518,Powell; Thomas Allan,132,0,146,14
1708247427372,CSE 120,A01,470808,Zhou; Yuan-Yuan,167,0,200,33
1708247427896,CSE 125,A00,410564,Voelker; Geoffrey M.,30,0,30,0
1708247428423,CSE 127,A01,467484,Fernandes; Earlence T,175,0,196,21
1708247428949,CSE 130,A01,467485,Polikarpova; Nadezhda,176,0,192,16
1708247429481,CSE 131,A01,459522,Ding; Yufei,36,0,50,14
1708247430008,CSE 132B,A01,470816,Deutsch; Alin Bernard,62,0,70,8
1708247430536,CSE 140,A01,410606,Orailoglu; Alex,99,0,100,1
1708247430536,CSE 140,B01,410622,Eldon; John,130,0,146,16
1708247431068,CSE 140L,A01,410655,Orailoglu; Alex,98,0,100,2
1708247431068,CSE 140L,B01,410658,Eldon; John,123,0,146,23
1708247431612,CSE 141,A01,467486,Zhao; Jishen,173,0,196,23
1708247432141,CSE 141L,A01,410685,Eldon; John,162,0,196,34
1708247432672,CSE 145,A01,410713,Kastner; Ryan Charles,25,0,25,0
1708247433205,CSE 150B,A01,470824,Gao; Sicun,311,0,362,51
1708247433730,CSE 156,A01,467487,Nakashole; Ndapandula,141,0,192,51
1708247434263,CSE 165,A01,410757,Weibel; Nadir & Schulze; Jurgen P.,40,0,50,10
1708247434790,CSE 168,A01,410759,Ramamoorthi; Ravi,24,0,25,1
1708247434790,CSE 168,A02,410761,Ramamoorthi; Ravi,24,0,25,1
1708247435324,CSE 175,A01,410764,Kumar; Rakesh,48,0,50,2
1708247435855,CSE 182,A01,455011,Bafna; Vineet,47,0,50,3
1708247436389,CSE 185,A01,410895,Gymrek; Melissa Ann,41,0,57,16
1708247436389,CSE 185,A02,479240,Gymrek; Melissa Ann,53,0,58,5
1708247436917,CSE 190,A00,410982,Grier; Daniel T,48,0,50,2
1708247436917,CSE 190,B00,410983,Riek; Laurel D,50,0,50,0
1708247436917,CSE 190,C00,410984,Staff,36,0,50,14
1708247436917,CSE 190,D00,481666,Saha; Barna & Impagliazzo; Russell,27,0,28,1
1708247437451,CSE 203A,A00,410985,Saha; Barna & Impagliazzo; Russell,0,0,0,0
1708247437976,CSE 209A,A00,410986,Grier; Daniel T,0,0,0,0
1708247438503,CSE 209B,A00,410987,Bellare; Mihir,0,0,0,0
1708247439029,CSE 217,A01,459553,Weibel; Nadir,0,0,0,0
1708247439554,CSE 218,A00,410989,Griswold; William G.,0,0,0,0
1708247440087,CSE 219,A00,410990,Hollan; James D. & Xia; Haijun,0,0,0,0
1708247440612,CSE 224,A01,470832,Snoeren; Alex C.,0,0,0,0
1708247441137,CSE 229A,A00,410993,Shalev; Aaron D,0,0,0,0
1708247441669,CSE 229C,A00,410994,Fernandes; Earlence T,0,0,0,0
1708247442195,CSE 231,A01,467488,Jhala; Ranjit,0,0,0,0
1708247442730,CSE 233,A00,410996,Vianu; Victor Dan,0,0,0,0
1708247443258,CSE 237D,A00,410998,Kastner; Ryan Charles,0,0,0,0
1708247443788,CSE 239A,A00,410999,Vianu; Victor Dan,0,0,0,0
1708247444314,CSE 239B,A00,411000,Coblenz; Michael J,0,0,0,0
1708247444840,CSE 240A,A00,411001,Chin; Bryan W.,0,0,0,0
1708247445366,CSE 252D,A00,411004,Chandraker; Manmohan Krishna,0,0,0,0
1708247445893,CSE 256,A00,411005,Nakashole; Ndapandula,0,0,0,0
1708247446433,CSE 260,A01,467491,Chin; Bryan W.,0,0,0,0
1708247446960,CSE 276B,A00,411007,Riek; Laurel D,0,0,0,0
1708247447492,CSE 276F,A01,459554,Su; Hao,0,0,0,0
1708247448017,CSE 283,A00,411009,Bafna; Vineet & Zhong; Sheng,0,0,0,0
1708247448546,CSE 290,A00,411010,Gao; Sicun,0,0,0,0
1708247448546,CSE 290,B00,411011,Chern; Albert Ren-Haur,0,0,0,0
1708247448546,CSE 290,C00,411012,Swanson; Steven James,0,0,0,0
1708247448546,CSE 290,E00,411013,Su; Hao,0,0,0,0
1708247448546,CSE 290,F00,411014,Riek; Laurel D,0,0,0,0
1708247448546,CSE 290,G00,411015,Gymrek; Melissa Ann,0,0,0,0
1708247448546,CSE 290,H00,479239,Dasgupta; Sanjoy & Gymrek; Melissa Ann,0,0,0,0
1708247448546,CSE 290,I00,481669,Bafna; Vineet,0,0,0,0
1708247448546,CSE 290,J00,494949,Paturi; Ramamohan,0,0,0,0
1708247449081,CSE 291,A00,411016,Li; Tzumao,0,0,0,0
1708247449081,CSE 291,B00,411017,Heninger; Nadia A,0,0,0,0
1708247449081,CSE 291,C00,411114,Chern; Albert Ren-Haur,0,0,0,0
1708247449081,CSE 291,D00,411115,Zhang; Yiying,0,0,0,0
1708247449081,CSE 291,E00,411116,Cheng; Chung Kuan,0,0,0,0
1708247449081,CSE 291,G00,411118,Lerner; Sorin,0,0,0,0
1708247449081,CSE 291,I00,481509,Shang; Jingbo,0,0,0,0
1708247449081,CSE 291,J00,494844,Savage; Stefan & Stefan; Deian,50,0,50,0
1708247449613,CSE 293,001,487239,Bafna; Vineet,9999,0,9999,0
1708247449613,CSE 293,002,487240,Bellare; Mihir,9999,0,9999,0
1708247449613,CSE 293,003,487241,Berg-Kirkpatrick; Taylor D,9999,0,9999,0
1708247449613,CSE 293,004,487242,Chandraker; Manmohan Krishna,9999,0,9999,0
1708247449613,CSE 293,005,487243,Cheng; Chung Kuan,9999,0,9999,0
1708247449613,CSE 293,006,487244,Christensen; Henrik I,9999,0,9999,0
1708247449613,CSE 293,007,487245,Coblenz; Michael J,9999,0,9999,0
1708247449613,CSE 293,008,487363,Cottrell; Garrison W,9999,0,9999,0
1708247449613,CSE 293,009,487366,Deutsch; Alin Bernard,9999,0,9999,0
1708247449613,CSE 293,010,487433,Esmaeilzadeh; Hadi,9999,0,9999,0
1708247449613,CSE 293,011,487434,Freund; Yoav,9999,0,9999,0
1708247449613,CSE 293,012,487455,Griswold; William G.,9999,0,9999,0
1708247449613,CSE 293,013,487469,Gymrek; Melissa Ann,9999,0,9999,0
1708247449613,CSE 293,014,487470,Heninger; Nadia A,9999,0,9999,0
1708247449613,CSE 293,015,487471,Impagliazzo; Russell,9999,0,9999,0
1708247449613,CSE 293,016,487472,Jhala; Ranjit,9999,0,9999,0
1708247449613,CSE 293,017,487473,Kahng; Andrew Byun,9999,0,9999,0
1708247449613,CSE 293,018,487474,Kane; Daniel Mertz,9999,0,9999,0
1708247449613,CSE 293,019,487475,Kriegman; David J,9999,0,9999,0
1708247449613,CSE 293,020,487476,Kumar; Arun Kumar,9999,0,9999,0
1708247449613,CSE 293,021,487477,Lerner; Sorin,9999,0,9999,0
1708247449613,CSE 293,022,487478,Lovett; Shachar,9999,0,9999,0
1708247449613,CSE 293,023,487520,McAuley; Julian John,9999,0,9999,0
1708247449613,CSE 293,024,487522,Micciancio; Daniele,9999,0,9999,0
1708247449613,CSE 293,025,487577,Orailoglu; Alex,9999,0,9999,0
1708247449613,CSE 293,026,487586,Pannuto; Patrick William,9999,0,9999,0
1708247449613,CSE 293,027,487598,Paturi; Ramamohan,9999,0,9999,0
1708247449613,CSE 293,028,487604,Polikarpova; Nadezhda,9999,0,9999,0
1708247449613,CSE 293,029,487609,Politz; Joseph Gibbs,9999,0,9999,0
1708247449613,CSE 293,030,487642,Porter; George M,9999,0,9999,0
1708247449613,CSE 293,031,487665,Porter; Leonard Emerson,9999,0,9999,0
1708247449613,CSE 293,032,487689,Ramamoorthi; Ravi,9999,0,9999,0
1708247449613,CSE 293,033,487698,Riek; Laurel D,9999,0,9999,0
1708247449613,CSE 293,034,487712,Sahoo; Debashis,9999,0,9999,0
1708247449613,CSE 293,035,487721,Saul; Lawrence,9999,0,9999,0
1708247449613,CSE 293,036,487735,Savage; Stefan,9999,0,9999,0
1708247449613,CSE 293,037,487744,Schulze; Jurgen P.,9999,0,9999,0
1708247449613,CSE 293,038,487758,Snoeren; Alex C.,9999,0,9999,0
1708247449613,CSE 293,039,487767,Shang; Jingbo,9999,0,9999,0
1708247449613,CSE 293,040,487790,Stefan; Deian,9999,0,9999,0
1708247449613,CSE 293,041,487817,Su; Hao,9999,0,9999,0
1708247449613,CSE 293,042,487827,Swanson; Steven James,9999,0,9999,0
1708247449613,CSE 293,043,487830,Tullsen; Dean Michael,9999,0,9999,0
1708247449613,CSE 293,044,487837,Vaccaro; Kristen Marie,9999,0,9999,0
1708247449613,CSE 293,045,487838,Voelker; Geoffrey M.,9999,0,9999,0
1708247449613,CSE 293,046,487842,Zhao; Jishen,9999,0,9999,0
1708247449613,CSE 293,047,487847,Zhou; Yuan-Yuan,9999,0,9999,0
1708247449613,CSE 293,048,487852,Gao; Sicun,9999,0,9999,0
1708247449613,CSE 293,049,487853,Weibel; Nadir,9999,0,9999,0
1708247449613,CSE 293,050,487854,Gupta; Rajesh K.,9999,0,9999,0
1708247449613,CSE 293,051,487855,Soosai Raj; Adalbert Geral,9999,0,9999,0
1708247449613,CSE 293,052,494373,Zhang; Hao,9999,0,9999,0
1708247450138,CSE 294,A00,411124,Voelker; Geoffrey M.,15,0,15,0
1708247450669,CSS 100,A01,396053,Trott; Sean Thomas,43,0,50,7
1708247451194,CSS 120,A01,479237,Mignozzetti; Umberto,47,0,50,3
1708247451194,CSS 120,A02,479238,Mignozzetti; Umberto,50,0,50,0
1708247451731,CSS 209,A00,396054,Styler; William Francis,21,0,35,14
1708247452264,CSS 296,001,396055,Mignozzetti; Umberto,0,0,0,1
1708247452264,CSS 296,002,396056,Styler; William Francis,0,0,0,1
1708247452264,CSS 296,003,396057,Broz; James Lawrence,0,0,0,2
1708247452264,CSS 296,004,396058,Elliott; Graham,0,0,0,5
1708247452264,CSS 296,005,396059,Sun; Feiyang,0,0,0,0
1708247452264,CSS 296,006,396060,Dewaard; Andrew Michael,0,0,0,0
1708247452796,DDPM 210,A00,400652,Ma; Joseph David,36,0,36,0
1708247453321,DDPM 211,A00,400653,Ma; Joseph David,36,0,36,0
1708247453848,DDPM 214,A00,400720,Ma; Joseph David,36,0,36,0
1708247454373,DERM 296,001,464131,Staff,50,0,50,0
1708247454373,DERM 296,002,464178,Staff,50,0,50,0
1708247454373,DERM 296,003,464181,Staff,50,0,50,0
1708247454911,DOC 3,A01,399409,Strom; Megan C.,0,0,0,0
1708247454911,DOC 3,A02,399414,Strom; Megan C.,0,0,0,0
1708247454911,DOC 3,A03,399432,Strom; Megan C.,0,0,0,0
1708247454911,DOC 3,A04,399461,Strom; Megan C.,0,0,0,0
1708247454911,DOC 3,A05,399470,Strom; Megan C.,0,0,0,0
1708247454911,DOC 3,A06,399476,Strom; Megan C.,0,0,0,0
1708247454911,DOC 3,A07,399547,Strom; Megan C.,0,0,0,0
1708247454911,DOC 3,A08,399548,Strom; Megan C.,0,0,0,0
1708247454911,DOC 3,A09,399675,Strom; Megan C.,0,0,0,0
1708247454911,DOC 3,A10,399687,Strom; Megan C.,0,0,0,0
1708247454911,DOC 3,A11,399704,Strom; Megan C.,0,0,0,0
1708247454911,DOC 3,A12,399707,Strom; Megan C.,0,0,0,0
1708247454911,DOC 3,A13,399714,Strom; Megan C.,0,0,0,0
1708247454911,DOC 3,A14,399721,Strom; Megan C.,0,0,0,0
1708247454911,DOC 3,A15,399765,Strom; Megan C.,0,0,0,0
1708247454911,DOC 3,A16,399766,Strom; Megan C.,0,0,0,0
1708247454911,DOC 3,B01,399786,Strom; Megan C.,0,0,0,0
1708247454911,DOC 3,B02,399787,Strom; Megan C.,0,0,0,0
1708247454911,DOC 3,B03,399788,Strom; Megan C.,0,0,0,0
1708247454911,DOC 3,B04,399845,Strom; Megan C.,0,0,0,0
1708247454911,DOC 3,B05,399846,Strom; Megan C.,0,0,0,0
1708247454911,DOC 3,B06,399895,Strom; Megan C.,0,0,0,0
1708247454911,DOC 3,B07,399916,Strom; Megan C.,0,0,0,0
1708247454911,DOC 3,B08,400073,Strom; Megan C.,0,0,0,0
1708247454911,DOC 3,B09,400074,Strom; Megan C.,0,0,0,0
1708247454911,DOC 3,B10,400076,Strom; Megan C.,0,0,0,0
1708247454911,DOC 3,B11,400077,Strom; Megan C.,0,0,0,0
1708247454911,DOC 3,B12,400078,Strom; Megan C.,0,0,0,0
1708247454911,DOC 3,B13,400079,Strom; Megan C.,0,0,0,0
1708247454911,DOC 3,B14,400080,Strom; Megan C.,0,0,0,0
1708247454911,DOC 3,B15,400081,Strom; Megan C.,0,0,0,0
1708247454911,DOC 3,B16,400082,Strom; Megan C.,0,0,0,0
1708247454911,DOC 3,C01,400084,Chapman; Dillon,0,0,0,0
1708247454911,DOC 3,C02,400085,Chapman; Dillon,0,0,0,0
1708247454911,DOC 3,C03,400086,Chapman; Dillon,0,0,0,0
1708247454911,DOC 3,C04,400087,Chapman; Dillon,0,0,0,0
1708247454911,DOC 3,C05,400113,Chapman; Dillon,0,0,0,0
1708247454911,DOC 3,C06,400114,Chapman; Dillon,0,0,0,0
1708247454911,DOC 3,C07,400117,Chapman; Dillon,0,0,0,0
1708247454911,DOC 3,C08,400118,Chapman; Dillon,0,0,0,0
1708247454911,DOC 3,C09,400119,Chapman; Dillon,0,0,0,0
1708247454911,DOC 3,C10,400121,Chapman; Dillon,0,0,0,0
1708247454911,DOC 3,C11,400122,Chapman; Dillon,0,0,0,0
1708247454911,DOC 3,C12,400126,Chapman; Dillon,0,0,0,0
1708247454911,DOC 3,C13,400157,Chapman; Dillon,0,0,0,0
1708247454911,DOC 3,C14,400240,Chapman; Dillon,0,0,0,0
1708247454911,DOC 3,C15,400241,Chapman; Dillon,0,0,0,0
1708247454911,DOC 3,C16,400242,Chapman; Dillon,0,0,0,0
1708247454911,DOC 3,D01,400253,Chapman; Dillon,0,0,0,0
1708247454911,DOC 3,D02,400294,Chapman; Dillon,0,0,0,0
1708247454911,DOC 3,D03,400295,Chapman; Dillon,0,0,0,0
1708247454911,DOC 3,D04,400430,Chapman; Dillon,0,0,0,0
1708247454911,DOC 3,D05,400438,Chapman; Dillon,0,0,0,0
1708247454911,DOC 3,D06,400439,Chapman; Dillon,0,0,0,0
1708247454911,DOC 3,D07,400441,Chapman; Dillon,0,0,0,0
1708247454911,DOC 3,D08,400442,Chapman; Dillon,0,0,0,0
1708247454911,DOC 3,D09,400443,Chapman; Dillon,0,0,0,0
1708247454911,DOC 3,D10,400445,Chapman; Dillon,0,0,0,0
1708247454911,DOC 3,D11,400446,Chapman; Dillon,0,0,0,0
1708247454911,DOC 3,D12,400447,Chapman; Dillon,0,0,0,0
1708247454911,DOC 3,D13,400448,Chapman; Dillon,0,0,0,0
1708247454911,DOC 3,D14,400646,Chapman; Dillon,0,0,0,0
1708247454911,DOC 3,D15,400647,Chapman; Dillon,0,0,0,0
1708247454911,DOC 3,D16,400648,Chapman; Dillon,0,0,0,0
1708247455436,DOC 100D,A00,400649,Pass; Natalye Joann,22,0,25,3
1708247455436,DOC 100D,B00,400650,Pass; Natalye Joann,25,0,25,0
1708247455964,DSC 10,A01,398041,Tiefenbruck; Janine LoBue,142,0,147,5
1708247455964,DSC 10,B01,398180,Tiefenbruck; Janine LoBue,144,0,147,3
1708247455964,DSC 10,C01,398400,Tiefenbruck; Janine LoBue,143,0,147,4
1708247456500,DSC 20,A01,398415,Langlois; Marina,200,0,200,0
1708247457026,DSC 30,A01,398436,Langlois; Marina,156,0,158,2
1708247457026,DSC 30,B01,398439,Langlois; Marina,144,0,150,6
1708247457551,DSC 40A,A01,398441,Rampure; Suraj,123,0,125,2
1708247457551,DSC 40A,B01,398443,Rampure; Suraj,125,0,125,0
1708247458099,DSC 40B,A01,398445,Staff,150,0,150,0
1708247458641,DSC 80,A01,398470,Lau; Samuel Ethan,70,0,70,0
1708247458641,DSC 80,B01,398541,Lau; Samuel Ethan,68,0,70,2
1708247459171,DSC 95,A01,398650,Rampure; Suraj,50,0,50,0
1708247459697,DSC 100,A01,398683,Salimi; Babak,147,0,150,3
1708247460220,DSC 102,A01,398708,Jin; Haojian,145,0,150,5
1708247460753,DSC 106,A01,398711,Wilber; Jared Dane,146,0,149,3
1708247461279,DSC 140A,A01,398724,Eldridge; Justin Matthew,98,0,100,2
1708247461279,DSC 140A,B01,479346,Ustun; Tevfik Berk,50,0,50,0
1708247461804,DSC 140B,A01,398726,Weng; Tsui-Wei (lily),144,0,150,6
1708247462331,DSC 190,A01,398738,Silberman; Jack,20,0,20,0
1708247462331,DSC 190,B01,479475,Ustun; Tevfik Berk,29,0,30,1
1708247462331,DSC 190,C01,481341,Rahman; Tauhidur,50,0,50,0
1708247462865,DSC 197,001,494360,Eldridge; Justin Matthew,9999,0,9999,0
1708247463391,DSC 214,A00,477322,Staff,22,0,60,38
1708247463921,DSC 231,A01,398863,Gupta; Rajesh K.,60,0,60,0
1708247464461,DSC 232R,A01,487133,Solares; Edwin A,39,0,60,21
1708247464986,DSC 240,A00,398957,Belkin; Mikhail,74,0,90,16
1708247466109,DSC 243,A00,398958,Ma; Yian,59,0,60,1
1708247466638,DSC 245,A00,398959,Huang; Biwei,42,0,60,18
1708247467167,DSC 253,A00,398960,Shang; Jingbo,0,0,30,30
1708247468708,DSC 258R,A01,398962,Shang; Jingbo,43,0,60,17
1708247469234,DSC 267R,A01,398964,Staff,56,0,60,4
1708247469794,DSC 291,A00,398965,Belkin; Mikhail,90,0,90,0
1708247469794,DSC 291,B00,398966,Weng; Tsui-Wei (lily),90,0,90,0
1708247469794,DSC 291,C00,398997,Staff,60,0,60,0
1708247469794,DSC 291,D00,398998,Zhang; Hao,40,0,40,0
1708247469794,DSC 291,E00,477386,Staff,50,0,50,0
1708247470325,DSC 293,A00,477388,Ustun; Tevfik Berk,9990,0,9999,9
1708247470851,DSC 295,A00,480826,Danks; David J,30,0,40,10
1708247471379,DSE 220,A00,398034,Dasgupta; Sanjoy,20,0,20,0
1708247471908,DSE 230,A00,398035,Nguyen; Mai Huong,20,0,20,0
1708247472432,DSE 260B,A00,398037,Altintas De Callaf; Ilkay,20,0,20,0
1708247472963,DSGN 1,A01,408210,Klemmer; Scott R,46,0,50,4
1708247472963,DSGN 1,A02,408245,Klemmer; Scott R,47,0,50,3
1708247473491,DSGN 119,A00,407467,Hollan; James D. & Xia; Haijun,76,0,90,14
1708247474024,DSGN 160,A00,494371,Aronoff-Spencer; Eliah Sea,15,0,20,5
1708247474553,DSGN 219,A00,474323,Hollan; James D. & Xia; Haijun,15,0,15,0
1708247475080,ECE 5,A01,428645,Morris; Karcher William,21,0,24,3
1708247475080,ECE 5,A02,428646,Morris; Karcher William,24,0,24,0
1708247475080,ECE 5,A03,428647,Morris; Karcher William,24,0,24,0
1708247475080,ECE 5,A04,428648,Morris; Karcher William,24,0,24,0
1708247475608,ECE 15,A01,428650,Sahay; Rajeev,119,0,120,1
1708247476139,ECE 16,A01,428652,Wang; Edward Jay,22,0,30,8
1708247476666,ECE 17,A01,428654,Sahay; Rajeev,48,0,60,12
1708247477192,ECE 25,A50,428657,Dey; Sujit,30,0,30,0
1708247477192,ECE 25,A51,428658,Dey; Sujit,30,0,30,0
1708247477749,ECE 30,A50,428674,Mir Arabbaygi; Siavash,28,0,30,2
1708247477749,ECE 30,A51,428675,Mir Arabbaygi; Siavash,28,0,30,2
1708247477749,ECE 30,A52,428676,Mir Arabbaygi; Siavash,28,0,30,2
1708247477749,ECE 30,A53,428679,Mir Arabbaygi; Siavash,29,0,30,1
1708247477749,ECE 30,A54,428680,Mir Arabbaygi; Siavash,30,0,30,0
1708247478296,ECE 35,A50,428684,Taur; Yuan,29,0,30,1
1708247478296,ECE 35,A51,428685,Taur; Yuan,30,0,30,0
1708247478296,ECE 35,A52,428686,Taur; Yuan,30,0,30,0
1708247478296,ECE 35,A53,428687,Taur; Yuan,29,0,30,1
1708247478822,ECE 45,A01,428689,Zeger; Kenneth A.,137,0,150,13
1708247479364,ECE 65,A50,428701,Baghdadchi; Saharnaz,28,0,30,2
1708247479364,ECE 65,A51,428742,Baghdadchi; Saharnaz,29,0,30,1
1708247479364,ECE 65,A52,428743,Baghdadchi; Saharnaz,30,0,30,0
1708247479364,ECE 65,A53,428754,Baghdadchi; Saharnaz,26,0,30,4
1708247479364,ECE 65,A54,428796,Baghdadchi; Saharnaz,30,0,30,0
1708247479364,ECE 65,A55,428797,Baghdadchi; Saharnaz,29,0,30,1
1708247479364,ECE 65,A56,428803,Baghdadchi; Saharnaz,30,0,30,0
1708247479891,ECE 100,A01,428978,Baghdadchi; Saharnaz,29,0,30,1
1708247479891,ECE 100,A02,428988,Baghdadchi; Saharnaz,30,0,30,0
1708247479891,ECE 100,A03,428989,Baghdadchi; Saharnaz,29,0,30,1
1708247479891,ECE 100,A04,429008,Baghdadchi; Saharnaz,29,0,30,1
1708247480418,ECE 101,A01,429017,Bharadia; Dinesh,57,0,60,3
1708247480418,ECE 101,A02,429019,Bharadia; Dinesh,60,0,60,0
1708247480944,ECE 103,A01,429027,Kuzum; Duygu,74,0,75,1
1708247481468,ECE 107,A01,429055,Fullerton; Eric E,73,0,75,2
1708247481994,ECE 108,A01,429068,Kang; Mingu,53,0,60,7
1708247482520,ECE 109,A01,429085,Orlitsky; Alon,98,0,100,2
1708247482520,ECE 109,A02,429098,Orlitsky; Alon,96,0,100,4
1708247483046,ECE 111,A01,429132,Turakhia; Yatish Girish,173,0,180,7
1708247483572,ECE 115,A01,429314,Yip; Michael,22,0,26,4
1708247484097,ECE 123,A01,429327,Sievenpiper; Daniel F.,56,0,60,4
1708247484623,ECE 125B,A50,429397,Esmaili; Gholamreza,23,0,24,1
1708247484623,ECE 125B,A51,429627,Esmaili; Gholamreza,23,0,24,1
1708247485149,ECE 134,A00,429630,Ng; Tse Nga,50,0,50,0
1708247485682,ECE 136L,A01,429634,Dayeh; Shadi Ahmad,3,0,5,2
1708247485682,ECE 136L,A02,429636,Dayeh; Shadi Ahmad,3,0,5,2
1708247485682,ECE 136L,A03,429637,Dayeh; Shadi Ahmad,5,0,5,0
1708247485682,ECE 136L,A04,429641,Dayeh; Shadi Ahmad,5,0,5,0
1708247486212,ECE 139,A00,429642,Nomura; Kenji,17,0,20,3
1708247486751,ECE 140B,A01,455349,Khoshabeh; Ramsin & Gessner; Richard K.,19,0,24,5
1708247486751,ECE 140B,A02,455351,Khoshabeh; Ramsin & Gessner; Richard K.,23,0,24,1
1708247486751,ECE 140B,A03,455354,Khoshabeh; Ramsin & Gessner; Richard K.,21,0,22,1
1708247487291,ECE 141B,A01,455355,Gessner; Richard K.,48,0,50,2
1708247487821,ECE 148,A01,492803,Silberman; Jack,0,0,0,0
1708247488348,ECE 153,A01,429655,Naghizadeh Ardabili; Parin,94,0,100,6
1708247488874,ECE 157A,A01,429657,Bharadia; Dinesh,22,0,25,3
1708247489406,ECE 158B,A01,429659,Zhang; Xinyu,14,0,20,6
1708247489931,ECE 161C,A00,429660,Cosman; Pamela C.,58,0,60,2
1708247490461,ECE 163,A00,429664,Hsueh; Tzu-Chien,95,0,100,5
1708247491004,ECE 165,A51,429672,Mercier; Patrick Philip,20,0,30,10
1708247491004,ECE 165,A52,429673,Mercier; Patrick Philip,22,0,30,8
1708247491004,ECE 165,A53,429674,Mercier; Patrick Philip,30,0,30,0
1708247491004,ECE 165,A54,429675,Mercier; Patrick Philip,30,0,30,0
1708247491544,ECE 171A,A01,429813,Zheng; Yang,96,0,100,4
1708247492069,ECE 175B,A01,429886,Xie; Pengtao,72,0,75,3
1708247492595,ECE 183,A01,430023,Mookherjea; Shayan,26,0,30,4
1708247493141,ECE 185,A01,430025,Papen; George C.,19,0,20,1
1708247493667,ECE 191,A00,430039,Zhang; Xinyu,30,0,30,0
1708247494194,ECE 196,A00,430040,Morris; Karcher William,18,0,24,6
1708247494194,ECE 196,B00,430045,Morris; Karcher William,23,0,24,1
1708247494723,ECE 198,001,430052,Nguyen; Truong Quang,9999,0,9999,0
1708247495383,ECE 200,001,438659,Atanasov; Nikolay A.,9999,0,9999,0
1708247495383,ECE 200,002,438660,Bharadia; Dinesh,9999,0,9999,0
1708247495383,ECE 200,003,438668,Cheng; Chung Kuan,9999,0,9999,0
1708247495383,ECE 200,004,438845,Cosman; Pamela C.,9999,0,9999,0
1708247495383,ECE 200,005,438846,Dayeh; Shadi Ahmad,9999,0,9999,0
1708247495383,ECE 200,006,438847,Fainman; Yeshaiahu,9999,0,9999,0
1708247495383,ECE 200,007,438848,Ford; Joseph Earl,9999,0,9999,0
1708247495383,ECE 200,008,438849,Franceschetti; Massimo,9999,0,9999,0
1708247495383,ECE 200,009,438850,Fullerton; Eric E,9999,0,9999,0
1708247495383,ECE 200,010,438851,Galton; Ian A,9999,0,9999,0
1708247495383,ECE 200,011,438852,Gilja; Vikash,9999,0,9999,0
1708247495383,ECE 200,012,438853,Hall; Drew A.,9999,0,9999,0
1708247495383,ECE 200,013,438854,Hsueh; Tzu-Chien,9999,0,9999,0
1708247495383,ECE 200,014,438855,Javidi; Tara,9999,0,9999,0
1708247495383,ECE 200,015,438865,Kahng; Andrew Byun,9999,0,9999,0
1708247495383,ECE 200,016,438866,Kim; Young-Han,9999,0,9999,0
1708247495383,ECE 200,017,438876,Koushanfar; Farinaz,9999,0,9999,0
1708247495383,ECE 200,018,438877,Kuzum; Duygu,9999,0,9999,0
1708247495383,ECE 200,019,438934,Le; Hanh-Phuc,9999,0,9999,0
1708247495383,ECE 200,020,438954,Lin; Bill,9999,0,9999,0
1708247495383,ECE 200,021,438955,Liu; Zhaowei,9999,0,9999,0
1708247495383,ECE 200,022,438957,Lo; Yu-Hwa,9999,0,9999,0
1708247495383,ECE 200,023,439086,Lomakin; Vitaliy,9999,0,9999,0
1708247495383,ECE 200,024,439087,Mercier; Patrick Philip,9999,0,9999,0
1708247495383,ECE 200,025,439088,Meyer; Florian,9999,0,9999,0
1708247495383,ECE 200,026,439090,Milstein; Laurence B.,9999,0,9999,0
1708247495383,ECE 200,027,439208,Mir Arabbaygi; Siavash,9999,0,9999,0
1708247495383,ECE 200,028,439209,Mookherjea; Shayan,9999,0,9999,0
1708247495383,ECE 200,029,439210,Morris; Karcher William,9999,0,9999,0
1708247495383,ECE 200,030,439211,Ng; Tse Nga,9999,0,9999,0
1708247495383,ECE 200,031,439219,Nguyen; Truong Quang,9999,0,9999,0
1708247495383,ECE 200,032,439220,Nomura; Kenji,9999,0,9999,0
1708247495383,ECE 200,033,439221,Orlitsky; Alon,9999,0,9999,0
1708247495383,ECE 200,034,439222,Pal; Piya,9999,0,9999,0
1708247495383,ECE 200,035,439223,Papen; George C.,9999,0,9999,0
1708247495383,ECE 200,036,439224,Radic; Stojan,9999,0,9999,0
1708247495383,ECE 200,037,439225,Rao; Bhaskar D.,9999,0,9999,0
1708247495383,ECE 200,038,439227,Rao; Ramesh R,9999,0,9999,0
1708247495383,ECE 200,039,439231,Rebeiz; Gabriel,9999,0,9999,0
1708247495383,ECE 200,040,439232,Sanford; John R,9999,0,9999,0
1708247495383,ECE 200,041,439302,Siegel; Paul H.,9999,0,9999,0
1708247495383,ECE 200,042,439303,Sievenpiper; Daniel F.,9999,0,9999,0
1708247495383,ECE 200,043,439305,Sworder; David D.,9999,0,9999,0
1708247495383,ECE 200,044,439306,Taur; Yuan,9999,0,9999,0
1708247495383,ECE 200,045,439419,Touri; Behrouz,9999,0,9999,0
1708247495383,ECE 200,046,439425,Trivedi; Mohan M.,9999,0,9999,0
1708247495383,ECE 200,047,439538,Vasconcelos; Nuno,9999,0,9999,0
1708247495383,ECE 200,048,439546,Wang; Xiaolong,9999,0,9999,0
1708247495383,ECE 200,049,439549,Xie; Pengtao,9999,0,9999,0
1708247495383,ECE 200,050,439551,Yip; Michael,9999,0,9999,0
1708247495383,ECE 200,051,439553,Zeger; Kenneth A.,9999,0,9999,0
1708247495383,ECE 200,052,439554,Zhang; Xinyu,9999,0,9999,0
1708247495383,ECE 200,053,439555,Zheng; Yang,9999,0,9999,0
1708247495383,ECE 200,054,439557,Turakhia; Yatish Girish,9999,0,9999,0
1708247495383,ECE 200,055,439558,Kang; Mingu,9999,0,9999,0
1708247495383,ECE 200,056,439560,Shi; Yuanyuan,9999,0,9999,0
1708247495383,ECE 200,057,439564,Wang; Edward Jay,9999,0,9999,0
1708247495383,ECE 200,058,439565,Antipa; Nicholas A,9999,0,9999,0
1708247495383,ECE 200,059,439566,Zheng; Yang,9999,0,9999,0
1708247495383,ECE 200,060,492991,Yu; Paul K L,9999,0,9999,0
1708247495383,ECE 200,061,492992,Ndao; Abdoulaye,9999,0,9999,0
1708247495383,ECE 200,062,493019,Naghizadeh Ardabili; Parin,9999,0,9999,0
1708247495383,ECE 200,063,493033,Sahay; Rajeev,9999,0,9999,0
1708247495909,ECE 208,A00,430053,Mir Arabbaygi; Siavash,0,0,0,0
1708247496435,ECE 212CN,A00,430054,Liu; Zhaowei,0,0,0,0
1708247496959,ECE 222C,A00,430055,Lomakin; Vitaliy,0,0,0,0
1708247497487,ECE 227,A00,430057,Franceschetti; Massimo,0,0,0,0
1708247498017,ECE 228,A00,430078,Shi; Yuanyuan,0,0,0,0
1708247498548,ECE 230C,A00,430079,Yu; Paul K L,0,0,0,0
1708247499090,ECE 235,A00,430081,Taur; Yuan,0,0,0,0
1708247499617,ECE 236B,A00,430082,Lo; Yu-Hwa,0,0,0,0
1708247500146,ECE 240C,A00,430083,Mookherjea; Shayan,0,0,0,0
1708247500671,ECE 250,A00,430115,Touri; Behrouz,0,0,0,0
1708247501203,ECE 251B,A00,430166,Vasconcelos; Manuela,0,0,0,0
1708247501729,ECE 258B,A00,430167,Milstein; Laurence B.,0,0,0,0
1708247502258,ECE 260C,A00,430168,Eldon; John,0,0,0,0
1708247502788,ECE 264B,A00,430169,Galton; Ian A,0,0,0,0
1708247503319,ECE 265B,A00,430170,Gudem; Prasad S.S.,0,0,0,0
1708247503848,ECE 266,A01,430273,Hall; Drew A.,0,0,0,0
1708247504379,ECE 271C,A00,430283,Vasconcelos; Nuno,0,0,0,0
1708247504912,ECE 272A,A01,430340,Poveda Fonseca; Jorge,0,0,0,0
1708247505443,ECE 273,A00,430352,Wang; Jun-Kun,0,0,0,0
1708247505969,ECE 276B,A00,430353,Atanasov; Nikolay A.,0,0,0,0
1708247506495,ECE 284,A00,430385,Wang; Edward,0,0,0,0
1708247507026,ECE 285,A00,430386,Wang; Xiaolong,0,0,0,0
1708247507026,ECE 285,B00,430387,Antipa; Nicholas A,0,0,0,0
1708247507558,ECON 1,A01,409576,Crane; Meredith Helen,87,0,100,13
1708247507558,ECON 1,A02,409577,Crane; Meredith Helen,96,0,100,4
1708247507558,ECON 1,A03,409578,Crane; Meredith Helen,97,0,100,3
1708247508091,ECON 2,A01,409580,Candido; Maria Teresa,70,0,75,5
1708247508616,ECON 3,A01,409582,Crane; Meredith Helen,109,0,120,11
1708247508616,ECON 3,A02,409583,Crane; Meredith Helen,114,0,115,1
1708247508616,ECON 3,A03,409584,Crane; Meredith Helen,110,0,115,5
1708247510164,ECON 4,A01,409586,Levkoff; Steven B.,88,0,92,4
1708247510164,ECON 4,A02,409587,Levkoff; Steven B.,89,0,90,1
1708247510748,ECON 5,A01,409589,Dai; Yinlin,53,0,58,5
1708247510748,ECON 5,A02,409590,Dai; Yinlin,56,0,58,2
1708247510748,ECON 5,A03,409591,Dai; Yinlin,54,0,54,0
1708247510748,ECON 5,A04,409593,Dai; Yinlin,55,0,55,0
1708247510748,ECON 5,B01,409595,Dai; Yinlin,57,0,58,1
1708247510748,ECON 5,B02,409596,Dai; Yinlin,49,0,49,0
1708247510748,ECON 5,B03,409597,Dai; Yinlin,59,0,59,0
1708247510748,ECON 5,B04,409598,Dai; Yinlin,55,0,55,0
1708247510748,ECON 5,C01,487209,Staff,40,0,45,5
1708247511326,ECON 100A,A01,409600,Famulari; Melissa,94,0,100,6
1708247511326,ECON 100A,A02,409601,Famulari; Melissa,98,0,100,2
1708247511326,ECON 100A,A03,409604,Famulari; Melissa,98,0,100,2
1708247511326,ECON 100A,B01,409610,Famulari; Melissa,76,0,80,4
1708247511853,ECON 100AH,A00,409612,Famulari; Melissa,19,0,20,1
1708247512395,ECON 100B,A01,409614,Grigoryan; Aram,109,0,120,11
1708247512395,ECON 100B,A02,409616,Grigoryan; Aram,117,0,120,3
1708247512395,ECON 100B,B01,409626,Grigoryan; Aram,47,0,50,3
1708247512395,ECON 100B,B02,409627,Grigoryan; Aram,49,0,50,1
1708247512922,ECON 100C,A01,409629,Levkoff; Steven B.,144,0,146,2
1708247512922,ECON 100C,B01,409632,Levkoff; Steven B.,143,0,146,3
1708247513446,ECON 106,A00,409633,Bowen; T. Renee,90,0,90,0
1708247513972,ECON 109T,A00,409634,Trevino; Isabel,18,0,20,2
1708247514502,ECON 110A,A01,409637,Staff,68,0,75,7
1708247516047,ECON 110B,A01,409663,Herreno Lopera; Juan,119,0,125,6
1708247516047,ECON 110B,A02,409682,Herreno Lopera; Juan,125,0,125,0
1708247516047,ECON 110B,B01,409734,Herreno Lopera; Juan,99,0,100,1
1708247516606,ECON 120A,A01,409739,Candido; Maria Teresa,84,0,90,6
1708247516606,ECON 120A,A02,409740,Candido; Maria Teresa,87,0,90,3
1708247516606,ECON 120A,B01,409742,Candido; Maria Teresa,85,0,90,5
1708247516606,ECON 120A,B02,409743,Candido; Maria Teresa,90,0,90,0
1708247517134,ECON 120B,A01,409748,Ma; Xinwei,128,0,130,2
1708247517134,ECON 120B,A02,409754,Ma; Xinwei,128,0,130,2
1708247517134,ECON 120B,B01,409756,Ma; Xinwei,26,0,40,14
1708247517668,ECON 120C,A01,409758,Sun; Yixiao,141,0,146,5
1708247517668,ECON 120C,B01,409762,Sun; Yixiao,144,0,146,2
1708247518194,ECON 129,A00,409763,Eckert; Fabian Paul,44,0,50,6
1708247518727,ECON 134,A00,409764,Gelber; Alexander Michael,45,0,50,5
1708247518727,ECON 134,B00,409765,Gelber; Alexander Michael,49,0,50,1
1708247519260,ECON 137,A00,409766,Niehaus; Paul,19,0,20,1
1708247519802,ECON 142,A00,409767,Trevino; Isabel,39,0,40,1
1708247519802,ECON 142,B00,409768,Trevino; Isabel,38,0,40,2
1708247520327,ECON 164,A00,409771,Muralidharan; Karthik,119,0,120,1
1708247520853,ECON 172A,A01,409773,Newhouse; Herbert S,67,0,75,8
1708247521379,ECON 172B,A01,409775,Newhouse; Herbert S,74,0,75,1
1708247521379,ECON 172B,B01,409777,Newhouse; Herbert S,71,0,75,4
1708247522436,ECON 191A,A00,409780,Cullen; Julie,20,0,20,0
1708247523024,ECON 200C,A00,409782,Du; Songzi,34,0,35,1
1708247523556,ECON 210C,A00,409784,Herreno Lopera; Juan & Wieland; Johannes Friedrich,35,0,35,0
1708247524082,ECON 220C,A00,409785,Sun; Yixiao,35,0,35,0
1708247524608,ECON 220F,A00,409786,Carson; Richard T,27,0,30,3
1708247525141,ECON 221,A00,409787,Zhu; Ying,25,0,25,0
1708247525671,ECON 241,A00,409788,Muralidharan; Karthik,18,0,20,2
1708247526197,ECON 243,A00,409789,Niehaus; Paul,18,0,20,2
1708247526723,ECON 248,A00,409790,Eckert; Fabian Paul,18,0,20,2
1708247527258,ECON 250C,A00,409791,Arnold; David Hall & Betts; Julian,25,0,25,0
1708247527785,ECON 268,A00,409792,Jacobsen; Mark,24,0,25,1
1708247528326,ECON 281,A00,409793,Meckel; Katherine Hunter,19,0,20,1
1708247528326,ECON 281,B00,409794,Herreno Lopera; Juan & Wieland; Johannes Friedrich,19,0,20,1
1708247528326,ECON 281,C00,477854,Herreno Lopera; Juan & Wieland; Johannes Friedrich,18,0,20,2
1708247528851,ECON 285,A00,409795,Eckert; Fabian Paul,20,0,20,0
1708247529390,ECON 286,A00,409796,Ma; Xinwei,15,0,15,0
1708247529390,ECON 286,B00,409797,Hamilton; James D.,15,0,15,0
1708247529390,ECON 286,C00,409798,Grigoryan; Aram,15,0,15,0
1708247529390,ECON 286,D00,409799,Niehaus; Paul,15,0,15,0
1708247529917,ECON 296,A00,409800,Eckert; Fabian Paul,20,0,20,0
1708247530450,EDS 31,A00,409801,Bussey; Thomas J,9,0,10,1
1708247530977,EDS 38,A01,409803,Chung; Luz Marina,25,0,25,0
1708247531505,EDS 39,A01,409805,Heinzman; Erica M.,24,0,25,1
1708247532031,EDS 102,A01,409807,Ambo; Theresa Jean,37,0,45,8
1708247532561,EDS 110R,A01,409809,Staff,42,0,50,8
1708247532561,EDS 110R,B01,481358,Staff,20,0,20,0
1708247533089,EDS 111,A00,479044,Wishard Guerra; Alison G.,56,0,60,4
1708247533622,EDS 117,A01,409818,Jones; Gabrielle Anastasia,21,0,23,2
1708247533622,EDS 117,A02,409819,Jones; Gabrielle Anastasia,23,0,23,0
1708247533622,EDS 117,A03,409820,Jones; Gabrielle Anastasia,22,0,23,1
1708247533622,EDS 117,A04,409821,Jones; Gabrielle Anastasia,21,0,21,0
1708247534149,EDS 118,A00,409828,Warstadt; Melissa Fawn,46,0,50,4
1708247534680,EDS 123,A00,409831,Bussey; Thomas J,10,0,10,0
1708247535218,EDS 124AR,A00,419352,Simon; Elizabeth A,82,0,100,18
1708247535218,EDS 124AR,B00,419377,Simon; Elizabeth A,97,0,100,3
1708247535218,EDS 124AR,C00,481485,Simon; Elizabeth A,25,0,25,0
1708247535218,EDS 124AR,D00,481490,Simon; Elizabeth A,25,0,25,0
1708247535749,EDS 124BR,A00,409838,Eguchi; Emi,53,0,75,22
1708247535749,EDS 124BR,B00,481363,Eguchi; Emi,25,0,25,0
1708247536276,EDS 125,A00,409839,Aragon; Maria Jose,48,0,50,2
1708247536802,EDS 126,A01,409843,Jones; Makeba,19,0,25,6
1708247536802,EDS 126,A02,409844,Jones; Makeba,25,0,25,0
1708247536802,EDS 126,A03,409846,Jones; Makeba,25,0,25,0
1708247536802,EDS 126,A04,409847,Jones; Makeba,25,0,25,0
1708247537334,EDS 128B,A01,409851,Pappas; Elizabeth,49,0,50,1
1708247537861,EDS 129C,A01,409906,Millstone; Rachel Diana,44,0,50,6
1708247538397,EDS 130,A01,409954,Mendez; Kathrina Mendoza,14,0,15,1
1708247538397,EDS 130,A02,409955,Mendez; Kathrina Mendoza,24,0,25,1
1708247538397,EDS 130,A03,409956,Mendez; Kathrina Mendoza,20,0,20,0
1708247538926,EDS 133,A01,409961,Bintliff; Amy S.V.,15,0,20,5
1708247538926,EDS 133,A02,409962,Bintliff; Amy S.V.,20,0,20,0
1708247538926,EDS 133,A03,489636,Bintliff; Amy S.V.,15,0,15,0
1708247539459,EDS 136,A01,409964,Chung; Luz Marina,30,0,30,0
1708247539459,EDS 136,A02,409977,Chung; Luz Marina,30,0,30,0
1708247539990,EDS 139,A00,479197,Millstone; Rachel Diana,42,0,50,8
1708247539990,EDS 139,B00,479198,Pappas; Elizabeth,49,0,50,1
1708247539990,EDS 139,C00,479199,Mendez; Kathrina Mendoza,58,0,60,2
1708247539990,EDS 139,D00,479200,Bintliff; Amy S.V.,56,0,60,4
1708247539990,EDS 139,E00,479201,Chung; Luz Marina,59,0,60,1
1708247539990,EDS 139,F00,479202,Bintliff; Amy S.V.,15,0,15,0
1708247539990,EDS 139,G00,479203,Mamas; Christoforos,27,0,30,3
1708247539990,EDS 139,H00,493997,Choi; Bailey Miyeon,28,0,30,2
1708247540519,EDS 141,A00,409979,Mamas; Christoforos,38,0,40,2
1708247541044,EDS 145,A01,409989,Choi; Bailey Miyeon,13,0,15,2
1708247541044,EDS 145,A02,409990,Choi; Bailey Miyeon,15,0,15,0
1708247541572,EDS 180,A00,409991,Chapman; Thandeka K,30,0,30,0
1708247541572,EDS 180,B00,409992,Ambo; Theresa Jean,24,0,25,1
1708247541572,EDS 180,C00,409993,Jones; Gabrielle Anastasia,20,0,20,0
1708247541572,EDS 180,D00,409994,Phuong; Andrew,24,0,24,0
1708247542104,EDS 198,001,487216,Eguchi; Emi,20,0,20,0
1708247542630,EDS 205B,A00,409995,Staff,40,0,45,5
1708247542630,EDS 205B,B00,409997,Staff,42,0,45,3
1708247543163,EDS 232,A00,409999,Hopkins; Megan Beth,9,0,12,3
1708247543689,EDS 255,A00,410001,Phuong; Andrew,14,0,15,1
1708247544214,EDS 257,A00,410003,Datnow; Amanda Lee,14,0,15,1
1708247544741,EDS 282,A00,479192,Daly; Alan J.,16,0,16,0
1708247545272,EDS 287B,A00,479193,Daly; Alan J.,16,0,16,0
1708247545798,EDS 288A,A00,410005,Staff,18,0,18,0
1708247546329,EDS 288C,A00,410007,Staff,18,0,18,0
1708247546861,EDS 289B,A01,410009,Daly; Alan J.,18,0,18,0
1708247547412,EDS 290,A00,410010,Black; Alison Michelle,30,0,30,0
1708247547412,EDS 290,B00,410012,Choi; Bailey Miyeon,29,0,30,1
1708247547412,EDS 290,C00,479205,Heinzman; Erica M.,0,0,0,0
1708247547937,EDS 291B,A01,479195,Daly; Alan J.,16,0,16,0
1708247548469,EDS 293B,A01,410016,Staff,18,0,18,0
1708247548996,EDS 294B,A00,479196,Burrell; Sade Renee,16,0,16,0
1708247549556,EDS 296,001,478927,Ambo; Theresa Jean,0,0,0,0
1708247549556,EDS 296,002,478935,Aragon; Maria Jose,0,0,0,1
1708247549556,EDS 296,003,478936,Chapman; Thandeka K,0,0,0,0
1708247549556,EDS 296,004,478942,Bintliff; Amy S.V.,0,0,0,0
1708247549556,EDS 296,005,478943,Clarke; Sherice Nicole,0,0,0,0
1708247549556,EDS 296,006,478967,Cohen; Shana R,0,0,0,1
1708247549556,EDS 296,007,478968,Datnow; Amanda Lee,0,0,0,0
1708247549556,EDS 296,008,478969,Daly; Alan J.,0,0,0,0
1708247549556,EDS 296,009,478970,Eguchi; Emi,0,0,0,0
1708247549556,EDS 296,010,478971,Fine; Sarah,0,0,0,0
1708247549556,EDS 296,011,478972,Jones; Gabrielle Anastasia,0,0,0,0
1708247549556,EDS 296,012,479020,Jones; Makeba,0,0,0,0
1708247549556,EDS 296,013,479021,Halter; Christopher P.,0,0,0,0
1708247549556,EDS 296,014,479027,Hofstetter; Carolyn,0,0,0,0
1708247549556,EDS 296,015,479028,Hopkins; Megan Beth,0,0,0,0
1708247549556,EDS 296,016,479034,Mamas; Christoforos,0,0,0,0
1708247549556,EDS 296,017,479035,Pollock; Mica,0,0,0,0
1708247549556,EDS 296,018,479036,Wishard Guerra; Alison G.,0,0,0,0
1708247549556,EDS 296,019,494549,Phuong; Andrew,0,0,0,0
1708247550093,EMED 296,001,464428,Singh; Sukhdeep,49,0,50,1
1708247550093,EMED 296,002,464438,Subramony; Rachna,49,0,50,1
1708247550093,EMED 296,003,464490,Staff,50,0,50,0
1708247550621,ENG 10,A00,399006,Evdokimenko; Ekaterina,30,0,30,0
1708247551153,ENG 100D,A00,399084,Ngo; Anh-Thu T.,33,0,50,17
1708247551680,ENG 100DR,A00,479230,Ngo; Anh-Thu T.,29,0,40,11
1708247552210,ENG 100L,A00,399163,Kleissl; Jan,6,0,6,0
1708247552210,ENG 100L,B00,399217,Bratton; Maryann,8,0,8,0
1708247552210,ENG 100L,C00,399218,Yu; Paul K L,8,0,8,0
1708247552210,ENG 100L,D00,399257,Bratton; Maryann,6,0,6,0
1708247552210,ENG 100L,E00,399258,de Oliveira; Mauricio,9,0,10,1
1708247552210,ENG 100L,F00,399314,Bratton; Maryann,7,0,7,0
1708247552210,ENG 100L,G00,399394,Boyle; Mary E. T.,14,0,15,1
1708247552778,ENVR 102,A00,400777,Daly; Heather Marie,19,0,20,1
1708247552778,ENVR 102,B00,400778,Montejo; Carolina,24,0,25,1
1708247552778,ENVR 102,C00,400791,Staff,23,0,25,2
1708247553303,ENVR 140,A01,400813,Siapno; Jacqueline A,12,0,15,3
1708247553303,ENVR 140,A02,400870,Siapno; Jacqueline A,15,0,15,0
1708247553303,ENVR 140,A03,400889,Siapno; Jacqueline A,15,0,15,0
1708247553303,ENVR 140,A04,400890,Siapno; Jacqueline A,15,0,15,0
1708247553829,ENVR 144,A01,400929,Herbst; Matthew,20,0,20,0
1708247554360,ERC 20,A00,400722,Evans; Ivan T,30,0,30,0
1708247554896,ESYS 103,A01,400931,Lerner; Amy M,32,0,34,2
1708247554896,ESYS 103,A02,400934,Lerner; Amy M,34,0,34,0
1708247554896,ESYS 103,A03,400938,Lerner; Amy M,28,0,34,6
1708247554896,ESYS 103,A04,400939,Lerner; Amy M,33,0,34,1
1708247554896,ESYS 103,A05,400940,Lerner; Amy M,34,0,34,0
1708247554896,ESYS 103,A06,400941,Lerner; Amy M,33,0,34,1
1708247555421,ESYS 187C,A01,400945,Hetherington; Elizabeth Dorsey,28,0,40,12
1708247555421,ESYS 187C,A02,400946,Hetherington; Elizabeth Dorsey,39,0,40,1
1708247555957,ETHN 3R,A01,400948,Streeby; Shelley,21,0,25,4
1708247555957,ETHN 3R,A02,401220,Streeby; Shelley,24,0,25,1
1708247555957,ETHN 3R,A03,401231,Streeby; Shelley,22,0,25,3
1708247555957,ETHN 3R,A04,401236,Streeby; Shelley,23,0,25,2
1708247555957,ETHN 3R,A05,401241,Streeby; Shelley,21,0,25,4
1708247555957,ETHN 3R,A06,401311,Streeby; Shelley,21,0,25,4
1708247555957,ETHN 3R,A07,401318,Streeby; Shelley,25,0,25,0
1708247555957,ETHN 3R,A08,401319,Streeby; Shelley,25,0,25,0
1708247555957,ETHN 3R,A09,401397,Streeby; Shelley,25,0,25,0
1708247555957,ETHN 3R,A10,401398,Streeby; Shelley,25,0,25,0
1708247555957,ETHN 3R,A11,401399,Streeby; Shelley,24,0,25,1
1708247555957,ETHN 3R,A12,401518,Streeby; Shelley,25,0,25,0
1708247555957,ETHN 3R,A13,401551,Streeby; Shelley,24,0,25,1
1708247555957,ETHN 3R,A14,401552,Streeby; Shelley,23,0,25,2
1708247556488,ETHN 30,A01,401554,Fuste; Jose Ignacio,24,0,25,1
1708247556488,ETHN 30,A02,401555,Fuste; Jose Ignacio,25,0,25,0
1708247556488,ETHN 30,A03,401556,Fuste; Jose Ignacio,25,0,25,0
1708247556488,ETHN 30,A04,401557,Fuste; Jose Ignacio,25,0,25,0
1708247557015,ETHN 100C,A00,401558,Museus; Samuel David,36,0,40,4
1708247557541,ETHN 101TV,A01,401560,Marez; Curtis F.,21,0,25,4
1708247557541,ETHN 101TV,A02,401564,Marez; Curtis F.,25,0,25,0
1708247558071,ETHN 108,A00,401584,Hankins; Sarah E.,25,0,29,4
1708247558603,ETHN 113A,A00,401657,Werner; Bradley T.,15,0,15,0
1708247559129,ETHN 114B,A00,401724,Frank; Ross H.,19,0,20,1
1708247559662,ETHN 120D,A01,401848,Alvarez; Luis A,8,0,10,2
1708247559662,ETHN 120D,A02,401853,Alvarez; Luis A,10,0,10,0
1708247560199,ETHN 125R,A00,401858,Sasaki; Christen T,39,0,50,11
1708247560726,ETHN 126,A00,401865,Tran; Ly Thi Hai,39,0,40,1
1708247561259,ETHN 127,A00,401866,Martin Sandino; Amanda Maria Yoland,24,0,25,1
1708247561791,ETHN 137,A00,401867,Martin Sandino; Amanda Maria Yoland,19,0,19,0
1708247562318,ETHN 139,A00,401992,Perreira; Christopher Michael,25,0,25,0
1708247562843,ETHN 143,A00,402059,Marez; Curtis F.,39,0,40,1
1708247563376,ETHN 144M,A00,402060,Jolivette; Andrew J,62,0,65,3
1708247563904,ETHN 150,A00,402158,Taylor-Garcia; Daphne,16,0,18,2
1708247564431,ETHN 153,A00,402160,Martinez-Matsuda; Veronica,24,0,25,1
1708247564963,ETHN 179,A00,402165,Richards; Stephanie F,23,0,25,2
1708247565495,ETHN 183,A00,402217,Steelman; Katherine Wallis,16,0,16,0
1708247566022,ETHN 186,A00,402313,Perez; Roy,15,0,15,0
1708247566550,ETHN 189,A00,479226,Museus; Samuel David,29,0,30,1
1708247567083,ETHN 196H,A00,402314,Espiritu; Yen,0,0,0,0
1708247567083,ETHN 196H,B00,402325,Perreira; Christopher Michael,0,0,0,0
1708247567083,ETHN 196H,C00,402344,Perez; Roy,0,0,0,0
1708247567083,ETHN 196H,D00,402345,Streeby; Shelley,0,0,0,0
1708247567083,ETHN 196H,E00,402346,Taylor-Garcia; Daphne,0,0,0,0
1708247567608,ETHN 200C,A00,402358,Fuste; Jose Ignacio,19,0,20,1
1708247568134,ETHN 230,A00,402359,Streeby; Shelley,16,0,20,4
1708247568663,ETHN 291,A00,402363,Perreira; Christopher Michael,16,0,20,4
1708247569191,EXPR 100,A00,477778,Staff,9999,0,9999,0
1708247569717,EXPR 105,A00,477779,Staff,9999,0,9999,0
1708247570247,EXPR 201,A00,477780,Staff,9999,0,9999,0
1708247570776,EXPR 205,A00,477781,Staff,9999,0,9999,0
1708247571309,FILM 87,A00,402794,Rahimi; Babak,19,0,20,1
1708247571309,FILM 87,B00,402796,Rahimi; Babak,20,0,20,0
1708247571309,FILM 87,C00,402821,Havis; Allan,19,0,20,1
1708247571840,FMPH 95,A00,481734,Larsen; Britta Ann,0,0,0,2
1708247572368,FMPH 101,A00,404648,Tan; Gene Brian,31,0,40,9
1708247572899,FMPH 102,A01,404692,Rana; Brinda Kanti,25,0,28,3
1708247572899,FMPH 102,A02,404714,Rana; Brinda Kanti,28,0,28,0
1708247572899,FMPH 102,B01,404739,Rana; Brinda Kanti,26,0,28,2
1708247572899,FMPH 102,B02,404746,Rana; Brinda Kanti,28,0,28,0
1708247573428,FMPH 110,A00,404747,Campbell; Chadwick Karl,52,0,55,3
1708247573428,FMPH 110,B00,404789,Zoumas-Morse; Christine E.,24,0,30,6
1708247573959,FMPH 120,A00,404792,Nguyen-Grozavu; France T.,48,0,60,12
1708247574486,FMPH 130,A00,404859,Gould; Carlos Francisco,49,0,55,6
1708247574486,FMPH 130,B00,479047,Ciborowski; Haley Minae,52,0,55,3
1708247575012,FMPH 155,A00,404864,Fielding-Miller; Rebecca,65,0,65,0
1708247575537,FMPH 161,A00,404865,Zoumas-Morse; Christine E.,27,0,35,8
1708247576069,FMPH 191,A00,404866,Eikey; Elizabeth Victoria,35,0,35,0
1708247576696,FMPH 194,A00,404938,Larsen; Britta Ann,0,0,0,0
1708247576696,FMPH 194,B00,404939,Marquez; Becky,0,0,0,0
1708247576696,FMPH 194,C00,404949,Nguyen-Grozavu; France T.,0,0,0,0
1708247576696,FMPH 194,D00,404950,Stone; Matthew David,0,0,0,0
1708247576696,FMPH 194,E00,404958,White; Anne Elizabeth Clar,0,0,0,0
1708247576696,FMPH 194,F00,404969,Zoumas-Morse; Christine E.,0,0,0,0
1708247577225,FMPH 223,A00,404977,Vaida; Florin,8,0,26,18
1708247577752,FMPH 225,A00,404978,Zou; Jingjing,0,0,0,0
1708247578283,FMPH 291,A00,404992,Salem; Rany Mansour,15,0,15,0
1708247578283,FMPH 291,C00,405005,Schwartzman; Armin,0,0,0,10
1708247578283,FMPH 291,D00,479113,Shadyab; Aladdin Hassan,0,0,0,0
1708247578283,FMPH 291,E00,479114,Shadyab; Aladdin Hassan,0,0,0,0
1708247578283,FMPH 291,F00,479115,Wynn; Adriane Michelle,0,0,0,3
1708247578283,FMPH 291,G00,479116,Xu; Ronghui,0,0,0,10
1708247578283,FMPH 291,H00,479119,Vaida; Florin,0,0,0,2
1708247578809,FPM 258C,A00,405129,Chen; Brian Hwa-Yang,11,0,15,4
1708247579341,FPM 259C,A00,405130,Nguyen; Annie Lu & Araneta; Maria Rosario Gorrez,4,0,5,1
1708247579868,FPM 278,A00,405131,Strong; David R,13,0,15,2
1708247580399,FPM 280C,A01,405133,Banegas; Matthew Patrick,10,0,10,0
1708247580925,FPM 296,001,464651,Johnson; Michelle Lee,49,0,50,1
1708247580925,FPM 296,002,464652,Staff,50,0,50,0
1708247580925,FPM 296,003,464653,Staff,50,0,50,0
1708247581454,FPM 297,001,479175,Vaida; Florin,9999,0,9999,0
1708247581454,FPM 297,002,494007,Strong; David R,9999,0,9999,0
1708247581454,FPM 297,003,494364,Bazzi; Angela Robertson,9999,0,9999,0
1708247581987,GLBH 20,A00,405134,Elwardani; Nile Regina,143,0,146,3
1708247582528,GLBH 100,A00,405135,Bhavsar; Radhika,68,0,70,2
1708247582528,GLBH 100,B00,477773,Villarino; Margarita,39,0,44,5
1708247582528,GLBH 100,C00,477855,Jenkins; Janis A.,20,0,20,0
1708247582528,GLBH 100,D00,481337,Mishra; Jyoti,40,0,40,0
1708247583056,GLBH 101,A00,405136,Sloane; Julia Kathryn,40,0,40,0
1708247583584,GLBH 107,A00,405137,Wilson; Brenda K,63,0,70,7
1708247584111,GLBH 111,A01,486865,Burgos; Jose L.,0,0,0,0
1708247584111,GLBH 111,B01,486867,Burgos; Jose L.,0,0,0,0
1708247584640,GLBH 114W,A00,405138,Walkover; Lillian B,17,0,17,0
1708247585169,GLBH 118,A00,405140,Wilson; Brenda K,31,0,32,1
1708247585702,GLBH 147,A00,405141,Stewart; Alexander B,40,0,40,0
1708247586231,GLBH 148,A00,405142,Olivas Hernandez; Olga Lid,93,0,100,7
1708247586758,GLBH 150B,A00,486855,Sanchez; Giselle,0,0,0,0
1708247587283,GLBH 181,A00,405154,Burgos; Jose L.,211,0,216,5
1708247587813,GLBH 215,A00,479241,Walkover; Lillian B,18,0,18,0
1708247588342,GLBH 260,A00,480722,Elwardani; Nile Regina,18,0,18,0
1708247588868,GSS 20,A00,405155,Siapno; Jacqueline A,25,0,30,5
1708247589394,GSS 25,A00,405156,Batarseh; Amanda Alicia,24,0,30,6
1708247589929,HDS 1,A01,405160,Reese; Clarissa Jane,25,0,25,0
1708247589929,HDS 1,A02,405168,Reese; Clarissa Jane,25,0,25,0
1708247589929,HDS 1,A03,405169,Reese; Clarissa Jane,22,0,25,3
1708247589929,HDS 1,A04,405170,Reese; Clarissa Jane,24,0,25,1
1708247589929,HDS 1,A05,405171,Reese; Clarissa Jane,23,0,25,2
1708247589929,HDS 1,A06,405172,Reese; Clarissa Jane,24,0,25,1
1708247589929,HDS 1,A07,405173,Reese; Clarissa Jane,24,0,25,1
1708247590459,HDS 60,A01,405175,Warstadt; Melissa Fawn,34,0,35,1
1708247590459,HDS 60,A02,405176,Warstadt; Melissa Fawn,33,0,35,2
1708247590984,HDS 95,A00,405177,Staff,38,0,40,2
1708247591513,HDS 120,A00,405178,Staff,0,0,0,0
1708247592038,HDS 122,A00,405179,Rodriguez; Victoria Calip,64,0,75,11
1708247592564,HDS 150,A00,405180,Staff,20,0,20,0
1708247592564,HDS 150,B00,405181,Staff,20,0,20,0
1708247592564,HDS 150,C00,405182,Staff,20,0,20,0
1708247593090,HDS 181,A01,405185,Bjorklund; Peter,30,0,30,0
1708247593632,HDS 191,A01,405187,Reese; Clarissa Jane,40,0,40,0
1708247593632,HDS 191,B01,405194,Staff,25,0,25,0
1708247594163,HIAF 113,A00,403736,Prestholdt; Jeremy,74,0,75,1
1708247594689,HIAF 114,A00,403738,Gyamfi; Bright,49,0,50,1
1708247595220,HIEA 132,A00,403740,Kletzer; Benjamin Nathan,25,0,30,5
1708247595746,HIEA 154,A00,403741,Henry; Todd A.,62,0,64,2
1708247596272,HIEU 139,A00,403742,Strasser; Ulrike,52,0,56,4
1708247596801,HIEU 171,A00,403743,Hansen; Jan Eric,62,0,64,2
1708247597332,HIEU 176,A00,403744,Hertz; Deborah,14,0,15,1
1708247597858,HIEU 183,A00,403800,Gallant; Thomas W.,15,0,15,0
1708247598384,HIEU 276,A00,403862,Hertz; Deborah,0,0,0,0
1708247598915,HIGL 127,A00,403802,Ivey; James Alexander,56,0,56,0
1708247599441,HIGR 201,A00,494372,Pineda De Avila; Nydia,9,0,10,1
1708247599971,HIGR 205,A00,403863,Strasser; Ulrike,11,0,15,4
1708247600499,HIGR 217C,A00,403864,Lu; Weijing,9,0,10,1
1708247601026,HIGR 239,A00,403865,Serlin; David,4,0,5,1
1708247601555,HIGR 240,A00,403875,Gates; Kelly,2,0,5,3
1708247602087,HILA 101,A00,403818,LeNeave; Kimiko Nicole,62,0,64,2
1708247602615,HILA 119,A00,403819,Kozameh; Sara J,47,0,50,3
1708247603146,HILA 144,A00,403821,Kozameh; Sara J,50,0,50,0
1708247603681,HILD 2C,A01,402843,Hendrickson; Gerald M.,31,0,32,1
1708247603681,HILD 2C,A02,403030,Hendrickson; Gerald M.,31,0,32,1
1708247603681,HILD 2C,A03,403042,Hendrickson; Gerald M.,32,0,32,0
1708247603681,HILD 2C,A04,403048,Hendrickson; Gerald M.,30,0,32,2
1708247603681,HILD 2C,A05,403049,Hendrickson; Gerald M.,32,0,32,0
1708247603681,HILD 2C,A06,403098,Hendrickson; Gerald M.,32,0,32,0
1708247604223,HILD 7C,A01,403501,Bermudez; Rosie Cano,27,0,32,5
1708247604223,HILD 7C,A02,403513,Bermudez; Rosie Cano,30,0,32,2
1708247604223,HILD 7C,A03,403570,Bermudez; Rosie Cano,32,0,32,0
1708247604223,HILD 7C,A04,403572,Bermudez; Rosie Cano,32,0,32,0
1708247604223,HILD 7C,A05,403587,Bermudez; Rosie Cano,32,0,32,0
1708247604223,HILD 7C,A06,403588,Bermudez; Rosie Cano,32,0,32,0
1708247604223,HILD 7C,A07,403589,Bermudez; Rosie Cano,29,0,32,3
1708247604223,HILD 7C,A08,403590,Bermudez; Rosie Cano,32,0,32,0
1708247604223,HILD 7C,A09,403601,Bermudez; Rosie Cano,30,0,32,2
1708247604223,HILD 7C,A10,403602,Bermudez; Rosie Cano,32,0,32,0
1708247604223,HILD 7C,A11,403603,Bermudez; Rosie Cano,32,0,32,0
1708247604223,HILD 7C,A12,403604,Bermudez; Rosie Cano,32,0,32,0
1708247604750,HILD 12,A01,403607,Henry; Todd A.,32,0,32,0
1708247604750,HILD 12,A02,403608,Henry; Todd A.,31,0,32,1
1708247604750,HILD 12,A03,403609,Henry; Todd A.,32,0,32,0
1708247604750,HILD 12,A04,403699,Henry; Todd A.,32,0,32,0
1708247604750,HILD 12,A05,403700,Henry; Todd A.,32,0,32,0
1708247604750,HILD 12,A06,403701,Henry; Todd A.,32,0,32,0
1708247605276,HILD 30,A01,403703,Soleiman; Matthew Teymour,29,0,32,3
1708247605276,HILD 30,A02,403704,Soleiman; Matthew Teymour,30,0,32,2
1708247605805,HINE 118,A00,403822,Kayali; Hasan,50,0,50,0
1708247606336,HISC 119,A00,403823,Golan; Tal,26,0,30,4
1708247606863,HISC 123,A00,403839,Pineda De Avila; Nydia,45,0,50,5
1708247607390,HITO 87,A00,403707,Patterson; Patrick H.,15,0,15,0
1708247607390,HITO 87,B00,403709,Patterson; Patrick H.,15,0,15,0
1708247607390,HITO 87,C00,403735,Schneewind; Sarah,15,0,15,0
1708247607917,HITO 100,B00,403841,Klann; Mary Cameron,24,0,25,1
1708247608443,HITO 170,A00,403842,Watts; Edward J.,8,0,10,2
1708247608970,HITO 193,A00,455333,Hill; Seth J,0,0,0,0
1708247609497,HIUS 114A,A00,403843,Lewandoski; Julia Mavis,52,0,56,4
1708247610024,HIUS 120D,A01,403854,Alvarez; Luis A,8,0,10,2
1708247610024,HIUS 120D,A02,403855,Alvarez; Luis A,10,0,10,0
1708247610554,HIUS 136,A00,403857,Martinez-Matsuda; Veronica,21,0,25,4
1708247611090,HIUS 144,A00,403858,Martinez-Matsuda; Veronica,55,0,56,1
1708247611090,HIUS 144,B00,403859,Vandevelde; Kenneth Joseph,54,0,56,2
1708247611090,HIUS 144,C00,403860,Klann; Mary Cameron,52,0,56,4
1708247611090,HIUS 144,D00,403861,Lewandoski; Julia Mavis,55,0,56,1
1708247611692,HUM 2,A01,422723,Watts; Edward J.,16,0,16,0
1708247611692,HUM 2,A02,422735,Watts; Edward J.,15,0,16,1
1708247611692,HUM 2,A03,422736,Watts; Edward J.,15,0,16,1
1708247611692,HUM 2,A04,422737,Watts; Edward J.,16,0,16,0
1708247611692,HUM 2,A05,422738,Watts; Edward J.,15,0,16,1
1708247611692,HUM 2,A06,422760,Watts; Edward J.,15,0,16,1
1708247611692,HUM 2,A07,422778,Watts; Edward J.,16,0,16,0
1708247611692,HUM 2,A08,422793,Watts; Edward J.,16,0,16,0
1708247611692,HUM 2,A09,422794,Watts; Edward J.,16,0,16,0
1708247611692,HUM 2,A10,422795,Watts; Edward J.,16,0,16,0
1708247611692,HUM 2,B01,422805,Markman; Kristina,13,0,16,3
1708247611692,HUM 2,B02,422806,Markman; Kristina,14,0,16,2
1708247611692,HUM 2,B03,422807,Markman; Kristina,14,0,16,2
1708247611692,HUM 2,B04,422808,Markman; Kristina,16,0,16,0
1708247611692,HUM 2,B05,422809,Markman; Kristina,16,0,16,0
1708247611692,HUM 2,B06,422842,Markman; Kristina,16,0,16,0
1708247611692,HUM 2,B07,422843,Markman; Kristina,15,0,16,1
1708247611692,HUM 2,B08,422848,Markman; Kristina,16,0,16,0
1708247611692,HUM 2,B09,422850,Markman; Kristina,15,0,16,1
1708247611692,HUM 2,B10,422851,Markman; Kristina,12,0,16,4
1708247611692,HUM 2,B11,422852,Markman; Kristina,15,0,16,1
1708247611692,HUM 2,B12,422853,Markman; Kristina,16,0,16,0
1708247611692,HUM 2,C01,422855,Rodriguez; Bretton Sigfred,15,0,16,1
1708247611692,HUM 2,C02,422856,Rodriguez; Bretton Sigfred,16,0,16,0
1708247611692,HUM 2,C03,422859,Rodriguez; Bretton Sigfred,15,0,16,1
1708247611692,HUM 2,C04,423106,Rodriguez; Bretton Sigfred,12,0,16,4
1708247611692,HUM 2,C05,423107,Rodriguez; Bretton Sigfred,15,0,16,1
1708247611692,HUM 2,C06,423108,Rodriguez; Bretton Sigfred,14,0,16,2
1708247611692,HUM 2,C07,423109,Rodriguez; Bretton Sigfred,15,0,16,1
1708247611692,HUM 2,C08,423110,Rodriguez; Bretton Sigfred,15,0,16,1
1708247611692,HUM 2,C09,423133,Rodriguez; Bretton Sigfred,14,0,16,2
1708247611692,HUM 2,C10,423134,Rodriguez; Bretton Sigfred,14,0,16,2
1708247611692,HUM 2,C11,423135,Rodriguez; Bretton Sigfred,16,0,16,0
1708247611692,HUM 2,C12,423136,Rodriguez; Bretton Sigfred,15,0,16,1
1708247611692,HUM 2,C13,423137,Rodriguez; Bretton Sigfred,16,0,16,0
1708247611692,HUM 2,C14,423138,Rodriguez; Bretton Sigfred,16,0,16,0
1708247611692,HUM 2,D01,423140,West; Geoffrey Scott,13,0,16,3
1708247611692,HUM 2,D02,423141,West; Geoffrey Scott,15,0,16,1
1708247611692,HUM 2,D03,423142,West; Geoffrey Scott,15,0,16,1
1708247611692,HUM 2,D04,423143,West; Geoffrey Scott,14,0,16,2
1708247611692,HUM 2,D05,423144,West; Geoffrey Scott,16,0,16,0
1708247611692,HUM 2,D06,423145,West; Geoffrey Scott,16,0,16,0
1708247611692,HUM 2,D07,423146,West; Geoffrey Scott,16,0,16,0
1708247611692,HUM 2,D08,423158,West; Geoffrey Scott,16,0,16,0
1708247611692,HUM 2,D09,423169,West; Geoffrey Scott,16,0,16,0
1708247611692,HUM 2,D10,423174,West; Geoffrey Scott,16,0,16,0
1708247611692,HUM 2,D11,423175,West; Geoffrey Scott,16,0,16,0
1708247611692,HUM 2,D12,423179,West; Geoffrey Scott,15,0,16,1
1708247611692,HUM 2,D13,423188,West; Geoffrey Scott,15,0,16,1
1708247611692,HUM 2,D14,423204,West; Geoffrey Scott,16,0,16,0
1708247612519,HUM 5,A01,423221,Lyon; Antony J.,26,0,30,4
1708247612519,HUM 5,A02,423232,Lyon; Antony J.,24,0,30,6
1708247612519,HUM 5,A03,423237,Lyon; Antony J.,18,0,30,12
1708247612519,HUM 5,A04,423240,Lyon; Antony J.,25,0,30,5
1708247612519,HUM 5,A05,423242,Lyon; Antony J.,28,0,30,2
1708247612519,HUM 5,A06,423244,Lyon; Antony J.,23,0,30,7
1708247612519,HUM 5,A07,423247,Lyon; Antony J.,27,0,30,3
1708247612519,HUM 5,A08,423254,Lyon; Antony J.,27,0,30,3
1708247612519,HUM 5,B01,423286,Patterson; Patrick H.,28,0,30,2
1708247612519,HUM 5,B02,423291,Patterson; Patrick H.,29,0,30,1
1708247612519,HUM 5,B03,423294,Patterson; Patrick H.,28,0,30,2
1708247612519,HUM 5,B04,423297,Patterson; Patrick H.,29,0,30,1
1708247612519,HUM 5,B05,423313,Patterson; Patrick H.,30,0,30,0
1708247612519,HUM 5,B06,423318,Patterson; Patrick H.,30,0,30,0
1708247612519,HUM 5,B07,423362,Patterson; Patrick H.,29,0,30,1
1708247612519,HUM 5,B08,423363,Patterson; Patrick H.,29,0,30,1
1708247612519,HUM 5,C01,423365,Caldwell; Michael Alan,23,0,30,7
1708247612519,HUM 5,C02,423474,Caldwell; Michael Alan,24,0,30,6
1708247612519,HUM 5,C03,423528,Caldwell; Michael Alan,30,0,30,0
1708247612519,HUM 5,C04,423529,Caldwell; Michael Alan,27,0,30,3
1708247612519,HUM 5,C05,423545,Caldwell; Michael Alan,30,0,30,0
1708247612519,HUM 5,C06,423546,Caldwell; Michael Alan,30,0,30,0
1708247612519,HUM 5,C07,423547,Caldwell; Michael Alan,29,0,30,1
1708247612519,HUM 5,C08,423548,Caldwell; Michael Alan,28,0,30,2
1708247613048,INTL 101,A01,404350,Day; Joel Keith,23,0,25,2
1708247613048,INTL 101,A02,404356,Day; Joel Keith,25,0,25,0
1708247613048,INTL 101,A03,404357,Day; Joel Keith,24,0,25,1
1708247613048,INTL 101,A04,404360,Day; Joel Keith,25,0,25,0
1708247613579,INTL 102,A01,404375,Fisk; David Lee,25,0,25,0
1708247613579,INTL 102,A02,404376,Fisk; David Lee,22,0,25,3
1708247613579,INTL 102,A03,404377,Fisk; David Lee,20,0,25,5
1708247613579,INTL 102,A04,404381,Fisk; David Lee,25,0,25,0
1708247614121,INTL 190,A00,404396,Samphantharak; Krislert,24,0,25,1
1708247614121,INTL 190,B00,404402,McIntosh; Justin Daniel,24,0,25,1
1708247614121,INTL 190,C00,404403,Vos; Stacie N.,24,0,25,1
1708247614121,INTL 190,D00,404404,Nadkarni; Vidya,24,0,25,1
1708247614121,INTL 190,E00,404407,Scott; Jeffrey F,25,0,25,0
1708247614121,INTL 190,F00,404409,Auerbach; Bradford C,25,0,25,0
1708247614121,INTL 190,G00,404442,Auerbach; Bradford C,25,0,25,0
1708247614121,INTL 190,H00,404465,Segui; Alan S,25,0,25,0
1708247614121,INTL 190,I00,404481,Segui; Alan S,25,0,25,0
1708247615746,JAPN 10C,A01,403881,Iwamoto; Naoki,15,0,15,0
1708247615746,JAPN 10C,B01,403884,McKee; Mayumi Mochizuki,15,0,15,0
1708247615746,JAPN 10C,C01,403887,Sato; Kyoko,10,0,10,0
1708247615746,JAPN 10C,C02,403888,Sato; Kyoko,10,0,10,0
1708247615746,JAPN 10C,D01,403890,Inada; Minori,8,0,10,2
1708247615746,JAPN 10C,D02,403891,Inada; Minori,10,0,10,0
1708247615746,JAPN 10C,E01,403893,Sato; Kyoko,10,0,10,0
1708247615746,JAPN 10C,E02,403894,Sato; Kyoko,10,0,10,0
1708247615746,JAPN 10C,F01,403896,McKee; Mayumi Mochizuki,10,0,10,0
1708247615746,JAPN 10C,F02,403897,McKee; Mayumi Mochizuki,10,0,10,0
1708247615746,JAPN 10C,G01,403899,Homma; Kunihiko,10,0,10,0
1708247615746,JAPN 10C,G02,403900,Homma; Kunihiko,10,0,10,0
1708247615746,JAPN 10C,H01,403902,Maruyama; Rie,10,0,10,0
1708247615746,JAPN 10C,H02,403903,Maruyama; Rie,9,0,10,1
1708247615746,JAPN 10C,I01,403905,Inada; Minori,10,0,10,0
1708247615746,JAPN 10C,I02,403906,Inada; Minori,9,0,10,1
1708247615746,JAPN 10C,J01,403915,Iwamoto; Naoki,10,0,10,0
1708247615746,JAPN 10C,J02,403916,Iwamoto; Naoki,9,0,10,1
1708247615746,JAPN 10C,K01,403918,Ross; Kayoko F,10,0,10,0
1708247615746,JAPN 10C,K02,403928,Ross; Kayoko F,10,0,10,0
1708247615746,JAPN 10C,L01,403935,Homma; Kunihiko,9,0,10,1
1708247615746,JAPN 10C,L02,403936,Homma; Kunihiko,10,0,10,0
1708247615746,JAPN 10C,M02,403939,Kamioka; Sachiko,13,0,15,2
1708247615746,JAPN 10C,N01,479041,Iwamoto; Naoki,15,0,15,0
1708247616337,JAPN 10CR,A01,403982,Inada; Minori,12,0,12,0
1708247616337,JAPN 10CR,A02,403983,Inada; Minori,12,0,12,0
1708247616914,JAPN 20C,A01,403988,Homma; Kunihiko,10,0,12,2
1708247616914,JAPN 20C,B02,404029,Kamioka; Sachiko,10,0,12,2
1708247616914,JAPN 20C,C01,404033,Takeda; Izumi,8,0,12,4
1708247616914,JAPN 20C,D02,404114,Kamioka; Sachiko,11,0,12,1
1708247616914,JAPN 20C,E01,404135,Simpson; Junko Tokuda,12,0,12,0
1708247617462,JAPN 130C,A01,404144,Maruyama; Rie,9,0,9,0
1708247617462,JAPN 130C,A02,404145,Maruyama; Rie,9,0,9,0
1708247617462,JAPN 130C,B01,404147,Simpson; Junko Tokuda,8,0,9,1
1708247617462,JAPN 130C,B02,404148,Simpson; Junko Tokuda,9,0,9,0
1708247617993,JAPN 135C,A00,404176,Ross; Kayoko F,16,0,16,0
1708247617993,JAPN 135C,B00,404253,Takeda; Izumi,14,0,16,2
1708247618520,JAPN 140C,A00,404255,Sato; Kyoko,18,0,20,2
1708247619047,JAPN 150C,A00,404258,McKee; Mayumi Mochizuki,14,0,14,0
1708247619574,JAPN 190,A00,404260,Miyao; Daisuke,17,0,20,3
1708247620102,JAPN 196B,001,487237,Turner; Christena L.,9999,0,9999,0
1708247620630,JWSP 3,A01,404485,Shuster; Alana,20,0,20,0
1708247621164,LATI 10,A01,405201,Kennemore; Amy Michelle,27,0,30,3
1708247621164,LATI 10,A02,405202,Kennemore; Amy Michelle,27,0,30,3
1708247621164,LATI 10,A03,405208,Kennemore; Amy Michelle,28,0,30,2
1708247621692,LATI 50,A01,405214,Kokinis; Troy Andreas,34,0,35,1
1708247621692,LATI 50,A02,405215,Kokinis; Troy Andreas,34,0,35,1
1708247622222,LATI 130,A01,482880,Alvarez; Camila Huerta,29,0,30,1
1708247622753,LATI 160,A01,477482,Kokinis; Troy Andreas,30,0,30,0
1708247623287,LATI 180,A00,405221,Kennemore; Amy Michelle,28,0,30,2
1708247623287,LATI 180,B00,405222,Mostajo; Lorena,30,0,30,0
1708247623819,LIAB 1C,A00,405278,Saab; Dima,13,0,14,1
1708247623819,LIAB 1C,B00,405279,Saab; Dima,11,0,14,3
1708247624347,LIAB 1CX,A00,405281,Akjeje; Abdelhak,19,0,20,1
1708247624347,LIAB 1CX,B00,405291,Akjeje; Abdelhak,20,0,20,0
1708247624874,LIAB 1F,A00,482814,El Cheddadi; Youniss,14,0,14,0
1708247625406,LIDS 19,001,492979,Goodall; Grant Todd,9999,0,9999,0
1708247625406,LIDS 19,002,492980,Goodall; Grant Todd,9999,0,9999,0
1708247625406,LIDS 19,003,492981,Goodall; Grant Todd,9999,0,9999,0
1708247625406,LIDS 19,004,492982,Goodall; Grant Todd,9999,0,9999,0
1708247625406,LIDS 19,005,492983,Goodall; Grant Todd,9999,0,9999,0
1708247625406,LIDS 19,006,492984,Goodall; Grant Todd,9999,0,9999,0
1708247625406,LIDS 19,007,492985,Goodall; Grant Todd,9999,0,9999,0
1708247625406,LIDS 19,008,492986,Goodall; Grant Todd,9999,0,9999,0
1708247625406,LIDS 19,009,492987,Goodall; Grant Todd,9999,0,9999,0
1708247625406,LIDS 19,010,492988,Goodall; Grant Todd,9999,0,9999,0
1708247625406,LIDS 19,011,492989,Goodall; Grant Todd,9999,0,9999,0
1708247625406,LIDS 19,012,492990,Goodall; Grant Todd,9999,0,9999,0
1708247625939,LIFR 1A,A00,405299,Van Moer; Vinciane G,13,0,14,1
1708247625939,LIFR 1A,B00,405300,Van Moer; Vinciane G,13,0,14,1
1708247625939,LIFR 1A,C00,405301,Van Moer; Vinciane G,13,0,14,1
1708247625939,LIFR 1A,D00,405307,Van Moer; Vinciane G,14,0,14,0
1708247627485,LIFR 1AX,A00,405308,Van Moer; Vinciane G,27,0,28,1
1708247627485,LIFR 1AX,B00,405309,Van Moer; Vinciane G,27,0,28,1
1708247628046,LIFR 1C,A00,405310,Van Moer; Vinciane G,14,0,14,0
1708247628046,LIFR 1C,B00,405311,Van Moer; Vinciane G,12,0,14,2
1708247628046,LIFR 1C,C00,405325,Van Moer; Vinciane G,13,0,14,1
1708247628046,LIFR 1C,D00,405326,Van Moer; Vinciane G,11,0,14,3
1708247628591,LIFR 1CX,A00,405332,Van Moer; Vinciane G,25,0,28,3
1708247628591,LIFR 1CX,B00,405333,Van Moer; Vinciane G,27,0,28,1
1708247629118,LIFR 1D,A00,405334,Van Moer; Vinciane G,13,0,14,1
1708247629118,LIFR 1D,B00,405335,Van Moer; Vinciane G,13,0,14,1
1708247629118,LIFR 1D,C00,405336,Van Moer; Vinciane G,13,0,14,1
1708247629118,LIFR 1D,D00,405337,Van Moer; Vinciane G,13,0,14,1
1708247629645,LIFR 1DX,A00,405338,Van Moer; Vinciane G,25,0,28,3
1708247629645,LIFR 1DX,B00,405394,Van Moer; Vinciane G,27,0,28,1
1708247630175,LIFR 11,001,405395,Goodall; Grant Todd,999,0,999,0
1708247630708,LIGM 1C,A00,405398,Fischer-Grunski; Eva K,12,0,14,2
1708247630708,LIGM 1C,B00,405400,Fischer-Grunski; Eva K,13,0,14,1
1708247630708,LIGM 1C,C00,405403,Fischer-Grunski; Eva K,13,0,14,1
1708247630708,LIGM 1C,D00,405404,Fischer-Grunski; Eva K,13,0,14,1
1708247631254,LIGM 1CX,A00,405407,Fischer-Grunski; Eva K,27,0,28,1
1708247631254,LIGM 1CX,B00,405408,Fischer-Grunski; Eva K,26,0,28,2
1708247631783,LIGM 11,001,405464,Goodall; Grant Todd,999,0,999,0
1708247632309,LIGN 8,A00,411133,McIntosh; Justin Daniel,232,0,240,8
1708247632917,LIGN 17,A00,411141,Kehler; Andrew Scott,287,0,300,13
1708247633444,LIGN 101,A01,411144,Staff,28,0,30,2
1708247633444,LIGN 101,A02,411147,Staff,29,0,30,1
1708247633444,LIGN 101,A03,411154,Staff,27,0,30,3
1708247633444,LIGN 101,A04,411163,Staff,29,0,30,1
1708247633975,LIGN 120,A01,411165,Ackerman; Farrell,28,0,30,2
1708247633975,LIGN 120,A02,411177,Ackerman; Farrell,23,0,27,4
1708247635518,LIGN 130,A01,411223,Staff,29,0,30,1
1708247635518,LIGN 130,A02,411231,Staff,30,0,30,0
1708247635518,LIGN 130,A03,411232,Staff,29,0,30,1
1708247636044,LIGN 141,A00,411276,Rose; Sharon,37,0,40,3
1708247636570,LIGN 144,A00,411277,Lott; Margaret S.,22,0,24,2
1708247637103,LIGN 148,A00,411278,Mayberry; Rachel,71,0,75,4
1708247637630,LIGN 165,A00,411279,Bergen; Leon,41,0,70,29
1708247638157,LIGN 168,A01,411281,Styler; William Francis,65,0,70,5
1708247638684,LIGN 175,A00,482816,Rodriguez Aispuro; Alejandro,35,0,40,5
1708247639210,LIGN 230,A00,411293,Caponigro; Ivano,19,0,20,1
1708247639743,LIGN 238,A00,411308,Bergen; Benjamin,20,0,20,0
1708247640286,LIGN 252,A00,411309,Bergen; Leon,28,0,30,2
1708247640814,LIGN 256,A00,411310,Nakashole; Ndapandula,0,0,5,5
1708247641341,LIGN 272,A00,482887,Kluender; Robert,10,0,10,0
1708247641867,LIHL 112P,A00,405228,Pagkalinawan; Leticia Cant,27,0,28,1
1708247642393,LIHL 114P,A00,405229,Nguyen; Hoan Thi,26,0,28,2
1708247642924,LIHL 117P,A00,405256,Sadegholvad; Elham,27,0,28,1
1708247643453,LIHL 118,A00,405257,Chen; Areana Yen,28,0,28,0
1708247643996,LIHL 124P,A00,405262,Nguyen; Hoan Thi,28,0,28,0
1708247644528,LIHL 132P,A00,405263,Pagkalinawan; Leticia Cant,28,0,28,0
1708247645055,LIHL 134P,A00,405269,Nguyen; Hoan Thi,28,0,28,0
1708247645580,LIHL 138,A00,405270,Chen; Areana Yen,27,0,28,1
1708247646106,LIIT 1C,A00,405465,Carnelos; Chiara,12,0,14,2
1708247646106,LIIT 1C,B00,405466,Carnelos; Chiara,14,0,14,0
1708247646632,LIIT 1CX,A00,405594,Carnelos; Chiara,28,0,28,0
1708247647158,LIPO 1C,A00,405595,Paladini; Denise,13,0,14,1
1708247647158,LIPO 1C,B00,405596,Paladini; Denise,14,0,14,0
1708247647689,LIPO 1CX,A00,405597,De Abreu; Cassia,28,0,28,0
1708247648216,LISL 1A,C00,405600,Lott; Margaret S.,13,0,14,1
1708247648216,LISL 1A,D00,405601,Lott; Margaret S.,10,0,14,4
1708247648216,LISL 1A,E00,405602,Lott; Margaret S.,13,0,14,1
1708247648216,LISL 1A,F00,405603,Lott; Margaret S.,13,0,14,1
1708247648747,LISL 1AR,A00,480605,Lott; Margaret S.,13,0,15,2
1708247648747,LISL 1AR,B00,480606,Lott; Margaret S.,14,0,15,1
1708247649277,LISL 1AX,A00,405754,Lott; Margaret S.,26,0,28,2
1708247649277,LISL 1AX,B00,405755,Lott; Margaret S.,23,0,28,5
1708247649805,LISL 1C,A00,405776,Lott; Margaret S.,13,0,14,1
1708247649805,LISL 1C,B00,405779,Lott; Margaret S.,14,0,14,0
1708247649805,LISL 1C,C00,405785,Lott; Margaret S.,14,0,14,0
1708247649805,LISL 1C,D00,405787,Lott; Margaret S.,9,0,14,5
1708247649805,LISL 1C,E00,405827,Lott; Margaret S.,12,0,14,2
1708247649805,LISL 1C,F00,405830,Lott; Margaret S.,13,0,14,1
1708247650333,LISL 1CX,A00,405844,Lott; Margaret S.,25,0,28,3
1708247650333,LISL 1CX,B00,405848,Lott; Margaret S.,25,0,28,3
1708247650333,LISL 1CX,C00,405849,Lott; Margaret S.,28,0,28,0
1708247650860,LISL 1D,A00,405850,Lott; Margaret S.,8,0,14,6
1708247650860,LISL 1D,B00,405851,Lott; Margaret S.,13,0,14,1
1708247650860,LISL 1D,C00,405852,Lott; Margaret S.,10,0,14,4
1708247651391,LISL 1DX,A00,405854,Lott; Margaret S.,17,0,22,5
1708247651391,LISL 1DX,B00,405855,Lott; Margaret S.,18,0,22,4
1708247651934,LISP 1A,001,405856,Munoz Sanchez; Alicia,11,0,14,3
1708247651934,LISP 1A,002,405857,Munoz Sanchez; Alicia,13,0,14,1
1708247651934,LISP 1A,003,405858,Munoz Sanchez; Alicia,14,0,14,0
1708247651934,LISP 1A,004,405861,Munoz Sanchez; Alicia,14,0,14,0
1708247653476,LISP 1AX,001,405862,Munoz Sanchez; Alicia,28,0,28,0
1708247653476,LISP 1AX,002,405863,Munoz Sanchez; Alicia,25,0,28,3
1708247654019,LISP 1C,001,405864,Munoz Sanchez; Alicia,13,0,14,1
1708247654019,LISP 1C,002,405865,Munoz Sanchez; Alicia,12,0,14,2
1708247654019,LISP 1C,003,405879,Munoz Sanchez; Alicia,12,0,14,2
1708247654019,LISP 1C,004,405880,Munoz Sanchez; Alicia,13,0,14,1
1708247654019,LISP 1C,005,405881,Munoz Sanchez; Alicia,12,0,14,2
1708247654019,LISP 1C,006,405882,Munoz Sanchez; Alicia,12,0,14,2
1708247654019,LISP 1C,007,405904,Munoz Sanchez; Alicia,14,0,14,0
1708247654019,LISP 1C,008,405905,Munoz Sanchez; Alicia,14,0,14,0
1708247654019,LISP 1C,009,405908,Munoz Sanchez; Alicia,14,0,14,0
1708247654019,LISP 1C,010,405917,Munoz Sanchez; Alicia,13,0,14,1
1708247654568,LISP 1CX,001,405922,Munoz Sanchez; Alicia,24,0,28,4
1708247654568,LISP 1CX,002,405990,Munoz Sanchez; Alicia,26,0,28,2
1708247654568,LISP 1CX,003,406007,Munoz Sanchez; Alicia,27,0,28,1
1708247654568,LISP 1CX,004,406008,Munoz Sanchez; Alicia,25,0,28,3
1708247654568,LISP 1CX,005,406015,Munoz Sanchez; Alicia,26,0,28,2
1708247655132,LISP 1D,001,406016,Munoz Sanchez; Alicia,12,0,14,2
1708247655132,LISP 1D,002,406017,Munoz Sanchez; Alicia,13,0,14,1
1708247655132,LISP 1D,003,406018,Munoz Sanchez; Alicia,14,0,14,0
1708247655132,LISP 1D,004,406019,Munoz Sanchez; Alicia,11,0,14,3
1708247655132,LISP 1D,005,406020,Munoz Sanchez; Alicia,13,0,14,1
1708247655132,LISP 1D,006,406021,Munoz Sanchez; Alicia,10,0,14,4
1708247655132,LISP 1D,007,406022,Munoz Sanchez; Alicia,13,0,14,1
1708247655132,LISP 1D,008,406023,Munoz Sanchez; Alicia,13,0,14,1
1708247655132,LISP 1D,009,406024,Munoz Sanchez; Alicia,11,0,14,3
1708247655132,LISP 1D,010,406025,Munoz Sanchez; Alicia,12,0,14,2
1708247655132,LISP 1D,011,406026,Munoz Sanchez; Alicia,13,0,14,1
1708247655132,LISP 1D,012,406027,Munoz Sanchez; Alicia,13,0,14,1
1708247655132,LISP 1D,013,406028,Munoz Sanchez; Alicia,12,0,14,2
1708247655132,LISP 1D,014,406029,Munoz Sanchez; Alicia,12,0,14,2
1708247655132,LISP 1D,015,406030,Munoz Sanchez; Alicia,10,0,14,4
1708247655132,LISP 1D,016,406031,Munoz Sanchez; Alicia,14,0,14,0
1708247655132,LISP 1D,017,406032,Munoz Sanchez; Alicia,14,0,14,0
1708247655132,LISP 1D,018,406033,Munoz Sanchez; Alicia,12,0,14,2
1708247655132,LISP 1D,019,406034,Munoz Sanchez; Alicia,13,0,14,1
1708247655132,LISP 1D,020,406035,Munoz Sanchez; Alicia,14,0,14,0
1708247655132,LISP 1D,021,406036,Munoz Sanchez; Alicia,13,0,14,1
1708247655132,LISP 1D,022,406037,Munoz Sanchez; Alicia,14,0,14,0
1708247655132,LISP 1D,023,406038,Munoz Sanchez; Alicia,14,0,14,0
1708247655132,LISP 1D,024,406039,Munoz Sanchez; Alicia,13,0,14,1
1708247656699,LISP 1DX,001,406040,Munoz Sanchez; Alicia,28,0,28,0
1708247656699,LISP 1DX,002,406041,Munoz Sanchez; Alicia,27,0,28,1
1708247656699,LISP 1DX,003,406127,Munoz Sanchez; Alicia,24,0,28,4
1708247656699,LISP 1DX,004,406128,Munoz Sanchez; Alicia,17,0,28,11
1708247656699,LISP 1DX,005,406418,Munoz Sanchez; Alicia,24,0,28,4
1708247656699,LISP 1DX,006,406536,Munoz Sanchez; Alicia,27,0,28,1
1708247656699,LISP 1DX,007,406561,Munoz Sanchez; Alicia,24,0,28,4
1708247656699,LISP 1DX,008,406576,Munoz Sanchez; Alicia,25,0,28,3
1708247656699,LISP 1DX,009,406679,Munoz Sanchez; Alicia,28,0,28,0
1708247656699,LISP 1DX,010,406691,Munoz Sanchez; Alicia,26,0,28,2
1708247656699,LISP 1DX,011,406692,Munoz Sanchez; Alicia,28,0,28,0
1708247656699,LISP 1DX,012,406693,Munoz Sanchez; Alicia,28,0,28,0
1708247657226,LISP 17,001,406694,Munoz Sanchez; Alicia,18,0,20,2
1708247657753,LISP 18,001,406695,Munoz Sanchez; Alicia,20,0,20,0
1708247658279,LTAM 105,A00,412520,Ruiz; Ariana,28,0,40,12
1708247658811,LTCH 101,A00,479214,Zhu; Ping,39,0,40,1
1708247659339,LTCS 87,A00,492906,Nguyen; Hoang Tan,20,0,20,0
1708247659339,LTCS 87,B00,492907,Nguyen; Hoang Tan,20,0,20,0
1708247659882,LTCS 150,A00,412543,Liao; Ping H,39,0,40,1
1708247660411,LTCS 225,A00,412819,Mendoza; Andrea,14,0,15,1
1708247660942,LTCS 250,A00,412821,Lee; Jin-Kyung,15,0,15,0
1708247661471,LTEA 110B,A00,412548,Liao; Ping H,60,0,60,0
1708247662002,LTEA 120A,A00,479216,Zhu; Ping,36,0,40,4
1708247662529,LTEA 120C,A00,412552,Fiss; Geraldine Anna,295,0,300,5
1708247663055,LTEA 132,A00,412561,Mendoza; Andrea,51,0,60,9
1708247663584,LTEA 141,A00,412565,Lee; Jin-Kyung,37,0,40,3
1708247664117,LTEN 23,A01,411317,Vijay; Ameeth Varma,24,0,25,1
1708247664117,LTEN 23,A02,411318,Vijay; Ameeth Varma,24,0,25,1
1708247664117,LTEN 23,A03,411371,Vijay; Ameeth Varma,25,0,25,0
1708247664117,LTEN 23,A04,411375,Vijay; Ameeth Varma,24,0,25,1
1708247664645,LTEN 28,A01,411632,Blanco; John D,25,0,25,0
1708247664645,LTEN 28,A02,411697,Blanco; John D,25,0,25,0
1708247664645,LTEN 28,A03,411698,Blanco; John D,25,0,25,0
1708247664645,LTEN 28,A04,411709,Blanco; John D,25,0,25,0
1708247664645,LTEN 28,A05,411719,Blanco; John D,25,0,25,0
1708247664645,LTEN 28,A06,411744,Blanco; John D,25,0,25,0
1708247664645,LTEN 28,A07,411780,Blanco; John D,25,0,25,0
1708247664645,LTEN 28,A08,411820,Blanco; John D,25,0,25,0
1708247665172,LTEN 110,A00,486891,Vitkus; Daniel J.,38,0,40,2
1708247665699,LTEN 144,A00,412570,Vijay; Ameeth Varma,39,0,40,1
1708247666230,LTEN 180,A00,412581,Perreira; Christopher Michael,18,0,25,7
1708247666757,LTEN 181,A00,412582,Mukherjee; Silpa,55,0,60,5
1708247667288,LTEN 245,A00,412824,Johnson; Sara E.,13,0,15,2
1708247667813,LTEN 259,A00,412825,Streeby; Shelley,13,0,15,2
1708247668423,LTEU 111,A00,412588,Kontje; Todd Curtis,38,0,40,2
1708247668957,LTEU 140,A00,480172,De Marchi Gherini; Adriana,36,0,37,1
1708247669488,LTEU 141,A00,412592,Cohen; Alain J. J.,40,0,40,0
1708247670014,LTFR 2A,A01,411996,Ploye; Catherine,25,0,25,0
1708247670541,LTFR 2C,A00,411997,Ploye; Catherine,24,0,25,1
1708247671067,LTFR 142,A00,412597,Zhiri; Oumelbanine,20,0,20,0
1708247671593,LTGK 3,A00,412001,Murray; Kourtney Kristine,30,0,30,0
1708247672123,LTGM 2C,A00,412002,Fischer-Grunski; Eva K,25,0,25,0
1708247673667,LTKO 1C,A01,412029,Cho; Hye Jin,24,0,25,1
1708247673667,LTKO 1C,B01,412164,Cho; Hye Jin,23,0,25,2
1708247673667,LTKO 1C,C01,412168,Cho; Hye Jin,25,0,25,0
1708247673667,LTKO 1C,D01,412353,Yim; Nancy,24,0,25,1
1708247673667,LTKO 1C,E01,412372,Yim; Nancy,25,0,25,0
1708247674197,LTKO 2C,A01,412374,Yim; Nancy,21,0,25,4
1708247674725,LTKO 130P,A00,412601,Lee; Jeyseon,25,0,25,0
1708247675254,LTKO 135,A00,412606,Lee; Jeyseon,25,0,25,0
1708247675786,LTLA 3,A00,412375,Murray; Kourtney Kristine,36,0,40,4
1708247676315,LTRU 1C,A01,412491,Wells; Patricia Rebecca,24,0,25,1
1708247676840,LTRU 104A,A01,412614,Wells; Patricia Rebecca,20,0,20,0
1708247677367,LTSP 2A,A01,412493,Lampell; Toni,24,0,25,1
1708247677895,LTSP 2B,A01,412497,Lampell; Toni,22,0,25,3
1708247677895,LTSP 2B,B01,479218,Lampell; Toni,24,0,25,1
1708247678422,LTSP 2C,A01,412499,Mastromartino; Alexandra L,23,0,25,2
1708247678948,LTSP 2D,A00,412500,Dominguez; Noelia,24,0,25,1
1708247679478,LTSP 2E,A00,412501,Mastromartino; Alexandra L,24,0,25,1
1708247679478,LTSP 2E,B00,412502,Mastromartino; Alexandra L,25,0,25,0
1708247680006,LTSP 87,A00,479212,Bessett; Ryan Matthew,20,0,20,0
1708247680532,LTSP 100B,A00,412619,Dominguez; Noelia,25,0,25,0
1708247680532,LTSP 100B,B00,412623,Dominguez; Noelia,24,0,25,1
1708247681063,LTSP 116,A00,412628,Blanco; John D,28,0,30,2
1708247681589,LTSP 135A,A00,412631,Parra; Max,27,0,30,3
1708247682117,LTSP 174,A00,479213,Staff,28,0,30,2
1708247682648,LTTH 115,A00,412632,Kontje; Todd Curtis,35,0,40,5
1708247683174,LTTH 210C,A00,412826,Batarseh; Amanda Alicia,14,0,15,1
1708247683701,LTTH 255,A00,412827,Ali; Mohammad Kazim,13,0,15,2
1708247684232,LTTH 260,A00,412828,Kim; Joo Ok,30,0,30,0
1708247684763,LTWL 19C,A00,412503,Kelting; Edward William,40,0,40,0
1708247685288,LTWL 101,A00,412633,Kelting; Edward William,39,0,40,1
1708247685818,LTWL 114,A00,412656,Fiss; Geraldine Anna,60,0,60,0
1708247686343,LTWL 123,A00,412674,Lampert-Weissig; Lisa,31,0,40,9
1708247686868,LTWL 172,A00,412729,De Marchi Gherini; Adriana,37,0,40,3
1708247687400,LTWL 183,A00,412731,Cohen; Alain J. J.,38,0,40,2
1708247687930,LTWL 184,A00,479219,Mukherjee; Silpa,38,0,40,2
1708247688458,LTWL 194A,A00,489635,Vijay; Ameeth Varma,27,0,31,4
1708247689000,LTWR 8A,A01,412505,Springer; Anna Joy,24,0,25,1
1708247689000,LTWR 8A,A02,412506,Springer; Anna Joy,24,0,25,1
1708247689000,LTWR 8A,A03,412507,Springer; Anna Joy,25,0,25,0
1708247689000,LTWR 8A,A04,412508,Springer; Anna Joy,23,0,25,2
1708247689527,LTWR 8C,A01,412511,Forbes; Camille,23,0,25,2
1708247689527,LTWR 8C,A02,412512,Forbes; Camille,25,0,25,0
1708247689527,LTWR 8C,A03,412514,Forbes; Camille,25,0,25,0
1708247689527,LTWR 8C,A04,412519,Forbes; Camille,24,0,25,1
1708247690053,LTWR 100,A00,412734,Forbes; Camille,7,0,15,8
1708247690643,LTWR 113,A00,412816,Carroll; Amy Sara,28,0,30,2
1708247691168,LTWR 114,A00,412817,Springer; Anna Joy,23,0,30,7
1708247691695,LTWR 126,A00,412818,Hoang; Lily Kim,25,0,30,5
1708247692224,LTWR 215,A00,412880,Carroll; Amy Sara,19,0,20,1
1708247692757,MAE 3,A01,435606,Qi; Huihui,16,0,20,4
1708247692757,MAE 3,A02,435607,Qi; Huihui,15,0,20,5
1708247692757,MAE 3,A03,435608,Qi; Huihui,19,0,20,1
1708247692757,MAE 3,B01,435618,Delson; Nathan Joseph & Mullin; Jennifer S,20,0,20,0
1708247692757,MAE 3,B02,435626,Delson; Nathan Joseph & Mullin; Jennifer S,20,0,20,0
1708247692757,MAE 3,B03,435666,Delson; Nathan Joseph & Mullin; Jennifer S,20,0,20,0
1708247692757,MAE 3,B04,435679,Delson; Nathan Joseph & Mullin; Jennifer S,20,0,20,0
1708247692757,MAE 3,B05,494545,Delson; Nathan Joseph & Mullin; Jennifer S,20,0,20,0
1708247693283,MAE 8,A01,435688,Pham; Hieu Tan,197,0,200,3
1708247693811,MAE 30B,A00,435689,Lubarda; Marko,128,0,130,2
1708247693811,MAE 30B,B00,435701,Ghazinejad; Maziar,117,0,130,13
1708247694342,MAE 101B,A00,435702,Saintillan; David,146,0,150,4
1708247694342,MAE 101B,B00,435703,Nomura; Keiko K.,138,0,146,8
1708247694874,MAE 101C,A00,435704,Sadeghizadeh; Zahra,53,0,65,12
1708247695399,MAE 101D,A00,435705,Chen; Renkun,14,0,20,6
1708247695928,MAE 105,A00,435706,Becker; Janet Maria,115,0,120,5
1708247696457,MAE 107,A00,435707,Lindsey; Stephanie,48,0,50,2
1708247696457,MAE 107,B00,435708,Davidson; Michael R,55,0,60,5
1708247696986,MAE 119,A00,435710,Hidalgo-Gonzalez; Patricia,100,0,120,20
1708247697513,MAE 120,A00,435722,Arefiev; Alexey,49,0,65,16
1708247698044,MAE 125,A00,435723,Kleissl; Jan,60,0,65,5
1708247698572,MAE 131A,A00,435724,Qi; Huihui,119,0,125,6
1708247698572,MAE 131A,B00,435725,Meyers; Marc,123,0,125,2
1708247699102,MAE 143B,A00,435726,Morimoto; Tania,114,0,120,6
1708247699102,MAE 143B,B00,435727,Herbert; Sylvia Lee,117,0,120,3
1708247699102,MAE 143B,C00,435728,Diagne; Mamadou Lamine,108,0,120,12
1708247699629,MAE 145,A00,435729,Martinez; Sonia,41,0,60,19
1708247700157,MAE 148,A01,492802,Silberman; Jack,14,0,24,10
1708247700685,MAE 150,A00,435730,Pham; Hieu Tan,52,0,60,8
1708247701216,MAE 152,A00,435731,Llewellyn Smith; Stefan G.,14,0,14,0
1708247701216,MAE 152,B00,435747,Llewellyn Smith; Stefan G.,12,0,14,2
1708247701216,MAE 152,C00,435748,Llewellyn Smith; Stefan G.,12,0,14,2
1708247701216,MAE 152,D00,435749,Llewellyn Smith; Stefan G.,8,0,14,6
1708247701216,MAE 152,E00,435750,Llewellyn Smith; Stefan G.,13,0,14,1
1708247701747,MAE 155B,A01,435752,Hwang; John T,36,0,50,14
1708247701747,MAE 155B,B01,435768,Anderson; Mark Ronald,27,0,50,23
1708247701747,MAE 155B,C01,494006,Saha; Abhishek,0,0,0,0
1708247702286,MAE 156B,A01,435770,Tustaniwskyj; Jerry I,33,0,40,7
1708247702286,MAE 156B,B01,435772,Ghazinejad; Maziar,35,0,40,5
1708247702286,MAE 156B,C01,435774,Delson; Nathan Joseph,38,0,40,2
1708247702286,MAE 156B,D01,435776,Saha; Abhishek,31,0,40,9
1708247702813,MAE 166,A00,435777,Fullerton; Eric E,44,0,50,6
1708247703343,MAE 170,A01,435779,Lubarda; Marko,30,0,32,2
1708247703343,MAE 170,A02,435780,Lubarda; Marko,27,0,32,5
1708247703343,MAE 170,A03,435781,Lubarda; Marko,32,0,32,0
1708247703343,MAE 170,A04,435782,Lubarda; Marko,31,0,32,1
1708247703343,MAE 170,A05,435783,Lubarda; Marko,29,0,32,3
1708247703343,MAE 170,A06,435784,Lubarda; Marko,30,0,32,2
1708247703343,MAE 170,B01,435786,Evdokimenko; Ekaterina,23,0,24,1
1708247703343,MAE 170,B02,435787,Evdokimenko; Ekaterina,20,0,24,4
1708247703343,MAE 170,B03,435788,Evdokimenko; Ekaterina,23,0,24,1
1708247703343,MAE 170,B04,435789,Evdokimenko; Ekaterina,23,0,24,1
1708247703343,MAE 170,B05,435790,Evdokimenko; Ekaterina,19,0,24,5
1708247703343,MAE 170,B06,435791,Evdokimenko; Ekaterina,23,0,24,1
1708247703869,MAE 180,A00,479477,Sadeghizadeh; Zahra,56,0,60,4
1708247704398,MAE 184,A00,435792,Anderson; Mark Ronald,7,0,50,43
1708247704927,MAE 190,A00,435793,Beg; Farhat N.,17,0,20,3
1708247704927,MAE 190,B00,479209,Gerardo; Hortense Flotilde,12,0,15,3
1708247705453,MAE 202,A00,435794,Bandaru; Prabhakar,32,0,70,38
1708247705979,MAE 205,A00,435804,Hwang; John T & Tynan; George Robert & Seshadri; Kalyanasundaram & Rangamani; Padmini & Bandaru; Prabhakar,9990,0,9999,9
1708247706514,MAE 207,A00,435805,Beg; Farhat N.,9,0,10,1
1708247706514,MAE 207,B00,435815,Campbell; Edward Michael,6,0,10,4
1708247706514,MAE 207,C00,477499,Gerardo; Hortense Flotilde,6,0,30,24
1708247707041,MAE 209,A00,435816,Scholtes Acevedo; Claire,25,0,30,5
1708247707567,MAE 210C,A00,435817,Becker; Janet Maria,23,0,30,7
1708247708091,MAE 211,A00,435818,Seshadri; Kalyanasundaram,20,0,30,10
1708247708618,MAE 214A,A00,435819,Sarkar; Sutanu,27,0,35,8
1708247709149,MAE 217C,A00,435820,Marinoni; Alessandro,10,0,10,0
1708247709678,MAE 221C,A00,435821,Seshadri; Kalyanasundaram,10,0,15,5
1708247710211,MAE 221D,A00,435822,Poulikakos; Lisa Voula,23,0,30,7
1708247710738,MAE 224A,A00,435823,Pawlak; Geno Ronald,5,0,10,5
1708247711264,MAE 227,A00,435824,Hidalgo-Gonzalez; Patricia,21,0,35,14
1708247711791,MAE 231A,A00,435825,Boechler; Nicholas Sebastia,14,0,30,16
1708247712323,MAE 240,A00,435826,Rosengren; Aaron,20,0,30,10
1708247712850,MAE 242,A00,435827,Martinez; Sonia,0,0,45,45
1708247713375,MAE 249,A00,435842,Tolley; Michael Thomas,0,0,35,35
1708247713901,MAE 253,A00,435891,Staff,24,0,25,1
1708247714428,MAE 256,A00,435949,Coimbra; Carlos F.,6,0,10,4
1708247714964,MAE 263,A00,435987,Rangamani; Padmini,10,0,10,0
1708247715493,MAE 266,A00,435988,Evdokimenko; Ekaterina,7,0,30,23
1708247716020,MAE 271C,A00,435990,Arzt; Eduard,10,0,10,0
1708247716547,MAE 281B,A00,435991,Cortes; Jorge,9,0,25,16
1708247717074,MAE 288A,A00,435998,McEneaney; William Michael,6,0,40,34
1708247717604,MAE 288B,A00,435999,Bitmead; Robert R.,41,0,45,4
1708247718131,MAE 290C,A00,436008,Schmidt; Oliver,26,0,30,4
1708247718658,MAE 294C,A01,436010,Young; William Roy,19,0,20,1
1708247719187,MATH 2,A01,431271,Staff,31,0,35,4
1708247719187,MATH 2,B01,431273,Staff,29,0,35,6
1708247719187,MATH 2,C01,431275,Staff,31,0,35,4
1708247719729,MATH 3C,A01,431277,Safii; Soheil,12,0,15,3
1708247719729,MATH 3C,A02,431278,Safii; Soheil,12,0,15,3
1708247719729,MATH 3C,A03,431279,Safii; Soheil,12,0,15,3
1708247719729,MATH 3C,A04,431280,Safii; Soheil,15,0,15,0
1708247719729,MATH 3C,A05,431281,Safii; Soheil,14,0,15,1
1708247719729,MATH 3C,A06,431282,Safii; Soheil,15,0,15,0
1708247720257,MATH 10A,A01,431284,Bowers; Adam R.,20,0,30,10
1708247720257,MATH 10A,A02,431285,Bowers; Adam R.,18,0,30,12
1708247720257,MATH 10A,A03,431369,Bowers; Adam R.,28,0,30,2
1708247720257,MATH 10A,A04,431395,Bowers; Adam R.,27,0,30,3
1708247720257,MATH 10A,A05,431450,Bowers; Adam R.,28,0,30,2
1708247720257,MATH 10A,A06,431508,Bowers; Adam R.,30,0,30,0
1708247720257,MATH 10A,B01,431572,Kowalenko; Ethan J,24,0,30,6
1708247720257,MATH 10A,B02,431573,Kowalenko; Ethan J,29,0,30,1
1708247720257,MATH 10A,B03,431574,Kowalenko; Ethan J,30,0,30,0
1708247720257,MATH 10A,B04,431576,Kowalenko; Ethan J,30,0,30,0
1708247720257,MATH 10A,B05,431577,Kowalenko; Ethan J,30,0,30,0
1708247720257,MATH 10A,B06,431583,Kowalenko; Ethan J,30,0,30,0
1708247720787,MATH 10B,A01,431595,Habib; Yousaf,29,0,36,7
1708247720787,MATH 10B,A02,431597,Habib; Yousaf,35,0,36,1
1708247720787,MATH 10B,A03,431669,Habib; Yousaf,37,0,37,0
1708247720787,MATH 10B,A04,431670,Habib; Yousaf,36,0,37,1
1708247720787,MATH 10B,A05,431671,Habib; Yousaf,70,0,70,0
1708247720787,MATH 10B,B01,431673,Habib; Yousaf,25,0,33,8
1708247720787,MATH 10B,B02,431712,Habib; Yousaf,33,0,33,0
1708247720787,MATH 10B,B03,431713,Habib; Yousaf,33,0,33,0
1708247720787,MATH 10B,B04,431714,Habib; Yousaf,33,0,33,0
1708247720787,MATH 10B,B05,431715,Habib; Yousaf,60,0,60,0
1708247720787,MATH 10B,C01,431717,Bach; Quang Tran,57,0,60,3
1708247720787,MATH 10B,C02,431718,Bach; Quang Tran,18,0,34,16
1708247720787,MATH 10B,C03,431719,Bach; Quang Tran,34,0,34,0
1708247720787,MATH 10B,C04,431720,Bach; Quang Tran,33,0,34,1
1708247720787,MATH 10B,C05,431721,Bach; Quang Tran,32,0,34,2
1708247720787,MATH 10B,D01,431723,Staff,28,0,34,6
1708247720787,MATH 10B,D02,431724,Staff,34,0,34,0
1708247720787,MATH 10B,D03,431725,Staff,34,0,34,0
1708247720787,MATH 10B,D04,431726,Staff,34,0,34,0
1708247720787,MATH 10B,D05,431727,Staff,57,0,60,3
1708247721314,MATH 10C,A01,431741,Staff,94,0,96,2
1708247721314,MATH 10C,A02,431742,Staff,39,0,40,1
1708247721314,MATH 10C,B01,431744,Staff,95,0,96,1
1708247721314,MATH 10C,B02,431746,Staff,27,0,40,13
1708247721314,MATH 10C,C01,431748,Pardo Guerra; Sebastian,30,0,40,10
1708247721314,MATH 10C,C02,431885,Pardo Guerra; Sebastian,40,0,40,0
1708247721314,MATH 10C,C03,431895,Pardo Guerra; Sebastian,32,0,33,1
1708247721314,MATH 10C,C04,431896,Pardo Guerra; Sebastian,32,0,32,0
1708247721843,MATH 11,A01,431933,Rava; Denise,82,0,100,18
1708247721843,MATH 11,A02,431960,Rava; Denise,66,0,70,4
1708247721843,MATH 11,A03,431971,Rava; Denise,39,0,40,1
1708247721843,MATH 11,B01,432053,Staff,99,0,100,1
1708247721843,MATH 11,B02,432064,Staff,37,0,45,8
1708247721843,MATH 11,B03,432073,Staff,44,0,45,1
1708247722373,MATH 18,A01,432082,Mackall; Eoin Travis,65,0,70,5
1708247722373,MATH 18,A02,432086,Mackall; Eoin Travis,68,0,70,2
1708247722373,MATH 18,B01,432089,Suk; Andrew Hoon,39,0,40,1
1708247722373,MATH 18,B02,432090,Suk; Andrew Hoon,35,0,40,5
1708247722373,MATH 18,B03,432091,Suk; Andrew Hoon,33,0,40,7
1708247722373,MATH 18,B04,432092,Suk; Andrew Hoon,30,0,40,10
1708247722373,MATH 18,B05,432093,Suk; Andrew Hoon,34,0,35,1
1708247722373,MATH 18,B06,432094,Suk; Andrew Hoon,33,0,35,2
1708247722373,MATH 18,B07,432095,Suk; Andrew Hoon,98,0,100,2
1708247722373,MATH 18,B08,432096,Suk; Andrew Hoon,100,0,100,0
1708247722373,MATH 18,B09,432097,Suk; Andrew Hoon,98,0,100,2
1708247722373,MATH 18,B10,432098,Suk; Andrew Hoon,69,0,70,1
1708247722901,MATH 20A,A01,432101,Briones; Jor-el Thomas Caparas,30,0,40,10
1708247722901,MATH 20A,A02,432102,Briones; Jor-el Thomas Caparas,98,0,100,2
1708247722901,MATH 20A,B01,432104,Briones; Jor-el Thomas Caparas,99,0,100,1
1708247722901,MATH 20A,B02,432105,Briones; Jor-el Thomas Caparas,40,0,40,0
1708247723429,MATH 20B,A01,432107,Quarfoot; David James,33,0,35,2
1708247723429,MATH 20B,A02,432108,Quarfoot; David James,18,0,35,17
1708247723429,MATH 20B,A03,432109,Quarfoot; David James,32,0,35,3
1708247723429,MATH 20B,A04,432110,Quarfoot; David James,34,0,35,1
1708247723429,MATH 20B,A05,432331,Quarfoot; David James,26,0,32,6
1708247723429,MATH 20B,A06,432411,Quarfoot; David James,31,0,32,1
1708247723429,MATH 20B,B01,432413,Mackall; Eoin Travis,62,0,65,3
1708247723429,MATH 20B,B02,432443,Mackall; Eoin Travis,65,0,65,0
1708247723429,MATH 20B,B03,432444,Mackall; Eoin Travis,60,0,60,0
1708247723429,MATH 20B,B04,432471,Mackall; Eoin Travis,60,0,60,0
1708247723959,MATH 20C,A01,432473,Ohm; Ko Woon,26,0,38,12
1708247723959,MATH 20C,A02,432474,Ohm; Ko Woon,36,0,38,2
1708247723959,MATH 20C,A03,432475,Ohm; Ko Woon,34,0,37,3
1708247723959,MATH 20C,A04,432546,Ohm; Ko Woon,36,0,37,1
1708247723959,MATH 20C,A05,432550,Ohm; Ko Woon,88,0,90,2
1708247723959,MATH 20C,B01,432568,Ohm; Ko Woon,43,0,45,2
1708247723959,MATH 20C,B02,432594,Ohm; Ko Woon,40,0,45,5
1708247723959,MATH 20C,B03,432609,Ohm; Ko Woon,85,0,90,5
1708247723959,MATH 20C,C01,432613,Cheng; Hsiao-Bing,67,0,70,3
1708247723959,MATH 20C,C02,432614,Cheng; Hsiao-Bing,68,0,70,2
1708247723959,MATH 20C,C03,432615,Cheng; Hsiao-Bing,70,0,70,0
1708247723959,MATH 20C,D01,432617,Cheng; Hsiao-Bing,69,0,70,1
1708247723959,MATH 20C,D02,432618,Cheng; Hsiao-Bing,68,0,70,2
1708247723959,MATH 20C,D03,432619,Cheng; Hsiao-Bing,70,0,70,0
1708247724495,MATH 20D,A01,432622,Hammock; Frances H,58,0,60,2
1708247724495,MATH 20D,A02,432623,Hammock; Frances H,58,0,60,2
1708247724495,MATH 20D,A03,432658,Hammock; Frances H,35,0,35,0
1708247724495,MATH 20D,A04,432660,Hammock; Frances H,35,0,35,0
1708247724495,MATH 20D,B01,432702,Hammock; Frances H,66,0,70,4
1708247724495,MATH 20D,B02,432703,Hammock; Frances H,70,0,70,0
1708247724495,MATH 20D,B03,432766,Hammock; Frances H,30,0,30,0
1708247724495,MATH 20D,B04,432782,Hammock; Frances H,20,0,30,10
1708247724495,MATH 20D,C01,432811,Sheng; Hongyi,60,0,60,0
1708247724495,MATH 20D,C02,432931,Sheng; Hongyi,60,0,60,0
1708247724495,MATH 20D,C03,432945,Sheng; Hongyi,28,0,30,2
1708247724495,MATH 20D,C04,432949,Sheng; Hongyi,30,0,30,0
1708247725025,MATH 20E,A01,433007,Eggers; John Dietrich,70,0,80,10
1708247725025,MATH 20E,A02,433070,Eggers; John Dietrich,77,0,80,3
1708247725025,MATH 20E,A03,433079,Eggers; John Dietrich,32,0,35,3
1708247725025,MATH 20E,B01,433092,Staff,86,0,90,4
1708247725025,MATH 20E,B02,433093,Staff,90,0,90,0
1708247725025,MATH 20E,C01,433237,Bach; Quang Tran,52,0,60,8
1708247725025,MATH 20E,C02,433238,Bach; Quang Tran,69,0,70,1
1708247725025,MATH 20E,C03,433239,Bach; Quang Tran,70,0,70,0
1708247725552,MATH 31CH,A01,433241,Rabin; Jeffrey Mark,35,0,35,0
1708247726082,MATH 95,A00,433242,Stevens; Laura Jeanne,30,0,30,0
1708247726610,MATH 100C,A01,433244,Pollack; Aaron,31,0,35,4
1708247726610,MATH 100C,A02,433245,Pollack; Aaron,35,0,35,0
1708247727140,MATH 102,A01,433298,Ophir; Amit,29,0,30,1
1708247727140,MATH 102,A02,433369,Ophir; Amit,30,0,30,0
1708247727140,MATH 102,A03,433373,Ophir; Amit,30,0,30,0
1708247727140,MATH 102,A04,433374,Ophir; Amit,29,0,30,1
1708247727140,MATH 102,B01,433572,Zhang; Ming,28,0,30,2
1708247727140,MATH 102,B02,433732,Zhang; Ming,30,0,30,0
1708247727140,MATH 102,B03,433733,Zhang; Ming,30,0,30,0
1708247727140,MATH 102,B04,433734,Zhang; Ming,29,0,30,1
1708247727667,MATH 103B,A01,433793,Lu; Yunze,23,0,30,7
1708247727667,MATH 103B,A02,433795,Lu; Yunze,30,0,30,0
1708247727667,MATH 103B,A03,433830,Lu; Yunze,28,0,30,2
1708247727667,MATH 103B,B01,433845,Lahiri; Aranya,24,0,30,6
1708247727667,MATH 103B,B02,433846,Lahiri; Aranya,28,0,30,2
1708247727667,MATH 103B,B03,433847,Lahiri; Aranya,27,0,30,3
1708247728197,MATH 109,A01,433849,Aycock; Jon Merrill,6,0,10,4
1708247728197,MATH 109,A02,433850,Aycock; Jon Merrill,9,0,10,1
1708247728197,MATH 109,B01,433852,Klevdal; Christian Sleek,10,0,10,0
1708247728197,MATH 109,B02,433859,Klevdal; Christian Sleek,10,0,10,0
1708247728197,MATH 109,C01,433861,Treuer; John N,5,0,10,5
1708247728197,MATH 109,C02,433862,Treuer; John N,10,0,10,0
1708247728197,MATH 109,D01,433864,Treuer; John N,8,0,10,2
1708247728197,MATH 109,D02,433865,Treuer; John N,8,0,10,2
1708247728197,MATH 109,E01,433868,Sheng; Hongyi,10,0,10,0
1708247728197,MATH 109,E02,433869,Sheng; Hongyi,19,0,20,1
1708247728723,MATH 110,A01,433871,Pillai; Mohandas K,24,0,35,11
1708247728723,MATH 110,A02,433872,Pillai; Mohandas K,33,0,35,2
1708247729250,MATH 112B,A01,480683,Komarova; Natalia,27,0,27,0
1708247729781,MATH 120B,A01,433885,Xiao; Ming,32,0,35,3
1708247729781,MATH 120B,A02,433886,Xiao; Ming,34,0,35,1
1708247730307,MATH 121B,A01,433888,Stevens; Laura Jeanne,29,0,30,1
1708247730839,MATH 140B,A01,433890,Seward; Brandon M.,31,0,35,4
1708247730839,MATH 140B,A02,433891,Seward; Brandon M.,35,0,35,0
1708247731373,MATH 140C,A01,433895,Spolaor; Luca,32,0,35,3
1708247731373,MATH 140C,A02,433896,Spolaor; Luca,35,0,35,0
1708247731901,MATH 142B,A01,433966,Eggers; John Dietrich,25,0,35,10
1708247731901,MATH 142B,A02,434063,Eggers; John Dietrich,32,0,35,3
1708247731901,MATH 142B,B01,434071,Sanchez; Anthony,32,0,35,3
1708247731901,MATH 142B,B02,434083,Sanchez; Anthony,34,0,35,1
1708247731901,MATH 142B,C01,434094,Kunnawalkam Elayavalli; Sr,31,0,35,4
1708247731901,MATH 142B,C02,434095,Kunnawalkam Elayavalli; Sr,34,0,35,1
1708247732427,MATH 144,A01,434097,Cloninger; Alexander,30,0,30,0
1708247732955,MATH 150B,A01,434104,Parise; Davide,33,0,35,2
1708247733485,MATH 152,A01,434107,Grier; Daniel T,20,0,40,20
1708247734013,MATH 154,A01,434109,Wesley; William J,31,0,35,4
1708247734013,MATH 154,A02,434119,Wesley; William J,35,0,35,0
1708247734013,MATH 154,A03,434120,Wesley; William J,35,0,35,0
1708247734013,MATH 154,A04,434121,Wesley; William J,34,0,35,1
1708247734013,MATH 154,B01,434126,Aliabadi Sr.; Mohsen,26,0,35,9
1708247734013,MATH 154,B02,434127,Aliabadi Sr.; Mohsen,34,0,35,1
1708247734013,MATH 154,B03,434138,Aliabadi Sr.; Mohsen,35,0,35,0
1708247734013,MATH 154,B04,434139,Aliabadi Sr.; Mohsen,35,0,35,0
1708247734541,MATH 163,A01,434144,Bowers; Adam R.,0,0,5,5
1708247735073,MATH 170A,A01,434148,Nag; Panchali,36,0,36,0
1708247735073,MATH 170A,A02,434149,Nag; Panchali,36,0,36,0
1708247735073,MATH 170A,A03,434150,Nag; Panchali,36,0,37,1
1708247735073,MATH 170A,A04,434151,Nag; Panchali,36,0,36,0
1708247735605,MATH 170B,A01,434155,Huang; Lei,31,0,35,4
1708247735605,MATH 170B,A02,434160,Huang; Lei,35,0,35,0
1708247735605,MATH 170B,A03,434161,Huang; Lei,35,0,35,0
1708247735605,MATH 170B,A04,434162,Huang; Lei,35,0,35,0
1708247736131,MATH 170C,A01,434176,Leok; Melvin,30,0,35,5
1708247736131,MATH 170C,A02,434300,Leok; Melvin,34,0,35,1
1708247736663,MATH 171B,A01,434576,Nie; Jiawang,25,0,35,10
1708247736663,MATH 171B,A02,434583,Nie; Jiawang,35,0,35,0
1708247736663,MATH 171B,A03,434584,Nie; Jiawang,35,0,35,0
1708247736663,MATH 171B,A04,434609,Nie; Jiawang,35,0,35,0
1708247737190,MATH 180A,A01,434638,Gartland; Christopher John,29,0,30,1
1708247737190,MATH 180A,A02,434821,Gartland; Christopher John,28,0,30,2
1708247737190,MATH 180A,A03,434833,Gartland; Christopher John,24,0,30,6
1708247737190,MATH 180A,A04,434839,Gartland; Christopher John,30,0,30,0
1708247737190,MATH 180A,A05,434843,Gartland; Christopher John,30,0,30,0
1708247737190,MATH 180A,A06,434895,Gartland; Christopher John,30,0,30,0
1708247737718,MATH 180B,A01,435085,Gartland; Christopher John,30,0,35,5
1708247737718,MATH 180B,A02,435086,Gartland; Christopher John,35,0,35,0
1708247737718,MATH 180B,A03,435087,Gartland; Christopher John,34,0,35,1
1708247737718,MATH 180B,A04,435088,Gartland; Christopher John,35,0,35,0
1708247738248,MATH 180C,A01,435090,Carfagnini; Marco,29,0,35,6
1708247738248,MATH 180C,A02,435091,Carfagnini; Marco,35,0,35,0
1708247738248,MATH 180C,A03,435092,Carfagnini; Marco,32,0,35,3
1708247738248,MATH 180C,A04,435113,Carfagnini; Marco,35,0,35,0
1708247738774,MATH 181A,A01,435279,Zhang; Danna,30,0,35,5
1708247738774,MATH 181A,A02,435300,Zhang; Danna,35,0,35,0
1708247738774,MATH 181A,A03,435301,Zhang; Danna,21,0,35,14
1708247738774,MATH 181A,A04,435302,Zhang; Danna,31,0,35,4
1708247739303,MATH 181B,A01,435315,Rava; Denise,33,0,35,2
1708247739303,MATH 181B,A02,435316,Rava; Denise,33,0,35,2
1708247739303,MATH 181B,A03,435317,Rava; Denise,33,0,35,2
1708247739303,MATH 181B,A04,435318,Rava; Denise,35,0,35,0
1708247739831,MATH 183,A01,435320,Quarfoot; David James,26,0,35,9
1708247739831,MATH 183,A02,435321,Quarfoot; David James,35,0,35,0
1708247739831,MATH 183,A03,435322,Quarfoot; David James,32,0,35,3
1708247739831,MATH 183,A04,435323,Quarfoot; David James,34,0,35,1
1708247739831,MATH 183,A05,435327,Quarfoot; David James,34,0,35,1
1708247739831,MATH 183,A06,435329,Quarfoot; David James,33,0,35,2
1708247740358,MATH 184,A01,435337,Verstraete; Jacques Allan,32,0,35,3
1708247740358,MATH 184,A02,435338,Verstraete; Jacques Allan,35,0,35,0
1708247740358,MATH 184,A03,435339,Verstraete; Jacques Allan,34,0,35,1
1708247740358,MATH 184,A04,435347,Verstraete; Jacques Allan,30,0,35,5
1708247740894,MATH 185,A01,435432,Arias-Castro; Ery,15,0,30,15
1708247740894,MATH 185,A02,435436,Arias-Castro; Ery,30,0,30,0
1708247740894,MATH 185,A03,435437,Arias-Castro; Ery,30,0,30,0
1708247740894,MATH 185,A04,435438,Arias-Castro; Ery,30,0,30,0
1708247741424,MATH 187A,A01,435443,Agrawal; Shishir,16,0,30,14
1708247741424,MATH 187A,A02,435444,Agrawal; Shishir,30,0,30,0
1708247741424,MATH 187A,A03,435503,Agrawal; Shishir,28,0,30,2
1708247741424,MATH 187A,A04,435507,Agrawal; Shishir,30,0,30,0
1708247741424,MATH 187A,A05,435554,Agrawal; Shishir,22,0,30,8
1708247741424,MATH 187A,A06,435558,Agrawal; Shishir,28,0,30,2
1708247741956,MATH 187B,A01,435570,Bucur; Alina Ioana,25,0,35,10
1708247741956,MATH 187B,A02,435571,Bucur; Alina Ioana,35,0,35,0
1708247742482,MATH 188,A01,435573,Kunnawalkam Elayavalli; Sr,35,0,35,0
1708247743011,MATH 189,A01,435577,Vishwanath; Siddharth,0,0,10,10
1708247743011,MATH 189,A02,435594,Vishwanath; Siddharth,0,0,10,10
1708247743011,MATH 189,A03,435595,Vishwanath; Siddharth,0,0,10,10
1708247743011,MATH 189,A04,435596,Vishwanath; Siddharth,0,0,10,10
1708247743011,MATH 189,A05,480706,Vishwanath; Siddharth,2,0,10,8
1708247743011,MATH 189,A06,481362,Vishwanath; Siddharth,6,0,10,4
1708247743543,MATH 200C,A00,430388,Bucur; Alina Ioana,15,0,15,0
1708247744125,MATH 202C,A00,430389,Rhoades; Brendon Patrick,15,0,15,0
1708247744652,MATH 203C,A00,430390,Izadi; Elham,15,0,15,0
1708247745178,MATH 204C,A00,430391,Sorensen; Claus M,15,0,15,0
1708247745707,MATH 208,A00,430392,Izadi; Elham,8,0,10,2
1708247746233,MATH 209,A00,430393,Pollack; Aaron,10,0,10,0
1708247746760,MATH 211A,A00,430394,Salehi Golsefidy; Alireza,10,0,10,0
1708247747289,MATH 211B,A00,430395,Seward; Brandon M.,10,0,10,0
1708247747815,MATH 212B,A01,480692,Komarova; Natalia,5,0,5,0
1708247748339,MATH 216C,A00,430429,Saab; Rayan,13,0,15,2
1708247748869,MATH 217,A00,430430,Li; Bo,13,0,15,2
1708247749394,MATH 218,A00,430431,Li; Bo,8,0,10,2
1708247749920,MATH 220C,A00,430432,Xiao; Ming,15,0,15,0
1708247750452,MATH 240C,A00,430433,Ebenfelt; Peter F,14,0,15,1
1708247750981,MATH 241B,A00,430434,Ioana; Adrian,14,0,15,1
1708247751509,MATH 243,A00,430435,Kunnawalkam Elayavalli; Sr,9,0,10,1
1708247752035,MATH 248,A00,430436,Bejenaru; Ioan,9,0,10,1
1708247752561,MATH 251C,A00,430437,Wenzl; Hans G,15,0,15,0
1708247753089,MATH 258,A00,430438,Spolaor; Luca,10,0,10,0
1708247753615,MATH 261C,A00,430439,Manners; Frederick,14,0,15,1
1708247754145,MATH 262A,A00,430440,Warnke; Lutz Peter,14,0,15,1
1708247754674,MATH 268,A00,430441,Buss; Samuel R,10,0,10,0
1708247755201,MATH 269,A00,430442,Rhoades; Brendon Patrick & Warnke; Lutz Peter,10,0,10,0
1708247755728,MATH 270C,A00,430445,Cheng; Li-Tien,15,0,15,0
1708247756254,MATH 273B,A00,430452,Zhu; Yuhua,15,0,15,0
1708247756780,MATH 276,A00,430458,Mc Culloch; Andrew Douglas & Amaro; Rommie E,0,0,0,0
1708247757305,MATH 277A,A00,430464,Dumitriu; Ioana,14,0,15,1
1708247757832,MATH 278A,A00,430470,Cheng; Li-Tien,9,0,10,1
1708247758357,MATH 278B,A00,430471,Cloninger; Alexander,10,0,10,0
1708247758883,MATH 278C,A00,430472,Nie; Jiawang,9,0,10,1
1708247759410,MATH 280C,A00,430485,Schweinsberg; Jason,13,0,15,2
1708247759936,MATH 281C,A00,430496,Arias-Castro; Ery,8,0,15,7
1708247760462,MATH 284,A00,430503,Xu; Ronghui,11,0,15,4
1708247760994,MATH 287C,A00,430520,Zhang; Danna,14,0,15,1
1708247761518,MATH 288,A00,430527,Carfagnini; Marco,9,0,10,1
1708247762044,MATH 289A,A00,430541,Novak; Jonathan I,14,0,15,1
1708247762569,MATH 290C,A00,430548,Roberts; Justin Deritter,13,0,15,2
1708247763096,MATH 292,A00,430660,Lu; Yunze,10,0,10,0
1708247763627,MATH 294,A00,430678,Fitzsimmons; Patrick J,11,0,15,4
1708247764152,MATH 295,A00,430692,Bejenaru; Ioan,15,0,15,0
1708247764681,MATH 297,001,430721,Gamst; Anthony Collins,0,0,0,0
1708247765221,MATS 200,A00,414457,Graeve; Olivia A,9995,0,9999,4
1708247765752,MATS 201C,A00,414465,Arzt; Eduard,38,0,50,12
1708247766276,MATS 236,A00,414466,Staff,17,0,20,3
1708247766802,MATS 252,A00,414467,Evdokimenko; Ekaterina,42,0,45,3
1708247767332,MATS 261B,A00,414468,Qiao; Yu,17,0,25,8
1708247767861,MATS 295,A00,414469,Graeve; Olivia A,9999,0,9999,0
1708247767861,MATS 295,B00,478858,Kummel; Andrew C,9999,0,9999,0
1708247768390,MCWP 40,001,414476,Montejo; Carolina,19,0,20,1
1708247768390,MCWP 40,004,414480,Wastal; Carrie King,13,0,15,2
1708247768390,MCWP 40,005,414481,Wastal; Carrie King,10,0,15,5
1708247768390,MCWP 40,006,414482,Wastal; Carrie King,12,0,15,3
1708247768390,MCWP 40,007,414483,Wastal; Carrie King,13,0,15,2
1708247768390,MCWP 40,008,414484,Wastal; Carrie King,15,0,15,0
1708247768390,MCWP 40,009,414487,Wastal; Carrie King,12,0,15,3
1708247768390,MCWP 40,014,414505,Staff,20,0,20,0
1708247768390,MCWP 40,015,494362,Wastal; Carrie King,14,0,15,1
1708247768938,MCWP 50,002,414534,Bartulis; Jason Michael,20,0,20,0
1708247768938,MCWP 50,003,414536,Bartulis; Jason Michael,20,0,20,0
1708247768938,MCWP 50,004,414538,Krone; Jarret,16,0,20,4
1708247768938,MCWP 50,005,414539,Krone; Jarret,19,0,20,1
1708247768938,MCWP 50,006,414540,Smith; Haydee Marie,16,0,20,4
1708247768938,MCWP 50,007,414544,Compas; Sean Matthew,14,0,20,6
1708247768938,MCWP 50,008,414549,Redela; Pamela Morgan,20,0,20,0
1708247768938,MCWP 50,011,414557,Carter; Andrea L,16,0,20,4
1708247768938,MCWP 50,012,414592,Silva; Kelly B,20,0,20,0
1708247768938,MCWP 50,013,414593,Silva; Kelly B,19,0,20,1
1708247768938,MCWP 50,014,414594,Carter; Andrea L,20,0,20,0
1708247768938,MCWP 50,016,414596,Morshed; Michael James,14,0,20,6
1708247768938,MCWP 50,017,414598,Morshed; Michael James,17,0,20,3
1708247768938,MCWP 50,019,414601,Redela; Pamela Morgan,17,0,20,3
1708247768938,MCWP 50,020,414606,Carter; Jennifer A,20,0,20,0
1708247768938,MCWP 50,021,414607,Carter; Jennifer A,19,0,20,1
1708247768938,MCWP 50,022,414649,Compas; Sean Matthew,11,0,20,9
1708247768938,MCWP 50,023,414650,Smith; Haydee Marie,20,0,20,0
1708247768938,MCWP 50,024,414651,Nies; Laurie Elizabeth,19,0,20,1
1708247768938,MCWP 50,025,414655,Nies; Laurie Elizabeth,18,0,20,2
1708247768938,MCWP 50,026,414656,Pham; Vincent Minhduc,19,0,20,1
1708247768938,MCWP 50,027,414657,Pham; Vincent Minhduc,20,0,20,0
1708247768938,MCWP 50,028,414668,Morshed; Michael James,16,0,20,4
1708247768938,MCWP 50,029,414669,Morshed; Michael James,19,0,20,1
1708247769464,MCWP 50R,A00,486838,Miller; Elizabeth Deen,19,0,20,1
1708247769464,MCWP 50R,B00,486843,Miller; Elizabeth Deen,16,0,20,4
1708247769464,MCWP 50R,C00,486844,Miller; Elizabeth Deen,19,0,20,1
1708247769993,MCWP 125,A00,414670,Wilson; Marion E.,20,0,20,0
1708247769993,MCWP 125,B00,414674,Guillen; Melinda,20,0,20,0
1708247769993,MCWP 125,C00,414678,Guillen; Melinda,20,0,20,0
1708247769993,MCWP 125,D00,414682,Guillen; Melinda,20,0,20,0
1708247770520,MED 231,A00,476440,Hurst; Samantha,7,0,7,0
1708247771055,MED 246,A00,492785,Gordts; Philip & Varki; Ajit P & Lewis; Amanda Lark & Godula; Kamil & Gagneux; Pascal & Esko; Jeffrey D. & Bode; Lars,10,0,10,0
1708247771580,MED 262,A00,492942,Koola; Jejo David,28,0,30,2
1708247772107,MED 267,A01,492789,Hogarth; Michael Andrew,25,0,30,5
1708247772633,MED 275,A00,464684,Liu; George Yenhsi,10,0,10,0
1708247773163,MED 276,A00,492786,Sitapati; Amy,23,0,25,2
1708247773691,MED 278,A00,492787,Carter; Hannah Kathryn & Mesirov; Jill P. & Curtius; Kathleen Mary,20,0,20,0
1708247774218,MED 296,001,464685,Chi; Neil C.,48,0,50,2
1708247774218,MED 296,002,464686,Hong; Kimberly N,49,0,50,1
1708247774218,MED 296,003,464687,Staff,50,0,50,0
1708247774748,MGT 3,A00,442429,Wagner; Timothy Ryan,95,0,98,3
1708247775273,MGT 4,A01,442443,Levkoff; Steven B.,0,0,5,5
1708247775273,MGT 4,A02,442444,Levkoff; Steven B.,4,0,5,1
1708247775804,MGT 5,A00,442446,Molloie Jr.; William H,184,0,196,12
1708247776330,MGT 12,A00,442447,Lindenberger; Wade Douglas,83,0,100,17
1708247776330,MGT 12,B00,442448,Lindenberger; Wade Douglas,72,0,100,28
1708247776330,MGT 12,C00,442449,Pecore; Joseph P.,88,0,100,12
1708247776865,MGT 16,A00,442452,Buchanan; Harold G,97,0,100,3
1708247776865,MGT 16,B00,442459,Buchanan; Harold G,92,0,100,8
1708247776865,MGT 16,C00,442461,Campbell; Robert Harold,113,0,120,7
1708247776865,MGT 16,D00,442475,Campbell; Robert Harold,118,0,120,2
1708247777395,MGT 18,A00,442477,McKay; Michael J,98,0,98,0
1708247777395,MGT 18,B00,442491,McKay; Michael J,96,0,98,2
1708247777395,MGT 18,C00,442493,McKay; Michael J,98,0,98,0
1708247777395,MGT 18,D00,442503,Chamberlain; Travis Dean,98,0,98,0
1708247777921,MGT 45,A00,442508,Pecore; Joseph P.,147,0,150,3
1708247777921,MGT 45,B00,442510,Pecore; Joseph P.,142,0,150,8
1708247778447,MGT 71,A00,442524,Lee; Hyun Seok,77,0,98,21
1708247778973,MGT 71R,A00,442526,Phiroz; Zal Navroze,77,0,98,21
1708247779504,MGT 100,A00,442541,Wilbur; Kenneth C,82,0,98,16
1708247779504,MGT 100,B00,442542,Wilbur; Kenneth C,89,0,98,9
1708247780038,MGT 103,A00,442543,Eberhard; Craig A,98,0,98,0
1708247780038,MGT 103,B00,442544,Eberhard; Craig A,95,0,98,3
1708247780038,MGT 103,C00,442545,Ehrich; Kristine R,90,0,98,8
1708247780038,MGT 103,D00,442547,Ehrich; Kristine R,96,0,98,2
1708247780038,MGT 103,E00,442548,Ehrich; Kristine R,97,0,98,1
1708247780038,MGT 103,F00,442549,Demill; Burritt,92,0,98,6
1708247780038,MGT 103,G00,442550,Bates; Kenneth Walter,97,0,98,1
1708247780565,MGT 105,A00,442558,Bates; Kenneth Walter,86,0,98,12
1708247781091,MGT 106,A00,442560,Eberhard; Craig A,95,0,98,3
1708247781620,MGT 109,A00,442574,Campbell; Colin Leslie,90,0,98,8
1708247782147,MGT 112,A00,442576,Somasundaram; Tyagarajan,96,0,98,2
1708247782147,MGT 112,B00,442590,Somasundaram; Tyagarajan,94,0,98,4
1708247782147,MGT 112,C00,442592,Zimmermann; Carsten,87,0,98,11
1708247782677,MGT 119,A00,442602,Staff,97,0,98,1
1708247782677,MGT 119,B00,442603,Anderson; Jon Marcus,96,0,98,2
1708247783203,MGT 121B,A00,442606,Klaas; Jeffrey David,94,0,98,4
1708247783732,MGT 128R,A00,442607,Krishnan; Viswanathan,84,0,98,14
1708247784258,MGT 131A,A00,442608,Houskeeper; Robert,148,0,150,2
1708247784784,MGT 131B,A00,442609,Houskeeper; Robert,100,0,100,0
1708247785310,MGT 132,A00,442610,Blakley; Bruce,97,0,98,1
1708247785841,MGT 137,A00,442611,Lindenberger; Wade Douglas,86,0,98,12
1708247786368,MGT 147,A00,442612,Anderson; John Charles,32,0,40,8
1708247786899,MGT 151R,A00,442613,Phiroz; Zal Navroze,92,0,98,6
1708247787425,MGT 153,A00,442650,Perols; Johan Lars,55,0,80,25
1708247787958,MGT 162,A00,442652,Demill; Burritt,81,0,98,17
1708247787958,MGT 162,B00,442654,Demill; Burritt,88,0,98,10
1708247787958,MGT 162,C00,442776,Staff,95,0,98,3
1708247787958,MGT 162,D00,442778,Staff,96,0,98,2
1708247788486,MGT 164,A00,442780,McKay; Mary A,97,0,98,1
1708247788486,MGT 164,B00,442849,McKay; Mary A,96,0,98,2
1708247788486,MGT 164,C00,442917,McKay; Mary A,97,0,98,1
1708247788486,MGT 164,D00,442949,Meyer; Alison Bloomfield,90,0,98,8
1708247789014,MGT 166,A00,443017,Moran; Cathleen L.,95,0,98,3
1708247789014,MGT 166,B00,443045,Moran; Cathleen L.,97,0,98,1
1708247789014,MGT 166,C00,443046,Moran; Cathleen L.,98,0,98,0
1708247789543,MGT 167,A00,443047,Klaas; Jeffrey David,93,0,98,5
1708247790069,MGT 171R,A00,443048,Phiroz; Zal Navroze,86,0,98,12
1708247790595,MGT 172,A00,443049,Hedges; Kathleen & Royal; Rebecca,116,0,120,4
1708247790595,MGT 172,B00,443050,Hedges; Kathleen,95,0,98,3
1708247790595,MGT 172,C00,443051,Zimmermann; Carsten,96,0,98,2
1708247791123,MGT 173,A00,443052,Hayes; Sherry Lorine,92,0,100,8
1708247791647,MGT 175,A00,443053,Gopal; Christopher S.,98,0,98,0
1708247792176,MGT 180,A00,443055,Bliss; Barbara Ann,139,0,150,11
1708247792176,MGT 180,B00,443069,Bliss; Barbara Ann,145,0,150,5
1708247792701,MGT 181,A00,443120,Buchanan; Harold G,147,0,150,3
1708247793231,MGT 183,A00,443121,Banerjee; Snehal,88,0,98,10
1708247793757,MGT 185,A00,443122,Dunn; Louis Jean,90,0,98,8
1708247794286,MGT 187,A00,443133,Dunn; Louis Jean,95,0,100,5
1708247794812,MGT 189,A00,443134,Avenancio-Leon; Carlos,98,0,98,0
1708247795341,MGT 227,A00,479242,Serra Garcia; Marta,19,0,20,1
1708247795872,MGT 259,A00,443135,Oveis; Christopher S,19,0,20,1
1708247796402,MGT 296,001,481416,Gneezy; Ayelet,3,0,3,0
1708247796402,MGT 296,002,481420,Amir; On,3,0,3,0
1708247796402,MGT 296,003,481466,Amir; On & Karmarkar; Uma R,3,0,3,0
1708247796402,MGT 296,004,481468,Liu; Jun,3,0,3,0
1708247796402,MGT 296,005,481469,Misra; Kanishka,3,0,3,0
1708247796402,MGT 296,006,481470,Erat; Sanjiv,3,0,3,0
1708247796402,MGT 296,007,481473,Timmermann; Allan,3,0,3,0
1708247796402,MGT 296,008,481474,Smith; Pamela Karen,3,0,3,0
1708247796402,MGT 296,009,481477,Zhang; Zhe,3,0,3,0
1708247796402,MGT 296,010,481478,Oveis; Christopher S,3,0,3,0
1708247796402,MGT 296,011,481479,Amir; On & Gneezy; Ayelet,3,0,3,0
1708247796402,MGT 296,012,481481,Wilbur; Kenneth C,3,0,3,0
1708247796969,MMW 13,A01,412918,Chang; Edmond Yi-Teh,15,0,16,1
1708247796969,MMW 13,A02,412928,Chang; Edmond Yi-Teh,16,0,16,0
1708247796969,MMW 13,A03,413017,Chang; Edmond Yi-Teh,16,0,16,0
1708247796969,MMW 13,A04,413018,Chang; Edmond Yi-Teh,16,0,16,0
1708247796969,MMW 13,A05,413019,Chang; Edmond Yi-Teh,15,0,16,1
1708247796969,MMW 13,A06,413020,Chang; Edmond Yi-Teh,16,0,16,0
1708247796969,MMW 13,A07,413021,Chang; Edmond Yi-Teh,15,0,16,1
1708247796969,MMW 13,A08,413023,Chang; Edmond Yi-Teh,16,0,16,0
1708247796969,MMW 13,A09,413024,Chang; Edmond Yi-Teh,16,0,16,0
1708247796969,MMW 13,A10,413025,Chang; Edmond Yi-Teh,16,0,16,0
1708247796969,MMW 13,A11,413026,Chang; Edmond Yi-Teh,16,0,16,0
1708247796969,MMW 13,A12,413027,Chang; Edmond Yi-Teh,16,0,16,0
1708247796969,MMW 13,A13,413028,Chang; Edmond Yi-Teh,0,0,0,0
1708247796969,MMW 13,A14,413029,Chang; Edmond Yi-Teh,0,0,0,0
1708247796969,MMW 13,A15,413030,Chang; Edmond Yi-Teh,14,0,16,2
1708247796969,MMW 13,A16,413031,Chang; Edmond Yi-Teh,15,0,16,1
1708247796969,MMW 13,A17,413032,Chang; Edmond Yi-Teh,16,0,16,0
1708247796969,MMW 13,A18,413034,Chang; Edmond Yi-Teh,14,0,16,2
1708247796969,MMW 13,A19,413035,Chang; Edmond Yi-Teh,16,0,16,0
1708247796969,MMW 13,A20,413036,Chang; Edmond Yi-Teh,16,0,16,0
1708247796969,MMW 13,A21,413037,Chang; Edmond Yi-Teh,0,0,0,0
1708247796969,MMW 13,A22,413038,Chang; Edmond Yi-Teh,0,0,0,0
1708247796969,MMW 13,B01,413290,Zhiri; Oumelbanine,15,0,16,1
1708247796969,MMW 13,B02,413291,Zhiri; Oumelbanine,15,0,16,1
1708247796969,MMW 13,B03,413308,Zhiri; Oumelbanine,14,0,16,2
1708247796969,MMW 13,B04,413322,Zhiri; Oumelbanine,14,0,16,2
1708247796969,MMW 13,B05,413343,Zhiri; Oumelbanine,12,0,16,4
1708247796969,MMW 13,B06,413344,Zhiri; Oumelbanine,14,0,16,2
1708247796969,MMW 13,B07,413524,Zhiri; Oumelbanine,16,0,16,0
1708247796969,MMW 13,B08,413584,Zhiri; Oumelbanine,16,0,16,0
1708247796969,MMW 13,B09,413588,Zhiri; Oumelbanine,15,0,16,1
1708247796969,MMW 13,B10,413590,Zhiri; Oumelbanine,16,0,16,0
1708247796969,MMW 13,B11,413779,Zhiri; Oumelbanine,12,0,16,4
1708247796969,MMW 13,B12,413780,Zhiri; Oumelbanine,9,0,16,7
1708247796969,MMW 13,B13,413781,Zhiri; Oumelbanine,0,0,0,0
1708247796969,MMW 13,B14,413782,Zhiri; Oumelbanine,0,0,0,0
1708247796969,MMW 13,B15,413808,Zhiri; Oumelbanine,16,0,16,0
1708247796969,MMW 13,B16,413815,Zhiri; Oumelbanine,15,0,16,1
1708247796969,MMW 13,B17,413816,Zhiri; Oumelbanine,15,0,16,1
1708247796969,MMW 13,B18,413817,Zhiri; Oumelbanine,12,0,16,4
1708247796969,MMW 13,B19,413822,Zhiri; Oumelbanine,16,0,16,0
1708247796969,MMW 13,B20,413823,Zhiri; Oumelbanine,14,0,16,2
1708247796969,MMW 13,B21,413825,Zhiri; Oumelbanine,0,0,0,0
1708247796969,MMW 13,B22,413826,Zhiri; Oumelbanine,0,0,0,0
1708247796969,MMW 13,B23,413827,Zhiri; Oumelbanine,16,0,16,0
1708247796969,MMW 13,B24,413834,Zhiri; Oumelbanine,15,0,16,1
1708247796969,MMW 13,C01,413859,Vitkus; Daniel J.,16,0,16,0
1708247796969,MMW 13,C02,413860,Vitkus; Daniel J.,16,0,16,0
1708247796969,MMW 13,C04,413868,Vitkus; Daniel J.,0,0,0,0
1708247796969,MMW 13,C05,413869,Vitkus; Daniel J.,16,0,16,0
1708247796969,MMW 13,C06,413871,Vitkus; Daniel J.,16,0,16,0
1708247796969,MMW 13,C07,413886,Vitkus; Daniel J.,16,0,16,0
1708247796969,MMW 13,C08,413908,Vitkus; Daniel J.,16,0,16,0
1708247796969,MMW 13,C09,413930,Vitkus; Daniel J.,16,0,16,0
1708247796969,MMW 13,C10,413952,Vitkus; Daniel J.,15,0,16,1
1708247796969,MMW 13,C11,413972,Vitkus; Daniel J.,16,0,16,0
1708247796969,MMW 13,C12,413991,Vitkus; Daniel J.,16,0,16,0
1708247796969,MMW 13,C13,414007,Vitkus; Daniel J.,0,0,0,0
1708247796969,MMW 13,C14,414017,Vitkus; Daniel J.,0,0,0,0
1708247796969,MMW 13,C15,414030,Vitkus; Daniel J.,16,0,16,0
1708247796969,MMW 13,C16,414032,Vitkus; Daniel J.,16,0,16,0
1708247796969,MMW 13,C17,414033,Vitkus; Daniel J.,15,0,16,1
1708247796969,MMW 13,C18,414034,Vitkus; Daniel J.,16,0,16,0
1708247796969,MMW 13,C19,414041,Vitkus; Daniel J.,16,0,16,0
1708247796969,MMW 13,C20,414056,Vitkus; Daniel J.,16,0,16,0
1708247796969,MMW 13,C21,414057,Vitkus; Daniel J.,15,0,16,1
1708247796969,MMW 13,C22,414059,Vitkus; Daniel J.,16,0,16,0
1708247797552,MMW 15,A01,414065,Chang; Edmond Yi-Teh,28,0,28,0
1708247797552,MMW 15,A02,414067,Chang; Edmond Yi-Teh,27,0,28,1
1708247797552,MMW 15,A03,414092,Chang; Edmond Yi-Teh,26,0,28,2
1708247797552,MMW 15,A04,414104,Chang; Edmond Yi-Teh,28,0,28,0
1708247797552,MMW 15,A05,414121,Chang; Edmond Yi-Teh,0,0,0,0
1708247797552,MMW 15,A06,414122,Chang; Edmond Yi-Teh,0,0,0,0
1708247797552,MMW 15,A07,414123,Chang; Edmond Yi-Teh,28,0,28,0
1708247797552,MMW 15,A08,414124,Chang; Edmond Yi-Teh,28,0,28,0
1708247797552,MMW 15,A09,414125,Chang; Edmond Yi-Teh,0,0,0,0
1708247797552,MMW 15,A10,414130,Chang; Edmond Yi-Teh,0,0,0,0
1708247797552,MMW 15,B01,414132,Radcliff; Pamela B.,27,0,28,1
1708247797552,MMW 15,B02,414134,Radcliff; Pamela B.,27,0,28,1
1708247797552,MMW 15,B03,414135,Radcliff; Pamela B.,26,0,28,2
1708247797552,MMW 15,B04,414136,Radcliff; Pamela B.,27,0,28,1
1708247797552,MMW 15,B05,414137,Radcliff; Pamela B.,28,0,28,0
1708247797552,MMW 15,B06,414138,Radcliff; Pamela B.,27,0,28,1
1708247797552,MMW 15,B07,414140,Radcliff; Pamela B.,26,0,28,2
1708247797552,MMW 15,B08,414141,Radcliff; Pamela B.,28,0,28,0
1708247797552,MMW 15,C01,414143,Prestholdt; Jeremy,0,0,0,0
1708247797552,MMW 15,C02,414144,Prestholdt; Jeremy,0,0,0,0
1708247797552,MMW 15,C03,414145,Prestholdt; Jeremy,24,0,28,4
1708247797552,MMW 15,C04,414147,Prestholdt; Jeremy,17,0,28,11
1708247797552,MMW 15,C05,414148,Prestholdt; Jeremy,28,0,28,0
1708247797552,MMW 15,C06,414149,Prestholdt; Jeremy,26,0,28,2
1708247797552,MMW 15,C07,414152,Prestholdt; Jeremy,25,0,28,3
1708247797552,MMW 15,C08,414153,Prestholdt; Jeremy,23,0,28,5
1708247798082,MSED 295,A00,477850,Rabin; Jeffrey Mark,5,0,5,0
1708247798082,MSED 295,B00,477852,Lo; Stanley M.,5,0,5,0
1708247798609,MSED 296C,A00,477853,Staff,14,0,15,1
1708247799136,MUS 1C,A01,416488,Ishov; Alexander Alexandrovich,24,0,25,1
1708247799136,MUS 1C,A02,416502,Ishov; Alexander Alexandrovich,25,0,25,0
1708247799136,MUS 1C,A03,416519,Ishov; Alexander Alexandrovich,25,0,25,0
1708247799136,MUS 1C,A04,416520,Ishov; Alexander Alexandrovich,25,0,25,0
1708247799136,MUS 1C,A05,416521,Ishov; Alexander Alexandrovich,25,0,25,0
1708247799666,MUS 2C,A01,416523,Richards; Stephanie F,30,0,30,0
1708247800194,MUS 2CK,A00,416524,Ohnishi; Takae,15,0,15,0
1708247800194,MUS 2CK,B00,416547,Ohnishi; Takae,15,0,15,0
1708247800722,MUS 2JK,A00,416548,Kenyatta; Kamau,15,0,15,0
1708247801251,MUS 4,A01,416562,Staff,25,0,25,0
1708247801251,MUS 4,A02,416634,Staff,24,0,25,1
1708247801251,MUS 4,A03,416644,Staff,25,0,25,0
1708247801251,MUS 4,A04,416659,Staff,24,0,25,1
1708247801251,MUS 4,A05,416667,Staff,25,0,25,0
1708247801251,MUS 4,A06,416757,Staff,25,0,25,0
1708247801251,MUS 4,A07,416830,Staff,25,0,25,0
1708247801251,MUS 4,A08,416953,Staff,23,0,25,2
1708247801251,MUS 4,A09,417005,Staff,25,0,25,0
1708247801251,MUS 4,A10,417007,Staff,24,0,25,1
1708247801780,MUS 7,A01,417048,Staff,23,0,24,1
1708247801780,MUS 7,A02,417102,Staff,23,0,24,1
1708247801780,MUS 7,A03,417103,Staff,23,0,24,1
1708247801780,MUS 7,A04,417114,Staff,21,0,24,3
1708247802314,MUS 8,A01,417119,Staff,14,0,20,6
1708247802314,MUS 8,A02,417163,Staff,16,0,20,4
1708247802314,MUS 8,A03,417164,Staff,16,0,20,4
1708247802314,MUS 8,A04,417165,Staff,17,0,20,3
1708247802314,MUS 8,A05,417194,Staff,18,0,20,2
1708247802314,MUS 8,A06,417198,Staff,20,0,20,0
1708247802841,MUS 11,A01,417201,Terrazas Perez; Wilfrido D,21,0,25,4
1708247802841,MUS 11,A02,417219,Terrazas Perez; Wilfrido D,23,0,25,2
1708247802841,MUS 11,A03,417220,Terrazas Perez; Wilfrido D,25,0,25,0
1708247802841,MUS 11,A04,417222,Terrazas Perez; Wilfrido D,25,0,25,0
1708247802841,MUS 11,A05,417223,Terrazas Perez; Wilfrido D,24,0,25,1
1708247802841,MUS 11,A06,417295,Terrazas Perez; Wilfrido D,23,0,25,2
1708247802841,MUS 11,A07,417297,Terrazas Perez; Wilfrido D,24,0,25,1
1708247802841,MUS 11,A08,417298,Terrazas Perez; Wilfrido D,25,0,25,0
1708247803371,MUS 12,A01,417300,Guy; Nancy,25,0,25,0
1708247803371,MUS 12,A02,417301,Guy; Nancy,25,0,25,0
1708247803371,MUS 12,A03,417302,Guy; Nancy,25,0,25,0
1708247803371,MUS 12,A04,417303,Guy; Nancy,25,0,25,0
1708247803902,MUS 13,A01,417305,Leslie Santana; Myrta,25,0,25,0
1708247803902,MUS 13,A02,417306,Leslie Santana; Myrta,25,0,25,0
1708247803902,MUS 13,A03,417307,Leslie Santana; Myrta,25,0,25,0
1708247803902,MUS 13,A04,417308,Leslie Santana; Myrta,25,0,25,0
1708247804429,MUS 15,A01,417327,Schaffer; Max Benjamin,18,0,20,2
1708247804429,MUS 15,A02,417331,Schaffer; Max Benjamin,19,0,20,1
1708247804429,MUS 15,A03,417358,Schaffer; Max Benjamin,19,0,20,1
1708247804429,MUS 15,A04,417359,Schaffer; Max Benjamin,17,0,20,3
1708247804429,MUS 15,A05,417360,Schaffer; Max Benjamin,20,0,20,0
1708247804429,MUS 15,A06,417370,Schaffer; Max Benjamin,20,0,20,0
1708247804429,MUS 15,A07,417371,Schaffer; Max Benjamin,17,0,20,3
1708247804429,MUS 15,A08,417372,Schaffer; Max Benjamin,18,0,20,2
1708247804429,MUS 15,A09,417378,Schaffer; Max Benjamin,19,0,20,1
1708247804429,MUS 15,A10,417379,Schaffer; Max Benjamin,19,0,20,1
1708247804956,MUS 17,A01,417381,Staff,22,0,25,3
1708247804956,MUS 17,A02,417406,Staff,24,0,25,1
1708247804956,MUS 17,A03,417420,Staff,24,0,25,1
1708247804956,MUS 17,A04,417594,Staff,24,0,25,1
1708247804956,MUS 17,A05,417595,Staff,25,0,25,0
1708247804956,MUS 17,A06,417605,Staff,21,0,25,4
1708247804956,MUS 17,A07,417606,Staff,25,0,25,0
1708247804956,MUS 17,A08,417627,Staff,25,0,25,0
1708247804956,MUS 17,A09,417628,Staff,21,0,25,4
1708247804956,MUS 17,A10,417629,Staff,24,0,25,1
1708247804956,MUS 17,A11,417630,Staff,25,0,25,0
1708247804956,MUS 17,A12,417631,Staff,24,0,25,1
1708247804956,MUS 17,A13,417632,Staff,25,0,25,0
1708247804956,MUS 17,A14,417633,Staff,25,0,25,0
1708247805491,MUS 32,001,418855,Dresser; Mark Stuart,10,0,10,0
1708247805491,MUS 32,002,418856,Kenyatta; Kamau,9,0,10,1
1708247805491,MUS 32,003,418864,Curtis; Charles Rector,10,0,10,0
1708247805491,MUS 32,004,418865,Carlstrom; Mitchell Kraig,9,0,10,1
1708247805491,MUS 32,005,418868,Terrazas Perez; Wilfrido D,10,0,10,0
1708247805491,MUS 32,006,418869,Ohnishi; Takae,10,0,10,0
1708247805491,MUS 32,007,418872,Burr; Anthony I,10,0,10,0
1708247805491,MUS 32,008,418873,Carlson; Erik Norman,10,0,10,0
1708247805491,MUS 32,009,418874,Blair; Kyle Adam,10,0,10,0
1708247805491,MUS 32,010,418875,Richards; Stephanie F,10,0,10,0
1708247806017,MUS 32V,A00,417634,Narucki; Susan M,10,0,10,0
1708247806017,MUS 32V,B00,417635,Staff,10,0,10,0
1708247806546,MUS 32VM,A00,417636,Staff,15,0,15,0
1708247807072,MUS 33C,A00,417637,Taylor; Alexander Lawther,20,0,20,0
1708247807597,MUS 43,A00,417647,Burr; Anthony I,83,0,90,7
1708247808124,MUS 95D,A00,417919,Staff,40,0,40,0
1708247808656,MUS 95E,A00,417933,Henson; Matthew Alexander,55,0,55,0
1708247809186,MUS 95G,A00,417935,Anderson; Kenneth,387,0,395,8
1708247809186,MUS 95G,B00,417937,Anderson; Kenneth,394,0,395,1
1708247809711,MUS 95JC,A00,417939,Kenyatta; Kamau,30,0,30,0
1708247810238,MUS 95L,A00,417940,Jones; Michael David,50,0,50,0
1708247810764,MUS 95W,A00,417946,Seshadri; Kartik,29,0,30,1
1708247810764,MUS 95W,B00,417948,Seshadri; Kartik,30,0,30,0
1708247811290,MUS 101C,A01,417951,Burr; Anthony I,33,0,35,2
1708247811816,MUS 103C,A00,417952,Davis; Anthony Curtis,14,0,15,1
1708247812346,MUS 103F,A00,417959,Obermueller; Karola,1,0,1,0
1708247812871,MUS 113,A00,418015,Narucki; Susan M,14,0,15,1
1708247813401,MUS 120C,A01,418032,Leslie Santana; Myrta,25,0,25,0
1708247813927,MUS 127,A00,418037,Richards; Stephanie F,92,0,100,8
1708247814459,MUS 130,A00,418047,Ohnishi; Takae,30,0,30,0
1708247814987,MUS 131,A00,418065,Roberts; Matana,30,0,30,0
1708247815514,MUS 132,001,418883,Dresser; Mark Stuart,10,0,10,0
1708247815514,MUS 132,002,418885,Kenyatta; Kamau,10,0,10,0
1708247815514,MUS 132,003,418886,Curtis; Charles Rector,10,0,10,0
1708247815514,MUS 132,004,418887,Carlstrom; Mitchell Kraig,10,0,10,0
1708247815514,MUS 132,005,418888,Jones; Michael David,10,0,10,0
1708247815514,MUS 132,006,418889,Terrazas Perez; Wilfrido D,10,0,10,0
1708247815514,MUS 132,007,418893,Ohnishi; Takae,10,0,10,0
1708247815514,MUS 132,008,418894,Burr; Anthony I,10,0,10,0
1708247815514,MUS 132,009,418896,Carlson; Erik Norman,10,0,10,0
1708247815514,MUS 132,010,418900,Blair; Kyle Adam,10,0,10,0
1708247815514,MUS 132,011,418932,Richards; Stephanie F,10,0,10,0
1708247815514,MUS 132,012,418933,Nourai; Keyarash,10,0,10,0
1708247816040,MUS 132R,A00,418067,Burr; Anthony I,5,0,5,0
1708247816040,MUS 132R,B00,418078,Jones; Michael David,5,0,5,0
1708247816568,MUS 132V,A00,418092,Narucki; Susan M,15,0,15,0
1708247816568,MUS 132V,B00,418096,Staff,15,0,15,0
1708247817093,MUS 134,A00,418098,Staff,40,0,40,0
1708247817623,MUS 137C,A00,418109,Kenyatta; Kamau,25,0,25,0
1708247818150,MUS 143,A00,418123,Burr; Anthony I,33,0,40,7
1708247818677,MUS 150,A00,418127,Davis; Anthony Curtis,28,0,30,2
1708247819203,MUS 151,A00,418129,Hankins; Sarah E.,21,0,30,9
1708247819729,MUS 160B,A00,418172,Staff,11,0,15,4
1708247819729,MUS 160B,B00,418175,Dubnov; Shlomo,14,0,15,1
1708247820254,MUS 172,A01,418178,Staff,36,0,40,4
1708247820782,MUS 174C,A00,418179,Erbe; Tom,24,0,27,3
1708247821313,MUS 175,A00,418247,Smyth; Tamara R.,28,0,30,2
1708247821838,MUS 177,A00,418265,Erbe; Tom,11,0,15,4
1708247822364,MUS 201A,A00,418267,Narucki; Susan M,15,0,15,0
1708247822364,MUS 201A,B00,418268,Dresser; Mark Stuart,13,0,15,2
1708247822894,MUS 203C,A00,418269,Lou; Michelle Siulai,15,0,15,0
1708247823424,MUS 203D,A00,418272,Davis; Anthony Curtis,4,0,5,1
1708247823424,MUS 203D,B00,418275,Obermueller; Karola,5,0,5,0
1708247823424,MUS 203D,C00,418277,Liang; Lei,5,0,5,0
1708247823424,MUS 203D,D00,418323,Lou; Michelle Siulai,5,0,5,0
1708247823950,MUS 204,A00,418324,Obermueller; Karola,24,0,25,1
1708247824480,MUS 205,A00,418325,Cimini; Amy Marie,22,0,25,3
1708247825007,MUS 206,A00,418326,Liang; Lei,13,0,15,2
1708247825007,MUS 206,B00,418327,Roberts; Matana,13,0,15,2
1708247825536,MUS 215C,A00,418328,Cimini; Amy Marie,14,0,15,1
1708247826062,MUS 232,001,418937,Dresser; Mark Stuart,9,0,10,1
1708247826062,MUS 232,002,418969,Kenyatta; Kamau,10,0,10,0
1708247826062,MUS 232,003,418971,Curtis; Charles Rector,10,0,10,0
1708247826062,MUS 232,004,418974,Terrazas Perez; Wilfrido D,10,0,10,0
1708247826062,MUS 232,005,418979,Ohnishi; Takae,10,0,10,0
1708247826062,MUS 232,006,418980,Burr; Anthony I,10,0,10,0
1708247826062,MUS 232,007,418981,Carlson; Erik Norman,10,0,10,0
1708247826062,MUS 232,008,418982,Richards; Stephanie F,10,0,10,0
1708247826062,MUS 232,009,418985,Narucki; Susan M,10,0,10,0
1708247826587,MUS 234,A00,418329,Staff,15,0,15,0
1708247827112,MUS 245,A00,418330,Carlson; Erik Norman,14,0,15,1
1708247827640,MUS 267,A00,418331,Erbe; Tom,15,0,15,0
1708247828165,MUS 270B,A00,418332,Staff,15,0,15,0
1708247828692,MUS 270D,A00,479231,Smyth; Tamara R.,15,0,15,0
1708247829225,NANO 103,A00,414714,Jahed Motlagh; Zeinab,40,0,40,0
1708247829756,NANO 108,A00,414740,Lubarda; Vlado,70,0,70,0
1708247830282,NANO 112,A01,414825,Vazquez Mena; Oscar,70,0,70,0
1708247830811,NANO 115L,A01,414830,Yang; Kesong,37,0,38,1
1708247830811,NANO 115L,B01,414832,Xu; Sheng,35,0,38,3
1708247831343,NANO 120B,A01,414835,Vecchio; Kenneth S,33,0,35,2
1708247831343,NANO 120B,B01,414841,Fenning; David,30,0,35,5
1708247831874,NANO 156,A00,414843,Fullerton; Eric E,24,0,30,6
1708247832402,NANO 158,A00,414844,Luo; Jian,29,0,30,1
1708247832929,NANO 175,A00,414850,Steinmetz; Nicole F,30,0,35,5
1708247833461,NANO 200,A00,414852,Jahed Motlagh; Zeinab,118,0,120,2
1708247833991,NANO 241,A00,414854,Pokorski; Jonathan Kyle,18,0,25,7
1708247834523,NANO 262,A00,414858,Wang; Joseph,50,0,50,0
1708247835050,NANO 271,A00,414862,Cubukcu; Ertugrul,22,0,25,3
1708247835575,NANO 272,A00,414877,Xu; Sheng,42,0,50,8
1708247836101,NANO 279,A00,414878,Liu; Ping,32,0,40,8
1708247836627,NANO 282,A00,414879,Steinmetz; Nicole F,30,0,30,0
1708247837153,NEU 200C,A00,455013,Staff,0,0,0,1
1708247837683,NEU 276,A01,479489,Staff,35,0,36,1
1708247838213,NEU 277,A00,479492,Risbrough; Victoria Blythe,0,0,0,0
1708247838739,NEU 296,001,464921,Evans; Sean Jeffrey,48,0,50,2
1708247838739,NEU 296,002,464922,Staff,50,0,50,0
1708247838739,NEU 296,003,464925,Staff,50,0,50,0
1708247839265,NEUG 221,A00,479490,Zheng; Binhai,15,0,15,0
1708247839791,NEUG 280,A00,479491,Chen; Xu,0,0,0,0
1708247840319,NEUG 296,A00,479493,Bloodgood; Brenda Laurie,9998,0,9999,1
1708247840852,OPTH 296,001,465054,Baxter; Sally Liu,49,0,50,1
1708247840852,OPTH 296,002,465068,Afshari; Natalie,49,0,50,1
1708247840852,OPTH 296,003,465074,Staff,50,0,50,0
1708247841380,ORTH 296,A00,465104,Staff,50,0,50,0
1708247841380,ORTH 296,001,465111,Staff,50,0,50,0
1708247841380,ORTH 296,002,465120,Staff,50,0,50,0
1708247841906,PATH 224,A01,494386,Ross; Camille,11,0,12,1
1708247842432,PATH 296,001,465373,Calcutt; Nigel A,49,0,50,1
1708247842432,PATH 296,002,465374,Staff,50,0,50,0
1708247842432,PATH 296,003,465375,Staff,50,0,50,0
1708247842964,PEDS 296,001,465527,Weiss; Katherine Jean,49,0,50,1
1708247842964,PEDS 296,002,465528,Staff,50,0,50,0
1708247842964,PEDS 296,003,465529,Staff,50,0,50,0
1708247843492,PH 196BH,A01,405158,Binkin; Nancy Jeanne,20,0,20,0
1708247844021,PHAR 219,A00,415016,Ross; Camille,1,0,1,0
1708247844547,PHAR 231,A00,415017,Furnari; Frank,20,0,20,0
1708247844547,PHAR 231,B00,415018,Lopez Ramirez; Miguel Alej,20,0,20,0
1708247845074,PHAR 276,A00,415020,Mc Culloch; Andrew Douglas & Amaro; Rommie E,1,0,1,0
1708247845599,PHAR 295,A00,415022,Brown; Joan Heller,15,0,15,0
1708247846130,PHIL 1,A00,415023,Harrell; Maralee Mae,58,0,60,2
1708247846658,PHIL 10,A01,415026,Grush; Rick Scott,40,0,44,4
1708247846658,PHIL 10,A02,415028,Grush; Rick Scott,42,0,44,2
1708247846658,PHIL 10,A03,415029,Grush; Rick Scott,0,0,0,0
1708247846658,PHIL 10,A04,415031,Grush; Rick Scott,0,0,0,0
1708247846658,PHIL 10,A05,415113,Grush; Rick Scott,43,0,44,1
1708247846658,PHIL 10,A06,415114,Grush; Rick Scott,43,0,44,1
1708247846658,PHIL 10,A07,415116,Grush; Rick Scott,44,0,44,0
1708247846658,PHIL 10,A08,415118,Grush; Rick Scott,43,0,44,1
1708247847189,PHIL 12,A01,415120,McKenzie; Kerry V.,28,0,30,2
1708247847189,PHIL 12,A02,415136,McKenzie; Kerry V.,30,0,30,0
1708247847189,PHIL 12,A03,415137,McKenzie; Kerry V.,27,0,30,3
1708247847189,PHIL 12,A04,415142,McKenzie; Kerry V.,30,0,30,0
1708247847719,PHIL 13,A01,415165,Brink; David O.,25,0,25,0
1708247847719,PHIL 13,A02,415179,Brink; David O.,22,0,25,3
1708247847719,PHIL 13,A03,415185,Brink; David O.,24,0,25,1
1708247847719,PHIL 13,A04,415201,Brink; David O.,25,0,25,0
1708247847719,PHIL 13,A05,415204,Brink; David O.,25,0,25,0
1708247847719,PHIL 13,A06,415220,Brink; David O.,25,0,25,0
1708247848250,PHIL 15,A01,415250,Fulkerson; Matthew Todd,27,0,30,3
1708247848250,PHIL 15,A02,415281,Fulkerson; Matthew Todd,29,0,30,1
1708247848784,PHIL 27,A01,415293,Brandt; Reuven A,20,0,25,5
1708247848784,PHIL 27,A02,415296,Brandt; Reuven A,0,0,0,0
1708247848784,PHIL 27,A03,415332,Brandt; Reuven A,22,0,25,3
1708247848784,PHIL 27,A04,415333,Brandt; Reuven A,22,0,25,3
1708247848784,PHIL 27,A05,415342,Brandt; Reuven A,20,0,25,5
1708247848784,PHIL 27,A06,415384,Brandt; Reuven A,24,0,25,1
1708247848784,PHIL 27,A07,415385,Brandt; Reuven A,25,0,25,0
1708247848784,PHIL 27,A08,415391,Brandt; Reuven A,0,0,0,0
1708247848784,PHIL 27,A09,415406,Brandt; Reuven A,0,0,0,0
1708247848784,PHIL 27,A10,415407,Brandt; Reuven A,0,0,0,0
1708247849312,PHIL 28,A01,415412,Lamey; Andy M.,24,0,25,1
1708247849312,PHIL 28,A02,415470,Lamey; Andy M.,20,0,25,5
1708247849312,PHIL 28,A03,415474,Lamey; Andy M.,0,0,0,0
1708247849312,PHIL 28,A04,415475,Lamey; Andy M.,22,0,25,3
1708247849312,PHIL 28,A05,415487,Lamey; Andy M.,24,0,25,1
1708247849312,PHIL 28,A06,415506,Lamey; Andy M.,21,0,25,4
1708247849312,PHIL 28,A07,415507,Lamey; Andy M.,25,0,25,0
1708247849312,PHIL 28,A08,415508,Lamey; Andy M.,24,0,25,1
1708247849312,PHIL 28,A09,415509,Lamey; Andy M.,25,0,25,0
1708247849312,PHIL 28,A10,415510,Lamey; Andy M.,0,0,0,0
1708247849840,PHIL 33,A01,415521,Hardimon; Michael O.,35,0,35,0
1708247849840,PHIL 33,A02,415522,Hardimon; Michael O.,35,0,35,0
1708247850370,PHIL 60,A00,415523,Marechal; Patricia,55,0,60,5
1708247850951,PHIL 102,A00,415524,Johnson; Monte,37,0,40,3
1708247851477,PHIL 106,A00,415544,Watkins; Eric,40,0,40,0
1708247852008,PHIL 112,A00,415545,Watkins; Eric,34,0,40,6
1708247852534,PHIL 115,A00,415548,Nelkin; Dana Kay,20,0,20,0
1708247853064,PHIL 120,A00,415549,Carr; Jennifer Rose,64,0,65,1
1708247853595,PHIL 134,A00,415552,Carr; Jennifer Rose,40,0,40,0
1708247854127,PHIL 150,A00,415553,Cohen; Jonathan David,38,0,40,2
1708247854655,PHIL 171,A00,415561,Brink; David O.,39,0,40,1
1708247855182,PHIL 172,A00,415563,Lamey; Andy M.,40,0,40,0
1708247855710,PHIL 174,A01,415576,Danks; David J,21,0,25,4
1708247855710,PHIL 174,A02,415582,Danks; David J,22,0,25,3
1708247855710,PHIL 174,A03,415583,Danks; David J,24,0,25,1
1708247855710,PHIL 174,A04,415584,Danks; David J,25,0,25,0
1708247856237,PHIL 175,A00,415585,Shields; Christopher John,40,0,40,0
1708247856764,PHIL 181,A00,415601,Tolley; Clinton,34,0,40,6
1708247857295,PHIL 209B,A00,415655,Serlin; David,4,0,5,1
1708247857822,PHIL 209C,A00,415658,Gates; Kelly,5,0,5,0
1708247858351,PHIL 210,A00,415659,Marechal; Patricia,20,0,20,0
1708247858877,PHIL 230,A00,415661,Grush; Rick Scott,20,0,20,0
1708247859407,PHIL 232,A00,415662,Sher; Gila,20,0,20,0
1708247859950,PHIL 260,A00,415675,Bazargan-Forward; Saba,20,0,20,0
1708247860481,PHIL 277,A00,479176,Tolley; Clinton,9,0,10,1
1708247861010,PHIL 285,A00,415685,Kovaka; Karenc,20,0,20,0
1708247861539,PHIL 287,A00,415697,Marechal; Patricia,5,0,5,0
1708247862081,PHIL 290,001,415701,Nelkin; Dana Kay,9999,0,9999,0
1708247862081,PHIL 290,002,415721,Bazargan-Forward; Saba,9999,0,9999,0
1708247862081,PHIL 290,003,415731,Brandt; Reuven A,9999,0,9999,0
1708247862081,PHIL 290,004,415743,Brink; David O.,9999,0,9999,0
1708247862081,PHIL 290,005,415747,Callender; Craig Adam,9999,0,9999,0
1708247862081,PHIL 290,006,415779,Carr; Jennifer Rose,9999,0,9999,0
1708247862081,PHIL 290,007,415780,Cartwright; Nancy D.,9999,0,9999,0
1708247862081,PHIL 290,008,415781,Cohen; Jonathan David,9999,0,9999,0
1708247862081,PHIL 290,009,415782,Danks; David J,9999,0,9999,0
1708247862081,PHIL 290,010,415783,Fulkerson; Matthew Todd,9999,0,9999,0
1708247862081,PHIL 290,011,415784,Grush; Rick Scott,9999,0,9999,0
1708247862081,PHIL 290,012,415785,Hardimon; Michael O.,9999,0,9999,0
1708247862081,PHIL 290,013,415786,Harrell; Maralee Mae,9999,0,9999,0
1708247862081,PHIL 290,014,415787,Johnson; Monte,9999,0,9999,0
1708247862081,PHIL 290,015,415788,Kovaka; Karenc,9999,0,9999,0
1708247862081,PHIL 290,016,415789,Lamey; Andy M.,9999,0,9999,0
1708247862081,PHIL 290,017,415790,Marechal; Patricia,9999,0,9999,0
1708247862081,PHIL 290,018,415791,McKenzie; Kerry V.,9999,0,9999,0
1708247862081,PHIL 290,019,415792,Rickless; Samuel Charles,9999,0,9999,0
1708247862081,PHIL 290,020,415793,Sher; Gila,9999,0,9999,0
1708247862081,PHIL 290,021,415794,Shields; Christopher John,9999,0,9999,0
1708247862081,PHIL 290,022,415805,Tolley; Clinton,9999,0,9999,0
1708247862081,PHIL 290,023,415806,Vargas; Manuel Rogelio,9999,0,9999,0
1708247862081,PHIL 290,024,415807,Watkins; Eric,9999,0,9999,0
1708247862081,PHIL 290,025,415815,Chen; Keming,9999,0,9999,0
1708247862624,PHIL 295,001,415816,Bazargan-Forward; Saba,9999,0,9999,0
1708247862624,PHIL 295,002,415857,Brandt; Reuven A,9999,0,9999,0
1708247862624,PHIL 295,003,415858,Brink; David O.,9999,0,9999,0
1708247862624,PHIL 295,004,415877,Callender; Craig Adam,9999,0,9999,0
1708247862624,PHIL 295,005,415878,Carr; Jennifer Rose,9999,0,9999,0
1708247862624,PHIL 295,006,415884,Cartwright; Nancy D.,9999,0,9999,0
1708247862624,PHIL 295,007,415885,Chen; Keming,9999,0,9999,0
1708247862624,PHIL 295,008,415891,Cohen; Jonathan David,9999,0,9999,0
1708247862624,PHIL 295,009,415892,Danks; David J,9999,0,9999,0
1708247862624,PHIL 295,010,415937,Fulkerson; Matthew Todd,9999,0,9999,0
1708247862624,PHIL 295,011,415940,Grush; Rick Scott,9999,0,9999,0
1708247862624,PHIL 295,012,415945,Hardimon; Michael O.,9999,0,9999,0
1708247862624,PHIL 295,013,415946,Harrell; Maralee Mae,9999,0,9999,0
1708247862624,PHIL 295,014,415953,Johnson; Monte,9999,0,9999,0
1708247862624,PHIL 295,015,415954,Kovaka; Karenc,9999,0,9999,0
1708247862624,PHIL 295,016,415957,Lamey; Andy M.,9999,0,9999,0
1708247862624,PHIL 295,017,415958,Marechal; Patricia,9999,0,9999,0
1708247862624,PHIL 295,018,415959,McKenzie; Kerry V.,9999,0,9999,0
1708247862624,PHIL 295,019,415960,Nelkin; Dana Kay,9999,0,9999,0
1708247862624,PHIL 295,020,415961,Rickless; Samuel Charles,9999,0,9999,0
1708247862624,PHIL 295,021,415987,Sher; Gila,9999,0,9999,0
1708247862624,PHIL 295,022,416027,Shields; Christopher John,9999,0,9999,0
1708247862624,PHIL 295,023,416030,Tolley; Clinton,9999,0,9999,0
1708247862624,PHIL 295,024,416033,Vargas; Manuel Rogelio,9999,0,9999,0
1708247862624,PHIL 295,025,416034,Watkins; Eric,9999,0,9999,0
1708247863152,PHYA 224,A00,442106,Sandstrom; Karin Marie,30,0,30,0
1708247863684,PHYS 1A,A00,441607,Gilbert; Dylan Paul,346,0,362,16
1708247864220,PHYS 1AL,001,441608,Arlett; Jessica Lynn & Yagil; Avi,30,0,30,0
1708247864220,PHYS 1AL,002,441609,Arlett; Jessica Lynn & Yagil; Avi,28,0,30,2
1708247864220,PHYS 1AL,003,441610,Arlett; Jessica Lynn & Yagil; Avi,26,0,30,4
1708247864220,PHYS 1AL,004,441611,Arlett; Jessica Lynn & Yagil; Avi,29,0,30,1
1708247864220,PHYS 1AL,005,441612,Arlett; Jessica Lynn & Yagil; Avi,28,0,30,2
1708247864220,PHYS 1AL,006,441616,Arlett; Jessica Lynn & Yagil; Avi,28,0,30,2
1708247864220,PHYS 1AL,007,441618,Arlett; Jessica Lynn & Yagil; Avi,26,0,30,4
1708247864220,PHYS 1AL,008,441620,Arlett; Jessica Lynn & Yagil; Avi,29,0,30,1
1708247864220,PHYS 1AL,009,441623,Arlett; Jessica Lynn & Yagil; Avi,29,0,30,1
1708247864220,PHYS 1AL,010,441625,Arlett; Jessica Lynn & Yagil; Avi,29,0,30,1
1708247864220,PHYS 1AL,011,441626,Arlett; Jessica Lynn & Yagil; Avi,29,0,30,1
1708247864220,PHYS 1AL,012,441627,Arlett; Jessica Lynn & Yagil; Avi,29,0,30,1
1708247864762,PHYS 1B,A00,441630,Groisman; Alexander,351,0,362,11
1708247865303,PHYS 1BL,001,441632,Arlett; Jessica Lynn & Yagil; Avi,28,0,30,2
1708247865303,PHYS 1BL,002,441634,Arlett; Jessica Lynn & Yagil; Avi,29,0,30,1
1708247865303,PHYS 1BL,003,441636,Arlett; Jessica Lynn & Yagil; Avi,29,0,30,1
1708247865303,PHYS 1BL,004,441637,Arlett; Jessica Lynn & Yagil; Avi,29,0,30,1
1708247865303,PHYS 1BL,005,441639,Arlett; Jessica Lynn & Yagil; Avi,29,0,30,1
1708247865303,PHYS 1BL,006,441641,Arlett; Jessica Lynn & Yagil; Avi,26,0,30,4
1708247865303,PHYS 1BL,007,441642,Arlett; Jessica Lynn & Yagil; Avi,23,0,30,7
1708247865303,PHYS 1BL,008,441643,Arlett; Jessica Lynn & Yagil; Avi,30,0,30,0
1708247865303,PHYS 1BL,009,441646,Arlett; Jessica Lynn & Yagil; Avi,29,0,30,1
1708247865303,PHYS 1BL,010,441648,Arlett; Jessica Lynn & Yagil; Avi,29,0,30,1
1708247865303,PHYS 1BL,011,441652,Arlett; Jessica Lynn & Yagil; Avi,29,0,30,1
1708247865303,PHYS 1BL,012,441654,Arlett; Jessica Lynn & Yagil; Avi,30,0,30,0
1708247865833,PHYS 1C,A00,441658,Popmintchev; Tenio,588,0,600,12
1708247865833,PHYS 1C,B00,441662,Popmintchev; Tenio,559,0,600,41
1708247866412,PHYS 1CL,001,441664,Arlett; Jessica Lynn & Yagil; Avi,29,0,30,1
1708247866412,PHYS 1CL,002,441665,Arlett; Jessica Lynn & Yagil; Avi,27,0,30,3
1708247866412,PHYS 1CL,003,441666,Arlett; Jessica Lynn & Yagil; Avi,25,0,30,5
1708247866412,PHYS 1CL,004,441667,Arlett; Jessica Lynn & Yagil; Avi,30,0,30,0
1708247866412,PHYS 1CL,005,441668,Arlett; Jessica Lynn & Yagil; Avi,28,0,30,2
1708247866412,PHYS 1CL,006,441669,Arlett; Jessica Lynn & Yagil; Avi,25,0,30,5
1708247866412,PHYS 1CL,007,441671,Arlett; Jessica Lynn & Yagil; Avi,27,0,30,3
1708247866412,PHYS 1CL,008,441673,Arlett; Jessica Lynn & Yagil; Avi,30,0,30,0
1708247866412,PHYS 1CL,009,441674,Arlett; Jessica Lynn & Yagil; Avi,26,0,30,4
1708247866412,PHYS 1CL,010,441676,Arlett; Jessica Lynn & Yagil; Avi,30,0,30,0
1708247866412,PHYS 1CL,011,441677,Arlett; Jessica Lynn & Yagil; Avi,30,0,30,0
1708247866412,PHYS 1CL,012,441683,Arlett; Jessica Lynn & Yagil; Avi,30,0,30,0
1708247866412,PHYS 1CL,013,441685,Arlett; Jessica Lynn & Yagil; Avi,28,0,30,2
1708247866412,PHYS 1CL,014,441687,Arlett; Jessica Lynn & Yagil; Avi,30,0,30,0
1708247866412,PHYS 1CL,015,441689,Arlett; Jessica Lynn & Yagil; Avi,17,0,30,13
1708247866412,PHYS 1CL,016,441692,Arlett; Jessica Lynn & Yagil; Avi,29,0,30,1
1708247866412,PHYS 1CL,017,441696,Arlett; Jessica Lynn & Yagil; Avi,25,0,30,5
1708247866412,PHYS 1CL,018,441698,Arlett; Jessica Lynn & Yagil; Avi,25,0,30,5
1708247866412,PHYS 1CL,019,441702,Arlett; Jessica Lynn & Yagil; Avi,25,0,30,5
1708247866412,PHYS 1CL,020,441705,Arlett; Jessica Lynn & Yagil; Avi,29,0,30,1
1708247866412,PHYS 1CL,021,441706,Arlett; Jessica Lynn & Yagil; Avi,30,0,30,0
1708247866412,PHYS 1CL,022,441707,Arlett; Jessica Lynn & Yagil; Avi,30,0,30,0
1708247866412,PHYS 1CL,023,441708,Arlett; Jessica Lynn & Yagil; Avi,27,0,30,3
1708247866412,PHYS 1CL,024,441710,Arlett; Jessica Lynn & Yagil; Avi,29,0,30,1
1708247866412,PHYS 1CL,025,441711,Arlett; Jessica Lynn & Yagil; Avi,28,0,30,2
1708247866412,PHYS 1CL,026,441712,Arlett; Jessica Lynn & Yagil; Avi,29,0,30,1
1708247866412,PHYS 1CL,027,441713,Arlett; Jessica Lynn & Yagil; Avi,26,0,30,4
1708247866412,PHYS 1CL,028,441714,Arlett; Jessica Lynn & Yagil; Avi,29,0,30,1
1708247866412,PHYS 1CL,029,441715,Arlett; Jessica Lynn & Yagil; Avi,25,0,30,5
1708247866412,PHYS 1CL,030,441717,Arlett; Jessica Lynn & Yagil; Avi,29,0,30,1
1708247866412,PHYS 1CL,031,441718,Arlett; Jessica Lynn & Yagil; Avi,27,0,30,3
1708247866412,PHYS 1CL,032,441721,Arlett; Jessica Lynn & Yagil; Avi,30,0,30,0
1708247866412,PHYS 1CL,033,441724,Arlett; Jessica Lynn & Yagil; Avi,28,0,30,2
1708247866412,PHYS 1CL,034,441726,Arlett; Jessica Lynn & Yagil; Avi,29,0,30,1
1708247866412,PHYS 1CL,035,441728,Arlett; Jessica Lynn & Yagil; Avi,29,0,30,1
1708247866412,PHYS 1CL,036,441729,Arlett; Jessica Lynn & Yagil; Avi,30,0,30,0
1708247866412,PHYS 1CL,037,441730,Arlett; Jessica Lynn & Yagil; Avi,27,0,30,3
1708247866412,PHYS 1CL,038,441732,Arlett; Jessica Lynn & Yagil; Avi,29,0,30,1
1708247866412,PHYS 1CL,039,441733,Arlett; Jessica Lynn & Yagil; Avi,27,0,30,3
1708247866412,PHYS 1CL,040,441734,Arlett; Jessica Lynn & Yagil; Avi,30,0,30,0
1708247866412,PHYS 1CL,041,441735,Arlett; Jessica Lynn & Yagil; Avi,29,0,30,1
1708247866412,PHYS 1CL,042,441766,Arlett; Jessica Lynn & Yagil; Avi,30,0,30,0
1708247866412,PHYS 1CL,043,441768,Arlett; Jessica Lynn & Yagil; Avi,29,0,30,1
1708247866412,PHYS 1CL,044,441770,Arlett; Jessica Lynn & Yagil; Avi,30,0,30,0
1708247866965,PHYS 2A,A01,460308,Bal; Gurleen K,28,0,30,2
1708247866965,PHYS 2A,A02,460320,Bal; Gurleen K,30,0,30,0
1708247866965,PHYS 2A,A03,460321,Bal; Gurleen K,29,0,30,1
1708247866965,PHYS 2A,A04,460325,Bal; Gurleen K,28,0,30,2
1708247866965,PHYS 2A,A05,460326,Bal; Gurleen K,29,0,30,1
1708247866965,PHYS 2A,A06,460327,Bal; Gurleen K,30,0,30,0
1708247866965,PHYS 2A,A07,460495,Bal; Gurleen K,28,0,30,2
1708247866965,PHYS 2A,A08,460535,Bal; Gurleen K,27,0,30,3
1708247866965,PHYS 2A,A09,460536,Bal; Gurleen K,30,0,30,0
1708247866965,PHYS 2A,A10,460537,Bal; Gurleen K,30,0,30,0
1708247866965,PHYS 2A,A11,460538,Bal; Gurleen K,30,0,30,0
1708247866965,PHYS 2A,A12,460539,Bal; Gurleen K,30,0,30,0
1708247867525,PHYS 2B,A01,460620,Barreiro Guerrero; Julio,30,0,30,0
1708247867525,PHYS 2B,A02,460625,Barreiro Guerrero; Julio,30,0,30,0
1708247867525,PHYS 2B,A03,460626,Barreiro Guerrero; Julio,29,0,30,1
1708247867525,PHYS 2B,A04,460716,Barreiro Guerrero; Julio,26,0,30,4
1708247867525,PHYS 2B,A05,460756,Barreiro Guerrero; Julio,29,0,30,1
1708247867525,PHYS 2B,A06,460837,Barreiro Guerrero; Julio,30,0,30,0
1708247867525,PHYS 2B,A07,460865,Barreiro Guerrero; Julio,30,0,30,0
1708247867525,PHYS 2B,A08,460866,Barreiro Guerrero; Julio,30,0,30,0
1708247867525,PHYS 2B,A09,460867,Barreiro Guerrero; Julio,29,0,30,1
1708247867525,PHYS 2B,A10,460868,Barreiro Guerrero; Julio,30,0,30,0
1708247867525,PHYS 2B,A11,460869,Barreiro Guerrero; Julio,30,0,30,0
1708247867525,PHYS 2B,A12,460874,Barreiro Guerrero; Julio,30,0,30,0
1708247867525,PHYS 2B,B01,469381,Barreiro Guerrero; Julio,30,0,30,0
1708247867525,PHYS 2B,B02,469382,Barreiro Guerrero; Julio,29,0,30,1
1708247867525,PHYS 2B,B03,469402,Barreiro Guerrero; Julio,27,0,30,3
1708247867525,PHYS 2B,B04,469403,Barreiro Guerrero; Julio,28,0,30,2
1708247867525,PHYS 2B,B05,469442,Barreiro Guerrero; Julio,30,0,30,0
1708247867525,PHYS 2B,B06,469449,Barreiro Guerrero; Julio,30,0,30,0
1708247867525,PHYS 2B,B07,469450,Barreiro Guerrero; Julio,29,0,30,1
1708247867525,PHYS 2B,B08,469451,Barreiro Guerrero; Julio,30,0,30,0
1708247867525,PHYS 2B,B09,469457,Barreiro Guerrero; Julio,29,0,30,1
1708247867525,PHYS 2B,B10,469460,Barreiro Guerrero; Julio,30,0,30,0
1708247867525,PHYS 2B,B11,469468,Barreiro Guerrero; Julio,30,0,30,0
1708247867525,PHYS 2B,B12,469475,Barreiro Guerrero; Julio,30,0,30,0
1708247868067,PHYS 2BL,A01,441779,Meyertholen; Andrew D.,21,0,24,3
1708247868067,PHYS 2BL,A02,441780,Meyertholen; Andrew D.,17,0,24,7
1708247868067,PHYS 2BL,A03,441781,Meyertholen; Andrew D.,21,0,24,3
1708247868067,PHYS 2BL,A04,441782,Meyertholen; Andrew D.,21,0,24,3
1708247868067,PHYS 2BL,A05,441784,Meyertholen; Andrew D.,23,0,24,1
1708247868067,PHYS 2BL,A06,441786,Meyertholen; Andrew D.,23,0,24,1
1708247868067,PHYS 2BL,A07,441788,Meyertholen; Andrew D.,23,0,24,1
1708247868067,PHYS 2BL,A08,441790,Meyertholen; Andrew D.,24,0,24,0
1708247868067,PHYS 2BL,A09,441792,Meyertholen; Andrew D.,24,0,24,0
1708247868067,PHYS 2BL,A10,441794,Meyertholen; Andrew D.,23,0,24,1
1708247868067,PHYS 2BL,A11,441796,Meyertholen; Andrew D.,22,0,24,2
1708247868067,PHYS 2BL,A12,441798,Meyertholen; Andrew D.,24,0,24,0
1708247868067,PHYS 2BL,A13,441800,Meyertholen; Andrew D.,24,0,24,0
1708247868067,PHYS 2BL,A14,441802,Meyertholen; Andrew D.,24,0,24,0
1708247868067,PHYS 2BL,A15,441804,Meyertholen; Andrew D.,23,0,24,1
1708247868593,PHYS 2C,A01,460540,Tan; Tzer Han,30,0,30,0
1708247868593,PHYS 2C,A02,460541,Tan; Tzer Han,28,0,30,2
1708247868593,PHYS 2C,A03,460542,Tan; Tzer Han,28,0,30,2
1708247868593,PHYS 2C,A04,460543,Tan; Tzer Han,28,0,30,2
1708247868593,PHYS 2C,A05,460544,Tan; Tzer Han,28,0,30,2
1708247868593,PHYS 2C,A06,460545,Tan; Tzer Han,29,0,30,1
1708247868593,PHYS 2C,A07,460553,Tan; Tzer Han,30,0,30,0
1708247868593,PHYS 2C,A08,460561,Tan; Tzer Han,30,0,30,0
1708247868593,PHYS 2C,A09,460562,Tan; Tzer Han,28,0,30,2
1708247868593,PHYS 2C,A10,460563,Tan; Tzer Han,29,0,30,1
1708247868593,PHYS 2C,A11,460567,Tan; Tzer Han,30,0,30,0
1708247868593,PHYS 2C,A12,460568,Tan; Tzer Han,28,0,30,2
1708247869123,PHYS 2CL,A01,441809,Ni; Kaixuan,25,0,28,3
1708247869123,PHYS 2CL,A02,441811,Ni; Kaixuan,27,0,28,1
1708247869123,PHYS 2CL,A03,441814,Ni; Kaixuan,23,0,28,5
1708247869123,PHYS 2CL,A04,441817,Ni; Kaixuan,28,0,28,0
1708247869123,PHYS 2CL,A05,441819,Ni; Kaixuan,26,0,28,2
1708247869123,PHYS 2CL,A06,441820,Ni; Kaixuan,27,0,28,1
1708247869655,PHYS 2D,A01,460569,Sharma; Vivek A.,24,0,25,1
1708247869655,PHYS 2D,A02,460574,Sharma; Vivek A.,24,0,25,1
1708247869655,PHYS 2D,A03,460575,Sharma; Vivek A.,25,0,25,0
1708247870188,PHYS 4B,A01,441829,Grinstein; Benjamin,34,0,38,4
1708247870188,PHYS 4B,A02,441831,Grinstein; Benjamin,30,0,32,2
1708247870188,PHYS 4B,A03,441832,Grinstein; Benjamin,30,0,30,0
1708247870188,PHYS 4B,A04,441833,Grinstein; Benjamin,30,0,30,0
1708247870714,PHYS 4E,A01,441907,Frano Pereira; Alex M,33,0,34,1
1708247870714,PHYS 4E,A02,441958,Frano Pereira; Alex M,34,0,34,0
1708247871254,PHYS 10,A01,441971,Burgasser; Adam Jonathan,118,0,120,2
1708247871782,PHYS 13,A01,441974,Wright; Shelley Adams,61,0,65,4
1708247872307,PHYS 87,A00,486898,Grinstein; Benjamin,19,0,20,1
1708247872836,PHYS 100C,A01,441978,Averitt; Richard Douglas,58,0,60,2
1708247873362,PHYS 105B,A01,441985,Green; Daniel Richard,37,0,40,3
1708247873888,PHYS 120,A01,441995,Arnold; Kam S,40,0,44,4
1708247873888,PHYS 120,A02,442011,Arnold; Kam S,41,0,44,3
1708247874415,PHYS 130A,A01,442032,Parker; Daniel E,74,0,75,1
1708247874942,PHYS 130B,A01,442056,Branson; James G,47,0,50,3
1708247875469,PHYS 139,A00,442057,Jun; Suckjoon,30,0,30,0
1708247875469,PHYS 139,B00,442059,Duarte; Javier Mauricio & Li; Aobo,42,0,50,8
1708247875994,PHYS 140A,A01,442065,Shotwell; Brian,49,0,50,1
1708247876524,PHYS 152B,A01,442067,Hirsch; Jorge Eduardo,17,0,20,3
1708247877051,PHYS 154,A01,442069,Jenkins; Elizabeth,29,0,30,1
1708247877593,PHYS 162,A01,442096,Keating; Brian,64,0,65,1
1708247878121,PHYS 170,A01,486870,Oh; Seungeun,39,0,40,1
1708247878647,PHYS 177,A00,442103,Dudko; Olga,20,0,20,0
1708247879179,PHYS 203B,A01,442132,Fogler; Michael M.,20,0,20,0
1708247879725,PHYS 210A,A01,442143,Hwa; Terence T.,20,0,20,0
1708247880251,PHYS 212C,A01,442200,Chivukula; Raja S,18,0,20,2
1708247880778,PHYS 215C,A00,442201,Intriligator; Kenneth Arthur,19,0,20,1
1708247881305,PHYS 225C,A01,442203,Flauger; Raphael M,19,0,20,1
1708247881831,PHYS 227,A00,442204,Tytler; David Robert,29,0,30,1
1708247882361,PHYS 230,A01,442206,McGreevy; John A.,20,0,20,0
1708247882888,PHYS 239,A00,442207,Goldenfeld; Nigel,20,0,20,0
1708247882888,PHYS 239,B00,442208,Duarte; Javier Mauricio & Li; Aobo,5,0,5,0
1708247883414,PHYS 244,A01,442280,Norman; Michael L,12,0,20,8
1708247883940,PHYS 250,A00,442300,Fogler; Michael M.,50,0,50,0
1708247884465,PHYS 251,A00,442307,Grinstein; Benjamin,20,0,20,0
1708247884995,PHYS 252,A00,442348,Diamond; Patrick H,10,0,10,0
1708247885520,PHYS 253,A00,442349,Theissen; Christopher Alexander,30,0,30,0
1708247886048,PHYS 254,A00,442352,Hwa; Terence T.,30,0,30,0
1708247886573,PHYS 255,A00,442423,Hwa; Terence T.,30,0,30,0
1708247887103,PHYS 258,A00,442426,Theissen; Christopher Alexander,30,0,30,0
1708247887629,PHYS 260,A00,442427,Frano Pereira; Alex M,50,0,50,0
1708247888158,PHYS 277,A00,442428,Dudko; Olga,20,0,20,0
1708247888703,POLI 5D,A01,419010,Dai; Yinlin,5,0,7,2
1708247888703,POLI 5D,A02,419020,Dai; Yinlin,7,0,7,0
1708247888703,POLI 5D,A03,419022,Dai; Yinlin,4,0,6,2
1708247888703,POLI 5D,A04,419040,Dai; Yinlin,5,0,5,0
1708247888703,POLI 5D,B01,419065,Dai; Yinlin,7,0,7,0
1708247888703,POLI 5D,B02,419068,Dai; Yinlin,7,0,7,0
1708247888703,POLI 5D,B03,419069,Dai; Yinlin,6,0,6,0
1708247888703,POLI 5D,B04,419070,Dai; Yinlin,5,0,5,0
1708247888703,POLI 5D,C01,487211,Staff,3,0,5,2
1708247889230,POLI 11D,A01,419072,Desposato; Scott,32,0,34,2
1708247889230,POLI 11D,A02,419073,Desposato; Scott,33,0,34,1
1708247889230,POLI 11D,A03,419082,Desposato; Scott,32,0,34,2
1708247889230,POLI 11D,A04,419123,Desposato; Scott,34,0,34,0
1708247889230,POLI 11D,A05,419124,Desposato; Scott,34,0,34,0
1708247889230,POLI 11D,A06,419125,Desposato; Scott,34,0,34,0
1708247889772,POLI 12D,A01,419127,Gartzke; Erik,29,0,34,5
1708247889772,POLI 12D,A02,419128,Gartzke; Erik,34,0,34,0
1708247889772,POLI 12D,A03,419129,Gartzke; Erik,34,0,34,0
1708247889772,POLI 12D,A04,419130,Gartzke; Erik,34,0,34,0
1708247889772,POLI 12D,A05,419131,Gartzke; Erik,32,0,34,2
1708247889772,POLI 12D,A06,419168,Gartzke; Erik,34,0,34,0
1708247890316,POLI 13DR,A01,477733,Draper; Matthew William,28,0,34,6
1708247890316,POLI 13DR,A02,477734,Draper; Matthew William,32,0,34,2
1708247890316,POLI 13DR,A03,477736,Draper; Matthew William,33,0,34,1
1708247890316,POLI 13DR,A04,477737,Draper; Matthew William,32,0,34,2
1708247890316,POLI 13DR,A05,477739,Draper; Matthew William,31,0,34,3
1708247890316,POLI 13DR,A06,477740,Draper; Matthew William,34,0,34,0
1708247890844,POLI 30D,A01,419179,Desposato; Scott,19,0,28,9
1708247890844,POLI 30D,A02,419180,Desposato; Scott,25,0,28,3
1708247890844,POLI 30D,A03,419181,Desposato; Scott,27,0,28,1
1708247890844,POLI 30D,A04,419182,Desposato; Scott,28,0,28,0
1708247890844,POLI 30D,A05,419187,Desposato; Scott,24,0,28,4
1708247890844,POLI 30D,A06,419189,Desposato; Scott,28,0,28,0
1708247891369,POLI 100E,A00,419191,Pitcher; Kennedy Anell,105,0,115,10
1708247891896,POLI 104P,A00,419192,Orfield; Michael Bennett,183,0,196,13
1708247892427,POLI 104U,A00,419193,Nichter; Maysa,90,0,115,25
1708247892954,POLI 108,A00,419194,Adida; Claire,293,0,295,2
1708247893480,POLI 110C,A00,419195,Soon; Valerie,47,0,50,3
1708247894006,POLI 120D,A00,419207,Hansen; Jan Eric,48,0,50,2
1708247894537,POLI 124A,A00,419209,Fortunato; David,48,0,50,2
1708247895081,POLI 131CR,A00,419211,Hoston; Germaine,41,0,50,9
1708247895081,POLI 131CR,B00,481592,Hoston; Germaine,10,0,10,0
1708247895608,POLI 136A,A00,419212,Roeder; Philip G,111,0,115,4
1708247896134,POLI 140D,A00,419213,Wong; Tak Kei,183,0,192,9
1708247896660,POLI 142D,A00,419214,Gartzke; Erik,227,0,230,3
1708247897187,POLI 145C,A00,419222,Fisk; David Lee,101,0,115,14
1708247897715,POLI 150A,A00,419225,Wong; Tak Kei,218,0,230,12
1708247898246,POLI 170A,A00,419226,Skillman; Rachel Diane,115,0,115,0
1708247898771,POLI 179,A00,419238,Staff,95,0,104,9
1708247899303,POLI 194,A00,455332,Hill; Seth J,0,0,0,0
1708247899833,POLI 194SD,A00,419248,Nichter; Maysa,999,0,999,0
1708247900377,POLI 197SD,001,419258,Nichter; Maysa,999,0,999,0
1708247900907,POLI 203B,A00,419265,Slantchev; Branislav,21,0,25,4
1708247901434,POLI 214R,A00,419275,Hoston; Germaine,23,0,25,2
1708247901960,POLI 219,A00,419289,Soon; Valerie,24,0,25,1
1708247902490,POLI 220A,A00,419299,Ferree; Karen E,21,0,25,4
1708247903016,POLI 233,A00,419333,Adida; Claire,23,0,25,2
1708247903545,POLI 243,A00,479118,Joseph; Michael F,23,0,25,2
1708247904075,POLI 251,A00,419334,Ban; Pamela M,23,0,25,2
1708247904654,POLI 257,A00,419335,Hill; Seth J,25,0,25,0
1708247905181,POLI 273,A00,419336,Mignozzetti; Umberto,16,0,25,9
1708247905712,POLI 280,A00,419337,Hafner-Burton; Emilie,18,0,25,7
1708247906238,POLI 281,A00,419338,Ban; Pamela M,21,0,25,4
1708247906762,POLI 282,A00,419339,Ferree; Karen E,19,0,25,6
1708247907286,POLI 283,A00,419340,Naoi; Megumi,23,0,25,2
1708247907811,POLI 285,A00,419341,Ingham; Sean,25,0,25,0
1708247908337,POLI 286,A00,419342,Mignozzetti; Umberto,23,0,25,2
1708247908864,POLI 288,A00,479174,Fowler; James,13,0,15,2
1708247909396,PSY 296,001,465760,Besterman; Aaron David,49,0,50,1
1708247909396,PSY 296,002,465765,Eyler; Lisa T.,49,0,50,1
1708247909396,PSY 296,003,465767,Patel; Ekta Himanshu,49,0,50,1
1708247909923,PSYC 3R,A00,419378,Pilegard; Celeste Cristine,314,0,325,11
1708247910449,PSYC 7,A00,419384,Powell; Lindsey Jane,288,0,295,7
1708247910981,PSYC 60,A01,460208,Lowe; Angela Beth,31,0,35,4
1708247910981,PSYC 60,A02,460209,Lowe; Angela Beth,28,0,35,7
1708247910981,PSYC 60,A03,460210,Lowe; Angela Beth,35,0,35,0
1708247910981,PSYC 60,A04,460211,Lowe; Angela Beth,33,0,35,2
1708247910981,PSYC 60,A05,460212,Lowe; Angela Beth,34,0,35,1
1708247910981,PSYC 60,A06,460213,Lowe; Angela Beth,35,0,35,0
1708247910981,PSYC 60,A07,460214,Lowe; Angela Beth,33,0,35,2
1708247910981,PSYC 60,B01,460215,Rose; Fred E.,35,0,35,0
1708247910981,PSYC 60,B02,460216,Rose; Fred E.,35,0,35,0
1708247910981,PSYC 60,B03,460218,Rose; Fred E.,35,0,35,0
1708247910981,PSYC 60,B04,460219,Rose; Fred E.,35,0,35,0
1708247910981,PSYC 60,B05,460220,Rose; Fred E.,32,0,35,3
1708247910981,PSYC 60,B06,460221,Rose; Fred E.,35,0,35,0
1708247910981,PSYC 60,B07,460222,Rose; Fred E.,35,0,35,0
1708247911513,PSYC 70,A01,460223,Pilegard; Celeste Cristine,29,0,35,6
1708247911513,PSYC 70,A02,460224,Pilegard; Celeste Cristine,32,0,35,3
1708247911513,PSYC 70,A03,460225,Pilegard; Celeste Cristine,34,0,35,1
1708247911513,PSYC 70,A04,460266,Pilegard; Celeste Cristine,33,0,35,2
1708247911513,PSYC 70,A05,460267,Pilegard; Celeste Cristine,35,0,35,0
1708247911513,PSYC 70,A06,460277,Pilegard; Celeste Cristine,34,0,35,1
1708247912046,PSYC 71,A01,419620,Staff,19,0,21,2
1708247912046,PSYC 71,A02,419662,Staff,20,0,21,1
1708247912046,PSYC 71,B01,419682,Geller; Emma Harlan,24,0,25,1
1708247912046,PSYC 71,B02,419732,Geller; Emma Harlan,26,0,26,0
1708247912572,PSYC 88,A00,419733,Dobkins; Karen R.,47,0,65,18
1708247913102,PSYC 100,A00,419734,Chapman; Eddie Nathaniel,388,0,410,22
1708247913632,PSYC 101,A00,419735,Walker; Caren Michelle,272,0,295,23
1708247914158,PSYC 102,A00,419779,Moranton; Nirelia Melbina-,292,0,295,3
1708247914688,PSYC 104,A00,419880,Fine; Rachel,267,0,295,28
1708247915215,PSYC 105,A00,419946,Lowe; Angela Beth,276,0,295,19
1708247915743,PSYC 111B,A01,419948,Geller; Emma Harlan,35,0,35,0
1708247916270,PSYC 116C,A01,420046,Lang; Ariel,25,0,25,0
1708247916800,PSYC 117,A01,420092,Bajic; Daniel Andrew,25,0,25,0
1708247917330,PSYC 118,A01,420095,Miller; Cory T.,37,0,45,8
1708247917856,PSYC 124,A00,420096,Chapman; Eddie Nathaniel,381,0,410,29
1708247918381,PSYC 127,A00,420097,Dickenson; Janna Alene,14,0,20,6
1708247918907,PSYC 132,A00,420121,Staff,114,0,120,6
1708247919437,PSYC 133R,A01,420172,Golden; Susan S. & Gorman; Michael R.,10,0,16,6
1708247919437,PSYC 133R,A02,420173,Golden; Susan S. & Gorman; Michael R.,16,0,16,0
1708247919437,PSYC 133R,A03,420175,Golden; Susan S. & Gorman; Michael R.,16,0,16,0
1708247919437,PSYC 133R,A04,420249,Golden; Susan S. & Gorman; Michael R.,13,0,16,3
1708247919963,PSYC 134,A00,420311,Kaye; Walter H.,296,0,300,4
1708247920489,PSYC 137,A00,420312,Lin; Chujun,292,0,295,3
1708247921021,PSYC 144,A00,420313,Wixted; John T,287,0,295,8
1708247921547,PSYC 147,A00,420315,Wong; Lauren Hitomi,120,0,146,26
1708247922073,PSYC 164,A00,420328,Kaplan; Paul,259,0,295,36
1708247922600,PSYC 172,A00,420336,Dickenson; Janna Alene,294,0,300,6
1708247923129,PSYC 178,A00,420337,Glaser; Dale,131,0,146,15
1708247923653,PSYC 179,A00,420338,Lacefield; Katharine I,257,0,328,71
1708247924184,PSYC 181,A00,420339,Anagnostaras; Stephan,333,0,350,17
1708247924710,PSYC 184,A00,420367,Wilson; Brent M,275,0,295,20
1708247925236,PSYC 188,A00,420368,Lacefield; Katharine I,234,0,300,66
1708247925801,PSYC 190,A00,420378,Barner; David A.,374,0,395,21
1708247926330,PSYC 193,B00,420626,Brashier; Nadia Marie,215,0,216,1
1708247926330,PSYC 193,C00,420643,Gremel; Christina M,33,0,35,2
1708247926862,PSYC 193L,A01,420817,Brown; Sandra A,65,0,65,0
1708247926862,PSYC 193L,B01,420830,Staff,26,0,30,4
1708247926862,PSYC 193L,C01,420832,Staff,49,0,49,0
1708247926862,PSYC 193L,D01,420834,Staff,27,0,30,3
1708247926862,PSYC 193L,E01,493996,Aron; Adam,24,0,24,0
1708247927390,PSYC 194C,A01,420905,Heyman; Gail D.,1,0,1,0
1708247927917,PSYC 205,A00,420906,Harris; Christine Renee,17,0,20,3
1708247928445,PSYC 218,A00,420907,Brady; Timothy Francis,11,0,20,9
1708247928972,PSYC 224,A00,420908,Gremel; Christina M,30,0,30,0
1708247929497,PSYC 242,A00,421469,Walker; Caren Michelle,27,0,30,3
1708247930025,PSYC 247,A00,421473,Walker; Caren Michelle,14,0,20,6
1708247930556,PSYC 270C,A00,421554,Dobkins; Karen R.,13,0,20,7
1708247931081,PSYC 272,A00,421561,Gentner; Tim,20,0,20,0
1708247931608,PSYC 274,A00,421564,McCullough; Michael E,29,0,30,1
1708247932133,PSYC 275,A00,421620,Staff,23,0,30,7
1708247932662,PSYC 276,A00,421622,McCullough; Michael E,14,0,20,6
1708247933188,PSYC 280,A00,421623,Serences; John Thomas,76,0,85,9
1708247933723,PSYC 296,001,421667,Anagnostaras; Stephan,9999,0,9999,0
1708247933723,PSYC 296,002,421773,Aron; Adam,9999,0,9999,0
1708247933723,PSYC 296,003,421794,Mukku; Dhananjaya,9999,0,9999,0
1708247933723,PSYC 296,004,421795,Barner; David A.,9998,0,9999,1
1708247933723,PSYC 296,005,421796,Schachner; Adena,9999,0,9999,0
1708247933723,PSYC 296,006,421797,Brown; Sandra A,9999,0,9999,0
1708247933723,PSYC 296,007,421798,Chapman; Eddie Nathaniel,9999,0,9999,0
1708247933723,PSYC 296,008,421799,Dickenson; Janna Alene,9999,0,9999,0
1708247933723,PSYC 296,009,421800,Dobkins; Karen R.,9998,0,9999,1
1708247933723,PSYC 296,010,421801,Fan; Judith Ellen,9999,0,9999,0
1708247933723,PSYC 296,011,421803,Ferreira; Victor,9999,0,9999,0
1708247933723,PSYC 296,012,421814,Geller; Emma Harlan,9998,0,9999,1
1708247933723,PSYC 296,013,422102,Gentner; Tim,9999,0,9999,0
1708247933723,PSYC 296,014,422103,Gorman; Michael R.,9999,0,9999,0
1708247933723,PSYC 296,015,422104,Gremel; Christina M,9999,0,9999,0
1708247933723,PSYC 296,016,422106,Harris; Christine Renee,9999,0,9999,0
1708247933723,PSYC 296,017,422107,Heyman; Gail D.,9999,0,9999,0
1708247933723,PSYC 296,018,422108,McCullough; Michael E,9999,0,9999,0
1708247933723,PSYC 296,019,422109,Mc Kenzie; Craig R.M.,9999,0,9999,0
1708247933723,PSYC 296,020,422122,Miller; Cory T.,9999,0,9999,0
1708247933723,PSYC 296,021,422123,Pashler; Harold E,9999,0,9999,0
1708247933723,PSYC 296,022,422124,Pilegard; Celeste Cristine,9999,0,9999,0
1708247933723,PSYC 296,023,422125,Powell; Lindsey Jane,9999,0,9999,0
1708247933723,PSYC 296,025,422127,Rickard; Timothy C.,9998,0,9999,1
1708247933723,PSYC 296,026,422128,Serences; John Thomas,9998,0,9999,1
1708247933723,PSYC 296,027,422130,Walker; Caren Michelle,9998,0,9999,1
1708247933723,PSYC 296,028,422132,Winkielman; Piotr,9999,0,9999,0
1708247933723,PSYC 296,029,422134,Wixted; John T,9996,0,9999,3
1708247933723,PSYC 296,030,422146,Brady; Timothy Francis,9998,0,9999,1
1708247933723,PSYC 296,031,422154,Carver; Leslie J.,9999,0,9999,0
1708247933723,PSYC 296,032,422161,Lin; Chujun,9999,0,9999,0
1708247933723,PSYC 296,033,422169,Brashier; Nadia Marie,9998,0,9999,1
1708247933723,PSYC 296,034,422177,Oesch; Nicholas W,9999,0,9999,0
1708247934247,RAD 296,001,465795,Staff,50,0,50,0
1708247934247,RAD 296,002,465796,Staff,50,0,50,0
1708247934247,RAD 296,003,465797,Staff,50,0,50,0
1708247934776,RELI 150,A00,419353,Rahimi; Babak,37,0,40,3
1708247935303,REV 87,A00,422721,Lyon; Antony J.,19,0,20,1
1708247935834,RMAS 296,001,465827,Murphy; James D,49,0,50,1
1708247935834,RMAS 296,002,465828,Staff,50,0,50,0
1708247935834,RMAS 296,003,465831,Staff,50,0,50,0
1708247936359,RMED 296,001,466791,Staff,50,0,50,0
1708247936359,RMED 296,002,466792,Staff,50,0,50,0
1708247936359,RMED 296,003,466793,Staff,50,0,50,0
1708247936888,SE 3,A01,446938,Van Den Einde; Yael Dahlia,50,0,52,2
1708247936888,SE 3,A02,446942,Van Den Einde; Yael Dahlia,49,0,52,3
1708247936888,SE 3,A03,446948,Van Den Einde; Yael Dahlia,52,0,53,1
1708247936888,SE 3,A04,446965,Van Den Einde; Yael Dahlia,53,0,53,0
1708247937420,SE 9,A01,447015,Kuester; Falko,30,0,34,4
1708247937420,SE 9,A02,447017,Kuester; Falko,33,0,33,0
1708247937420,SE 9,A03,447022,Kuester; Falko,31,0,33,2
1708247937966,SE 101B,A01,447040,Kosmatka; John B,55,0,56,1
1708247938503,SE 105,A01,447042,Qiao; Yu,118,0,120,2
1708247939029,SE 110A,A01,467467,Asaro; Robert J,56,0,56,0
1708247939564,SE 110B,A00,447045,Zhu; Qiang,122,0,125,3
1708247940091,SE 130B,A01,447049,Chadha; Mayank,92,0,100,8
1708247940623,SE 131A,A01,447059,Krysl; Petr,102,0,110,8
1708247941150,SE 132,A01,447078,Chen; Jiun-Shyan,48,0,50,2
1708247941679,SE 140B,A01,447086,Restrepo; Jose,29,0,34,5
1708247941679,SE 140B,A02,447123,Restrepo; Jose,21,0,33,12
1708247941679,SE 140B,A03,447124,Restrepo; Jose,30,0,33,3
1708247942210,SE 143B,A01,447133,Tehrani; Mehran,11,0,15,4
1708247942210,SE 143B,A02,447134,Tehrani; Mehran,13,0,15,2
1708247942736,SE 150A,A01,447136,Uang; Chia-Ming,94,0,100,6
1708247943263,SE 150B,A01,447214,Morrison; Machel Leigh,49,0,50,1
1708247943793,SE 151B,A00,447215,Shing; P. Benson,71,0,75,4
1708247944319,SE 160B,A01,467468,Kim; Hyunsun Alicia,91,0,100,9
1708247944847,SE 165,A00,447238,Farrar; Charles R.,9,0,10,1
1708247945378,SE 184,A00,447253,Hutchinson; Tara,20,0,20,0
1708247945904,SE 202,A00,447392,Kosmatka; John B,25,0,30,5
1708247946434,SE 204,A00,447482,Todd; Michael,12,0,20,8
1708247946965,SE 206,A00,447483,Conte; Joel P,30,0,30,0
1708247947492,SE 213,A00,447499,Palermo; Alessandro,17,0,30,13
1708247948023,SE 215,A00,447500,Zhu; Qiang,34,0,45,11
1708247948551,SE 222,A00,447507,Elgamal; Ahmed,30,0,30,0
1708247949076,SE 227,A00,447576,Hutchinson; Tara,20,0,25,5
1708247949608,SE 244,A00,447577,Elgamal; Ahmed,29,0,30,1
1708247950135,SE 247,A00,447580,Hutchinson; Tara,0,0,5,5
1708247950665,SE 251B,A00,447612,Qiao; Yu,15,0,25,10
1708247951190,SE 253B,A00,447613,Kim; Hyonny,28,0,30,2
1708247951717,SE 260B,A00,447614,Kim; Hyunsun Alicia,10,0,10,0
1708247952250,SE 265,A00,447615,Farrar; Charles R.,20,0,25,5
1708247952774,SE 266,A00,447616,Loh; Chin Hsiung,23,0,25,2
1708247953830,SE 280,A00,447650,Krysl; Petr,22,0,25,3
1708247954363,SE 281,A01,447658,Kuester; Falko,12,0,30,18
1708247954893,SE 290,A00,447659,Qiao; Yu,78,0,100,22
1708247955427,SE 296,001,447666,Asaro; Robert J,9999,0,9999,0
1708247955427,SE 296,002,447669,Chen; Jiun-Shyan,9999,0,9999,0
1708247955427,SE 296,003,447689,Conte; Joel P,9999,0,9999,0
1708247955427,SE 296,004,447690,Elgamal; Ahmed,9999,0,9999,0
1708247955427,SE 296,005,447728,Hutchinson; Tara,9999,0,9999,0
1708247955427,SE 296,006,447733,Jandaghi Semnani; Shabnam,9999,0,9999,0
1708247955427,SE 296,007,447734,Kim; Hyonny,9999,0,9999,0
1708247955427,SE 296,008,447737,Kim; Hyunsun Alicia,9999,0,9999,0
1708247955427,SE 296,009,447738,Kosmatka; John B,9999,0,9999,0
1708247955427,SE 296,010,447739,Krysl; Petr,9999,0,9999,0
1708247955427,SE 296,011,447740,Kuester; Falko,9999,0,9999,0
1708247955427,SE 296,012,447741,Lanza Di Scalea; Francesco,9999,0,9999,0
1708247955427,SE 296,013,447742,Loh; Kenneth J. H.,9999,0,9999,0
1708247955427,SE 296,014,447745,McCartney; John Scott,9999,0,9999,0
1708247955427,SE 296,015,447747,Morrison; Machel Leigh,9999,0,9999,0
1708247955427,SE 296,016,447749,Mosqueda; Gilberto,9999,0,9999,0
1708247955427,SE 296,017,447874,Qiao; Yu,9999,0,9999,0
1708247955427,SE 296,018,447875,Restrepo; Jose,9999,0,9999,0
1708247955427,SE 296,019,447886,Shing; P. Benson,9999,0,9999,0
1708247955427,SE 296,020,447887,Todd; Michael,9999,0,9999,0
1708247955427,SE 296,021,447888,Tomac; Ingrid,9999,0,9999,0
1708247955427,SE 296,022,447889,Tsampras; Georgios,9999,0,9999,0
1708247955427,SE 296,023,447890,Uang; Chia-Ming,9999,0,9999,0
1708247955427,SE 296,024,447931,Van Den Einde; Yael Dahlia,9999,0,9999,0
1708247955427,SE 296,025,447932,Zhu; Qiang,9999,0,9999,0
1708247955427,SE 296,026,448007,Tehrani; Mehran,9999,0,9999,0
1708247955427,SE 296,027,448008,Palermo; Alessandro,9999,0,9999,0
1708247955427,SE 296,028,492941,Farrar; Charles R.,9998,0,9999,1
1708247955954,SIO 10,A00,446025,Borsa; Adrian Antal,573,0,590,17
1708247956486,SIO 16,A00,446031,Gee; Jeffrey S,119,0,120,1
1708247957023,SIO 50,A01,446057,Cook; Geoffrey W,19,0,22,3
1708247957023,SIO 50,A02,446058,Cook; Geoffrey W,21,0,22,1
1708247957550,SIO 75,A00,446060,Norris; Richard D.,32,0,35,3
1708247958134,SIO 87,A00,479215,Feddersen; Falk & Morzfeld; Matthias,20,0,20,0
1708247958134,SIO 87,B00,489613,Cook; Geoffrey W,19,0,20,1
1708247958134,SIO 87,C00,489620,Cook; Geoffrey W,20,0,20,0
1708247958661,SIO 90,A00,446061,Staff,61,0,70,9
1708247959188,SIO 113,A01,446064,May; David Alexander,27,0,30,3
1708247960242,SIO 128,A00,446115,Bartlett; Douglas H,110,0,120,10
1708247960774,SIO 135,A01,446153,Fricker; Helen A.,16,0,17,1
1708247960774,SIO 135,A02,446156,Fricker; Helen A.,14,0,18,4
1708247962323,SIO 136,A01,446159,Kacev; David & Wegner; Nicholas Craig & Bartlett; Douglas H,31,0,33,2
1708247962323,SIO 136,A02,446160,Kacev; David & Wegner; Nicholas Craig & Bartlett; Douglas H,33,0,33,0
1708247962847,SIO 139,A00,446164,Kacev; David,66,0,70,4
1708247963375,SIO 141,A01,446173,Pomeroy; Robert S.,11,0,12,1
1708247963900,SIO 143,A01,446175,Andersson; Andreas Jerry,21,0,30,9
1708247964428,SIO 145,A01,446181,Choy; Carolyn Anela,6,0,18,12
1708247964960,SIO 152,A01,446184,Van Allen; Emily Joyce,8,0,10,2
1708247964960,SIO 152,A02,479204,Van Allen; Emily Joyce,10,0,10,0
1708247965495,SIO 153,A01,446188,Capaldi; Tomas,24,0,26,2
1708247966019,SIO 160,A00,446189,Stegman; David,21,0,25,4
1708247966545,SIO 164,A00,446193,Staff,28,0,35,7
1708247967075,SIO 173,A00,446194,Lutsko; Nicholas J.,28,0,30,2
1708247967603,SIO 174,A00,446197,Aluwihare; Lihini & Russell; Lynn M.,26,0,30,4
1708247968132,SIO 181,A01,446200,Tresguerres; Martin,18,0,25,7
1708247968132,SIO 181,A02,446201,Tresguerres; Martin,23,0,25,2
1708247968132,SIO 181,A03,446209,Tresguerres; Martin,24,0,25,1
1708247968132,SIO 181,A04,446211,Tresguerres; Martin,24,0,25,1
1708247968132,SIO 181,A05,446223,Tresguerres; Martin,24,0,25,1
1708247968132,SIO 181,A06,446236,Tresguerres; Martin,24,0,25,1
1708247968659,SIO 192,A00,479211,Gerwick; William Henry,20,0,20,0
1708247969188,SIO 194,A00,455340,Hill; Seth J,0,0,0,0
1708247969714,SIOB 262,A00,446243,Gerwick; William Henry,23,0,25,2
1708247970241,SIOB 269,A00,446244,Staff,19,0,20,1
1708247970772,SIOB 270,A01,446261,Allen; Andrew Ellis & Petrik; Colleen Mary,18,0,20,2
1708247971300,SIOB 278,A00,446273,Arcila; Dahiana K,13,0,15,2
1708247971300,SIOB 278,B00,481742,Aburto Oropeza; Marco Octavio,18,0,20,2
1708247971827,SIOB 279,A00,446286,Franks; Peter,31,0,35,4
1708247972357,SIOB 291,A00,446292,Hechinger; Ryan F.,20,0,20,0
1708247972900,SIOB 296,A00,446293,Mongiardino Koch; Nicolas,16,0,20,4
1708247973429,SIOB 297,A00,446294,Allen; Eric,66,0,70,4
1708247973957,SIOC 202B,A00,446312,Stramski; Dariusz & Gabriel; Anne Alice-Agnes,17,0,20,3
1708247974484,SIOC 203C,A01,446314,Young; William Roy,5,0,5,0
1708247975021,SIOC 207C,A00,492798,Vasconcelos; Manuela,5,0,5,0
1708247975552,SIOC 208,A00,446315,Merrifield; Mark A,16,0,20,4
1708247976080,SIOC 209,A00,478924,Werner; Bradley T.,11,0,15,4
1708247976080,SIOC 209,B00,479224,Watson-Parris; Duncan,15,0,25,10
1708247976080,SIOC 209,C00,480739,Ricke; Katharine L,24,0,24,0
1708247976606,SIOC 212B,A01,446324,Cessi; Paola,40,0,40,0
1708247977131,SIOC 217C,A00,446325,Lutsko; Nicholas J.,25,0,25,0
1708247977663,SIOC 220,A00,446326,Rudnick; Daniel Lars,13,0,15,2
1708247978192,SIOC 224,A00,446327,Eisenman; Ian,20,0,25,5
1708247978721,SIOC 228,A00,446328,Shi; Yuanyuan,1,0,10,9
1708247979252,SIOC 235,A00,446342,Xie; Shang-Ping,14,0,15,1
1708247979779,SIOC 251,A00,446343,Evan; Amato Tomas,19,0,20,1
1708247980307,SIOG 200B,A00,446344,Gabriel; Anne Alice-Agnes,9,0,10,1
1708247980834,SIOG 221,A00,446354,Parnell-Turner; Ross Ernes,29,0,30,1
1708247981367,SIOG 227B,A00,446355,Laske; Gabi & Shearer; Peter M,19,0,20,1
1708247981893,SIOG 228,A00,446356,Van Allen; Emily Joyce,7,0,20,13
1708247982421,SIOG 230,A00,446359,Constable; Catherine G,25,0,25,0
1708247982950,SIOG 232,A00,446360,Constable; Catherine G & Constable; Steven C,37,0,40,3
1708247983476,SIOG 234,A00,446361,Sandwell; David T,15,0,15,0
1708247984002,SIOG 236,A01,477658,Fricker; Helen A.,5,0,5,0
1708247984002,SIOG 236,A02,477685,Fricker; Helen A.,3,0,5,2
1708247984534,SIOG 239,A00,446362,Gabriel; Anne Alice-Agnes,19,0,20,1
1708247984534,SIOG 239,B00,481507,May; David Alexander,6,0,6,0
1708247984534,SIOG 239,C00,486863,Fialko; Yuri A.,15,0,15,0
1708247985060,SIOG 268,A00,446364,Barbeau; Katherine,12,0,15,3
1708247985588,SOCE 194,A00,455341,Hill; Seth J,0,0,0,0
1708247986119,SOCG 204,A00,446551,Ng; Kwai,0,0,8,8
1708247986649,SOCG 206,A00,446552,Alvarez; Camila Huerta,4,0,8,4
1708247987175,SOCG 214,A00,446553,Raudenbush; Danielle,3,0,8,5
1708247987702,SOCG 255B,A00,446602,Serlin; David,2,0,5,3
1708247988227,SOCG 255C,A00,446813,Gates; Kelly,3,0,5,2
1708247988762,SOCG 290,A00,446910,Thorpe; Charles Robert,0,0,10,10
1708247988762,SOCG 290,B00,446911,Goldman; Harvey Stern,1,0,10,9
1708247988762,SOCG 290,C00,446914,Lampland; Martha,5,0,10,5
1708247989305,SOCI 2,A01,446373,Rogers; Julia Ellen,28,0,30,2
1708247989305,SOCI 2,A02,446374,Rogers; Julia Ellen,29,0,30,1
1708247989305,SOCI 2,A03,446382,Rogers; Julia Ellen,29,0,30,1
1708247989305,SOCI 2,A04,446384,Rogers; Julia Ellen,30,0,30,0
1708247989305,SOCI 2,A05,446389,Rogers; Julia Ellen,30,0,30,0
1708247989305,SOCI 2,A06,446393,Rogers; Julia Ellen,29,0,30,1
1708247989839,SOCI 20,A01,446396,Calderon-Zaks; Michael Aar,33,0,34,1
1708247989839,SOCI 20,A02,446409,Calderon-Zaks; Michael Aar,34,0,34,0
1708247990366,SOCI 40,A01,446417,Raudenbush; Danielle,30,0,32,2
1708247990366,SOCI 40,A02,446419,Raudenbush; Danielle,31,0,32,1
1708247990366,SOCI 40,A03,446434,Raudenbush; Danielle,31,0,32,1
1708247990366,SOCI 40,A04,446436,Raudenbush; Danielle,28,0,32,4
1708247990366,SOCI 40,A05,446441,Raudenbush; Danielle,29,0,32,3
1708247990366,SOCI 40,A06,446445,Raudenbush; Danielle,32,0,32,0
1708247990892,SOCI 60,A01,446461,Sutton; April Marie,30,0,32,2
1708247990892,SOCI 60,A02,446468,Sutton; April Marie,30,0,32,2
1708247990892,SOCI 60,A03,446469,Sutton; April Marie,26,0,32,6
1708247990892,SOCI 60,A04,446471,Sutton; April Marie,31,0,32,1
1708247991423,SOCI 100,A01,446480,Payne; Christine Anna,28,0,30,2
1708247991423,SOCI 100,A02,446491,Payne; Christine Anna,29,0,30,1
1708247991423,SOCI 100,A03,446492,Payne; Christine Anna,28,0,30,2
1708247991423,SOCI 100,A04,446493,Payne; Christine Anna,27,0,30,3
1708247991950,SOCI 103M,A00,481672,Kilpatrick; Kevin,27,0,28,1
1708247992481,SOCI 104,A00,446494,Turner; Christena L.,28,0,30,2
1708247993008,SOCI 104Q,A00,446495,Rogers; Julia Ellen,27,0,30,3
1708247993539,SOCI 106,A00,446496,Payne; Christine Anna,25,0,30,5
1708247994065,SOCI 107,A00,446497,Staff,30,0,30,0
1708247994592,SOCI 109,A00,446498,Rona-Tas; Akos,20,0,25,5
1708247995123,SOCI 111,A00,446499,Ribas Norris; Janet Vanesa,54,0,56,2
1708247995650,SOCI 114,A00,446500,Lampland; Martha,73,0,75,2
1708247996178,SOCI 117,A01,446502,Jones; Gabrielle Anastasia,14,0,17,3
1708247996178,SOCI 117,A02,446516,Jones; Gabrielle Anastasia,17,0,17,0
1708247996178,SOCI 117,A03,458787,Jones; Gabrielle Anastasia,17,0,17,0
1708247996178,SOCI 117,A04,458835,Jones; Gabrielle Anastasia,19,0,19,0
1708247996707,SOCI 120T,A00,446518,Staff,56,0,56,0
1708247997234,SOCI 123,A00,446519,Staff,79,0,80,1
1708247997767,SOCI 125,A00,487186,Calderon-Zaks; Michael Aar,55,0,56,1
1708247998294,SOCI 126,A01,446532,Jones; Makeba,15,0,15,0
1708247998294,SOCI 126,A02,446533,Jones; Makeba,15,0,15,0
1708247998294,SOCI 126,A03,458839,Jones; Makeba,15,0,15,0
1708247998294,SOCI 126,A04,458840,Jones; Makeba,15,0,15,0
1708247998821,SOCI 133,A00,446534,Calderon-Zaks; Michael Aar,53,0,56,3
1708247999347,SOCI 135,A00,486886,Ruiz; Jonathan Joseph,55,0,56,1
1708247999877,SOCI 136,A00,486887,Ruiz; Jonathan Joseph,56,0,56,0
1708248000403,SOCI 139,A00,446535,Ribas Norris; Janet Vanesa,78,0,80,2
1708248000934,SOCI 140J,A00,446537,Estefan; Michel,76,0,100,24
1708248001465,SOCI 142,A00,477639,Crofts; Christine,43,0,50,7
1708248002008,SOCI 146,A00,446538,Summers; Valerie R.,113,0,120,7
1708248002537,SOCI 151,A00,446540,Goldman; Harvey Stern,56,0,56,0
1708248003066,SOCI 156,A00,446541,Ostovany; Khashayar,55,0,56,1
1708248003592,SOCI 157,A00,446542,Jules-Rosette; Bennetta W.,28,0,28,0
1708248004124,SOCI 159,A00,494493,Estefan; Michel,93,0,96,3
1708248004649,SOCI 161,A00,477638,Staff,45,0,45,0
1708248005176,SOCI 162,A00,477642,Staff,54,0,55,1
1708248005706,SOCI 165,A00,446543,Rona-Tas; Akos,49,0,56,7
1708248006232,SOCI 171,A00,446544,Thorpe; Charles Robert,56,0,56,0
1708248006759,SOCI 173,A00,482888,Crofts; Christine,92,0,100,8
1708248007284,SOCI 180,A00,446545,Ostovany; Khashayar,55,0,56,1
1708248007813,SOCI 183,A00,446546,Sutton; April Marie,43,0,45,2
1708248008339,SOCI 185,A00,494495,Staff,30,0,30,0
1708248008870,SOCI 188D,A00,446549,Kokinis; Troy Andreas,24,0,25,1
1708248009399,SOCI 198RA,001,446550,Ng; Kwai,30,0,30,0
1708248009924,SOMC 224C,A00,466928,Bhakta; Savita Ganapathi,160,0,160,0
1708248010455,SOMC 229,A00,466925,Hoang; Mai Phuong,160,0,160,0
1708248010982,SOMC 240,A00,466937,Coyne; Christopher John,150,0,150,0
1708248011509,SOMC 242,A00,466931,Kline; Ahnika Sarah,160,0,160,0
1708248012039,SOMC 244,A00,466939,Mandel; Jess,150,0,150,0
1708248012619,SOMC 245C,A01,466935,Noel; Geoffroy Pierre Jean,160,0,160,0
1708248013149,SOMC 246C,A00,487163,Eyler; Lisa T.,160,0,160,0
1708248013676,SOMC 247C,A50,466950,Calcutt; Nigel A,160,0,160,0
1708248014203,SOMC 248C,A00,466936,Joshi; Weena Erin,160,0,160,0
1708248014734,SOMC 255C,A00,466951,Allison; Matthew,160,0,160,0
1708248015263,SPPH 161R,A01,476600,Chambers; Christina D,99,0,100,1
1708248015791,SPPH 263B,A01,460901,Hook; Vivian Yuan-Ho,25,0,25,0
1708248016317,SPPS 200A,A00,460907,Luli; Alex J,99,0,99,0
1708248016846,SPPS 200B,A00,460928,Luli; Alex J,99,0,99,0
1708248017373,SPPS 200C,A00,460934,Luli; Alex J,95,0,99,4
1708248017899,SPPS 203,A00,460955,Painter; Nathan A.,83,0,99,16
1708248018427,SPPS 205,A01,460978,Bandeira; Nuno Filipe Cabrita,64,0,80,16
1708248018955,SPPS 209,A00,460979,Bounthavong; Mark,94,0,99,5
1708248019481,SPPS 210,001,460980,Gustafsson; Asa Birgitta,99,0,99,0
1708248020008,SPPS 211A,A00,460987,Ferguson; Fleur,85,0,99,14
1708248020532,SPPS 211B,A00,460991,Ferguson; Fleur,97,0,99,2
1708248021074,SPPS 211C,A00,460992,Ferguson; Fleur,95,0,99,4
1708248021604,SPPS 211D,A00,460993,Tsunoda; Shirley M.,99,0,99,0
1708248022137,SPPS 212C,A01,460995,Saunders; Ila Maewal,95,0,99,4
1708248022666,SPPS 213C,A00,460996,Awdishu; Linda,95,0,99,4
1708248023198,SPPS 218B,A00,460997,Mandyam; Chitra,95,0,99,4
1708248023723,SPPS 225,A01,460999,Reed; Chantal,83,0,99,16
1708248024254,SPPS 236,A00,461000,Reid; Erin G.,97,0,99,2
1708248024784,SPPS 237,A00,461002,Mimoto; Mizuho Stacy,97,0,99,2
1708248025309,SPPS 238,A00,461041,Beyhan; Sinem,97,0,99,2
1708248025835,SPPS 241,A01,461122,Tsunoda; Shirley M.,83,0,99,16
1708248026361,SPPS 249,A00,461123,Brandl; Katharina,97,0,99,2
1708248026888,SPPS 250,A00,461126,Tsunoda; Shirley M.,45,0,50,5
1708248027418,SPPS 251,A00,461127,Chen; Timothy,99,0,99,0
1708248027944,SPPS 252,A00,461128,Abdul-Mutakabbir; Jacinda,74,0,80,6
1708248028495,SPPS 254,A00,481670,Shapiro; Desiree Nicolette,77,0,80,3
1708248029023,SPPS 261,A00,461129,Chambers; Christina D,93,0,99,6
1708248029550,SPPS 278,A00,459983,Fricovsky; Eduardo Santiago,98,0,99,1
1708248030080,SPPS 280,A00,461259,Fricovsky; Eduardo Santiago,19,0,20,1
1708248030624,SPPS 283,A00,461283,Tsunoda; Shirley M.,96,0,99,3
1708248031149,SURG 261,A00,466973,Staff,50,0,50,0
1708248031693,SURG 296,001,467004,Agha Hosseini; Ava,49,0,50,1
1708248031693,SURG 296,002,467005,Hinchcliff; Katharine Moss,49,0,50,1
1708248031693,SURG 296,003,467006,Eliceiri; Brian,49,0,50,1
1708248032264,SYN 1,001,448577,Bishop; Graham,19,0,20,1
1708248032264,SYN 1,002,448578,Iatarola; Briana Marie,19,0,20,1
1708248032264,SYN 1,003,448579,Browne; Emily,20,0,20,0
1708248032264,SYN 1,004,448580,Vega; Adrian,20,0,20,0
1708248032264,SYN 1,005,448581,Browne; Emily,20,0,20,0
1708248032264,SYN 1,006,448582,Rock; Martin,20,0,20,0
1708248032264,SYN 1,007,448583,Rock; Martin,20,0,20,0
1708248032264,SYN 1,008,448584,Iatarola; Briana Marie,19,0,20,1
1708248032264,SYN 1,009,448585,Bishop; Graham,20,0,20,0
1708248032264,SYN 1,010,448586,Bishop; Graham,20,0,20,0
1708248032264,SYN 1,011,448587,Gladstein; Jill M,15,0,15,0
1708248032264,SYN 1,012,448588,Meyer; Leslie Rose,20,0,20,0
1708248032264,SYN 1,013,448589,Rosenberg; Ryan Glenn,20,0,20,0
1708248032264,SYN 1,014,448627,Rosenberg; Ryan Glenn,19,0,20,1
1708248032264,SYN 1,015,448630,Atkinson; Arthur Laird,20,0,20,0
1708248032264,SYN 1,016,448651,Hom; Kirstyn Courtney,20,0,20,0
1708248032264,SYN 1,017,448652,Difruscio; Mark,20,0,20,0
1708248032264,SYN 1,018,448669,Hom; Kirstyn Courtney,20,0,20,0
1708248032264,SYN 1,019,448674,Hom; Kirstyn Courtney,18,0,20,2
1708248032264,SYN 1,020,448675,Atkinson; Arthur Laird,20,0,20,0
1708248032264,SYN 1,021,448678,Gladstein; Jill M,15,0,15,0
1708248032264,SYN 1,022,448682,Iatarola; Briana Marie,20,0,20,0
1708248032264,SYN 1,023,448691,Birberick; Brittany Celest,20,0,20,0
1708248032264,SYN 1,024,448751,Birberick; Brittany Celest,20,0,20,0
1708248032264,SYN 1,027,448766,Deavenport; James Cary,19,0,20,1
1708248032264,SYN 1,028,448767,Meyer; Leslie Rose,20,0,20,0
1708248032264,SYN 1,029,448775,Tawater; Hanna Jean,20,0,20,0
1708248032264,SYN 1,030,448777,Tawater; Hanna Jean,20,0,20,0
1708248032264,SYN 1,031,448792,Deavenport; James Cary,20,0,20,0
1708248032264,SYN 1,032,480169,Tawater; Hanna Jean,18,0,20,2
1708248032793,SYN 1R,001,448793,Difruscio; Mark,20,0,20,0
1708248032793,SYN 1R,004,449146,Difruscio; Mark,20,0,20,0
1708248033337,SYN 100,A01,449148,Staff,11,0,15,4
1708248033337,SYN 100,A02,449149,Staff,15,0,15,0
1708248033337,SYN 100,B01,449164,Gladstein; Jill M,0,0,0,0
1708248033337,SYN 100,B02,449166,Gladstein; Jill M,0,0,0,1
1708248033337,SYN 100,C01,449244,Staff,7,0,15,8
1708248033337,SYN 100,C02,449274,Staff,13,0,15,2
1708248033337,SYN 100,D01,449278,Staff,20,0,20,0
1708248033337,SYN 100,D02,449279,Staff,20,0,20,0
1708248033337,SYN 100,E01,449281,Rock; Martin,9,0,15,6
1708248033337,SYN 100,E02,449282,Rock; Martin,14,0,15,1
1708248033337,SYN 100,F01,449304,Browne; Emily,12,0,15,3
1708248033337,SYN 100,F02,449306,Browne; Emily,14,0,15,1
1708248033337,SYN 100,I01,449390,Gormally; Brenna,0,0,0,0
1708248033337,SYN 100,I02,449391,Gormally; Brenna,0,0,0,0
1708248033337,SYN 100,J01,449401,Atkinson; Arthur Laird,11,0,15,4
1708248033337,SYN 100,J02,449402,Atkinson; Arthur Laird,14,0,15,1
1708248033337,SYN 100,K01,449404,Deavenport; James Cary,11,0,15,4
1708248033337,SYN 100,K02,449405,Deavenport; James Cary,14,0,15,1
1708248033337,SYN 100,L01,449408,Rosenberg; Ryan Glenn,10,0,15,5
1708248033337,SYN 100,L02,449420,Rosenberg; Ryan Glenn,15,0,15,0
1708248034878,SYN 150,001,450016,Vega; Adrian,19,0,19,0
1708248034878,SYN 150,003,450031,Birberick; Brittany Celest,20,0,20,0
1708248035406,SYN 150R,001,494950,Vega; Adrian,20,0,20,0
1708248035932,SYN 198,001,494388,Staff,9999,0,9999,0
1708248036477,TDAC 1,A00,450042,Walsh; Kim C.,14,0,20,6
1708248036477,TDAC 1,B00,450043,Walsh; Kim C.,11,0,20,9
1708248036477,TDAC 1,C00,450044,Walsh; Kim C.,15,0,20,5
1708248036477,TDAC 1,D00,486830,Basso; Beatrice,20,0,20,0
1708248036477,TDAC 1,E00,492912,Walsh; Kim C.,15,0,20,5
1708248036477,TDAC 1,F00,492936,Walsh; Kim C.,18,0,20,2
1708248037003,TDAC 101,A00,450895,Celik; Aysan Karagasli,18,0,20,2
1708248037530,TDAC 102,A00,450904,Walsh; Kim C.,20,0,20,0
1708248037530,TDAC 102,B00,450916,Harting; Carla Kelso,20,0,20,0
1708248038062,TDAC 108,A00,450917,Buescher; Stephen W.,18,0,20,2
1708248038604,TDAC 109,A00,450924,Blair; Kyle Adam,20,0,20,0
1708248039131,TDAC 122,A00,451025,Perry; Lamar,30,0,30,0
1708248039131,TDAC 122,B00,480845,Perry; Lamar,30,0,30,0
1708248039657,TDAC 123,A00,451026,Buescher; Stephen W.,30,0,30,0
1708248039657,TDAC 123,B00,451028,Celik; Aysan Karagasli,30,0,30,0
1708248039657,TDAC 123,C00,480851,Perry; Lamar,30,0,30,0
1708248040184,TDDE 101,A00,451030,Guirguis; Mark C,18,0,20,2
1708248040713,TDDE 112,A00,451032,Staff,20,0,20,0
1708248041238,TDDE 130,A00,451033,Guirguis; Mark C,19,0,20,1
1708248041764,TDDE 132,A00,451034,Guirguis; Mark C,20,0,20,0
1708248042308,TDDE 169A,A00,481304,Petrovich; Victoria A.,19,0,20,1
1708248042834,TDDM 1,A00,450045,Weinberg; Sadie,27,0,30,3
1708248043365,TDDM 101,A00,451067,Staff,29,0,30,1
1708248043891,TDDR 101,A00,451068,Powell; Lora,29,0,34,5
1708248044416,TDDR 102,A00,451069,Powell; Lora,19,0,20,1
1708248044946,TDDR 111,A00,451070,Castro; Robert Jess,15,0,16,1
1708248044946,TDDR 111,B00,451071,Castro; Robert Jess,15,0,16,1
1708248045475,TDDR 190,A00,451073,Perry; Lamar,1,0,1,0
1708248046007,TDGE 1,A01,450047,Salovey; Todd,20,0,20,0
1708248046007,TDGE 1,A02,450048,Salovey; Todd,20,0,20,0
1708248046007,TDGE 1,A03,450085,Salovey; Todd,18,0,20,2
1708248046007,TDGE 1,A04,450093,Salovey; Todd,20,0,20,0
1708248046007,TDGE 1,A05,450096,Salovey; Todd,19,0,20,1
1708248046007,TDGE 1,A06,450132,Salovey; Todd,16,0,20,4
1708248046539,TDGE 25,A00,450236,Harting; Carla Kelso,12,0,20,8
1708248046539,TDGE 25,B00,450240,Harting; Carla Kelso,16,0,20,4
1708248046539,TDGE 25,C00,450243,Harting; Carla Kelso,14,0,20,6
1708248046539,TDGE 25,D00,450388,Harting; Carla Kelso,16,0,20,4
1708248047066,TDGE 100,A01,451098,Salovey; Todd,24,0,25,1
1708248047066,TDGE 100,A02,451099,Salovey; Todd,24,0,25,1
1708248047592,TDGE 124,A00,451122,Fulton; Julia,169,0,200,31
1708248048124,TDGE 125,A00,480853,Havis; Allan,198,0,200,2
1708248048124,TDGE 125,B00,480886,Staff,216,0,220,4
1708248048649,TDGE 133,A00,481097,Brill; Robert L.,20,0,20,0
1708248049184,TDGE 196B,A00,493144,Barricelli; Marc Alexander,1,0,1,0
1708248049184,TDGE 196B,B00,493148,Buescher; Stephen W.,2,0,2,0
1708248049184,TDGE 196B,C00,493151,Burelle; Julie Sara Veronique,1,0,1,0
1708248049184,TDGE 196B,D00,493189,Castro; Robert Jess,2,0,2,0
1708248049184,TDGE 196B,E00,493190,Guirguis; Mark C,1,0,1,0
1708248049184,TDGE 196B,F00,493240,Iizuka; Naomi Hisako,1,0,1,0
1708248049184,TDGE 196B,G00,493241,Perry; Lamar,1,0,1,0
1708248049184,TDGE 196B,H00,493249,Powell; Lora,1,0,1,0
1708248049184,TDGE 196B,I00,493296,Stein; Deborah Isobel,6,0,6,0
1708248049711,TDGR 213C,A00,451385,Buescher; Stephen W.,10,0,10,0
1708248050239,TDGR 220A,A00,451386,Barricelli; Marc Alexander,10,0,10,0
1708248050765,TDGR 239,A00,451387,Blair; Kyle Adam,10,0,10,0
1708248051291,TDGR 240,A00,481306,Portes; Elizabeth Marie,5,0,5,0
1708248051819,TDGR 245,A00,451388,Perry; Lamar,7,0,7,0
1708248052345,TDGR 250,A00,451395,Iizuka; Naomi Hisako,8,0,10,2
1708248052875,TDGR 251,A00,451397,Iizuka; Naomi Hisako,9,0,10,1
1708248052875,TDGR 251,B00,451398,Stein; Deborah Isobel,9,0,10,1
1708248053419,TDGR 257B,A00,451399,Finch; Michael S,8,0,10,2
1708248053945,TDGR 278,A00,481307,Petrovich; Victoria A.,4,0,5,1
1708248054479,TDGR 279,A00,451400,Bokovikova; Alina V,9,0,10,1
1708248054479,TDGR 279,B00,451401,Brill; Robert L.,10,0,10,0
1708248054479,TDGR 279,C00,451402,Petrovich; Victoria A.,10,0,10,0
1708248054479,TDGR 279,D00,451403,McElver; Robert Harrison,10,0,10,0
1708248054479,TDGR 279,E00,451404,Kuhl; Christopher August,10,0,10,0
1708248055021,TDGR 286,A00,451405,Knox; Leila Elizabeth,9,0,10,1
1708248055548,TDGR 288,A00,451406,Powell; Lora,6,0,7,1
1708248056081,TDGR 292,A00,451407,Power; Jade Yukana,10,0,10,0
1708248056081,TDGR 292,B00,451408,Mehrishi; Rishika,10,0,10,0
1708248056606,TDGR 293,001,451417,Power; Jade Yukana,7,0,7,0
1708248056606,TDGR 293,002,451418,Burelle; Julie Sara Veronique,7,0,7,0
1708248056606,TDGR 293,003,451419,Yapp; Hentyle T,7,0,7,0
1708248056606,TDGR 293,005,451421,Anderson; Mysia Anyse,7,0,7,0
1708248057131,TDGR 294,001,451429,Burelle; Julie Sara Veronique,7,0,7,0
1708248057131,TDGR 294,002,451431,Power; Jade Yukana,7,0,7,0
1708248057131,TDGR 294,003,451432,Yapp; Hentyle T,7,0,7,0
1708248057661,TDGR 295,A00,451433,Barricelli; Marc Alexander,10,0,10,0
1708248058187,TDGR 296,A00,451489,Powell; Lora,6,0,7,1
1708248058187,TDGR 296,B00,451497,Porter; Lisa,6,0,7,1
1708248058717,TDHD 175,A00,451123,Jun; Grace Shin Hae,40,0,40,0
1708248059247,TDHD 176,A00,451124,Caligagan; Maria T.,40,0,40,0
1708248059772,TDHT 10,A00,450409,Power; Jade Yukana,20,0,20,0
1708248059772,TDHT 10,B00,450450,Power; Jade Yukana,19,0,20,1
1708248060298,TDHT 23,A01,450546,Salimi; Rana,24,0,24,0
1708248060298,TDHT 23,A02,450549,Salimi; Rana,22,0,24,2
1708248060298,TDHT 23,A03,450553,Salimi; Rana,24,0,24,0
1708248060826,TDHT 101,A00,451125,Anderson; Mysia Anyse,25,0,25,0
1708248060826,TDHT 101,B00,451126,Mehrishi; Rishika,23,0,25,2
1708248061351,TDHT 104,A00,451225,Basso; Beatrice,22,0,25,3
1708248061894,TDHT 109,A01,451227,Anderson; Mysia Anyse,25,0,25,0
1708248062420,TDHT 122,A00,451228,Power; Jade Yukana,21,0,25,4
1708248062947,TDMV 1,A00,450558,Caligagan; Maria T.,15,0,30,15
1708248063473,TDMV 2,A00,450627,Anabo; Cherry,24,0,30,6
1708248064000,TDMV 3,A00,450630,Arcidiacono; Kristin,37,0,40,3
1708248064527,TDMV 11,A00,481244,Fyall; DauntÉ Edward,30,0,30,0
1708248065054,TDMV 20,A00,450789,Smith; Alison D,38,0,40,2
1708248065582,TDMV 110,A00,451229,Caligagan; Maria T.,28,0,30,2
1708248066108,TDMV 111,A00,451234,Smith; Alison D,28,0,30,2
1708248066640,TDMV 120,A00,451260,Weinberg; Sadie,30,0,30,0
1708248066640,TDMV 120,B00,451261,Sammartano; Tonnie,30,0,30,0
1708248067222,TDMV 122,A00,451262,Staff,28,0,30,2
1708248067752,TDMV 123,A00,451263,Duran; Marcos Antonio,28,0,30,2
1708248068281,TDMV 130,A00,451272,Mack; Kara Shanai',30,0,30,0
1708248068811,TDMV 138,A00,451275,Jun; Grace Shin Hae,4,0,30,26
1708248069338,TDMV 140,A00,451276,Lima; Paulo Henrique,40,0,40,0
1708248069338,TDMV 140,B00,451308,Power; Jade Yukana,39,0,40,1
1708248069338,TDMV 140,C00,451371,Caligagan; Tony,40,0,40,0
1708248069338,TDMV 140,D00,451373,Corrales; Joseph Bernales,28,0,30,2
1708248069865,TDMV 141,A00,451374,Caligagan; Tony,26,0,30,4
1708248070394,TDMV 142,A00,451375,Blanco; Juan Carlos,26,0,40,14
1708248070920,TDMV 143,A00,451376,Fyall; DauntÉ Edward,39,0,40,1
1708248071448,TDMV 144,A00,451377,Anabo; Cherry,39,0,40,1
1708248071974,TDMV 149,A00,451378,Jun; Grace Shin Hae,36,0,40,4
1708248072501,TDPF 162,A00,451379,Alvarez; Ana Maria,40,0,40,0
1708248073029,TDPR 6,A01,450799,Guirguis; Mark C,50,0,50,0
1708248073029,TDPR 6,A02,450801,Guirguis; Mark C,50,0,50,0
1708248073555,TDPR 102,A00,451380,Guirguis; Mark C,20,0,20,0
1708248074083,TDPR 104,A00,451381,Powell; Lora,15,0,15,0
1708248074613,TDPW 1,A00,450808,Stein; Deborah Isobel,14,0,15,1
1708248074613,TDPW 1,B00,450864,Stein; Deborah Isobel,13,0,15,2
1708248074613,TDPW 1,C00,450865,Stein; Deborah Isobel,15,0,15,0
1708248074613,TDPW 1,D00,450868,Stein; Deborah Isobel,13,0,15,2
1708248074613,TDPW 1,E00,450874,Stein; Deborah Isobel,14,0,15,1
1708248075137,TDPW 102,A00,451382,Staff,18,0,20,2
1708248075663,TDPW 104,A00,481182,Staff,17,0,20,3
1708248076194,TDTR 10,A00,450881,Wilson; Terry A.,28,0,30,2
1708248076720,TDTR 15,A00,450882,Smith; Alison D,30,0,30,0
1708248077251,TMC 15,A00,479039,Hemans; Patricia Ann Benitez,25,0,25,0
1708248077779,TMC 87,A00,479049,Solomon; Amanda Lee Albaniel,20,0,20,0
1708248078309,UROL 296,001,467060,Anger; Jennifer Tash,49,0,50,1
1708248078309,UROL 296,002,467061,Staff,50,0,50,0
1708248079852,USP 3,A01,458852,Martin; Isaac,34,0,35,1
1708248079852,USP 3,A02,458853,Martin; Isaac,35,0,35,0
1708248079852,USP 3,A03,458861,Martin; Isaac,34,0,35,1
1708248079852,USP 3,A04,458862,Martin; Isaac,32,0,35,3
1708248080384,USP 4,A00,451772,Schwaller; Nora Louise,19,0,25,6
1708248080910,USP 5,A01,458863,Shenkman; Michael Thomas,33,0,35,2
1708248080910,USP 5,A02,458864,Shenkman; Michael Thomas,31,0,35,4
1708248081436,USP 15,A01,458931,Staff,33,0,35,2
1708248081436,USP 15,A02,459024,Staff,31,0,35,4
1708248081984,USP 25,A00,451786,Sun; Feiyang,57,0,60,3
1708248082516,USP 100,A00,451787,Moses; Kelema Lee,55,0,60,5
1708248083043,USP 108,A00,477594,Martin; Isaac,25,0,25,0
1708248083572,USP 119,A00,477595,Schwaller; Nora Louise,23,0,25,2
1708248084098,USP 124,A00,451790,Hinds; Juli Beth,62,0,70,8
1708248084628,USP 128B,A01,451910,Lewis; Leslie R,12,0,13,1
1708248085173,USP 142B,A01,451954,Lewis; Leslie R,24,0,25,1
1708248085700,USP 142C,A00,451977,Lerner; Amy M,0,0,0,0
1708248086243,USP 145,A00,451999,Yaghmaee; Saman,140,0,146,6
1708248086770,USP 150,A00,452165,Staff,44,0,50,6
1708248087315,USP 151,A00,452166,Staff,49,0,50,1
1708248087858,USP 152A,A01,459025,Weaver; Todd D,25,0,25,0
1708248087858,USP 152A,A02,459074,Weaver; Todd D,24,0,25,1
1708248088385,USP 152B,A00,452224,Moeder; Nathan L,21,0,25,4
1708248088913,USP 153,A00,452339,Shenkman; Michael Thomas,50,0,50,0
1708248089440,USP 158A,A00,452410,Sun; Feiyang,25,0,25,0
1708248089968,USP 159B,A00,452411,Gherini; Paul Pier-Carlo,6,0,8,2
1708248090497,USP 160,A00,452412,Wartell; Julie Dara,25,0,25,0
1708248091025,USP 164,A00,452413,Moses; Kelema Lee,22,0,25,3
1708248091555,USP 165C,A00,452442,Frank; Lawrence Douglas,20,0,20,0
1708248092081,USP 169,A00,452598,Bajaj; Ravi Siddharth,32,0,35,3
1708248092612,USP 170,A00,477593,Entezam; Maryam,60,0,60,0
1708248093138,USP 172,A00,452676,Peerson; Susan,19,0,25,6
1708248093903,USP 175,A00,452848,Velasco; Diego,18,0,20,2
1708248094430,USP 177A,A00,453084,Velasco; Diego,21,0,25,4
1708248094960,USP 177B,A00,453127,Peerson; Susan,22,0,25,3
1708248095491,USP 183,A00,453128,Sutton; April Marie,19,0,20,1
1708248096018,USP 188B,A00,453187,Pezzoli; Keith,30,0,30,0
1708248096546,USP 190,A00,453234,Pezzoli; Keith,0,0,0,1
1708248097076,USP 191B,A00,453240,Polat; Soydan Alihan,18,0,20,2
1708248097606,USP 193,A00,453251,Bussell; Mirle Rabinowitz,24,0,25,1
1708248098137,USP 194,A00,455342,Hill; Seth J,0,0,0,0
1708248098662,USP 265C,A00,453264,Frank; Lawrence Douglas,10,0,10,0
1708248099192,VIS 3,A01,453427,Staff,25,0,25,0
1708248099192,VIS 3,A02,453428,Staff,15,0,25,10
1708248099192,VIS 3,A03,453429,Staff,25,0,25,0
1708248099192,VIS 3,A04,453430,Staff,21,0,25,4
1708248099192,VIS 3,A05,453431,Staff,25,0,25,0
1708248099192,VIS 3,A06,453432,Staff,23,0,25,2
1708248099192,VIS 3,A07,453433,Staff,17,0,25,8
1708248099192,VIS 3,A08,453434,Staff,23,0,25,2
1708248099192,VIS 3,A09,453435,Staff,21,0,25,4
1708248099192,VIS 3,A10,453436,Staff,23,0,25,2
1708248099718,VIS 9,A00,453437,Camargo; William,116,0,146,30
1708248100248,VIS 10,A00,453438,Kiratli; Solen,189,0,200,11
1708248100780,VIS 21B,A01,453440,Shen; Kuiyi,31,0,32,1
1708248100780,VIS 21B,A02,453441,Shen; Kuiyi,31,0,32,1
1708248100780,VIS 21B,A03,453442,Shen; Kuiyi,31,0,32,1
1708248100780,VIS 21B,A04,453443,Shen; Kuiyi,32,0,32,0
1708248100780,VIS 21B,A05,453444,Shen; Kuiyi,32,0,32,0
1708248100780,VIS 21B,A06,453452,Shen; Kuiyi,32,0,32,0
1708248100780,VIS 21B,A07,453468,Shen; Kuiyi,30,0,32,2
1708248100780,VIS 21B,A08,453587,Shen; Kuiyi,32,0,32,0
1708248101307,VIS 22,A01,453589,Rose; Jordan M,32,0,32,0
1708248101307,VIS 22,A02,453590,Rose; Jordan M,32,0,32,0
1708248101307,VIS 22,A03,453615,Rose; Jordan M,31,0,32,1
1708248101307,VIS 22,A04,453616,Rose; Jordan M,32,0,32,0
1708248101307,VIS 22,A05,453617,Rose; Jordan M,30,0,32,2
1708248101307,VIS 22,A06,453618,Rose; Jordan M,30,0,32,2
1708248101307,VIS 22,A07,453620,Rose; Jordan M,32,0,32,0
1708248101307,VIS 22,A08,453621,Rose; Jordan M,32,0,32,0
1708248101307,VIS 22,A09,453635,Rose; Jordan M,32,0,32,0
1708248101307,VIS 22,A10,453636,Rose; Jordan M,32,0,32,0
1708248101834,VIS 31,A00,453637,Dominguez; Ricardo,133,0,146,13
1708248102360,VIS 41,A01,453644,D'Elena-Tweed; Jessica Erin,23,0,25,2
1708248102360,VIS 41,A02,453645,D'Elena-Tweed; Jessica Erin,22,0,25,3
1708248102360,VIS 41,A03,453646,D'Elena-Tweed; Jessica Erin,25,0,25,0
1708248102360,VIS 41,A04,453647,D'Elena-Tweed; Jessica Erin,18,0,25,7
1708248102360,VIS 41,A05,453648,D'Elena-Tweed; Jessica Erin,25,0,25,0
1708248102360,VIS 41,A06,453650,D'Elena-Tweed; Jessica Erin,24,0,25,1
1708248102904,VIS 70N,A01,453652,Garnett; Mariah J,21,0,22,1
1708248102904,VIS 70N,A02,453653,Garnett; Mariah J,21,0,22,1
1708248102904,VIS 70N,A03,453654,Garnett; Mariah J,22,0,22,0
1708248102904,VIS 70N,A04,453657,Garnett; Mariah J,22,0,22,0
1708248102904,VIS 70N,A05,453662,Garnett; Mariah J,20,0,22,2
1708248102904,VIS 70N,A06,453663,Garnett; Mariah J,22,0,22,0
1708248103434,VIS 83,A00,453664,Kester; Grant,137,0,146,9
1708248103961,VIS 101A,A00,453666,Cruz; Edwin Teddy,10,0,15,5
1708248104486,VIS 102,A00,453668,Cruz; Edwin Teddy,81,0,85,4
1708248105015,VIS 105A,A00,453669,Adler; Amy,29,0,30,1
1708248105542,VIS 105B,A00,453738,Herc-Balaszek; Malgorzata,25,0,30,5
1708248105542,VIS 105B,B00,453739,Staff,27,0,30,3
1708248106084,VIS 106A,A00,453740,Staff,22,0,25,3
1708248106627,VIS 106B,A00,453741,De Luca; Mara Julia,20,0,25,5
1708248107152,VIS 106C,A00,453746,Vangenderen; Monique Luise,11,0,15,4
1708248107677,VIS 107A,A00,453747,Gregoire; Mathieu,19,0,25,6
1708248108203,VIS 107B,A00,453748,Dean; Danielle Adobi,23,0,25,2
1708248108731,VIS 110A,A00,453749,Adler; Amy,13,0,15,2
1708248109257,VIS 110E,A00,453798,Gregoire; Mathieu,14,0,15,1
1708248109782,VIS 110F,A00,453799,Staff,15,0,15,0
1708248110310,VIS 110N,A00,453803,Dean; Danielle Adobi,15,0,15,0
1708248110836,VIS 123B,A00,453804,Gaines; Malik Julian,75,0,75,0
1708248111362,VIS 125BN,A00,453813,Welchman; John C.,75,0,75,0
1708248111893,VIS 126P,A00,453814,Wardwell; Mariana Razo,74,0,75,1
1708248112419,VIS 128E,A00,453815,Staff,75,0,75,0
1708248112945,VIS 129E,A00,453855,Shen; Kuiyi,12,0,15,3
1708248113478,VIS 131,A00,453859,Trigilio; Michael,12,0,15,3
1708248113478,VIS 131,B00,479342,Mangolte; Babette,15,0,15,0
1708248114005,VIS 133A,A00,454231,Barbosa; Erika Katrina,13,0,15,2
1708248114536,VIS 134,A00,454232,Yoldas; Pinar,59,0,75,16
1708248115068,VIS 141B,A00,454233,Stalbaum; Brett,12,0,15,3
1708248115598,VIS 145B,A00,454234,Alexander; Amy J,14,0,15,1
1708248115598,VIS 145B,B00,454235,Kiratli; Solen,8,0,15,7
1708248116129,VIS 147A,A01,454237,Stalbaum; Brett,20,0,22,2
1708248116129,VIS 147A,A02,454238,Stalbaum; Brett,18,0,22,4
1708248116657,VIS 157,A01,454240,Cartwright; Lisa,32,0,34,2
1708248116657,VIS 157,A02,454241,Cartwright; Lisa,32,0,34,2
1708248117184,VIS 159,A01,454243,Akten; Mehmet,34,0,34,0
1708248117184,VIS 159,A02,454244,Akten; Mehmet,32,0,34,2
1708248117184,VIS 159,A03,454300,Akten; Mehmet,30,0,34,4
1708248117184,VIS 159,A04,454301,Akten; Mehmet,33,0,34,1
1708248117184,VIS 159,A05,454302,Akten; Mehmet,30,0,34,4
1708248117184,VIS 159,A06,454307,Akten; Mehmet,33,0,34,1
1708248117184,VIS 159,A07,454308,Akten; Mehmet,34,0,34,0
1708248117184,VIS 159,A08,454309,Akten; Mehmet,33,0,34,1
1708248117714,VIS 160B,A00,454310,Alexander; Amy J,13,0,15,2
1708248117714,VIS 160B,B00,454311,Akten; Mehmet,14,0,15,1
1708248117714,VIS 160B,C00,454312,Stone; Patricia,12,0,15,3
1708248118240,VIS 164,A00,454313,Cross; Brian R,19,0,22,3
1708248118240,VIS 164,B00,454314,Camargo; William,22,0,22,0
1708248118766,VIS 165,A00,454315,Erdmann; Dean,22,0,22,0
1708248119295,VIS 167,A00,454316,Staff,18,0,22,4
1708248119821,VIS 169A,A00,454317,Mostajo; Lorena,21,0,22,1
1708248120347,VIS 171,A00,454318,Nakayama; Yue,21,0,22,1
1708248120876,VIS 174,A00,454319,Staff,19,0,22,3
1708248121406,VIS 177,A00,454320,Cho; Erica,21,0,22,1
1708248121986,VIS 178,A00,454321,Staff,0,0,0,0
1708248122515,VIS 179,A00,454322,Erdmann; Dean,22,0,22,0
1708248123040,VIS 180A,A00,454323,Nakayama; Yue,21,0,22,1
1708248123566,VIS 180B,A00,454341,Cross; Brian R,20,0,22,2
1708248124091,VIS 183A,A00,454342,Cho; Erica,17,0,22,5
1708248124623,VIS 185,A00,454343,Miller; Nicole L,18,0,22,4
1708248125153,VIS 190,A00,454360,Crandall; Jordan,15,0,15,0
1708248125153,VIS 190,B00,454361,D'Elena-Tweed; Jessica Erin,10,0,15,5
1708248125681,VIS 202,A00,454369,Miller; Nicole L,12,0,15,3
1708248126206,VIS 203,A00,454370,Garnett; Mariah J,8,0,15,7
1708248126731,VIS 206,A00,454376,Kester; Grant,10,0,15,5
1708248127261,VIS 208,A00,454377,Moss; Ceci,15,0,15,0
1708248127791,VIS 211,A00,454413,Segade; Alexandro Abraham,0,0,0,2
1708248128316,VIS 243,A00,454429,Rose; Jordan M,5,0,15,10
1708248128845,VIS 255,A00,454430,Welchman; John C.,8,0,15,7
1708248129373,VIS 262,A00,454431,Yoldas; Pinar,11,0,15,4
1708248129901,WCWP 10A,001,454442,Uriarte; Emma,17,0,20,3
1708248129901,WCWP 10A,002,454443,Uriarte; Emma,14,0,20,6
1708248129901,WCWP 10A,003,454479,Uriarte; Emma,19,0,20,1
1708248129901,WCWP 10A,004,454480,Staff,0,0,0,0
1708248129901,WCWP 10A,005,454484,Staff,0,0,0,0
1708248129901,WCWP 10A,006,454485,Staff,0,0,0,0
1708248129901,WCWP 10A,007,454487,Staff,0,0,0,0
1708248129901,WCWP 10A,008,454488,Susi; Natalie,14,0,20,6
1708248129901,WCWP 10A,009,454489,Staff,0,0,0,0
1708248129901,WCWP 10A,010,454490,Staff,0,0,0,0
1708248130435,WCWP 10B,001,454492,Ornelas; Tricia,20,0,20,0
1708248130435,WCWP 10B,002,454501,Ornelas; Tricia,20,0,20,0
1708248130435,WCWP 10B,003,454565,Gagnon; Jeffrey C,2,0,20,18
1708248130435,WCWP 10B,004,454604,Ornelas; Tricia,16,0,20,4
1708248130435,WCWP 10B,005,454668,Staff,16,0,16,0
1708248130435,WCWP 10B,006,454724,Staff,16,0,16,0
1708248130435,WCWP 10B,007,454725,Staff,14,0,16,2
1708248130435,WCWP 10B,008,454768,Staff,0,0,0,0
1708248130435,WCWP 10B,009,454769,Staff,0,0,0,0
1708248130435,WCWP 10B,010,454770,Staff,0,0,0,0
1708248130435,WCWP 10B,011,454771,Dhir; Simrita,16,0,20,4
1708248130435,WCWP 10B,012,454772,Dhir; Simrita,16,0,20,4
1708248130435,WCWP 10B,013,454773,Merryman; Walter,17,0,20,3
1708248130435,WCWP 10B,014,454774,Dhir; Simrita,18,0,20,2
1708248130435,WCWP 10B,015,454775,Merryman; Walter,17,0,20,3
1708248130435,WCWP 10B,016,454776,Merryman; Walter,18,0,20,2
1708248130435,WCWP 10B,017,454777,Welji; Haleema Nazir,14,0,16,2
1708248130435,WCWP 10B,018,478868,Staff,16,0,16,0
1708248130435,WCWP 10B,019,478869,Staff,0,0,0,0
1708248130435,WCWP 10B,020,478876,Staff,0,0,0,0
1708248130435,WCWP 10B,021,478877,Staff,0,0,0,0
1708248130435,WCWP 10B,022,478887,Staff,0,0,0,0
1708248130435,WCWP 10B,023,478889,Staff,16,0,16,0
1708248130435,WCWP 10B,024,478892,Staff,0,0,0,0
1708248130435,WCWP 10B,025,478907,Staff,0,0,0,0
1708248130972,WCWP 100,A00,454800,McCleary; Keith Long,20,0,20,0
1708248130972,WCWP 100,B00,454804,McCleary; Keith Long,20,0,20,0
1708248130972,WCWP 100,C00,454822,Twohig; Niall Ivan,19,0,20,1
1708248130972,WCWP 100,D00,454855,Young; Mark T,20,0,20,0
1708248130972,WCWP 100,E00,454860,Twohig; Niall Ivan,20,0,20,0
1708248130972,WCWP 100,F00,454932,Young; Mark T,20,0,20,0
1708248130972,WCWP 100,G00,454933,Young; Mark T,20,0,20,0
1708248131498,WES 207,A00,454941,Kastner; Ryan Charles,20,0,20,0
1708248132024,WES 265,A00,454942,Staff,19,0,20,1
1708248133752,AAS 10,A01,392963,Butler; Elizabeth Annette,34,0,34,0
1708248133752,AAS 10,A02,392965,Butler; Elizabeth Annette,33,0,34,1
1708248134280,AAS 170,A00,392977,Butler; Elizabeth Annette,31,0,32,1
1708248134809,AAS 198,001,479182,Childs; Dennis R.,20,0,20,0
1708248135340,AESE 261,A00,387945,Staff,33,0,33,0
1708248135868,AESE 278D,A00,387953,Staff,33,0,33,0
1708248136397,AESE 278E,A00,387954,Staff,33,0,33,0
1708248136926,AESE 279A,A00,387956,Staff,33,0,33,0
1708248137455,AIP 197P,001,494494,Goldfarb; Brian,9999,0,9999,0
1708248137987,ANAR 100,A00,387884,Shtienberg; Gilad,15,0,16,1
1708248138514,ANAR 104,A01,387886,Tamberino; Anthony Thomas,21,0,25,4
1708248139039,ANAR 111,A00,387888,Staff,36,0,36,0
1708248139568,ANAR 115,A00,387889,Shtienberg; Gilad,36,0,36,0
1708248140094,ANAR 120,A00,387890,Staff,36,0,36,0
1708248140619,ANAR 155,A00,387891,Braswell; Geoffrey E.,15,0,25,10
1708248141146,ANAR 164,A00,387892,Staff,32,0,35,3
1708248141678,ANBI 100,A00,489626,Fox; Patrick Keolu Ozer,39,0,40,1
1708248142208,ANBI 111,A00,387893,Hrvoj Mihic; Branka,37,0,40,3
1708248143261,ANBI 144,A00,387896,Wilder; Linnea Lorene,72,0,75,3
1708248143791,ANBI 149,A00,489628,Non; Amy L,0,0,0,0
1708248144315,ANBI 173,A00,387897,Wilder; Linnea Lorene,74,0,75,1
1708248144840,ANBI 174,A00,489627,Strum; Shirley C.,13,0,15,2
1708248145371,ANES 296,001,463968,Gabriel; Rodney A,49,0,50,1
1708248145371,ANES 296,002,463969,Staff,50,0,50,0
1708248145371,ANES 296,003,463970,Staff,50,0,50,0
1708248145897,ANSC 100,A00,387898,Bialecki; Jon Anthony,40,0,40,0
1708248146424,ANSC 101,A00,387900,Sloane; Julia Kathryn,34,0,40,6
1708248146953,ANSC 117,A00,387901,Martin Sandino; Amanda Maria Yoland,13,0,15,2
1708248147482,ANSC 134,A00,387902,Staff,38,0,40,2
1708248148007,ANSC 137,A00,387903,Stewart; Alexander B,80,0,80,0
1708248148534,ANSC 138,A00,387904,Parish; Steven Martin,14,0,15,1
1708248149059,ANSC 142,A00,387905,Stone; Annika Britt,34,0,40,6
1708248149584,ANSC 147,A00,387906,Stewart; Alexander B,40,0,40,0
1708248150115,ANSC 148,A00,387907,Olivas Hernandez; Olga Lid,92,0,92,0
1708248150641,ANSC 186,A00,387910,Hankins; Joseph D.,28,0,30,2
1708248151169,ANTH 2,A01,387863,Marchetto; Maria Carolina,37,0,40,3
1708248151169,ANTH 2,A02,387864,Marchetto; Maria Carolina,40,0,40,0
1708248151169,ANTH 2,A03,387865,Marchetto; Maria Carolina,36,0,40,4
1708248151169,ANTH 2,A04,387866,Marchetto; Maria Carolina,39,0,40,1
1708248151703,ANTH 3,A01,387868,Stroth; Luke Reyneri,28,0,30,2
1708248151703,ANTH 3,A02,387869,Stroth; Luke Reyneri,29,0,30,1
1708248151703,ANTH 3,A03,387870,Stroth; Luke Reyneri,30,0,30,0
1708248151703,ANTH 3,A04,387871,Stroth; Luke Reyneri,29,0,30,1
1708248152235,ANTH 10,A00,387872,Stewart; Alexander B,80,0,80,0
1708248152762,ANTH 21,A01,387874,Stone; Annika Britt,40,0,40,0
1708248152762,ANTH 21,A02,387875,Stone; Annika Britt,40,0,40,0
1708248152762,ANTH 21,A03,387876,Stone; Annika Britt,40,0,40,0
1708248152762,ANTH 21,A04,387877,Stone; Annika Britt,39,0,40,1
1708248153290,ANTH 23,A01,387879,Staff,40,0,40,0
1708248153290,ANTH 23,A02,387880,Staff,40,0,40,0
1708248153290,ANTH 23,A03,387881,Staff,40,0,40,0
1708248153290,ANTH 23,A04,387882,Staff,40,0,40,0
1708248153818,ANTH 24,A00,387883,Pedersen; David,40,0,40,0
1708248154345,ANTH 103,A00,387911,Staff,343,0,350,7
1708248154872,ANTH 105,A00,387912,Staff,73,0,75,2
1708248155397,ANTH 112,A00,387913,Staff,23,0,25,2
1708248155926,ANTH 120,A00,479486,Parish; Steven Martin,28,0,30,2
1708248156452,ANTH 128B,A01,387923,Lewis; Leslie R,12,0,12,0
1708248156978,ANTH 192,A00,387925,Varma; Saiba,20,0,20,0
1708248157504,ANTH 196C,A00,387927,Varma; Saiba,15,0,15,0
1708248158030,ANTH 212,A00,387931,Marchetto; Maria Carolina,25,0,25,0
1708248158030,ANTH 212,B00,479487,Semendeferi; Ekaterini,25,0,25,0
1708248158560,ANTH 220,A00,387932,Csordas; Thomas J.,9,0,12,3
1708248159093,ANTH 230,001,493297,Goldstein; Paul S,18,0,20,2
1708248159620,ANTH 260,A00,479223,Jenkins; Janis A.,25,0,25,0
1708248160149,ANTH 272,A00,387936,Serlin; David,5,0,5,0
1708248160674,ANTH 273,A00,387938,Gates; Kelly,5,0,5,0
1708248161199,ANTH 288,A00,387940,Braswell; Geoffrey E.,25,0,25,0
1708248161736,ANTH 295,001,493298,Algaze; Guillermo,3,0,3,0
1708248161736,ANTH 295,002,493299,Brenner; Suzanne A,3,0,3,0
1708248161736,ANTH 295,003,493300,Csordas; Thomas J.,3,0,3,0
1708248161736,ANTH 295,004,493422,Fox; Patrick Keolu Ozer,3,0,3,0
1708248161736,ANTH 295,005,493472,Gagneux; Pascal,3,0,3,0
1708248161736,ANTH 295,006,493515,Goldstein; Paul S,3,0,3,0
1708248161736,ANTH 295,007,493592,Hankins; Joseph D.,3,0,3,0
1708248161736,ANTH 295,008,493631,Jassal; Aftab,3,0,3,0
1708248161736,ANTH 295,009,493639,Jenkins; Janis A.,3,0,3,0
1708248161736,ANTH 295,010,493657,Kaiser; Bronwyn Nicole,3,0,3,0
1708248161736,ANTH 295,011,493692,Kang; Byung Chu,3,0,3,0
1708248161736,ANTH 295,012,493758,Marchetto; Maria Carolina,3,0,3,0
1708248161736,ANTH 295,013,493761,Non; Amy L,3,0,3,0
1708248161736,ANTH 295,014,493762,Pedersen; David,3,0,3,0
1708248161736,ANTH 295,015,493825,Rivera-Collazo; Isabel C,3,0,3,0
1708248161736,ANTH 295,016,493826,Varma; Saiba,3,0,3,0
1708248161736,ANTH 295,017,493828,Yeh; Rihan Wen Xin,3,0,3,0
1708248162270,ANTH 296,001,493830,Braswell; Geoffrey E.,3,0,3,0
1708248162270,ANTH 296,002,493836,Marchetto; Maria Carolina,3,0,3,0
1708248162270,ANTH 296,003,493838,Rivera-Collazo; Isabel C,3,0,3,0
1708248162270,ANTH 296,004,493840,Varma; Saiba,3,0,3,0
1708248162270,ANTH 296,005,493842,Algaze; Guillermo,3,0,3,0
1708248162270,ANTH 296,006,493845,Brenner; Suzanne A,3,0,3,0
1708248162270,ANTH 296,007,493846,Csordas; Thomas J.,3,0,3,0
1708248162270,ANTH 296,008,493907,Fox; Patrick Keolu Ozer,3,0,3,0
1708248162270,ANTH 296,009,493949,Gagneux; Pascal,3,0,3,0
1708248162270,ANTH 296,010,493960,Goldstein; Paul S,3,0,3,0
1708248162270,ANTH 296,011,493961,Hankins; Joseph D.,3,0,3,0
1708248162270,ANTH 296,012,493962,Jassal; Aftab,3,0,3,0
1708248162270,ANTH 296,013,493963,Jenkins; Janis A.,3,0,3,0
1708248162270,ANTH 296,014,493964,Kaiser; Bronwyn Nicole,3,0,3,0
1708248162270,ANTH 296,015,493965,Kang; Byung Chu,3,0,3,0
1708248162270,ANTH 296,016,493966,Levy; Thomas E,3,0,3,0
1708248162270,ANTH 296,017,493967,Non; Amy L,3,0,3,0
1708248162270,ANTH 296,018,493968,Pedersen; David,3,0,3,0
1708248162270,ANTH 296,019,493969,Postero; Nancy Grey,3,0,3,0
1708248162270,ANTH 296,020,493970,Semendeferi; Ekaterini,3,0,3,0
1708248162270,ANTH 296,021,493971,Yeh; Rihan Wen Xin,3,0,3,0
1708248162799,AUD 236,A00,480192,Harris; Jeffrey Paul,12,0,12,0
1708248163324,AUD 260,A00,480227,Spriggs; Meghan K,12,0,12,0
1708248163852,AUD 272,A00,480367,Zettner; Erika,12,0,12,0
1708248164376,AUD 275,A00,480369,Zettner; Erika,12,0,12,0
1708248164902,AUD 284,A00,480370,Zettner; Erika,12,0,12,0
1708248164902,AUD 284,B00,480372,Spriggs; Meghan K,12,0,12,0
1708248165427,AUD 291,A00,480374,Zettner; Erika,12,0,12,0
1708248165957,AUD 296,A00,480375,Zettner; Erika,12,0,12,0
1708248165957,AUD 296,B00,480376,Harris; Jeffrey Paul,12,0,12,0
1708248165957,AUD 296,C00,480377,Ryan; Allen F.,12,0,12,0
1708248166498,AWP 3,002,387672,Given; William Allan,9,0,9,0
1708248166498,AWP 3,003,387678,Staff,5,0,5,0
1708248166498,AWP 3,004,387681,Staff,0,0,0,0
1708248166498,AWP 3,007,387784,West; Geoffrey Scott,4,0,5,1
1708248166498,AWP 3,009,387786,Kolodezh; Samuel,5,0,5,0
1708248166498,AWP 3,010,387787,Gilbert; Peter W,5,0,5,0
1708248167029,AWP 4A,001,387791,Staff,12,0,12,0
1708248167029,AWP 4A,002,387792,Staff,0,0,0,0
1708248167571,AWP 4B,001,387793,Bolin; Jillian,0,0,0,0
1708248167571,AWP 4B,002,387794,Bolin; Jillian,0,0,0,0
1708248167571,AWP 4B,003,387795,Bauer; Holly Jean,0,0,0,0
1708248167571,AWP 4B,004,387796,Vaughn; Kelsey Sara,0,0,0,0
1708248167571,AWP 4B,005,387797,Vaughn; Kelsey Sara,0,0,0,0
1708248167571,AWP 4B,007,387799,Ajo; Frances Margaret,0,0,0,0
1708248167571,AWP 4B,008,387800,Ajo; Frances Margaret,0,0,0,0
1708248167571,AWP 4B,009,387801,Hall; Graham T,0,0,0,0
1708248167571,AWP 4B,010,387802,Hall; Graham T,0,0,0,0
1708248167571,AWP 4B,011,387803,Heiser; Jerrod A,0,0,0,0
1708248167571,AWP 4B,012,387804,Heiser; Jerrod A,0,0,0,0
1708248167571,AWP 4B,013,387805,Jones; William Jadie,0,0,0,0
1708248167571,AWP 4B,014,387806,Jones; William Jadie,0,0,0,0
1708248167571,AWP 4B,015,387807,Christie; Veronica Ann,0,0,0,0
1708248167571,AWP 4B,016,387808,Christie; Veronica Ann,0,0,0,0
1708248167571,AWP 4B,019,387820,Falcon; Jennifer A,0,0,0,0
1708248167571,AWP 4B,020,387821,Falcon; Jennifer A,0,0,0,0
1708248167571,AWP 4B,021,387822,Eastin; Schuyler E.,0,0,0,0
1708248167571,AWP 4B,023,387824,Coulter; Jane Elisabeth,0,0,0,0
1708248167571,AWP 4B,025,387826,O'Neil; Courtney L,0,0,0,0
1708248167571,AWP 4B,026,387827,O'Neil; Courtney L,0,0,0,0
1708248167571,AWP 4B,027,387828,Tsurska Svetina; Olena,0,0,0,0
1708248167571,AWP 4B,028,387829,Tsurska Svetina; Olena,0,0,0,0
1708248167571,AWP 4B,029,387830,Spicer; Jacqueline,0,0,0,0
1708248167571,AWP 4B,030,387831,Spicer; Jacqueline,0,0,0,0
1708248167571,AWP 4B,031,387832,Steinberg; Stacy A,0,0,0,0
1708248167571,AWP 4B,032,387833,Steinberg; Stacy A,0,0,0,0
1708248167571,AWP 4B,033,387834,Chandler; Bailee Daniele,0,0,0,0
1708248167571,AWP 4B,034,387835,Chandler; Bailee Daniele,0,0,0,0
1708248167571,AWP 4B,035,387836,Tiernan; Christa Michelle,0,0,0,0
1708248167571,AWP 4B,036,387837,Tiernan; Christa Michelle,0,0,0,0
1708248167571,AWP 4B,037,387840,Gardella; Alexander Drew,0,0,0,0
1708248167571,AWP 4B,038,387841,Gardella; Alexander Drew,0,0,0,0
1708248167571,AWP 4B,039,387857,Zimmerman; Guy,0,0,0,0
1708248167571,AWP 4B,040,387858,Zimmerman; Guy,0,0,0,0
1708248167571,AWP 4B,041,387859,Zroka; Amy Liane,0,0,0,0
1708248167571,AWP 4B,042,387860,Zroka; Amy Liane,0,0,0,0
1708248168107,BENG 87,A00,489656,Sah; Robert Lie-Yuan,20,0,20,0
1708248168107,BENG 87,B00,489657,Sah; Robert Lie-Yuan,20,0,20,0
1708248168107,BENG 87,C00,494754,Omens; Jeffrey Howard,20,0,20,0
1708248168639,BENG 100,A01,387959,Alexandrov; Ludmil B,26,0,28,2
1708248168639,BENG 100,A02,387960,Alexandrov; Ludmil B,26,0,28,2
1708248168639,BENG 100,A03,387984,Alexandrov; Ludmil B,26,0,28,2
1708248168639,BENG 100,A04,387985,Alexandrov; Ludmil B,25,0,28,3
1708248168639,BENG 100,A05,387986,Alexandrov; Ludmil B,27,0,28,1
1708248169169,BENG 102,A00,387987,Chapelin; Fanny,55,0,56,1
1708248169701,BENG 103B,A00,387993,Fraley; Stephanie I.,116,0,120,4
1708248170231,BENG 112B,A01,388053,Shi; Lingyan,26,0,30,4
1708248170231,BENG 112B,A02,388054,Shi; Lingyan,29,0,30,1
1708248170765,BENG 125,A00,388055,Hasty; Jeff M,120,0,160,40
1708248171291,BENG 133,A01,388866,Mali; Prashant Gulab Ram,36,0,40,4
1708248171819,BENG 140B,A01,388884,Cabrales; Pedro,28,0,30,2
1708248171819,BENG 140B,A02,388885,Cabrales; Pedro,30,0,30,0
1708248171819,BENG 140B,A03,388886,Cabrales; Pedro,26,0,30,4
1708248172351,BENG 160,A50,388889,Aguado; Brian Alberto,23,0,25,2
1708248172351,BENG 160,A51,388919,Aguado; Brian Alberto,25,0,25,0
1708248172351,BENG 160,A52,388920,Aguado; Brian Alberto,25,0,25,0
1708248172882,BENG 168,A01,388961,Khojah; Reem I,30,0,30,0
1708248173412,BENG 172,A50,389087,Omens; Jeffrey Howard & Cabrales; Pedro,15,0,20,5
1708248173412,BENG 172,A51,389088,Omens; Jeffrey Howard & Cabrales; Pedro,14,0,20,6
1708248173943,BENG 182,A01,389128,Bafna; Vineet,28,0,30,2
1708248174474,BENG 186A,A00,389130,Kwon; Ester Jihae,105,0,120,15
1708248174999,BENG 187A,A00,389289,Taylor Amos; Alyssa C,157,0,170,13
1708248175526,BENG 187D,A00,389290,Taylor Amos; Alyssa C,33,0,60,27
1708248175526,BENG 187D,B00,389300,Taylor Amos; Alyssa C,51,0,60,9
1708248175526,BENG 187D,C00,389302,Taylor Amos; Alyssa C,35,0,60,25
1708248176122,BENG 189,A00,389303,Contijoch; Francisco,26,0,30,4
1708248176650,BENG 193,A00,389328,Engler; Adam J.,0,0,0,0
1708248177179,BENG 196,A00,436038,Engler; Adam J.,9999,0,9999,0
1708248177705,BENG 197,A00,436081,Engler; Adam J.,9999,0,9999,0
1708248178232,BENG 203,A00,389385,Bafna; Vineet & Zhong; Sheng,20,0,20,0
1708248178758,BENG 207,A00,389386,Kwon; Ester Jihae,10,0,40,30
1708248178758,BENG 207,B00,389400,Taylor Amos; Alyssa C,8,0,30,22
1708248178758,BENG 207,C00,389432,Khojah; Reem I,20,0,40,20
1708248179285,BENG 209,A00,389456,Scholtes Acevedo; Claire,30,0,30,0
1708248179815,BENG 213,A00,389496,Palsson; Bernhard O.,16,0,20,4
1708248180873,BENG 224,A00,389515,Staff,0,0,0,0
1708248181404,BENG 226,A01,479043,Schmid-Schoenbein; Geert W,7,0,30,23
1708248181933,BENG 227,A00,389591,Fraley; Stephanie I.,56,0,120,64
1708248182459,BENG 230C,A00,389810,Mc Culloch; Andrew Douglas,43,0,90,47
1708248182985,BENG 232,A01,390161,Sah; Robert Lie-Yuan,6,0,50,44
1708248183510,BENG 233,A00,390290,Shah; Sameer B,33,0,50,17
1708248184037,BENG 234,A00,390291,Silva; Gabriel,21,0,56,35
1708248184582,BENG 235,A00,390318,Bintu; Bogdan,16,0,40,24
1708248185107,BENG 276,A00,390357,Mc Culloch; Andrew Douglas & Amaro; Rommie E,0,0,0,0
1708248185636,BENG 280C,A01,390443,McVeigh; Elliot R.,45,0,56,11
1708248186165,BENG 281,A00,390444,Kravets; Vira V.,50,0,110,60
1708248186689,BENG 283,A00,390445,Komives; Elizabeth A,4,0,4,0
1708248187216,BENG 292,A01,390623,Ross; Camille,20,0,20,0
1708248187741,BENG 294C,A00,390709,Engler; Adam J.,17,0,20,3
1708248188270,BENG 295,A00,436300,Watson; John Thomas,9999,0,9999,0
1708248188798,BGGN 205,A00,423656,Daugherty; Matthew Dorton,47,0,60,13
1708248189323,BGGN 207,A01,423703,Ross; Camille,0,0,0,0
1708248189849,BGGN 215,A00,423704,Petrie; Katherine Lynn,22,0,30,8
1708248190376,BGGN 216,A01,423855,Mueller; Liam O'Connor,37,0,50,13
1708248190901,BGGN 218,A00,423861,David; Michael,19,0,30,11
1708248191429,BGGN 223,A00,423862,Bier; Ethan,17,0,35,18
1708248191960,BGGN 230,A00,423863,Taylor; Susan S.,8,0,15,7
1708248192492,BGGN 232,A00,423864,Briggs; Steven & Troemel; Emily Ruth,25,0,30,5
1708248193021,BGGN 239,A01,424014,Kronenberg; Mitchell E.,30,0,30,0
1708248193546,BGGN 240,A01,424016,Juavinett; Ashley Lauren,0,0,6,6
1708248194075,BGGN 248,A00,424017,Halpain; Shelley,26,0,30,4
1708248194601,BGGN 249C,A00,424052,Staff,33,0,33,0
1708248195131,BGGN 250,A01,424091,Zou; Yimin,7,0,8,1
1708248195662,BGGN 252,A01,424093,Sejnowski; Terrence J,4,0,6,2
1708248196188,BGGN 255,A00,424094,Root; Cory Matthew,29,0,30,1
1708248196716,BGGN 262,A01,424096,Villa Rodriguez; Elizabeth,30,0,30,0
1708248197243,BGGN 267,A01,424099,Benna; Marcus K & Aljadeff; Johnatan,5,0,6,1
1708248197772,BGGN 270,A00,477483,Juavinett; Ashley Lauren,67,0,75,8
1708248198419,BGGN 271,001,481745,Ackerman; Susan,9998,0,9999,1
1708248198419,BGGN 271,002,481746,Akbari; Omar Sultan,9999,0,9999,0
1708248198419,BGGN 271,003,481747,Allen; Nicola J,9999,0,9999,0
1708248198419,BGGN 271,004,481748,Banegas; Matthew Patrick,9999,0,9999,0
1708248198419,BGGN 271,005,481749,Breen; Ellen C.,9998,0,9999,1
1708248198419,BGGN 271,006,481750,Briggs; Steven,9998,0,9999,1
1708248198419,BGGN 271,007,481751,Bui; Jack D,9999,0,9999,0
1708248198419,BGGN 271,008,481762,Busch; Wolfgang,9999,0,9999,0
1708248198419,BGGN 271,009,481763,Castle; Michael James,9999,0,9999,0
1708248198419,BGGN 271,010,481764,Chang; John Tzu-yu,9999,0,9999,0
1708248198419,BGGN 271,011,481765,Chen; Ju,9998,0,9999,1
1708248198419,BGGN 271,012,481766,Chen; Xu,9999,0,9999,0
1708248198419,BGGN 271,013,481767,Cheng; Christine Shiang-Ling,9999,0,9999,0
1708248198419,BGGN 271,014,481768,Cherqui; Stephanie,9999,0,9999,0
1708248198419,BGGN 271,015,481769,Cho; Yoshitake,9999,0,9999,0
1708248198419,BGGN 271,016,481770,Church; Kellie Breen,9998,0,9999,1
1708248198419,BGGN 271,017,481771,Cleland; Elsa Eleanor,9999,0,9999,0
1708248198419,BGGN 271,018,481779,Cohen; Shiran,9998,0,9999,1
1708248198419,BGGN 271,019,481814,Cook-Andersen; Heidi Leigh,9999,0,9999,0
1708248198419,BGGN 271,020,481815,Cooke; James Edward,9999,0,9999,0
1708248198419,BGGN 271,021,481816,Coufal; Nicole Gabriele,9998,0,9999,1
1708248198419,BGGN 271,022,481818,Crotty Alexander; Laura E,9999,0,9999,0
1708248198419,BGGN 271,023,481819,Daugherty; Matthew Dorton,9998,0,9999,1
1708248198419,BGGN 271,024,481820,De Guglielmo; Giordano,9998,0,9999,1
1708248198419,BGGN 271,025,481821,Doherty; Taylor Alan,9998,0,9999,1
1708248198419,BGGN 271,026,481822,Dulawa; Stephanie Carole,9999,0,9999,0
1708248198419,BGGN 271,027,481823,Esko; Jeffrey D.,9998,0,9999,1
1708248198419,BGGN 271,028,481824,Feldstein; Ariel E,9998,0,9999,1
1708248198419,BGGN 271,029,481825,Friedman; Rick Adam,9999,0,9999,0
1708248198419,BGGN 271,030,481826,Furnari; Frank,9999,0,9999,0
1708248198419,BGGN 271,031,481829,Ghosh; Pradipta,9998,0,9999,1
1708248198419,BGGN 271,032,481830,Gleeson; Joseph Gerard,9999,0,9999,0
1708248198419,BGGN 271,033,481831,Golden; Susan S.,9998,0,9999,1
1708248198419,BGGN 271,034,481832,Goren; Alon M,9998,0,9999,1
1708248198419,BGGN 271,035,481834,Gustafsson; Asa Birgitta,9999,0,9999,0
1708248198419,BGGN 271,036,481836,Hamdoun; Amr,9999,0,9999,0
1708248198419,BGGN 271,037,481837,Hao; Nan,9999,0,9999,0
1708248198419,BGGN 271,038,481840,Holway; David A.,9998,0,9999,1
1708248198419,BGGN 271,039,481841,Huffaker; Alisa,9998,0,9999,1
1708248198419,BGGN 271,040,481843,Sebat; Lilia Mikhailovna,9998,0,9999,1
1708248198419,BGGN 271,041,481889,Ideker; Trey,9999,0,9999,0
1708248198419,BGGN 271,042,481890,Jiang; Qingfei,9998,0,9999,1
1708248198419,BGGN 271,043,482311,Jin; Yishi,9999,0,9999,0
1708248198419,BGGN 271,044,482334,Joiner; William J.,9999,0,9999,0
1708248198419,BGGN 271,045,482353,Kaech; Susan Michelle,9998,0,9999,1
1708248198419,BGGN 271,046,482378,Karin; Michael,9999,0,9999,0
1708248198419,BGGN 271,047,482379,Kleinfeld; David,9999,0,9999,0
1708248198419,BGGN 271,048,482413,Koffler; Yacov,9999,0,9999,0
1708248198419,BGGN 271,049,482414,Komiyama; Takaki,9999,0,9999,0
1708248198419,BGGN 271,050,482415,Kryazhimskiy; Sergey A,9999,0,9999,0
1708248198419,BGGN 271,051,482416,Lawson; Mark Andrew,9999,0,9999,0
1708248198419,BGGN 271,052,482417,Lee; Yun Sok,9999,0,9999,0
1708248198419,BGGN 271,053,482451,Leutgeb; Stefan,9998,0,9999,1
1708248198419,BGGN 271,054,482452,Lo; Stanley M.,9999,0,9999,0
1708248198419,BGGN 271,055,482453,Lu; Pengzhe,9998,0,9999,1
1708248198419,BGGN 271,056,482454,Lykke-Andersen; Jens,9998,0,9999,1
1708248198419,BGGN 271,057,482456,McDonnell; Lisa Marie,9999,0,9999,0
1708248198419,BGGN 271,058,482461,McHugh; Colleen A,9998,0,9999,1
1708248198419,BGGN 271,059,482478,Meharena; Hiruy Sibhatu,9999,0,9999,0
1708248198419,BGGN 271,060,482497,Morris; Gerald P,9999,0,9999,0
1708248198419,BGGN 271,061,482499,Mukamel; Eran A,9998,0,9999,1
1708248198419,BGGN 271,062,482535,Muotri; Alysson,9999,0,9999,0
1708248198419,BGGN 271,063,482551,Muroyama; Andrew David,9999,0,9999,0
1708248198419,BGGN 271,064,482552,Neal; Sonya E,9999,0,9999,0
1708248198419,BGGN 271,065,482618,Nieh; James Charles,9999,0,9999,0
1708248198419,BGGN 271,066,482619,O'Donoghue; Anthony John,9999,0,9999,0
1708248198419,BGGN 271,067,482626,Pantham; Priyadarshini,9999,0,9999,0
1708248198419,BGGN 271,068,482633,Parast; Mana,9999,0,9999,0
1708248198419,BGGN 271,069,482634,Perry; Michael William,9999,0,9999,0
1708248198419,BGGN 271,070,482639,Pride; David Tevis,9999,0,9999,0
1708248198419,BGGN 271,071,482645,Pruneda-Paz; Jose L.,9999,0,9999,0
1708248198419,BGGN 271,072,482648,Rana; Tariq,9999,0,9999,0
1708248198419,BGGN 271,073,482650,Risbrough; Victoria Blythe,9999,0,9999,0
1708248198419,BGGN 271,074,482655,Rissman; Robert Andrew,9999,0,9999,0
1708248198419,BGGN 271,075,482656,Rosenfeld; Michael G,9999,0,9999,0
1708248198419,BGGN 271,076,482657,Saier; Milton H.,9999,0,9999,0
1708248198419,BGGN 271,077,482663,Sander; Maike,9999,0,9999,0
1708248198419,BGGN 271,078,482664,Schenk; Simon,9999,0,9999,0
1708248198419,BGGN 271,079,482665,Schoeneberg; Johannes,9998,0,9999,1
1708248198419,BGGN 271,080,482666,Schroeder; Julian I,9998,0,9999,1
1708248198419,BGGN 271,081,482667,Shaner; Nathan C.,9999,0,9999,0
1708248198419,BGGN 271,082,482668,Sheikh; Farah,9999,0,9999,0
1708248198419,BGGN 271,083,482669,Shurin; Jonathan,9999,0,9999,0
1708248198419,BGGN 271,084,482675,Sigurdson; Christina,9999,0,9999,0
1708248198419,BGGN 271,085,482676,Smith; David M.,9999,0,9999,0
1708248198419,BGGN 271,086,482677,Steinmetz; Nicole F,9999,0,9999,0
1708248198419,BGGN 271,087,482692,Su; Chih-Ying,9999,0,9999,0
1708248198419,BGGN 271,088,482694,Suel; Gurol Mehmet,9999,0,9999,0
1708248198419,BGGN 271,089,482695,Telese; Francesca,9999,0,9999,0
1708248198419,BGGN 271,090,482745,Thackray; Varykina G.,9999,0,9999,0
1708248198419,BGGN 271,091,482746,Towers; Christina Garlingt,9999,0,9999,0
1708248198419,BGGN 271,092,482747,Troemel; Emily Ruth,9997,0,9999,2
1708248198419,BGGN 271,093,482748,Tye; Kay M,9999,0,9999,0
1708248198419,BGGN 271,094,482749,Valdez-Jasso; Daniela,9998,0,9999,1
1708248198419,BGGN 271,095,482750,Wahlin; Karl Jonas,9997,0,9999,2
1708248198419,BGGN 271,096,482751,Welsbie; Derek,9999,0,9999,0
1708248198419,BGGN 271,097,482752,Wilkinson; Miles Frome,9999,0,9999,0
1708248198419,BGGN 271,098,482754,Yaksh; Tony L.,9999,0,9999,0
1708248198419,BGGN 271,099,482760,Yang; Jing,9999,0,9999,0
1708248198419,BGGN 271,100,482761,Yeo; Eugene Wei-Ming,9998,0,9999,1
1708248198419,BGGN 271,101,482763,Ying; Wei,9999,0,9999,0
1708248198419,BGGN 271,102,482764,Zarrinpar; Amir,9999,0,9999,0
1708248198419,BGGN 271,103,482765,Zengler; Karsten B,9999,0,9999,0
1708248198419,BGGN 271,104,482766,Zhang; Dong-Er,9999,0,9999,0
1708248198419,BGGN 271,105,482768,Zhao; Yunde,9999,0,9999,0
1708248198419,BGGN 271,106,482776,Zheng; Binhai,9999,0,9999,0
1708248198419,BGGN 271,107,482777,Zheng; Ye,9998,0,9999,1
1708248198419,BGGN 271,108,482806,Zuniga; Elina I,9999,0,9999,0
1708248198945,BGGN 273,A01,424101,Mueller; Liam O'Connor,43,0,50,7
1708248200493,BGGN 280,A00,424102,Ernst; Andreas,3,0,5,2
1708248200493,BGGN 280,C00,481361,Amaro; Rommie E,2,0,5,3
1708248201020,BGGN 281,A00,424103,Desai; Arshad & Oegema; Karen,0,0,5,5
1708248201548,BGGN 283,A00,424104,Rivera; Fabian Chavez,0,0,5,5
1708248201548,BGGN 283,B00,424105,Russell; Alistair B,4,0,5,1
1708248201548,BGGN 283,D00,424107,Wildonger; Jill Cathleen,1,0,5,4
1708248202074,BGGN 284,A00,424108,Glasgow; Stacey Marie,2,0,5,3
1708248202605,BGGN 285,A00,424109,Chisholm; Andrew D.,1,0,5,4
1708248202605,BGGN 285,B00,424110,Farley; Emma Kristen,2,0,5,3
1708248203130,BGGN 295,A00,424120,Tour; Ella,10,0,30,20
1708248203655,BGJC 204,A00,424138,Lu; Li-Fan & Chang; John Tzu-yu,9998,0,9999,1
1708248204180,BGJC 215,A00,424139,Cooke; James Edward & Lo; Stanley M.,10,0,10,0
1708248204966,BGRD 200,001,485528,Ackerman; Susan,9998,0,9999,1
1708248204966,BGRD 200,002,485529,Akbari; Omar Sultan,9999,0,9999,0
1708248204966,BGRD 200,003,485530,Allen; Eric,9999,0,9999,0
1708248204966,BGRD 200,004,485531,Allen; Nicola J,9999,0,9999,0
1708248204966,BGRD 200,005,485533,Amaro; Rommie E,9999,0,9999,0
1708248204966,BGRD 200,006,485535,Augustine; Vineet,9999,0,9999,0
1708248204966,BGRD 200,007,485536,Ayres; Janelle Samantha,9999,0,9999,0
1708248204966,BGRD 200,008,485538,Banegas; Matthew Patrick,9999,0,9999,0
1708248204966,BGRD 200,009,485539,Banghart; Matthew Ryan,9999,0,9999,0
1708248204966,BGRD 200,010,485542,Benna; Marcus K,9999,0,9999,0
1708248204966,BGRD 200,011,485543,Bennett; Eric J,9999,0,9999,0
1708248204966,BGRD 200,012,485545,Bloodgood; Brenda Laurie,9999,0,9999,0
1708248204966,BGRD 200,013,485546,Breen; Ellen C.,9998,0,9999,1
1708248204966,BGRD 200,014,485548,Briggs; Steven,9998,0,9999,1
1708248204966,BGRD 200,015,485549,Bui; Jack D,9999,0,9999,0
1708248204966,BGRD 200,016,485552,Busch; Wolfgang,9999,0,9999,0
1708248204966,BGRD 200,017,485621,Callaway; Edward M,9999,0,9999,0
1708248204966,BGRD 200,018,485622,Castle; Michael James,9999,0,9999,0
1708248204966,BGRD 200,019,485623,Chaim; Isaac,9999,0,9999,0
1708248204966,BGRD 200,020,485624,Chang; John Tzu-yu,9999,0,9999,0
1708248204966,BGRD 200,021,485625,Chen; Ju,9999,0,9999,0
1708248204966,BGRD 200,022,485626,Chen; Xu,9999,0,9999,0
1708248204966,BGRD 200,023,485627,Cheng; Christine Shiang-Ling,9999,0,9999,0
1708248204966,BGRD 200,024,485632,Cherqui; Stephanie,9999,0,9999,0
1708248204966,BGRD 200,025,485633,Cho; Yoshitake,9999,0,9999,0
1708248204966,BGRD 200,026,485634,Church; Kellie Breen,9999,0,9999,0
1708248204966,BGRD 200,027,485635,Cleland; Elsa Eleanor,9999,0,9999,0
1708248204966,BGRD 200,028,485636,Cohen; Shiran,9998,0,9999,1
1708248204966,BGRD 200,029,485639,Cook-Andersen; Heidi Leigh,9999,0,9999,0
1708248204966,BGRD 200,030,485686,Cooke; James Edward,9999,0,9999,0
1708248204966,BGRD 200,031,485688,Cooper; Kimberly Lynn,9999,0,9999,0
1708248204966,BGRD 200,032,485689,Coufal; Nicole Gabriele,9998,0,9999,1
1708248204966,BGRD 200,033,485690,Crotty Alexander; Laura E,9999,0,9999,0
1708248204966,BGRD 200,034,485691,Staff,9999,0,9999,0
1708248204966,BGRD 200,035,485692,De Guglielmo; Giordano,9999,0,9999,0
1708248204966,BGRD 200,036,485693,De Silva; Shermin,9999,0,9999,0
1708248204966,BGRD 200,037,485694,Desai; Arshad,9999,0,9999,0
1708248204966,BGRD 200,038,485695,Dickinson; Alexandra Jazz,9999,0,9999,0
1708248204966,BGRD 200,039,485717,Doherty; Taylor Alan,9998,0,9999,1
1708248204966,BGRD 200,040,485720,Dulawa; Stephanie Carole,9999,0,9999,0
1708248204966,BGRD 200,041,485721,Ecker; Joseph R,9999,0,9999,0
1708248204966,BGRD 200,042,485760,Engle; Dannielle D,9999,0,9999,0
1708248204966,BGRD 200,043,485761,Ernst; Andreas,9998,0,9999,1
1708248204966,BGRD 200,044,485766,Esko; Jeffrey D.,9998,0,9999,1
1708248204966,BGRD 200,045,485905,Evans; Ronald M,9999,0,9999,0
1708248204966,BGRD 200,046,485907,Staff,9999,0,9999,0
1708248204966,BGRD 200,047,485918,Feldstein; Ariel E,9998,0,9999,1
1708248204966,BGRD 200,048,485938,Friedman; Rick Adam,9999,0,9999,0
1708248204966,BGRD 200,049,485986,Furnari; Frank,9999,0,9999,0
1708248204966,BGRD 200,050,486018,Gage; Fred H,9999,0,9999,0
1708248204966,BGRD 200,051,486139,George; Monique Leana,9999,0,9999,0
1708248204966,BGRD 200,052,486140,Ghosh; Pradipta,9998,0,9999,1
1708248204966,BGRD 200,053,486141,Glass; Christopher,9998,0,9999,1
1708248204966,BGRD 200,054,486142,Gleeson; Joseph Gerard,9999,0,9999,0
1708248204966,BGRD 200,055,486143,Golden; Susan S.,9999,0,9999,0
1708248204966,BGRD 200,056,486144,Goldrath; Ananda,9999,0,9999,0
1708248204966,BGRD 200,057,486145,Goren; Alon M,9998,0,9999,1
1708248204966,BGRD 200,058,486146,Gustafsson; Asa Birgitta,9999,0,9999,0
1708248204966,BGRD 200,059,486164,Gutkind; Jorge Silvio,9999,0,9999,0
1708248204966,BGRD 200,060,486203,Hamdoun; Amr,9999,0,9999,0
1708248204966,BGRD 200,061,486204,Hampton; Randolph Y.,9999,0,9999,0
1708248204966,BGRD 200,062,486205,Hao; Nan,9999,0,9999,0
1708248204966,BGRD 200,063,486206,Staff,9999,0,9999,0
1708248204966,BGRD 200,064,486207,Hasty; Jeff M,9999,0,9999,0
1708248204966,BGRD 200,065,486208,Hollern; Daniel Patrick,9999,0,9999,0
1708248204966,BGRD 200,066,486209,Holway; David A.,9997,0,9999,2
1708248204966,BGRD 200,067,486214,Huffaker; Alisa,9998,0,9999,1
1708248204966,BGRD 200,068,486215,Hui; Enfu,9999,0,9999,0
1708248204966,BGRD 200,069,486216,Hwa; Terence T.,9999,0,9999,0
1708248204966,BGRD 200,070,486217,Sebat; Lilia Mikhailovna,9998,0,9999,1
1708248204966,BGRD 200,071,486218,Ideker; Trey,9999,0,9999,0
1708248204966,BGRD 200,072,486219,Jackrel; Sara,9998,0,9999,1
1708248204966,BGRD 200,073,486224,Jiang; Qingfei,9998,0,9999,1
1708248204966,BGRD 200,074,486225,Jin; Yishi,9999,0,9999,0
1708248204966,BGRD 200,075,486226,Joiner; William J.,9999,0,9999,0
1708248204966,BGRD 200,076,486227,Jun; Suckjoon,9999,0,9999,0
1708248204966,BGRD 200,077,486228,Kadonaga; James T,9998,0,9999,1
1708248204966,BGRD 200,078,486229,Kaech; Susan Michelle,9997,0,9999,2
1708248204966,BGRD 200,079,486237,Karin; Michael,9999,0,9999,0
1708248204966,BGRD 200,080,486238,Kleinfeld; David,9999,0,9999,0
1708248204966,BGRD 200,081,486239,Knight; Robin,9999,0,9999,0
1708248204966,BGRD 200,082,486335,Koffler; Yacov,9999,0,9999,0
1708248204966,BGRD 200,083,486336,Komiyama; Takaki,9999,0,9999,0
1708248204966,BGRD 200,084,486337,Kosuri; Pallav,9999,0,9999,0
1708248204966,BGRD 200,085,486353,Kryazhimskiy; Sergey A,9999,0,9999,0
1708248204966,BGRD 200,086,486354,Kurle; Carolyn M.,9999,0,9999,0
1708248204966,BGRD 200,087,486355,Law; Julie A,9999,0,9999,0
1708248204966,BGRD 200,088,486356,Lawson; Mark Andrew,9999,0,9999,0
1708248204966,BGRD 200,089,486357,Lee; Kuo Fen,9999,0,9999,0
1708248204966,BGRD 200,090,486376,Lee; Yun Sok,9999,0,9999,0
1708248204966,BGRD 200,091,486413,Leutgeb; Jill K.,9999,0,9999,0
1708248204966,BGRD 200,092,486414,Leutgeb; Stefan,9998,0,9999,1
1708248204966,BGRD 200,093,486415,Lim; Byungkook,9999,0,9999,0
1708248204966,BGRD 200,094,486419,Lo; Stanley M.,9999,0,9999,0
1708248204966,BGRD 200,095,486420,Looger; Loren Lee,9999,0,9999,0
1708248204966,BGRD 200,096,486422,Lovett-Barron; Matthew Rod,9999,0,9999,0
1708248204966,BGRD 200,097,486423,Lu; Li-Fan,9998,0,9999,1
1708248204966,BGRD 200,098,486424,Lu; Pengzhe,9998,0,9999,1
1708248204966,BGRD 200,099,486425,Lykke-Andersen; Jens,9998,0,9999,1
1708248204966,BGRD 200,100,486426,Lyumkis; Dmitry Evgenievich,9999,0,9999,0
1708248204966,BGRD 200,101,486427,Madigan; Cressida Ariana,9999,0,9999,0
1708248204966,BGRD 200,102,486428,Staff,9999,0,9999,0
1708248204966,BGRD 200,103,486429,Mayfield; Stephen P.,9998,0,9999,1
1708248204966,BGRD 200,104,486430,McDonnell; Lisa Marie,9999,0,9999,0
1708248204966,BGRD 200,105,486620,McHugh; Colleen A,9998,0,9999,1
1708248204966,BGRD 200,106,486621,Meharena; Hiruy Sibhatu,9999,0,9999,0
1708248204966,BGRD 200,107,486622,Staff,9999,0,9999,0
1708248204966,BGRD 200,108,486681,Morris; Gerald P,9999,0,9999,0
1708248204966,BGRD 200,109,486682,Mukamel; Eran A,9998,0,9999,1
1708248204966,BGRD 200,110,486683,Muotri; Alysson,9999,0,9999,0
1708248204966,BGRD 200,111,486684,Muroyama; Andrew David,9999,0,9999,0
1708248204966,BGRD 200,112,486687,Murre; Cornelis,9999,0,9999,0
1708248204966,BGRD 200,113,486691,Neal; Sonya E,9999,0,9999,0
1708248204966,BGRD 200,114,486692,Nieh; James Charles,9998,0,9999,1
1708248204966,BGRD 200,115,486693,Nimmerjahn; Axel,9999,0,9999,0
1708248204966,BGRD 200,116,486694,Nizet; Victor F.,9999,0,9999,0
1708248204966,BGRD 200,117,486695,O'Donoghue; Anthony John,9999,0,9999,0
1708248204966,BGRD 200,118,486706,Oegema; Karen,9999,0,9999,0
1708248204966,BGRD 200,119,486708,O'Shea; Clodagh,9999,0,9999,0
1708248204966,BGRD 200,120,486709,Pantham; Priyadarshini,9999,0,9999,0
1708248204966,BGRD 200,121,486715,Parast; Mana,9999,0,9999,0
1708248204966,BGRD 200,122,486716,Pasquinelli; Amy,9998,0,9999,1
1708248204966,BGRD 200,123,486718,Pekkurnaz Banghart; Gulcin,9999,0,9999,0
1708248204966,BGRD 200,124,486720,Perry; Michael William,9999,0,9999,0
1708248204966,BGRD 200,125,486721,Pfaff; Samuel,9999,0,9999,0
1708248204966,BGRD 200,126,486723,Pogliano; Joseph,9999,0,9999,0
1708248204966,BGRD 200,127,486724,Pogliano; Kit J.,9999,0,9999,0
1708248204966,BGRD 200,128,486727,Pride; David Tevis,9999,0,9999,0
1708248204966,BGRD 200,129,486728,Pruneda-Paz; Jose L.,9999,0,9999,0
1708248204966,BGRD 200,130,486733,Staff,9999,0,9999,0
1708248204966,BGRD 200,131,486734,Rana; Tariq,9999,0,9999,0
1708248204966,BGRD 200,132,486736,Reck-Peterson; Samara L,9999,0,9999,0
1708248204966,BGRD 200,133,486738,Rennison; Diana,9999,0,9999,0
1708248204966,BGRD 200,134,486741,Rifkin; Scott,9999,0,9999,0
1708248204966,BGRD 200,135,486743,Risbrough; Victoria Blythe,9999,0,9999,0
1708248204966,BGRD 200,136,486749,Rissman; Robert Andrew,9999,0,9999,0
1708248204966,BGRD 200,137,486750,Rivera; Fabian Chavez,9999,0,9999,0
1708248204966,BGRD 200,138,486753,Root; Cory Matthew,9999,0,9999,0
1708248204966,BGRD 200,139,486760,Rosenfeld; Michael G,9998,0,9999,1
1708248204966,BGRD 200,140,486763,Russell; Alistair B,9999,0,9999,0
1708248204966,BGRD 200,141,486766,Saier; Milton H.,9999,0,9999,0
1708248204966,BGRD 200,142,486768,Sander; Maike,9999,0,9999,0
1708248204966,BGRD 200,143,486770,Saphire; Erica Ollmann,9999,0,9999,0
1708248204966,BGRD 200,144,486771,Schenk; Simon,9999,0,9999,0
1708248204966,BGRD 200,145,486774,Schoeneberg; Johannes,9999,0,9999,0
1708248204966,BGRD 200,146,486777,Schroeder; Julian I,9998,0,9999,1
1708248204966,BGRD 200,147,486783,Shah; Sameer B,9999,0,9999,0
1708248204966,BGRD 200,148,486784,Shaner; Nathan C.,9999,0,9999,0
1708248204966,BGRD 200,149,486785,Shaw; Reuben,9999,0,9999,0
1708248204966,BGRD 200,150,486786,Sheikh; Farah,9999,0,9999,0
1708248204966,BGRD 200,151,486787,Staff,9999,0,9999,0
1708248204966,BGRD 200,152,486788,Signer; Robert,9999,0,9999,0
1708248204966,BGRD 200,153,486789,Sigurdson; Christina,9999,0,9999,0
1708248204966,BGRD 200,154,486790,Smith; David M.,9999,0,9999,0
1708248204966,BGRD 200,155,486791,Soncin; Francesca,9999,0,9999,0
1708248204966,BGRD 200,156,486792,Steinmetz; Nicole F,9999,0,9999,0
1708248204966,BGRD 200,157,486793,Su; Chih-Ying,9999,0,9999,0
1708248204966,BGRD 200,158,486794,Suel; Gurol Mehmet,9999,0,9999,0
1708248204966,BGRD 200,159,486795,Sun; Xin,9999,0,9999,0
1708248204966,BGRD 200,160,486796,Telese; Francesca,9999,0,9999,0
1708248204966,BGRD 200,161,486797,Thackray; Varykina G.,9999,0,9999,0
1708248204966,BGRD 200,162,486798,Towers; Christina Garlingt,9999,0,9999,0
1708248204966,BGRD 200,163,486799,Traver; David,9999,0,9999,0
1708248204966,BGRD 200,164,486800,Troemel; Emily Ruth,9998,0,9999,1
1708248204966,BGRD 200,165,486801,Tye; Kay M,9999,0,9999,0
1708248204966,BGRD 200,166,486802,Valdez-Jasso; Daniela,9998,0,9999,1
1708248204966,BGRD 200,167,486803,Vijayanand; Pandurangan,9999,0,9999,0
1708248204966,BGRD 200,168,486804,Villa Rodriguez; Elizabeth,9999,0,9999,0
1708248204966,BGRD 200,169,486805,Wahlin; Karl Jonas,9997,0,9999,2
1708248204966,BGRD 200,170,486806,Wang; Jean Yin Jen,9999,0,9999,0
1708248204966,BGRD 200,171,486807,Welsbie; Derek,9999,0,9999,0
1708248204966,BGRD 200,172,486808,Wildonger; Jill Cathleen,9998,0,9999,1
1708248204966,BGRD 200,173,486809,Wilkinson; Miles Frome,9999,0,9999,0
1708248204966,BGRD 200,174,486810,Winzeler; Elizabeth A,9999,0,9999,0
1708248204966,BGRD 200,175,486811,Yaksh; Tony L.,9999,0,9999,0
1708248204966,BGRD 200,176,486812,Yang; Jing,9999,0,9999,0
1708248204966,BGRD 200,177,486813,Staff,9999,0,9999,0
1708248204966,BGRD 200,178,486814,Yeo; Eugene Wei-Ming,9998,0,9999,1
1708248204966,BGRD 200,179,486815,Ying; Wei,9999,0,9999,0
1708248204966,BGRD 200,180,486816,Zarrinpar; Amir,9999,0,9999,0
1708248204966,BGRD 200,181,486817,Zengler; Karsten B,9999,0,9999,0
1708248204966,BGRD 200,182,486818,Zhang; Dong-Er,9999,0,9999,0
1708248204966,BGRD 200,183,486819,Zhao; Yunde,9999,0,9999,0
1708248204966,BGRD 200,184,486820,Zheng; Binhai,9999,0,9999,0
1708248204966,BGRD 200,185,486821,Zheng; Ye,9998,0,9999,1
1708248204966,BGRD 200,186,486822,Zuniga; Elina I,9999,0,9999,0
1708248205491,BGSE 200,A00,424140,Tour; Ella & Petrie; Katherine Lynn,9995,0,9999,4
1708248206018,BGSE 205,A00,424177,Bennett; Eric J,49,0,50,1
1708248206018,BGSE 205,B00,424179,Bennett; Eric J,48,0,50,2
1708248206018,BGSE 205,C00,424182,Bennett; Eric J,47,0,50,3
1708248206018,BGSE 205,D00,424184,Bennett; Eric J,46,0,50,4
1708248206018,BGSE 205,E00,424185,Bennett; Eric J,50,0,50,0
1708248206548,BIBC 100,A01,425401,Corbett; Kevin Daniel,150,0,158,8
1708248206548,BIBC 100,B01,477769,Amaro; Rommie E,156,0,158,2
1708248207099,BIBC 102,A01,425425,Bozinovic; Goran,255,0,256,1
1708248207099,BIBC 102,B01,425440,Hampton; Randolph Y.,250,0,256,6
1708248207099,BIBC 102,C01,486849,Flagg; Matthew Paul,63,0,120,57
1708248207659,BIBC 103,A01,425476,Grossman; Emily N,17,0,24,7
1708248207659,BIBC 103,A02,425509,Grossman; Emily N,21,0,24,3
1708248207659,BIBC 103,A03,425530,Grossman; Emily N,18,0,24,6
1708248207659,BIBC 103,A04,425536,Grossman; Emily N,22,0,24,2
1708248207659,BIBC 103,B01,425538,Boumechache; Miyyada,20,0,24,4
1708248207659,BIBC 103,B02,425539,Boumechache; Miyyada,24,0,24,0
1708248207659,BIBC 103,B03,425548,Boumechache; Miyyada,24,0,24,0
1708248207659,BIBC 103,B04,425549,Boumechache; Miyyada,24,0,24,0
1708248208217,BIBC 120,A01,425592,Coleman; Aaron B.,242,0,256,14
1708248208780,BIBC 194,A00,425609,Ernst; Andreas,21,0,27,6
1708248208780,BIBC 194,B00,477632,Saier; Milton H.,26,0,27,1
1708248208780,BIBC 194,C00,481360,Amaro; Rommie E,23,0,27,4
1708248208780,BIBC 194,D00,486852,Flagg; Matthew Paul,21,0,32,11
1708248209356,BICD 100,A01,470377,Troemel; Emily Ruth,127,0,128,1
1708248209356,BICD 100,A02,470378,Troemel; Emily Ruth,126,0,128,2
1708248209356,BICD 100,B01,470409,Reinagel; Pam,59,0,64,5
1708248209356,BICD 100,B02,470413,Reinagel; Pam,62,0,64,2
1708248209356,BICD 100,B03,470464,Reinagel; Pam,64,0,64,0
1708248209356,BICD 100,B04,470468,Reinagel; Pam,63,0,64,1
1708248209356,BICD 100,C01,470469,Beyhan; Sinem,51,0,64,13
1708248209356,BICD 100,C02,470605,Beyhan; Sinem,58,0,64,6
1708248209356,BICD 100,C03,470606,Beyhan; Sinem,60,0,64,4
1708248209356,BICD 100,C04,470607,Beyhan; Sinem,63,0,64,1
1708248209356,BICD 100,D01,477465,Nguyen; Vu Quang,158,0,160,2
1708248210912,BICD 100R,A01,425674,Smith; Laurie,29,0,34,5
1708248210912,BICD 100R,A02,425675,Smith; Laurie,30,0,34,4
1708248210912,BICD 100R,A03,425676,Smith; Laurie,30,0,34,4
1708248211440,BICD 104,A01,425696,Greenspan; Ralph J.,60,0,64,4
1708248211982,BICD 110,A01,470608,Muroyama; Andrew David,264,0,275,11
1708248211982,BICD 110,B01,425721,Ernst; Andreas,246,0,275,29
1708248212525,BICD 112,A01,458177,Cooper; Kimberly Lynn & Traver; David,10,0,32,22
1708248212525,BICD 112,A02,458180,Cooper; Kimberly Lynn & Traver; David,28,0,32,4
1708248213054,BICD 123,A01,425725,Zhao; Yunde,24,0,32,8
1708248213581,BICD 140,A01,425728,Lu; Li-Fan,228,0,240,12
1708248214110,BICD 158,A01,425730,Bier; Ethan,136,0,145,9
1708248214638,BICD 194,A00,425731,Desai; Arshad & Oegema; Karen,18,0,27,9
1708248214638,BICD 194,B00,481735,Wilhelm; James E.,29,0,32,3
1708248215168,BIEB 121,A00,425732,Butler; Shannon Rhey,21,0,32,11
1708248215168,BIEB 121,B00,425733,Butler; Shannon Rhey,24,0,32,8
1708248215698,BIEB 130,A01,425735,Kurle; Carolyn M.,243,0,295,52
1708248216223,BIEB 146,A01,425737,Petrie; Katherine Lynn,366,0,395,29
1708248216749,BIEB 148,A01,470637,Rose; Noah Hartmann,59,0,63,4
1708248216749,BIEB 148,A02,470638,Rose; Noah Hartmann,61,0,63,2
1708248217275,BIEB 154,A01,458184,Stockwell; Sarah R,29,0,30,1
1708248217275,BIEB 154,A02,458186,Stockwell; Sarah R,29,0,30,1
1708248217800,BIEB 176,A01,425741,De Silva; Shermin,56,0,64,8
1708248218331,BIEB 182,A01,458194,Roy; Kaustuv,25,0,32,7
1708248218331,BIEB 182,A02,458215,Roy; Kaustuv,31,0,32,1
1708248218875,BILD 1,A01,424267,Patrick; Gentry,249,0,250,1
1708248218875,BILD 1,B01,424272,Burg; Michael,231,0,250,19
1708248218875,BILD 1,C01,424293,Pickett; Brooke Elizabeth,245,0,250,5
1708248218875,BILD 1,D01,458292,Gonzalez Gamboa; Ivonne,48,0,50,2
1708248218875,BILD 1,D02,458295,Gonzalez Gamboa; Ivonne,50,0,50,0
1708248218875,BILD 1,D03,458296,Gonzalez Gamboa; Ivonne,50,0,50,0
1708248218875,BILD 1,D04,458297,Gonzalez Gamboa; Ivonne,49,0,50,1
1708248218875,BILD 1,D05,458303,Gonzalez Gamboa; Ivonne,50,0,50,0
1708248219426,BILD 2,A01,458304,Reyes Gonzalez; Catalina,53,0,56,3
1708248219426,BILD 2,A02,458307,Reyes Gonzalez; Catalina,55,0,56,1
1708248219426,BILD 2,A03,458313,Reyes Gonzalez; Catalina,55,0,56,1
1708248219426,BILD 2,A04,458320,Reyes Gonzalez; Catalina,56,0,56,0
1708248219426,BILD 2,B01,458324,Reyes Gonzalez; Catalina,47,0,56,9
1708248219426,BILD 2,B02,458327,Reyes Gonzalez; Catalina,54,0,56,2
1708248219426,BILD 2,B03,458339,Reyes Gonzalez; Catalina,56,0,56,0
1708248219426,BILD 2,B04,458340,Reyes Gonzalez; Catalina,56,0,56,0
1708248219426,BILD 2,C01,458387,Park; Ji Young,44,0,49,5
1708248219426,BILD 2,C02,458544,Park; Ji Young,46,0,49,3
1708248219426,BILD 2,C03,458557,Park; Ji Young,47,0,49,2
1708248219426,BILD 2,C04,458563,Park; Ji Young,46,0,49,3
1708248219977,BILD 3,A01,424312,Hammond; LaTisha Marie,331,0,350,19
1708248219977,BILD 3,B01,470107,Stockwell; Sarah R,66,0,70,4
1708248219977,BILD 3,B02,470110,Stockwell; Sarah R,70,0,70,0
1708248219977,BILD 3,B03,470116,Stockwell; Sarah R,70,0,70,0
1708248219977,BILD 3,B04,470123,Stockwell; Sarah R,67,0,70,3
1708248219977,BILD 3,B05,470150,Stockwell; Sarah R,70,0,70,0
1708248219977,BILD 3,C01,470159,Cooper; Kimberly Lynn,67,0,70,3
1708248219977,BILD 3,C02,470160,Cooper; Kimberly Lynn,69,0,70,1
1708248219977,BILD 3,C03,470164,Cooper; Kimberly Lynn,70,0,70,0
1708248219977,BILD 3,C04,470165,Cooper; Kimberly Lynn,69,0,70,1
1708248219977,BILD 3,C05,470374,Cooper; Kimberly Lynn,68,0,70,2
1708248220521,BILD 4,A01,424318,Staff,22,0,24,2
1708248220521,BILD 4,A02,424324,Staff,24,0,24,0
1708248220521,BILD 4,A03,424325,Staff,24,0,24,0
1708248220521,BILD 4,A04,424326,Staff,22,0,24,2
1708248220521,BILD 4,A05,424327,Staff,24,0,24,0
1708248220521,BILD 4,A06,424330,Staff,24,0,24,0
1708248220521,BILD 4,A07,424331,Staff,24,0,24,0
1708248220521,BILD 4,A08,424342,Staff,24,0,24,0
1708248220521,BILD 4,B01,424462,Pickett; Brooke Elizabeth,23,0,24,1
1708248220521,BILD 4,B02,424466,Pickett; Brooke Elizabeth,24,0,24,0
1708248220521,BILD 4,B03,424469,Pickett; Brooke Elizabeth,23,0,24,1
1708248220521,BILD 4,B04,424470,Pickett; Brooke Elizabeth,22,0,24,2
1708248220521,BILD 4,B05,424700,Pickett; Brooke Elizabeth,23,0,24,1
1708248220521,BILD 4,B06,424723,Pickett; Brooke Elizabeth,24,0,24,0
1708248220521,BILD 4,B07,424730,Pickett; Brooke Elizabeth,24,0,24,0
1708248220521,BILD 4,B08,424929,Pickett; Brooke Elizabeth,22,0,24,2
1708248220521,BILD 4,C01,424947,Gonzalez Gamboa; Ivonne,22,0,24,2
1708248220521,BILD 4,C02,424951,Gonzalez Gamboa; Ivonne,23,0,24,1
1708248220521,BILD 4,C03,424991,Gonzalez Gamboa; Ivonne,23,0,24,1
1708248220521,BILD 4,C04,424993,Gonzalez Gamboa; Ivonne,24,0,24,0
1708248220521,BILD 4,C05,424994,Gonzalez Gamboa; Ivonne,24,0,24,0
1708248220521,BILD 4,C06,425209,Gonzalez Gamboa; Ivonne,24,0,24,0
1708248220521,BILD 4,C07,425233,Gonzalez Gamboa; Ivonne,24,0,24,0
1708248220521,BILD 4,C08,425247,Gonzalez Gamboa; Ivonne,24,0,24,0
1708248221069,BILD 60,A01,425326,Hammond; LaTisha Marie,62,0,64,2
1708248221594,BILD 83,A00,425347,Pogliano; Joseph,25,0,30,5
1708248222122,BILD 87,A00,425368,Saier; Milton H.,20,0,20,0
1708248222653,BIMM 100,A01,425744,Cooper; Andrew Michael,303,0,320,17
1708248222653,BIMM 100,B01,425746,Cooper; Andrew Michael,315,0,320,5
1708248223204,BIMM 101,A01,425748,McDonnell; Lisa Marie,8,0,24,16
1708248223204,BIMM 101,A02,425749,McDonnell; Lisa Marie,23,0,24,1
1708248223204,BIMM 101,B01,425751,Day; Christopher D,22,0,24,2
1708248223204,BIMM 101,B02,425752,Day; Christopher D,24,0,24,0
1708248223204,BIMM 101,B03,425753,Day; Christopher D,22,0,24,2
1708248223204,BIMM 101,B04,425754,Day; Christopher D,24,0,24,0
1708248223204,BIMM 101,C01,425756,Rusert; Jessica Marie,17,0,24,7
1708248223204,BIMM 101,C02,425757,Rusert; Jessica Marie,23,0,24,1
1708248223204,BIMM 101,C03,425758,Rusert; Jessica Marie,23,0,24,1
1708248223204,BIMM 101,C04,425759,Rusert; Jessica Marie,23,0,24,1
1708248223732,BIMM 110,A01,425764,Niwa; Maho,55,0,56,1
1708248223732,BIMM 110,A02,425765,Niwa; Maho,56,0,56,0
1708248223732,BIMM 110,A03,425766,Niwa; Maho,56,0,56,0
1708248223732,BIMM 110,A04,425767,Niwa; Maho,55,0,56,1
1708248224260,BIMM 116R,A01,425771,Golden; Susan S. & Gorman; Michael R.,55,0,72,17
1708248224260,BIMM 116R,A02,425772,Golden; Susan S. & Gorman; Michael R.,53,0,72,19
1708248224260,BIMM 116R,A03,425773,Golden; Susan S. & Gorman; Michael R.,66,0,72,6
1708248224260,BIMM 116R,A04,425774,Golden; Susan S. & Gorman; Michael R.,70,0,72,2
1708248224790,BIMM 118,A01,425779,David; Michael,83,0,96,13
1708248225318,BIMM 120,A01,425792,Pirino; Giorgia,203,0,216,13
1708248225318,BIMM 120,B01,470639,Saier; Milton H.,201,0,216,15
1708248225852,BIMM 121,A01,425830,Gustafson-Brown; Cindy,18,0,24,6
1708248225852,BIMM 121,A02,425831,Gustafson-Brown; Cindy,21,0,24,3
1708248225852,BIMM 121,A03,425832,Gustafson-Brown; Cindy,24,0,24,0
1708248225852,BIMM 121,A04,425833,Gustafson-Brown; Cindy,23,0,24,1
1708248225852,BIMM 121,B01,425835,Pirino; Giorgia,18,0,24,6
1708248225852,BIMM 121,B02,425836,Pirino; Giorgia,24,0,24,0
1708248225852,BIMM 121,C01,425838,Park; Ji Young,6,0,24,18
1708248225852,BIMM 121,C02,425839,Park; Ji Young,20,0,24,4
1708248226382,BIMM 134,A01,425841,Burg; Michael,393,0,416,23
1708248226907,BIMM 143,A01,425843,Grant; Barry J,17,0,40,23
1708248226907,BIMM 143,B01,425845,Bozinovic; Goran,33,0,40,7
1708248227446,BIMM 182,A01,455012,Bafna; Vineet,28,0,50,22
1708248227977,BIMM 194,A00,425847,Rivera; Fabian Chavez,24,0,27,3
1708248227977,BIMM 194,B00,425868,Russell; Alistair B,16,0,27,11
1708248227977,BIMM 194,D00,425870,Wildonger; Jill Cathleen,14,0,27,13
1708248228504,BIOM 202,A00,390710,Corbett; Kevin Daniel,93,0,100,7
1708248229037,BIOM 219,A00,390713,Ross; Camille,0,0,0,7
1708248229564,BIOM 231,A00,455099,Furnari; Frank,0,0,0,0
1708248229564,BIOM 231,B00,455100,Lopez Ramirez; Miguel Alej,0,0,0,0
1708248230091,BIOM 242,A00,390714,Hamilton; Bruce Alan,20,0,20,0
1708248230619,BIOM 246,A00,492784,Gordts; Philip & Varki; Ajit P & Lewis; Amanda Lark & Godula; Kamil & Gagneux; Pascal & Esko; Jeffrey D. & Bode; Lars,0,0,0,0
1708248231146,BIOM 252,A00,390715,Ayyagari; Radha,27,0,28,1
1708248231687,BIOM 254,A00,390718,Corbett; Kevin Daniel,14,0,20,6
1708248232300,BIOM 272,A00,390722,Hangauer; Matthew John,16,0,20,4
1708248232827,BIOM 274,A00,390725,Sun; Bryan Kee-Hong,7,0,15,8
1708248233358,BIOM 283,A00,390728,Komives; Elizabeth A,2,0,2,0
1708248233884,BIOM 285,A00,390730,Gaulton; Kyle J,10,0,20,10
1708248234415,BIOM 295,A00,455083,Brown; Joan Heller,0,0,0,0
1708248234947,BIPN 100,A01,425872,Augustine; Vineet,240,0,245,5
1708248234947,BIPN 100,B01,425874,George; Monique Leana,240,0,245,5
1708248234947,BIPN 100,C01,458640,Maita; Isabella Vincenza,44,0,49,5
1708248234947,BIPN 100,C02,458646,Maita; Isabella Vincenza,48,0,49,1
1708248234947,BIPN 100,C03,458714,Maita; Isabella Vincenza,48,0,49,1
1708248234947,BIPN 100,C04,458716,Maita; Isabella Vincenza,48,0,49,1
1708248234947,BIPN 100,C05,458717,Maita; Isabella Vincenza,46,0,49,3
1708248235474,BIPN 105,A01,425877,Armour; Jon Christopher,13,0,21,8
1708248235474,BIPN 105,A02,425878,Armour; Jon Christopher,21,0,21,0
1708248235474,BIPN 105,A03,425879,Armour; Jon Christopher,9,0,21,12
1708248235474,BIPN 105,A04,425880,Armour; Jon Christopher,20,0,21,1
1708248236006,BIPN 120,A01,425882,Cooke; James Edward,371,0,395,24
1708248236547,BIPN 140,A01,425884,Hibbs; Ryan E.,183,0,192,9
1708248238094,BIPN 144,A01,425886,Zou; Yimin,153,0,158,5
1708248238696,BIPN 145,A01,425888,Maita; Isabella Vincenza,41,0,42,1
1708248238696,BIPN 145,B01,425918,Marino; Marc J,37,0,42,5
1708248238696,BIPN 145,B02,425954,Marino; Marc J,40,0,42,2
1708248239227,BIPN 147,A01,426086,Sejnowski; Terrence J,53,0,64,11
1708248239754,BIPN 152,A01,426112,Halpain; Shelley,97,0,128,31
1708248240282,BIPN 162,A01,426120,Juavinett; Ashley Lauren,17,0,30,13
1708248240813,BIPN 164,A01,455010,Benna; Marcus K & Aljadeff; Johnatan,120,0,120,0
1708248241339,BIPN 194,A00,426122,Glasgow; Stacey Marie,20,0,27,7
1708248241868,BISP 170,A00,426158,French; Kathleen Ann,26,0,30,4
1708248242394,BISP 182,A00,426168,Pogliano; Joseph,9999,0,9999,0
1708248242920,BISP 194,A00,426240,Chisholm; Andrew D.,11,0,27,16
1708248242920,BISP 194,B00,426241,Farley; Emma Kristen,25,0,27,2
1708248243449,BNFO 281,A00,427175,Gaasterland; Theresa,85,0,100,15
1708248243984,BNFO 283,A00,427211,Carter; Hannah Kathryn & Chavez; Alejandro,39,0,50,11
1708248243984,BNFO 283,B00,480483,Amariuta-Bartell; Tiffany & Dorrestein; Pieter,21,0,30,9
1708248244510,BNFO 294,B01,427269,Ross; Camille,47,0,50,3
1708248245133,CAT 3,A01,396994,Glaser; Amelia,15,0,15,0
1708248245133,CAT 3,A02,396995,Glaser; Amelia,15,0,15,0
1708248245133,CAT 3,A03,396996,Glaser; Amelia,7,0,15,8
1708248245133,CAT 3,A04,396997,Glaser; Amelia,12,0,15,3
1708248245133,CAT 3,A05,397004,Glaser; Amelia,15,0,15,0
1708248245133,CAT 3,A06,397039,Glaser; Amelia,11,0,15,4
1708248245133,CAT 3,A07,397040,Glaser; Amelia,13,0,15,2
1708248245133,CAT 3,A08,397084,Glaser; Amelia,15,0,15,0
1708248245133,CAT 3,A09,397269,Glaser; Amelia,13,0,15,2
1708248245133,CAT 3,A10,397270,Glaser; Amelia,0,0,15,15
1708248245133,CAT 3,A11,397271,Glaser; Amelia,9,0,15,6
1708248245133,CAT 3,A12,397272,Glaser; Amelia,12,0,15,3
1708248245133,CAT 3,A13,397273,Glaser; Amelia,15,0,15,0
1708248245133,CAT 3,A14,397274,Glaser; Amelia,14,0,15,1
1708248245133,CAT 3,B01,397276,Porter; Lisa,15,0,15,0
1708248245133,CAT 3,B02,397277,Porter; Lisa,15,0,15,0
1708248245133,CAT 3,B03,397278,Porter; Lisa,14,0,15,1
1708248245133,CAT 3,B04,397279,Porter; Lisa,15,0,15,0
1708248245133,CAT 3,B06,397281,Porter; Lisa,15,0,15,0
1708248245133,CAT 3,B07,397291,Porter; Lisa,15,0,15,0
1708248245133,CAT 3,B09,397293,Porter; Lisa,15,0,15,0
1708248245133,CAT 3,B10,397294,Porter; Lisa,15,0,15,0
1708248245133,CAT 3,B11,397295,Porter; Lisa,12,0,15,3
1708248245133,CAT 3,B12,397296,Porter; Lisa,14,0,15,1
1708248245133,CAT 3,B13,397297,Porter; Lisa,11,0,15,4
1708248245133,CAT 3,B14,397298,Porter; Lisa,15,0,15,0
1708248245133,CAT 3,B15,397299,Porter; Lisa,15,0,15,0
1708248245133,CAT 3,B16,397300,Porter; Lisa,15,0,15,0
1708248245133,CAT 3,C01,397302,Marchisotto; Jennifer Anne,13,0,15,2
1708248245133,CAT 3,C02,397308,Marchisotto; Jennifer Anne,9,0,15,6
1708248245133,CAT 3,C03,397309,Marchisotto; Jennifer Anne,9,0,15,6
1708248245133,CAT 3,C04,397315,Marchisotto; Jennifer Anne,11,0,15,4
1708248245133,CAT 3,C05,397316,Marchisotto; Jennifer Anne,14,0,15,1
1708248245133,CAT 3,C06,397322,Marchisotto; Jennifer Anne,15,0,15,0
1708248245133,CAT 3,C07,397323,Marchisotto; Jennifer Anne,15,0,15,0
1708248245133,CAT 3,C08,397329,Marchisotto; Jennifer Anne,15,0,15,0
1708248245133,CAT 3,C09,397333,Marchisotto; Jennifer Anne,15,0,15,0
1708248245133,CAT 3,C10,397336,Marchisotto; Jennifer Anne,15,0,15,0
1708248245133,CAT 3,C11,397354,Marchisotto; Jennifer Anne,13,0,15,2
1708248245133,CAT 3,C12,397357,Marchisotto; Jennifer Anne,15,0,15,0
1708248245133,CAT 3,C13,397364,Marchisotto; Jennifer Anne,14,0,15,1
1708248245133,CAT 3,C14,397367,Marchisotto; Jennifer Anne,14,0,15,1
1708248245133,CAT 3,C15,397369,Marchisotto; Jennifer Anne,15,0,15,0
1708248245133,CAT 3,C16,397373,Marchisotto; Jennifer Anne,15,0,15,0
1708248245133,CAT 3,C17,397374,Marchisotto; Jennifer Anne,15,0,15,0
1708248245133,CAT 3,C18,397380,Marchisotto; Jennifer Anne,14,0,15,1
1708248245133,CAT 3,D02,397405,Rahimi; Babak,13,0,15,2
1708248245133,CAT 3,D03,397408,Rahimi; Babak,14,0,15,1
1708248245133,CAT 3,D04,397415,Rahimi; Babak,15,0,15,0
1708248245133,CAT 3,D05,397416,Rahimi; Babak,15,0,15,0
1708248245133,CAT 3,D06,397422,Rahimi; Babak,15,0,15,0
1708248245133,CAT 3,D07,397426,Rahimi; Babak,14,0,15,1
1708248245133,CAT 3,D09,397447,Rahimi; Babak,11,0,15,4
1708248245133,CAT 3,D10,397450,Rahimi; Babak,13,0,15,2
1708248245133,CAT 3,D11,397625,Rahimi; Babak,13,0,15,2
1708248245133,CAT 3,D12,397630,Rahimi; Babak,15,0,15,0
1708248245133,CAT 3,D13,397631,Rahimi; Babak,14,0,15,1
1708248245133,CAT 3,D14,397635,Rahimi; Babak,14,0,15,1
1708248245663,CAT 3CE,A01,397642,Bronstein; Phoebe Malan,25,0,25,0
1708248246192,CAT 87,A00,397645,Bronstein; Phoebe Malan,19,0,20,1
1708248246718,CAT 90,A00,480731,Bronstein; Phoebe Malan,20,0,20,0
1708248247248,CAT 124,A01,397662,Knight; Amy,5,0,5,0
1708248247248,CAT 124,A02,397722,Knight; Amy,5,0,5,0
1708248247248,CAT 124,A03,397726,Knight; Amy,5,0,5,0
1708248247248,CAT 124,A04,397829,Knight; Amy,4,0,5,1
1708248247799,CAT 125,001,397832,Popko; Elizabeth Ashley,20,0,20,0
1708248247799,CAT 125,002,397833,Delaville; Romain,20,0,20,0
1708248247799,CAT 125,003,397834,Marchisotto; Jennifer Anne,18,0,20,2
1708248247799,CAT 125,004,397835,Bigham; David Joseph,20,0,20,0
1708248247799,CAT 125,005,397836,Bigham; David Joseph,19,0,20,1
1708248247799,CAT 125,006,397837,Bigham; David Joseph,16,0,20,4
1708248247799,CAT 125,007,397838,Vanderschuit; Maya Alysia,20,0,20,0
1708248247799,CAT 125,008,397839,Vanderschuit; Maya Alysia,20,0,20,0
1708248247799,CAT 125,009,397840,Vanderschuit; Maya Alysia,20,0,20,0
1708248247799,CAT 125,010,397841,Morales; Celeste Georgianna,15,0,16,1
1708248247799,CAT 125,011,397842,Morales; Celeste Georgianna,16,0,16,0
1708248247799,CAT 125,012,397881,Morales; Celeste Georgianna,19,0,20,1
1708248247799,CAT 125,013,397954,Rose; Becca Rae,18,0,20,2
1708248247799,CAT 125,014,397956,Rose; Becca Rae,20,0,20,0
1708248247799,CAT 125,015,397998,Rose; Becca Rae,19,0,20,1
1708248247799,CAT 125,016,397999,Tosun; Adriana,20,0,20,0
1708248247799,CAT 125,017,398001,Tosun; Adriana,20,0,20,0
1708248247799,CAT 125,018,398009,Irwin; Matthew Joseph,19,0,20,1
1708248247799,CAT 125,019,398010,Irwin; Matthew Joseph,18,0,20,2
1708248247799,CAT 125,020,398014,Irwin; Matthew Joseph,20,0,20,0
1708248248326,CAT 125R,A00,398015,Smith; Lauryn Alissa,19,0,20,1
1708248248326,CAT 125R,B00,398016,Smith; Lauryn Alissa,17,0,20,3
1708248248326,CAT 125R,C00,398017,Smith; Lauryn Alissa,19,0,20,1
1708248248326,CAT 125R,D00,398019,Tosun; Adriana,19,0,20,1
1708248248326,CAT 125R,E00,398020,Hyland; Tina Mae,12,0,20,8
1708248248326,CAT 125R,F00,398027,Hyland; Tina Mae,18,0,20,2
1708248248326,CAT 125R,G00,398028,Hyland; Tina Mae,18,0,20,2
1708248248887,CCE 1,A01,396087,Kenley Grounds; Nicole,40,0,40,0
1708248248887,CCE 1,B01,396142,Quijada; David,39,0,40,1
1708248248887,CCE 1,C01,396159,Bigley; Michele Heather,39,0,40,1
1708248248887,CCE 1,D01,396164,Bigley; Michele Heather,40,0,40,0
1708248248887,CCE 1,E01,396166,Lee; Kassandra,40,0,40,0
1708248248887,CCE 1,F01,396168,Lee; Kassandra,40,0,40,0
1708248248887,CCE 1,G01,396170,Staff,40,0,40,0
1708248248887,CCE 1,H01,396172,Staff,40,0,40,0
1708248249413,CENG 101B,A00,392993,Chen; Shaochen,44,0,45,1
1708248249953,CENG 101C,A00,392997,Li; Yanran,148,0,150,2
1708248250483,CENG 113,A00,393000,Chen; Zheng,69,0,70,1
1708248250483,CENG 113,B00,393001,Li; Wan-Lu,69,0,70,1
1708248251010,CENG 124B,A00,393036,Powell; Alyssa & Russ; Benjamin Edward,113,0,120,7
1708248251552,CENG 157,A00,393220,Opatkiewicz; Justin Paul,50,0,57,7
1708248252078,CENG 160,A00,393231,Powell; Alyssa,70,0,80,10
1708248252605,CENG 170,A01,393238,Drews; Aaron,27,0,30,3
1708248253130,CENG 175,A00,393239,Steinmetz; Nicole F,34,0,35,1
1708248253658,CENG 176B,A01,393285,Opatkiewicz; Justin Paul,46,0,52,6
1708248253658,CENG 176B,B01,393629,Zhang; Liangfang,40,0,49,9
1708248254188,CENG 205,A00,393681,Jahed Motlagh; Zeinab,53,0,60,7
1708248254714,CENG 257,A00,393682,Opatkiewicz; Justin Paul,10,0,13,3
1708248255272,CGS 87,A00,489609,Wesling; Megan E.,20,0,20,0
1708248255798,CGS 100B,A00,396181,Whitley; Leila Marie,28,0,30,2
1708248256327,CGS 109,A00,396194,Whitley; Leila Marie,19,0,20,1
1708248256869,CGS 112,A00,396220,Martin Sandino; Amanda Maria Yoland,22,0,25,3
1708248257395,CGS 114,A00,396223,Steelman; Katherine Wallis,14,0,16,2
1708248257921,CGS 116,A00,396295,Staff,19,0,20,1
1708248258446,CGS 117,A00,396306,Martin Sandino; Amanda Maria Yoland,14,0,15,1
1708248258973,CGS 118,A00,396314,Hankins; Joseph D.,28,0,29,1
1708248259502,CGS 128,A00,396366,Whitley; Leila Marie,14,0,15,1
1708248260032,CGS 137,A00,396865,Martin Sandino; Amanda Maria Yoland,16,0,19,3
1708248260560,CGS 150,A00,396901,Taylor-Garcia; Daphne,18,0,18,0
1708248261089,CGS 196B,A00,396904,Lo; Stanley M.,7,0,7,0
1708248261089,CGS 196B,B00,396973,Brenner; Suzanne A,7,0,7,0
1708248261089,CGS 196B,C00,396985,Jones; Makeba,7,0,7,0
1708248261620,CGS 198,001,396987,Anderson; Patrick W.,0,0,0,0
1708248261620,CGS 198,002,396988,Anderson; Patrick W.,0,0,0,0
1708248261620,CGS 198,003,396989,Anderson; Patrick W.,0,0,0,0
1708248261620,CGS 198,004,396990,Anderson; Patrick W.,0,0,0,0
1708248262148,CGS 200,A00,396991,Perez; Roy,0,0,0,3
1708248262677,CHEM 6A,A01,459563,Deshmukh; Lalit,40,0,40,0
1708248262677,CHEM 6A,A02,459564,Deshmukh; Lalit,35,0,40,5
1708248262677,CHEM 6A,A03,459565,Deshmukh; Lalit,31,0,40,9
1708248262677,CHEM 6A,A04,459566,Deshmukh; Lalit,30,0,38,8
1708248262677,CHEM 6A,A05,459567,Deshmukh; Lalit,40,0,40,0
1708248262677,CHEM 6A,A06,459568,Deshmukh; Lalit,37,0,40,3
1708248262677,CHEM 6A,A07,459569,Deshmukh; Lalit,37,0,40,3
1708248262677,CHEM 6A,A08,459570,Deshmukh; Lalit,0,0,0,0
1708248263230,CHEM 6B,A01,467314,Ortony; Julia Helen,39,0,40,1
1708248263230,CHEM 6B,A02,467322,Ortony; Julia Helen,32,0,40,8
1708248263230,CHEM 6B,A03,467323,Ortony; Julia Helen,40,0,40,0
1708248263230,CHEM 6B,A04,467325,Ortony; Julia Helen,32,0,40,8
1708248263230,CHEM 6B,A05,467326,Ortony; Julia Helen,39,0,40,1
1708248263230,CHEM 6B,A06,467346,Ortony; Julia Helen,40,0,40,0
1708248263230,CHEM 6B,B01,467360,Hopkins; Patrycja Anna,35,0,40,5
1708248263230,CHEM 6B,B02,467363,Hopkins; Patrycja Anna,37,0,40,3
1708248263230,CHEM 6B,B03,467364,Hopkins; Patrycja Anna,35,0,40,5
1708248263230,CHEM 6B,B04,467380,Hopkins; Patrycja Anna,40,0,40,0
1708248263230,CHEM 6B,B05,467381,Hopkins; Patrycja Anna,40,0,40,0
1708248263230,CHEM 6B,B06,467382,Hopkins; Patrycja Anna,39,0,40,1
1708248263793,CHEM 6C,A01,468994,Ternansky; Robert J.,39,0,40,1
1708248263793,CHEM 6C,A02,469054,Ternansky; Robert J.,38,0,40,2
1708248263793,CHEM 6C,A03,469065,Ternansky; Robert J.,39,0,40,1
1708248263793,CHEM 6C,A04,469069,Ternansky; Robert J.,40,0,40,0
1708248263793,CHEM 6C,A05,469080,Ternansky; Robert J.,40,0,40,0
1708248263793,CHEM 6C,B01,469318,Ternansky; Robert J.,39,0,40,1
1708248263793,CHEM 6C,B02,469319,Ternansky; Robert J.,40,0,40,0
1708248263793,CHEM 6C,B03,469320,Ternansky; Robert J.,39,0,40,1
1708248263793,CHEM 6C,B04,469321,Ternansky; Robert J.,40,0,40,0
1708248263793,CHEM 6C,B05,469322,Ternansky; Robert J.,40,0,40,0
1708248263793,CHEM 6C,C01,469323,Schurmeier; Kimberly,38,0,40,2
1708248263793,CHEM 6C,C02,469324,Schurmeier; Kimberly,36,0,40,4
1708248263793,CHEM 6C,C03,469325,Schurmeier; Kimberly,38,0,40,2
1708248263793,CHEM 6C,C04,469326,Schurmeier; Kimberly,36,0,40,4
1708248263793,CHEM 6C,C05,469327,Schurmeier; Kimberly,40,0,40,0
1708248263793,CHEM 6C,D01,460183,Schurmeier; Kimberly,39,0,40,1
1708248263793,CHEM 6C,D02,460184,Schurmeier; Kimberly,32,0,40,8
1708248263793,CHEM 6C,D03,460185,Schurmeier; Kimberly,26,0,40,14
1708248263793,CHEM 6C,D04,460186,Schurmeier; Kimberly,38,0,40,2
1708248263793,CHEM 6C,D05,460187,Schurmeier; Kimberly,40,0,40,0
1708248263793,CHEM 6C,E01,460188,Stallings; Dontarie M,24,0,40,16
1708248263793,CHEM 6C,E02,460190,Stallings; Dontarie M,25,0,40,15
1708248263793,CHEM 6C,E03,460191,Stallings; Dontarie M,3,0,20,17
1708248263793,CHEM 6C,E04,460192,Stallings; Dontarie M,36,0,40,4
1708248263793,CHEM 6C,E05,460193,Stallings; Dontarie M,37,0,40,3
1708248264320,CHEM 6CH,A01,459630,Tezcan; Faik,40,0,40,0
1708248264885,CHEM 7L,A01,393998,Jazzar; Rodolphe,0,0,0,3
1708248264885,CHEM 7L,A02,393999,Jazzar; Rodolphe,10,0,24,14
1708248264885,CHEM 7L,A03,394000,Jazzar; Rodolphe,21,0,24,3
1708248264885,CHEM 7L,A04,394001,Jazzar; Rodolphe,22,0,24,2
1708248264885,CHEM 7L,A05,394002,Jazzar; Rodolphe,18,0,24,6
1708248264885,CHEM 7L,A06,394003,Jazzar; Rodolphe,22,0,24,2
1708248264885,CHEM 7L,A07,394004,Jazzar; Rodolphe,18,0,21,3
1708248264885,CHEM 7L,A08,394005,Jazzar; Rodolphe,0,0,0,0
1708248264885,CHEM 7L,A09,394006,Jazzar; Rodolphe,20,0,24,4
1708248264885,CHEM 7L,A10,394007,Jazzar; Rodolphe,24,0,24,0
1708248264885,CHEM 7L,B01,394009,Jazzar; Rodolphe,0,0,0,1
1708248264885,CHEM 7L,B02,394010,Jazzar; Rodolphe,1,0,6,5
1708248264885,CHEM 7L,B03,394011,Jazzar; Rodolphe,15,0,24,9
1708248264885,CHEM 7L,B04,394012,Jazzar; Rodolphe,18,0,21,3
1708248264885,CHEM 7L,B05,394013,Jazzar; Rodolphe,0,0,0,0
1708248264885,CHEM 7L,B06,394014,Jazzar; Rodolphe,15,0,24,9
1708248264885,CHEM 7L,B07,394015,Jazzar; Rodolphe,18,0,24,6
1708248264885,CHEM 7L,B08,394016,Jazzar; Rodolphe,23,0,24,1
1708248264885,CHEM 7L,B09,394017,Jazzar; Rodolphe,24,0,24,0
1708248264885,CHEM 7L,B10,394018,Jazzar; Rodolphe,24,0,24,0
1708248264885,CHEM 7L,C01,394020,Staff,0,0,0,0
1708248264885,CHEM 7L,C02,394021,Staff,21,0,24,3
1708248264885,CHEM 7L,C03,394022,Staff,23,0,24,1
1708248264885,CHEM 7L,C04,394023,Staff,24,0,24,0
1708248264885,CHEM 7L,C05,394024,Staff,0,0,0,0
1708248264885,CHEM 7L,C06,394025,Staff,20,0,24,4
1708248264885,CHEM 7L,C07,394026,Staff,22,0,24,2
1708248264885,CHEM 7L,C08,394027,Staff,23,0,24,1
1708248264885,CHEM 7L,C09,394028,Staff,24,0,24,0
1708248264885,CHEM 7L,C10,394029,Staff,23,0,24,1
1708248265416,CHEM 11,A01,459661,Staff,42,0,44,2
1708248265416,CHEM 11,A02,459664,Staff,44,0,44,0
1708248265416,CHEM 11,A03,459702,Staff,42,0,44,2
1708248265416,CHEM 11,A04,459707,Staff,44,0,44,0
1708248265416,CHEM 11,A05,459708,Staff,43,0,44,1
1708248265416,CHEM 11,A06,459711,Staff,41,0,44,3
1708248265944,CHEM 40A,A01,459576,Albizati; Kim F.,36,0,40,4
1708248265944,CHEM 40A,A02,459577,Albizati; Kim F.,33,0,40,7
1708248265944,CHEM 40A,A03,459578,Albizati; Kim F.,37,0,40,3
1708248265944,CHEM 40A,A04,459579,Albizati; Kim F.,38,0,40,2
1708248265944,CHEM 40A,A05,459580,Albizati; Kim F.,40,0,40,0
1708248265944,CHEM 40A,A06,459581,Albizati; Kim F.,37,0,40,3
1708248265944,CHEM 40A,A07,459582,Albizati; Kim F.,38,0,40,2
1708248265944,CHEM 40A,A08,459588,Albizati; Kim F.,39,0,40,1
1708248266494,CHEM 40B,A01,467442,Weizman; Haim,29,0,40,11
1708248266494,CHEM 40B,A02,467443,Weizman; Haim,33,0,40,7
1708248266494,CHEM 40B,A03,467444,Weizman; Haim,39,0,40,1
1708248266494,CHEM 40B,A04,467445,Weizman; Haim,38,0,40,2
1708248266494,CHEM 40B,A05,467446,Weizman; Haim,39,0,40,1
1708248266494,CHEM 40B,A06,467447,Weizman; Haim,37,0,40,3
1708248266494,CHEM 40B,A07,467448,Weizman; Haim,31,0,40,9
1708248266494,CHEM 40B,A08,467449,Weizman; Haim,40,0,40,0
1708248266494,CHEM 40B,B01,467383,Molinski; Tadeusz,40,0,40,0
1708248266494,CHEM 40B,B02,467384,Molinski; Tadeusz,40,0,40,0
1708248266494,CHEM 40B,B03,467385,Molinski; Tadeusz,40,0,40,0
1708248266494,CHEM 40B,B04,467399,Molinski; Tadeusz,40,0,40,0
1708248266494,CHEM 40B,B05,467400,Molinski; Tadeusz,40,0,40,0
1708248266494,CHEM 40B,B06,467401,Molinski; Tadeusz,40,0,40,0
1708248266494,CHEM 40B,B07,467402,Molinski; Tadeusz,40,0,40,0
1708248266494,CHEM 40B,B08,467404,Molinski; Tadeusz,39,0,40,1
1708248267028,CHEM 41B,A01,459571,Klosterman; Jeremy K,40,0,40,0
1708248267028,CHEM 41B,A02,459572,Klosterman; Jeremy K,36,0,37,1
1708248267028,CHEM 41B,A03,459573,Klosterman; Jeremy K,40,0,40,0
1708248267589,CHEM 41C,A01,459589,Tor; Yitzhak,40,0,40,0
1708248267589,CHEM 41C,A02,459624,Tor; Yitzhak,38,0,40,2
1708248267589,CHEM 41C,A03,459625,Tor; Yitzhak,40,0,40,0
1708248267589,CHEM 41C,A04,459626,Tor; Yitzhak,40,0,40,0
1708248267589,CHEM 41C,A05,459627,Tor; Yitzhak,29,0,29,0
1708248267589,CHEM 41C,A06,459628,Tor; Yitzhak,38,0,40,2
1708248267589,CHEM 41C,A07,459629,Tor; Yitzhak,40,0,40,0
1708248268151,CHEM 43A,A01,394068,Lam; Tin Yiu,12,0,24,12
1708248268151,CHEM 43A,A02,394088,Lam; Tin Yiu,23,0,24,1
1708248268151,CHEM 43A,A03,394092,Lam; Tin Yiu,23,0,24,1
1708248268151,CHEM 43A,A04,394093,Lam; Tin Yiu,21,0,24,3
1708248268151,CHEM 43A,A05,394094,Lam; Tin Yiu,23,0,24,1
1708248268151,CHEM 43A,A06,394096,Lam; Tin Yiu,15,0,24,9
1708248268151,CHEM 43A,A07,394115,Lam; Tin Yiu,20,0,24,4
1708248268151,CHEM 43A,A08,394116,Lam; Tin Yiu,22,0,24,2
1708248268151,CHEM 43A,A09,394117,Lam; Tin Yiu,22,0,24,2
1708248268151,CHEM 43A,A10,394118,Lam; Tin Yiu,20,0,24,4
1708248268151,CHEM 43A,A11,394119,Lam; Tin Yiu,8,0,13,5
1708248268151,CHEM 43A,A12,394120,Lam; Tin Yiu,24,0,24,0
1708248268151,CHEM 43A,A13,394132,Lam; Tin Yiu,24,0,24,0
1708248268151,CHEM 43A,B01,394134,Lam; Tin Yiu,24,0,24,0
1708248268151,CHEM 43A,B02,394135,Lam; Tin Yiu,16,0,24,8
1708248268151,CHEM 43A,B03,394136,Lam; Tin Yiu,14,0,24,10
1708248268151,CHEM 43A,B04,394137,Lam; Tin Yiu,17,0,24,7
1708248268151,CHEM 43A,B05,394138,Lam; Tin Yiu,20,0,24,4
1708248268151,CHEM 43A,B06,394139,Lam; Tin Yiu,19,0,24,5
1708248268151,CHEM 43A,B07,394140,Lam; Tin Yiu,20,0,24,4
1708248268151,CHEM 43A,B08,394141,Lam; Tin Yiu,24,0,24,0
1708248268151,CHEM 43A,B09,394142,Lam; Tin Yiu,20,0,24,4
1708248268151,CHEM 43A,B10,394143,Lam; Tin Yiu,24,0,24,0
1708248268151,CHEM 43A,B11,394145,Lam; Tin Yiu,22,0,24,2
1708248268151,CHEM 43A,B12,394146,Lam; Tin Yiu,23,0,24,1
1708248268678,CHEM 96,A00,394159,Bussey; Thomas J,24,0,25,1
1708248269205,CHEM 100A,A01,394161,Li; Shaowei,16,0,22,6
1708248269205,CHEM 100A,A02,394162,Li; Shaowei,20,0,24,4
1708248269205,CHEM 100A,A03,394163,Li; Shaowei,22,0,24,2
1708248269205,CHEM 100A,A04,394164,Li; Shaowei,24,0,24,0
1708248269205,CHEM 100A,A05,394165,Li; Shaowei,24,0,24,0
1708248269205,CHEM 100A,A06,394166,Li; Shaowei,20,0,22,2
1708248269736,CHEM 100B,A01,394175,Pomeroy; Robert S.,19,0,25,6
1708248270261,CHEM 105A,A01,394177,Young; Mark,31,0,39,8
1708248270261,CHEM 105A,B01,394179,Young; Mark,0,0,0,0
1708248270790,CHEM 108,A01,394181,Staff,14,0,20,6
1708248270790,CHEM 108,A02,394182,Staff,23,0,24,1
1708248270790,CHEM 108,B01,394184,Staff,4,0,20,16
1708248270790,CHEM 108,B02,394185,Staff,23,0,24,1
1708248271319,CHEM 109,A01,394187,Piercy; Marc Anthony,17,0,20,3
1708248271319,CHEM 109,A02,394188,Piercy; Marc Anthony,22,0,24,2
1708248271319,CHEM 109,B01,394193,Piercy; Marc Anthony,12,0,20,8
1708248271319,CHEM 109,B02,394194,Piercy; Marc Anthony,23,0,24,1
1708248271849,CHEM 111,A00,394195,Thiemens; Mark H,97,0,100,3
1708248272398,CHEM 114B,A01,459574,Piercy; Marc Anthony,39,0,45,6
1708248272398,CHEM 114B,A02,459575,Piercy; Marc Anthony,40,0,45,5
1708248272931,CHEM 114C,A01,467286,Komives; Elizabeth A,32,0,44,12
1708248272931,CHEM 114C,A02,467287,Komives; Elizabeth A,42,0,44,2
1708248272931,CHEM 114C,A03,467290,Komives; Elizabeth A,42,0,44,2
1708248272931,CHEM 114C,A04,467295,Komives; Elizabeth A,43,0,44,1
1708248273458,CHEM 114D,A00,394198,Ghosh; Gourisankar,29,0,30,1
1708248273985,CHEM 118,A01,459788,Donoghue; Daniel J.,37,0,40,3
1708248273985,CHEM 118,A02,459800,Donoghue; Daniel J.,37,0,40,3
1708248273985,CHEM 118,A03,459807,Donoghue; Daniel J.,36,0,40,4
1708248273985,CHEM 118,A04,459809,Donoghue; Daniel J.,38,0,40,2
1708248273985,CHEM 118,A05,459811,Donoghue; Daniel J.,37,0,40,3
1708248273985,CHEM 118,A06,459826,Donoghue; Daniel J.,39,0,40,1
1708248274513,CHEM 119,A01,467427,Joseph; Simpson,35,0,40,5
1708248274513,CHEM 119,A02,467441,Joseph; Simpson,0,0,0,0
1708248275039,CHEM 120B,A01,467450,Griffith; Kent,37,0,40,3
1708248275039,CHEM 120B,A02,467451,Griffith; Kent,34,0,40,6
1708248275039,CHEM 120B,A03,467452,Griffith; Kent,35,0,40,5
1708248275567,CHEM 123,A00,394211,Schimpf; Alina M,0,0,0,1
1708248276094,CHEM 125,A00,394217,Tezcan; Faik,18,0,20,2
1708248276620,CHEM 126A,A01,459715,Yong; Haiwang,39,0,40,1
1708248276620,CHEM 126A,A02,459725,Yong; Haiwang,36,0,40,4
1708248277148,CHEM 126B,A01,467405,Tauber; Michael,36,0,40,4
1708248277148,CHEM 126B,A02,467406,Tauber; Michael,39,0,40,1
1708248277148,CHEM 126B,A03,467426,Tauber; Michael,39,0,40,1
1708248277675,CHEM 132,A01,460181,Galperin; Michael,42,0,45,3
1708248277675,CHEM 132,A02,460182,Galperin; Michael,37,0,45,8
1708248278202,CHEM 135,A01,394222,Tauber; Michael,15,0,15,0
1708248278745,CHEM 143B,A01,394229,Klosterman; Jeremy K,16,0,24,8
1708248278745,CHEM 143B,A02,394230,Klosterman; Jeremy K,21,0,24,3
1708248279271,CHEM 156,A00,394231,Romero; Erik Anthony,30,0,30,0
1708248279798,CHEM 157,A00,394232,Tor; Yitzhak,74,0,80,6
1708248280326,CHEM 165,A01,460194,Herzik; Mark Anthony,21,0,25,4
1708248280853,CHEM 167,A01,467296,Deshmukh; Lalit,39,0,40,1
1708248280853,CHEM 167,A02,467297,Deshmukh; Lalit,33,0,40,7
1708248280853,CHEM 167,A03,467298,Deshmukh; Lalit,37,0,40,3
1708248280853,CHEM 167,A04,467312,Deshmukh; Lalit,37,0,40,3
1708248281383,CHEM 173,A00,394284,Young; Mark,48,0,50,2
1708248281910,CHEM 174,A01,455015,Pomeroy; Robert S.,45,0,50,5
1708248282437,CHEM 186,A00,477716,Paesani; Francesco & Gilson; Michael K.,6,0,12,6
1708248282968,CHEM 188,A00,394294,Bussey; Thomas J,19,0,20,1
1708248283497,CHEM 214,A00,394336,Ghosh; Gourisankar,12,0,20,8
1708248284023,CHEM 217,A00,394341,Joseph; Simpson,25,0,30,5
1708248284555,CHEM 221,A00,394425,Taylor; Susan S.,10,0,20,10
1708248285080,CHEM 225,A00,394429,Tezcan; Faik,4,0,10,6
1708248285608,CHEM 227,A00,394430,Schimpf; Alina M,26,0,30,4
1708248286134,CHEM 229,A00,394431,Stauber; Julia Megan,13,0,20,7
1708248286660,CHEM 235,A01,394433,Tauber; Michael,20,0,20,0
1708248288260,CHEM 236,A00,394434,Kummel; Andrew C,14,0,15,1
1708248288786,CHEM 241,A00,394435,Pokorski; Jonathan Kyle,14,0,15,1
1708248289312,CHEM 250,A00,394436,Weizman; Haim,0,0,0,16
1708248289841,CHEM 256,A00,394437,Romero; Erik Anthony,15,0,20,5
1708248290374,CHEM 257,A00,394438,Tor; Yitzhak,23,0,30,7
1708248290902,CHEM 265,A01,460195,Herzik; Mark Anthony,13,0,20,7
1708248291432,CHEM 273,A00,394440,Young; Mark,13,0,20,7
1708248291959,CHEM 276,A00,394441,Mc Culloch; Andrew Douglas & Amaro; Rommie E,0,0,0,0
1708248292490,CHEM 283,A00,394443,Komives; Elizabeth A,2,0,4,2
1708248293016,CHEM 286,A00,477693,Paesani; Francesco & Gilson; Michael K.,26,0,34,8
1708248293546,CHEM 291,A00,394446,Komives; Elizabeth A,20,0,20,0
1708248294074,CHEM 294,A00,394447,Romero; Erik Anthony,50,0,50,0
1708248294608,CHIN 10CD,A01,394453,Liu; Mingming,17,0,17,0
1708248294608,CHIN 10CD,A02,394457,Liu; Mingming,18,0,18,0
1708248295135,CHIN 10CM,A01,394465,Chen; Pei-Chia,11,0,12,1
1708248295135,CHIN 10CM,A02,394466,Chen; Pei-Chia,12,0,12,0
1708248295135,CHIN 10CM,B01,394468,Liu; Mingming,11,0,13,2
1708248295135,CHIN 10CM,B02,394469,Liu; Mingming,13,0,13,0
1708248295668,CHIN 10CN,A01,394581,Xu; Li,14,0,14,0
1708248295668,CHIN 10CN,A02,394582,Xu; Li,14,0,14,0
1708248295668,CHIN 10CN,B01,394585,Xu; Li,14,0,14,0
1708248295668,CHIN 10CN,B02,394586,Xu; Li,13,0,14,1
1708248296200,CHIN 20CD,A01,394591,Wang; Xiao,11,0,12,1
1708248296200,CHIN 20CD,A02,394592,Wang; Xiao,11,0,12,1
1708248296728,CHIN 20CN,A01,394597,Anderson; Qin-Hong,7,0,8,1
1708248296728,CHIN 20CN,A02,394599,Anderson; Qin-Hong,8,0,8,0
1708248296728,CHIN 20CN,B01,394601,Anderson; Qin-Hong,14,0,15,1
1708248297258,CHIN 100CM,A00,394602,Anderson; Qin-Hong,19,0,20,1
1708248297785,CHIN 100CN,A00,394603,Chen; Pei-Chia,24,0,24,0
1708248298310,CHIN 169B,A00,394623,Wang; Xiao,19,0,20,1
1708248298840,CLAS 87,A00,394669,Herbst; Matthew,19,0,20,1
1708248299367,CLAS 121R,A01,394671,Herbst; Matthew,11,0,12,1
1708248299367,CLAS 121R,B01,486854,Herbst; Matthew,8,0,8,0
1708248299899,CLIN 294C,A00,476856,Wierenga; Christina E & Banks; Sarah Jane,20,0,20,0
1708248300424,CLIN 296,001,476768,Brookman; Lauren Irene,94,0,100,6
1708248300424,CLIN 296,002,476855,Brookman; Lauren Irene,10,0,10,0
1708248300952,CLRE 238R,A00,394675,Mehta; Ravindra L.,9998,0,9999,1
1708248301478,CLRE 254,A00,394678,Vaida; Florin,9999,0,9999,0
1708248302004,CLRE 256,A00,394685,Morris; Sheldon,9999,0,9999,0
1708248302530,CLRE 258,A00,394692,Mehta; Ravindra L.,9999,0,9999,0
1708248303057,CLRE 260,A00,394693,Cuomo; Raphael Eduardo,9999,0,9999,0
1708248303587,CLRE 264,A00,394696,Mehta; Ravindra L.,9999,0,9999,0
1708248304118,CLRE 267,A00,394703,Vaida; Florin,9999,0,9999,0
1708248304644,CLRE 297,001,394705,Cuomo; Raphael Eduardo,9999,0,9999,0
1708248305174,CMM 246,A00,492783,Gordts; Philip & Varki; Ajit P & Lewis; Amanda Lark & Godula; Kamil & Gagneux; Pascal & Esko; Jeffrey D. & Bode; Lars,9,0,10,1
1708248305717,CMM 250,A00,492943,Willert; Karl Heinrich,31,0,40,9
1708248306243,COGR 200B,A00,395746,Jack; Caroline Sarah,2,0,5,3
1708248306774,COGR 225B,A00,395750,Serlin; David,1,0,5,4
1708248307300,COGR 225C,A00,395753,Gates; Kelly,1,0,5,4
1708248307828,COGR 275,A00,395943,Goldfarb; Brian,6,0,10,4
1708248307828,COGR 275,B00,396046,Fattal; Alexander Leor,4,0,10,6
1708248307828,COGR 275,C00,396047,Kidman; Shawna F,4,0,10,6
1708248308353,COGR 280,A00,396048,Ahn; Patricia Jeehyun,6,0,10,4
1708248308892,COGS 1,A01,407484,Boyle; Mary E. T.,52,0,60,8
1708248308892,COGS 1,A02,407498,Boyle; Mary E. T.,54,0,60,6
1708248308892,COGS 1,A03,407504,Boyle; Mary E. T.,59,0,60,1
1708248308892,COGS 1,A04,407512,Boyle; Mary E. T.,57,0,60,3
1708248308892,COGS 1,A05,407513,Boyle; Mary E. T.,60,0,60,0
1708248308892,COGS 1,A06,407514,Boyle; Mary E. T.,58,0,60,2
1708248308892,COGS 1,A07,407515,Boyle; Mary E. T.,57,0,57,0
1708248309419,COGS 9,A01,407520,Shannon; Kyle Michael,54,0,60,6
1708248309419,COGS 9,A02,407521,Shannon; Kyle Michael,60,0,60,0
1708248309419,COGS 9,A03,407522,Shannon; Kyle Michael,59,0,60,1
1708248309419,COGS 9,A04,407524,Shannon; Kyle Michael,57,0,60,3
1708248309419,COGS 9,A05,407525,Shannon; Kyle Michael,59,0,60,1
1708248309948,COGS 10,A01,407527,Morgan; Eric,45,0,50,5
1708248309948,COGS 10,A02,407530,Morgan; Eric,46,0,50,4
1708248309948,COGS 10,A03,407531,Morgan; Eric,46,0,50,4
1708248309948,COGS 10,A04,407532,Morgan; Eric,47,0,50,3
1708248309948,COGS 10,A05,407534,Morgan; Eric,47,0,50,3
1708248309948,COGS 10,A06,407539,Morgan; Eric,50,0,50,0
1708248309948,COGS 10,A07,407628,Morgan; Eric,50,0,50,0
1708248310477,COGS 11,A01,407699,Boroditsky; Lera,179,0,180,1
1708248311004,COGS 12,A00,407702,Boroditsky; Lera,75,0,75,0
1708248311531,COGS 14A,A01,407706,Barrera; Steven James,51,0,57,6
1708248311531,COGS 14A,A02,407707,Barrera; Steven James,54,0,57,3
1708248311531,COGS 14A,A03,407712,Barrera; Steven James,0,0,0,1
1708248311531,COGS 14A,A04,407715,Barrera; Steven James,57,0,57,0
1708248311531,COGS 14A,A05,407717,Barrera; Steven James,55,0,56,1
1708248311531,COGS 14A,A06,407718,Barrera; Steven James,52,0,55,3
1708248311531,COGS 14A,A07,407720,Barrera; Steven James,49,0,55,6
1708248312058,COGS 14B,A01,407723,Hoffman; Drew Ellen,52,0,57,5
1708248312058,COGS 14B,A02,407726,Hoffman; Drew Ellen,48,0,55,7
1708248312058,COGS 14B,A03,407727,Hoffman; Drew Ellen,52,0,55,3
1708248312058,COGS 14B,A04,407729,Hoffman; Drew Ellen,52,0,55,3
1708248312058,COGS 14B,A05,407730,Hoffman; Drew Ellen,50,0,55,5
1708248312605,COGS 17,A01,407733,Johnson; Christine M.,50,0,50,0
1708248312605,COGS 17,A02,407734,Johnson; Christine M.,48,0,50,2
1708248312605,COGS 17,A03,407735,Johnson; Christine M.,46,0,50,4
1708248312605,COGS 17,A04,407740,Johnson; Christine M.,47,0,50,3
1708248312605,COGS 17,A05,407745,Johnson; Christine M.,48,0,50,2
1708248312605,COGS 17,A06,407824,Johnson; Christine M.,48,0,50,2
1708248312605,COGS 17,A07,407878,Johnson; Christine M.,50,0,55,5
1708248312605,COGS 17,A08,408015,Johnson; Christine M.,52,0,55,3
1708248313179,COGS 18,A01,408118,Ellis; Shannon Elizabeth,27,0,35,8
1708248313179,COGS 18,A02,408119,Ellis; Shannon Elizabeth,31,0,35,4
1708248313179,COGS 18,A03,408120,Ellis; Shannon Elizabeth,23,0,35,12
1708248313179,COGS 18,A04,408136,Ellis; Shannon Elizabeth,33,0,35,2
1708248313179,COGS 18,A05,408141,Ellis; Shannon Elizabeth,35,0,35,0
1708248313179,COGS 18,A06,408143,Ellis; Shannon Elizabeth,34,0,35,1
1708248313179,COGS 18,A07,408144,Ellis; Shannon Elizabeth,35,0,35,0
1708248313179,COGS 18,A08,408145,Ellis; Shannon Elizabeth,34,0,35,1
1708248313179,COGS 18,A09,408146,Ellis; Shannon Elizabeth,35,0,35,0
1708248313179,COGS 18,B01,408148,Ellis; Shannon Elizabeth,30,0,32,2
1708248313179,COGS 18,B02,408149,Ellis; Shannon Elizabeth,26,0,32,6
1708248313179,COGS 18,B03,408151,Ellis; Shannon Elizabeth,27,0,33,6
1708248313179,COGS 18,B04,408154,Ellis; Shannon Elizabeth,32,0,33,1
1708248313179,COGS 18,B05,408163,Ellis; Shannon Elizabeth,29,0,33,4
1708248313179,COGS 18,B06,408176,Ellis; Shannon Elizabeth,33,0,33,0
1708248313179,COGS 18,B07,408177,Ellis; Shannon Elizabeth,31,0,33,2
1708248313179,COGS 18,B08,408178,Ellis; Shannon Elizabeth,32,0,33,1
1708248313179,COGS 18,B09,408195,Ellis; Shannon Elizabeth,31,0,33,2
1708248313706,COGS 87,A00,408196,Deak; Gedeon O.,20,0,20,0
1708248313706,COGS 87,B00,479478,Fleischer; Jason G,20,0,20,0
1708248314234,COGS 100,A01,408262,Allen; Michael Gordon,54,0,56,2
1708248314234,COGS 100,A02,408263,Allen; Michael Gordon,52,0,56,4
1708248314234,COGS 100,A03,408264,Allen; Michael Gordon,55,0,56,1
1708248314234,COGS 100,A04,408265,Allen; Michael Gordon,56,0,56,0
1708248314234,COGS 100,A05,408266,Allen; Michael Gordon,56,0,56,0
1708248314234,COGS 100,A06,408349,Allen; Michael Gordon,55,0,56,1
1708248314764,COGS 101A,A01,408352,Morgan; Eric,60,0,60,0
1708248314764,COGS 101A,A02,408353,Morgan; Eric,58,0,60,2
1708248314764,COGS 101A,A03,408354,Morgan; Eric,57,0,60,3
1708248314764,COGS 101A,A04,408355,Morgan; Eric,59,0,60,1
1708248315290,COGS 101B,A01,408373,Barrera; Steven James,47,0,50,3
1708248315290,COGS 101B,A02,408380,Barrera; Steven James,46,0,50,4
1708248315290,COGS 101B,A03,408384,Barrera; Steven James,38,0,50,12
1708248315290,COGS 101B,A04,408385,Barrera; Steven James,37,0,50,13
1708248315817,COGS 101C,A01,408387,Trott; Sean Thomas,48,0,50,2
1708248315817,COGS 101C,A02,408388,Trott; Sean Thomas,43,0,50,7
1708248315817,COGS 101C,A03,408389,Trott; Sean Thomas,45,0,50,5
1708248316351,COGS 107A,A01,408396,Boyle; Mary E. T.,54,0,56,2
1708248316351,COGS 107A,A02,408397,Boyle; Mary E. T.,54,0,56,2
1708248316351,COGS 107A,A03,408399,Boyle; Mary E. T.,51,0,56,5
1708248316351,COGS 107A,A04,408409,Boyle; Mary E. T.,50,0,56,6
1708248316351,COGS 107A,A05,408410,Boyle; Mary E. T.,51,0,56,5
1708248316351,COGS 107A,A06,408411,Boyle; Mary E. T.,55,0,56,1
1708248317898,COGS 107B,A01,408413,Mooshagian; Eric Frederick,46,0,50,4
1708248317898,COGS 107B,A02,408414,Mooshagian; Eric Frederick,43,0,50,7
1708248317898,COGS 107B,A03,408428,Mooshagian; Eric Frederick,43,0,50,7
1708248317898,COGS 107B,A04,408434,Mooshagian; Eric Frederick,46,0,50,4
1708248317898,COGS 107B,A05,408435,Mooshagian; Eric Frederick,50,0,50,0
1708248317898,COGS 107B,A06,408446,Mooshagian; Eric Frederick,49,0,50,1
1708248318440,COGS 107C,A01,408500,Chiba; Andrea,51,0,60,9
1708248318440,COGS 107C,A02,408519,Chiba; Andrea,55,0,60,5
1708248318440,COGS 107C,A03,408524,Chiba; Andrea,56,0,60,4
1708248318982,COGS 108,A01,408532,Fleischer; Jason G,45,0,60,15
1708248318982,COGS 108,A02,408543,Fleischer; Jason G,58,0,60,2
1708248318982,COGS 108,A03,408544,Fleischer; Jason G,59,0,60,1
1708248318982,COGS 108,A04,408552,Fleischer; Jason G,32,0,60,28
1708248318982,COGS 108,A05,408554,Fleischer; Jason G,47,0,60,13
1708248318982,COGS 108,A06,408574,Fleischer; Jason G,43,0,60,17
1708248318982,COGS 108,A07,408576,Fleischer; Jason G,56,0,60,4
1708248319510,COGS 112,A01,408682,Hoffman; Drew Ellen,33,0,50,17
1708248319510,COGS 112,A02,408683,Hoffman; Drew Ellen,38,0,50,12
1708248319510,COGS 112,A03,408684,Hoffman; Drew Ellen,48,0,60,12
1708248320037,COGS 122,A01,408695,Dow; Steven P,21,0,50,29
1708248320563,COGS 125,A00,408697,Klemmer; Scott R,36,0,50,14
1708248321092,COGS 126,A01,408787,Hollan; James D.,44,0,50,6
1708248321624,COGS 138,A01,408866,Khosla; Meenakshi,72,0,75,3
1708248322150,COGS 142,A01,408868,Rossano; Federico,49,0,50,1
1708248322680,COGS 144,A01,408950,Rossano; Federico,48,0,50,2
1708248323206,COGS 155,A01,408993,Staff,49,0,50,1
1708248323736,COGS 157,A00,408994,Creel; Sarah,0,0,0,0
1708248324261,COGS 160,A00,409031,Deak; Gedeon O.,20,0,20,0
1708248324789,COGS 175,A01,409035,Rill; Bryan,67,0,75,8
1708248325322,COGS 178,A00,409274,Jernigan; Terry Lynne,68,0,70,2
1708248325849,COGS 179,A00,409278,Staff,40,0,40,0
1708248326378,COGS 184,A01,409317,Johnson; Christine M.,42,0,50,8
1708248326904,COGS 185,A01,409476,Tu; Zhuowen,33,0,50,17
1708248326904,COGS 185,A02,409525,Tu; Zhuowen,45,0,50,5
1708248327431,COGS 188,A01,409527,Fleischer; Jason G,46,0,75,29
1708248327962,COGS 190C,001,409528,Chiba; Andrea,9999,0,9999,0
1708248327962,COGS 190C,002,409530,Fleischer; Jason G,9999,0,9999,0
1708248327962,COGS 190C,003,409531,Boyle; Mary E. T.,9999,0,9999,0
1708248327962,COGS 190C,004,409532,Nitz; Douglas A.,9999,0,9999,0
1708248327962,COGS 190C,005,409535,Rangel; Lara M,9999,0,9999,0
1708248327962,COGS 190C,006,409536,Rossano; Federico,9999,0,9999,0
1708248327962,COGS 190C,007,409537,Deak; Gedeon O.,9999,0,9999,0
1708248327962,COGS 190C,008,409538,Trott; Sean Thomas,9999,0,9999,0
1708248327962,COGS 190C,009,409540,Creel; Sarah,9999,0,9999,0
1708248327962,COGS 190C,010,409541,Voytek; Bradley Thomas,9999,0,9999,0
1708248327962,COGS 190C,011,409542,Greene; Deanna Jacquelyn,9999,0,9999,0
1708248327962,COGS 190C,012,409543,Ellis; Shannon Elizabeth,9999,0,9999,0
1708248327962,COGS 190C,013,409546,Kirsh; David Joel,9999,0,9999,0
1708248328501,COGS 190D,A00,409547,Voytek; Bradley Thomas,20,0,20,0
1708248329030,COGS 194,A00,409548,Hill; Seth J,9999,0,9999,0
1708248329556,COGS 200,A01,406697,Creel; Sarah,0,0,0,0
1708248330084,COGS 205,A00,406698,Chiba; Andrea,20,0,20,0
1708248330612,COGS 209,A00,406699,Mukamel; Eran A,42,0,68,26
1708248331141,COGS 210C,001,406700,Kirsh; David Joel,9999,0,9999,0
1708248331141,COGS 210C,002,406701,Greene; Deanna Jacquelyn,9998,0,9999,1
1708248331141,COGS 210C,003,406702,Xia; Haijun,9999,0,9999,0
1708248331141,COGS 210C,004,406703,Nitz; Douglas A.,9998,0,9999,1
1708248331141,COGS 210C,005,406710,Hollan; James D.,9999,0,9999,0
1708248331141,COGS 210C,006,406713,De Sa; Virginia,9999,0,9999,0
1708248331141,COGS 210C,007,406714,Rossano; Federico,9999,0,9999,0
1708248331141,COGS 210C,008,406740,Kiyonaga; Anastasia,9999,0,9999,0
1708248331141,COGS 210C,009,406745,Guo; Philip J,9998,0,9999,1
1708248331141,COGS 210C,010,406746,Dow; Steven P,9999,0,9999,0
1708248331141,COGS 210C,011,406747,Bergen; Benjamin,9999,0,9999,0
1708248331141,COGS 210C,012,406758,Coulson; Seana M,9999,0,9999,0
1708248331666,COGS 211C,A00,406763,Coulson; Seana M,17,0,20,3
1708248332192,COGS 229,A00,406788,Hollan; James D. & Xia; Haijun,5,0,10,5
1708248332720,COGS 238,A00,406789,Bergen; Benjamin,17,0,20,3
1708248333244,COGS 278,A00,406794,Jernigan; Terry Lynne,18,0,20,2
1708248333782,COMM 10,A01,394711,Schmidt; Thomas Rainer,20,0,24,4
1708248333782,COMM 10,A02,394714,Schmidt; Thomas Rainer,24,0,24,0
1708248333782,COMM 10,A03,394716,Schmidt; Thomas Rainer,24,0,24,0
1708248333782,COMM 10,A04,394717,Schmidt; Thomas Rainer,22,0,24,2
1708248333782,COMM 10,A05,394731,Schmidt; Thomas Rainer,24,0,24,0
1708248333782,COMM 10,A06,394733,Schmidt; Thomas Rainer,24,0,24,0
1708248333782,COMM 10,A07,394740,Schmidt; Thomas Rainer,24,0,24,0
1708248333782,COMM 10,A08,394741,Schmidt; Thomas Rainer,24,0,24,0
1708248333782,COMM 10,A09,394751,Schmidt; Thomas Rainer,23,0,24,1
1708248333782,COMM 10,A10,394779,Schmidt; Thomas Rainer,24,0,24,0
1708248333782,COMM 10,A11,394809,Schmidt; Thomas Rainer,24,0,24,0
1708248333782,COMM 10,A12,394811,Schmidt; Thomas Rainer,24,0,24,0
1708248333782,COMM 10,A13,394818,Schmidt; Thomas Rainer,24,0,24,0
1708248333782,COMM 10,A14,394825,Schmidt; Thomas Rainer,23,0,24,1
1708248333782,COMM 10,A15,394828,Schmidt; Thomas Rainer,24,0,24,0
1708248333782,COMM 10,A16,394829,Schmidt; Thomas Rainer,0,0,0,0
1708248333782,COMM 10,A17,486828,Schmidt; Thomas Rainer,20,0,21,1
1708248334313,COMM 20,A01,394834,McKenna; Denise,69,0,70,1
1708248334855,COMM 80,A01,394849,Campbell; Robert Harold,120,0,120,0
1708248335399,COMM 100C,A01,394957,Kidman; Shawna F,24,0,25,1
1708248335399,COMM 100C,A02,394972,Kidman; Shawna F,25,0,25,0
1708248335399,COMM 100C,A03,394977,Kidman; Shawna F,22,0,25,3
1708248335399,COMM 100C,A04,394981,Kidman; Shawna F,25,0,25,0
1708248335399,COMM 100C,A05,394985,Kidman; Shawna F,24,0,25,1
1708248335399,COMM 100C,A06,394989,Kidman; Shawna F,23,0,25,2
1708248335399,COMM 100C,A07,394993,Kidman; Shawna F,24,0,25,1
1708248335399,COMM 100C,A08,394997,Kidman; Shawna F,23,0,25,2
1708248335399,COMM 100C,A09,394999,Kidman; Shawna F,25,0,25,0
1708248335399,COMM 100C,A10,395018,Kidman; Shawna F,25,0,25,0
1708248335399,COMM 100C,A11,395041,Kidman; Shawna F,24,0,25,1
1708248335399,COMM 100C,A12,395080,Kidman; Shawna F,24,0,25,1
1708248335925,COMM 101,A01,395135,Halm; Gavin Patrick,15,0,15,0
1708248335925,COMM 101,A02,395252,Halm; Gavin Patrick,15,0,15,0
1708248335925,COMM 101,A03,395253,Halm; Gavin Patrick,15,0,15,0
1708248335925,COMM 101,A04,395263,Halm; Gavin Patrick,15,0,15,0
1708248336467,COMM 101D,A00,395264,Martinico; Daniel J,13,0,16,3
1708248336994,COMM 101K,A00,395266,Ahn; Patricia Jeehyun,16,0,18,2
1708248337521,COMM 101N,A00,395267,Martinico; Daniel J,16,0,16,0
1708248338047,COMM 102C,A01,395270,Campion; Camille E,5,0,6,1
1708248338047,COMM 102C,A02,395271,Campion; Camille E,6,0,6,0
1708248338047,COMM 102C,A03,395272,Campion; Camille E,5,0,6,1
1708248338589,COMM 102M,A01,395285,Davis; Zeinabu I.,9,0,10,1
1708248338589,COMM 102M,A02,395288,Davis; Zeinabu I.,8,0,10,2
1708248339114,COMM 103D,A00,395343,Gates; Kelly,34,0,35,1
1708248339640,COMM 107,A00,395461,Serlin; David,33,0,35,2
1708248340166,COMM 109D,A00,395462,Halm; Gavin Patrick,72,0,75,3
1708248340695,COMM 110G,A00,395481,Whitworth-Smith; Andrew C,32,0,35,3
1708248341226,COMM 110M,A00,395482,Harb; Anthony Joseph,34,0,35,1
1708248341753,COMM 111A,A00,487217,Pavon Aramburu; Maria Laur,34,0,35,1
1708248342284,COMM 113T,A00,395516,Fields; Gary,35,0,35,0
1708248342864,COMM 114A,A00,395517,Zilberg; Elana,32,0,35,3
1708248343393,COMM 114B,A00,395523,Zilberg; Elana,19,0,20,1
1708248343920,COMM 114E,A00,487218,Pavon Aramburu; Maria Laur,34,0,35,1
1708248344450,COMM 114W,A00,395524,Walkover; Lillian B,17,0,18,1
1708248344976,COMM 126,A00,479341,Staff,26,0,30,4
1708248345505,COMM 132,A00,481491,Rojo Solis; Juan Jose,0,0,0,0
1708248346032,COMM 134,A00,395578,Abuelhiga; Soraya Jill,28,0,30,2
1708248346559,COMM 143,A00,395579,Rojo Solis; Juan Jose,28,0,30,2
1708248347090,COMM 146,A00,395584,Jack; Caroline Sarah,29,0,30,1
1708248347620,COMM 168,A00,395592,Harb; Anthony Joseph,29,0,30,1
1708248348146,COMM 170,A00,395608,Pavon Aramburu; Maria Laur,30,0,30,0
1708248348678,COMM 173,A00,395609,Alac; Morana,29,0,30,1
1708248349223,COMM 174,A00,395679,Alac; Morana,30,0,30,0
1708248349750,COMM 190,A00,395682,Abuelhiga; Soraya Jill,19,0,23,4
1708248349750,COMM 190,B00,395696,Staff,21,0,23,2
1708248349750,COMM 190,C00,395697,Fattal; Alexander Leor,22,0,23,1
1708248350288,CSE 8A,A50,459200,Miranda; Gregory Joseph,34,0,35,1
1708248350288,CSE 8A,A51,459205,Miranda; Gregory Joseph,34,0,35,1
1708248350288,CSE 8A,A52,459206,Miranda; Gregory Joseph,34,0,35,1
1708248350288,CSE 8A,A53,459212,Miranda; Gregory Joseph,34,0,35,1
1708248350288,CSE 8A,A54,459213,Miranda; Gregory Joseph,34,0,35,1
1708248350288,CSE 8A,A55,459232,Miranda; Gregory Joseph,34,0,35,1
1708248350814,CSE 11,A01,470735,Ochoa; Benjamin Lawrence,180,0,195,15
1708248351342,CSE 12,A01,470744,Cao; Yingjun,189,0,200,11
1708248351342,CSE 12,B01,470752,Miranda; Gregory Joseph,71,0,100,29
1708248351342,CSE 12,B02,470760,Miranda; Gregory Joseph,93,0,100,7
1708248351870,CSE 15L,A01,410174,Solares; Edwin A,6,0,10,4
1708248351870,CSE 15L,B01,410215,Solares; Edwin A,7,0,10,3
1708248351870,CSE 15L,C01,410305,Solares; Edwin A,3,0,10,7
1708248351870,CSE 15L,D01,410400,Solares; Edwin A,1,0,10,9
1708248352397,CSE 20,A01,470765,Minnes Kemp; Mor Mia,145,0,150,5
1708248352925,CSE 21,A01,470776,Jones; Miles E,68,0,73,5
1708248352925,CSE 21,A02,482889,Jones; Miles E,68,0,72,4
1708248353471,CSE 29,A01,494014,Soosai Raj; Adalbert Geral,48,0,50,2
1708248353471,CSE 29,A02,494016,Soosai Raj; Adalbert Geral,40,0,50,10
1708248353471,CSE 29,B01,494018,Shalev; Aaron D,16,0,20,4
1708248353998,CSE 30,A01,470784,Cao; Yingjun,141,0,150,9
1708248353998,CSE 30,B01,467469,Muller; P Keith,98,0,120,22
1708248354530,CSE 87,A00,410528,Moshiri; Niema,20,0,20,0
1708248355058,CSE 90,A00,486885,Minnes Kemp; Mor Mia,0,0,0,0
1708248355589,CSE 91,A00,486872,Minnes Kemp; Mor Mia,0,0,0,0
1708248355589,CSE 91,B00,486873,Minnes Kemp; Mor Mia,0,0,0,0
1708248356115,CSE 95,A00,410529,Minnes Kemp; Mor Mia,50,0,50,0
1708248356642,CSE 100,A01,470792,Sahoo; Debashis,55,0,70,15
1708248357168,CSE 100R,A01,410556,Moshiri; Niema,1,0,40,39
1708248357695,CSE 101,A01,470797,Jones; Miles E,14,0,44,30
1708248357695,CSE 101,A02,482892,Jones; Miles E,32,0,43,11
1708248358241,CSE 105,A01,470800,Micciancio; Daniele,85,0,98,13
1708248358768,CSE 107,A01,467479,Bellare; Mihir,141,0,146,5
1708248359300,CSE 109,A01,459538,Shang; Jingbo,0,0,25,25
1708248359832,CSE 110,A50,459395,Powell; Thomas Allan,49,0,50,1
1708248359832,CSE 110,A51,459512,Powell; Thomas Allan,37,0,50,13
1708248359832,CSE 110,A52,459513,Powell; Thomas Allan,46,0,50,4
1708248359832,CSE 110,A53,459514,Powell; Thomas Allan,48,0,50,2
1708248359832,CSE 110,A54,459515,Powell; Thomas Allan,48,0,50,2
1708248359832,CSE 110,A55,459516,Powell; Thomas Allan,45,0,50,5
1708248359832,CSE 110,A56,459517,Powell; Thomas Allan,47,0,48,1
1708248360356,CSE 112,A50,459518,Powell; Thomas Allan,132,0,146,14
1708248360883,CSE 120,A01,470808,Zhou; Yuan-Yuan,167,0,200,33
1708248361412,CSE 125,A00,410564,Voelker; Geoffrey M.,30,0,30,0
1708248361944,CSE 127,A01,467484,Fernandes; Earlence T,175,0,196,21
1708248362471,CSE 130,A01,467485,Polikarpova; Nadezhda,176,0,192,16
1708248362999,CSE 131,A01,459522,Ding; Yufei,36,0,50,14
1708248363530,CSE 132B,A01,470816,Deutsch; Alin Bernard,62,0,70,8
1708248364058,CSE 140,A01,410606,Orailoglu; Alex,99,0,100,1
1708248364058,CSE 140,B01,410622,Eldon; John,130,0,146,16
1708248364585,CSE 140L,A01,410655,Orailoglu; Alex,98,0,100,2
1708248364585,CSE 140L,B01,410658,Eldon; John,123,0,146,23
1708248365116,CSE 141,A01,467486,Zhao; Jishen,173,0,196,23
1708248365643,CSE 141L,A01,410685,Eldon; John,162,0,196,34
1708248366170,CSE 145,A01,410713,Kastner; Ryan Charles,25,0,25,0
1708248366697,CSE 150B,A01,470824,Gao; Sicun,310,0,362,52
1708248367225,CSE 156,A01,467487,Nakashole; Ndapandula,141,0,192,51
1708248367769,CSE 165,A01,410757,Weibel; Nadir & Schulze; Jurgen P.,40,0,50,10
1708248368301,CSE 168,A01,410759,Ramamoorthi; Ravi,24,0,25,1
1708248368301,CSE 168,A02,410761,Ramamoorthi; Ravi,24,0,25,1
1708248368828,CSE 175,A01,410764,Kumar; Rakesh,48,0,50,2
1708248369357,CSE 182,A01,455011,Bafna; Vineet,47,0,50,3
1708248369884,CSE 185,A01,410895,Gymrek; Melissa Ann,41,0,57,16
1708248369884,CSE 185,A02,479240,Gymrek; Melissa Ann,53,0,58,5
1708248370413,CSE 190,A00,410982,Grier; Daniel T,48,0,50,2
1708248370413,CSE 190,B00,410983,Riek; Laurel D,50,0,50,0
1708248370413,CSE 190,C00,410984,Staff,36,0,50,14
1708248370413,CSE 190,D00,481666,Saha; Barna & Impagliazzo; Russell,27,0,28,1
1708248370939,CSE 203A,A00,410985,Saha; Barna & Impagliazzo; Russell,0,0,0,0
1708248371469,CSE 209A,A00,410986,Grier; Daniel T,0,0,0,0
1708248371995,CSE 209B,A00,410987,Bellare; Mihir,0,0,0,0
1708248372523,CSE 217,A01,459553,Weibel; Nadir,0,0,0,0
1708248373053,CSE 218,A00,410989,Griswold; William G.,0,0,0,0
1708248373584,CSE 219,A00,410990,Hollan; James D. & Xia; Haijun,0,0,0,0
1708248374111,CSE 224,A01,470832,Snoeren; Alex C.,0,0,0,0
1708248374636,CSE 229A,A00,410993,Shalev; Aaron D,0,0,0,0
1708248375167,CSE 229C,A00,410994,Fernandes; Earlence T,0,0,0,0
1708248375695,CSE 231,A01,467488,Jhala; Ranjit,0,0,0,0
1708248376221,CSE 233,A00,410996,Vianu; Victor Dan,0,0,0,0
1708248376748,CSE 237D,A00,410998,Kastner; Ryan Charles,0,0,0,0
1708248377274,CSE 239A,A00,410999,Vianu; Victor Dan,0,0,0,0
1708248377800,CSE 239B,A00,411000,Coblenz; Michael J,0,0,0,0
1708248378338,CSE 240A,A00,411001,Chin; Bryan W.,0,0,0,0
1708248378865,CSE 252D,A00,411004,Chandraker; Manmohan Krishna,0,0,0,0
1708248379392,CSE 256,A00,411005,Nakashole; Ndapandula,0,0,0,0
1708248379919,CSE 260,A01,467491,Chin; Bryan W.,0,0,0,0
1708248380464,CSE 276B,A00,411007,Riek; Laurel D,0,0,0,0
1708248380988,CSE 276F,A01,459554,Su; Hao,0,0,0,0
1708248381515,CSE 283,A00,411009,Bafna; Vineet & Zhong; Sheng,0,0,0,0
1708248382045,CSE 290,A00,411010,Gao; Sicun,0,0,0,0
1708248382045,CSE 290,B00,411011,Chern; Albert Ren-Haur,0,0,0,0
1708248382045,CSE 290,C00,411012,Swanson; Steven James,0,0,0,0
1708248382045,CSE 290,E00,411013,Su; Hao,0,0,0,0
1708248382045,CSE 290,F00,411014,Riek; Laurel D,0,0,0,0
1708248382045,CSE 290,G00,411015,Gymrek; Melissa Ann,0,0,0,0
1708248382045,CSE 290,H00,479239,Dasgupta; Sanjoy & Gymrek; Melissa Ann,0,0,0,0
1708248382045,CSE 290,I00,481669,Bafna; Vineet,0,0,0,0
1708248382045,CSE 290,J00,494949,Paturi; Ramamohan,0,0,0,0
1708248382588,CSE 291,A00,411016,Li; Tzumao,0,0,0,0
1708248382588,CSE 291,B00,411017,Heninger; Nadia A,0,0,0,0
1708248382588,CSE 291,C00,411114,Chern; Albert Ren-Haur,0,0,0,0
1708248382588,CSE 291,D00,411115,Zhang; Yiying,0,0,0,0
1708248382588,CSE 291,E00,411116,Cheng; Chung Kuan,0,0,0,0
1708248382588,CSE 291,G00,411118,Lerner; Sorin,0,0,0,0
1708248382588,CSE 291,I00,481509,Shang; Jingbo,0,0,0,0
1708248382588,CSE 291,J00,494844,Savage; Stefan & Stefan; Deian,50,0,50,0
1708248383250,CSE 293,001,487239,Bafna; Vineet,9999,0,9999,0
1708248383250,CSE 293,002,487240,Bellare; Mihir,9999,0,9999,0
1708248383250,CSE 293,003,487241,Berg-Kirkpatrick; Taylor D,9999,0,9999,0
1708248383250,CSE 293,004,487242,Chandraker; Manmohan Krishna,9999,0,9999,0
1708248383250,CSE 293,005,487243,Cheng; Chung Kuan,9999,0,9999,0
1708248383250,CSE 293,006,487244,Christensen; Henrik I,9999,0,9999,0
1708248383250,CSE 293,007,487245,Coblenz; Michael J,9999,0,9999,0
1708248383250,CSE 293,008,487363,Cottrell; Garrison W,9999,0,9999,0
1708248383250,CSE 293,009,487366,Deutsch; Alin Bernard,9999,0,9999,0
1708248383250,CSE 293,010,487433,Esmaeilzadeh; Hadi,9999,0,9999,0
1708248383250,CSE 293,011,487434,Freund; Yoav,9999,0,9999,0
1708248383250,CSE 293,012,487455,Griswold; William G.,9999,0,9999,0
1708248383250,CSE 293,013,487469,Gymrek; Melissa Ann,9999,0,9999,0
1708248383250,CSE 293,014,487470,Heninger; Nadia A,9999,0,9999,0
1708248383250,CSE 293,015,487471,Impagliazzo; Russell,9999,0,9999,0
1708248383250,CSE 293,016,487472,Jhala; Ranjit,9999,0,9999,0
1708248383250,CSE 293,017,487473,Kahng; Andrew Byun,9999,0,9999,0
1708248383250,CSE 293,018,487474,Kane; Daniel Mertz,9999,0,9999,0
1708248383250,CSE 293,019,487475,Kriegman; David J,9999,0,9999,0
1708248383250,CSE 293,020,487476,Kumar; Arun Kumar,9999,0,9999,0
1708248383250,CSE 293,021,487477,Lerner; Sorin,9999,0,9999,0
1708248383250,CSE 293,022,487478,Lovett; Shachar,9999,0,9999,0
1708248383250,CSE 293,023,487520,McAuley; Julian John,9999,0,9999,0
1708248383250,CSE 293,024,487522,Micciancio; Daniele,9999,0,9999,0
1708248383250,CSE 293,025,487577,Orailoglu; Alex,9999,0,9999,0
1708248383250,CSE 293,026,487586,Pannuto; Patrick William,9999,0,9999,0
1708248383250,CSE 293,027,487598,Paturi; Ramamohan,9999,0,9999,0
1708248383250,CSE 293,028,487604,Polikarpova; Nadezhda,9999,0,9999,0
1708248383250,CSE 293,029,487609,Politz; Joseph Gibbs,9999,0,9999,0
1708248383250,CSE 293,030,487642,Porter; George M,9999,0,9999,0
1708248383250,CSE 293,031,487665,Porter; Leonard Emerson,9999,0,9999,0
1708248383250,CSE 293,032,487689,Ramamoorthi; Ravi,9999,0,9999,0
1708248383250,CSE 293,033,487698,Riek; Laurel D,9999,0,9999,0
1708248383250,CSE 293,034,487712,Sahoo; Debashis,9999,0,9999,0
1708248383250,CSE 293,035,487721,Saul; Lawrence,9999,0,9999,0
1708248383250,CSE 293,036,487735,Savage; Stefan,9999,0,9999,0
1708248383250,CSE 293,037,487744,Schulze; Jurgen P.,9999,0,9999,0
1708248383250,CSE 293,038,487758,Snoeren; Alex C.,9999,0,9999,0
1708248383250,CSE 293,039,487767,Shang; Jingbo,9999,0,9999,0
1708248383250,CSE 293,040,487790,Stefan; Deian,9999,0,9999,0
1708248383250,CSE 293,041,487817,Su; Hao,9999,0,9999,0
1708248383250,CSE 293,042,487827,Swanson; Steven James,9999,0,9999,0
1708248383250,CSE 293,043,487830,Tullsen; Dean Michael,9999,0,9999,0
1708248383250,CSE 293,044,487837,Vaccaro; Kristen Marie,9999,0,9999,0
1708248383250,CSE 293,045,487838,Voelker; Geoffrey M.,9999,0,9999,0
1708248383250,CSE 293,046,487842,Zhao; Jishen,9999,0,9999,0
1708248383250,CSE 293,047,487847,Zhou; Yuan-Yuan,9999,0,9999,0
1708248383250,CSE 293,048,487852,Gao; Sicun,9999,0,9999,0
1708248383250,CSE 293,049,487853,Weibel; Nadir,9999,0,9999,0
1708248383250,CSE 293,050,487854,Gupta; Rajesh K.,9999,0,9999,0
1708248383250,CSE 293,051,487855,Soosai Raj; Adalbert Geral,9999,0,9999,0
1708248383250,CSE 293,052,494373,Zhang; Hao,9999,0,9999,0
1708248383789,CSE 294,A00,411124,Voelker; Geoffrey M.,15,0,15,0
1708248384316,CSS 100,A01,396053,Trott; Sean Thomas,43,0,50,7
1708248384842,CSS 120,A01,479237,Mignozzetti; Umberto,47,0,50,3
1708248384842,CSS 120,A02,479238,Mignozzetti; Umberto,50,0,50,0
1708248385369,CSS 209,A00,396054,Styler; William Francis,21,0,35,14
1708248385897,CSS 296,001,396055,Mignozzetti; Umberto,0,0,0,1
1708248385897,CSS 296,002,396056,Styler; William Francis,0,0,0,1
1708248385897,CSS 296,003,396057,Broz; James Lawrence,0,0,0,2
1708248385897,CSS 296,004,396058,Elliott; Graham,0,0,0,5
1708248385897,CSS 296,005,396059,Sun; Feiyang,0,0,0,0
1708248385897,CSS 296,006,396060,Dewaard; Andrew Michael,0,0,0,0
1708248386425,DDPM 210,A00,400652,Ma; Joseph David,36,0,36,0
1708248386952,DDPM 211,A00,400653,Ma; Joseph David,36,0,36,0
1708248387481,DDPM 214,A00,400720,Ma; Joseph David,36,0,36,0
1708248388007,DERM 296,001,464131,Staff,50,0,50,0
1708248388007,DERM 296,002,464178,Staff,50,0,50,0
1708248388007,DERM 296,003,464181,Staff,50,0,50,0
1708248388592,DOC 3,A01,399409,Strom; Megan C.,0,0,0,0
1708248388592,DOC 3,A02,399414,Strom; Megan C.,0,0,0,0
1708248388592,DOC 3,A03,399432,Strom; Megan C.,0,0,0,0
1708248388592,DOC 3,A04,399461,Strom; Megan C.,0,0,0,0
1708248388592,DOC 3,A05,399470,Strom; Megan C.,0,0,0,0
1708248388592,DOC 3,A06,399476,Strom; Megan C.,0,0,0,0
1708248388592,DOC 3,A07,399547,Strom; Megan C.,0,0,0,0
1708248388592,DOC 3,A08,399548,Strom; Megan C.,0,0,0,0
1708248388592,DOC 3,A09,399675,Strom; Megan C.,0,0,0,0
1708248388592,DOC 3,A10,399687,Strom; Megan C.,0,0,0,0
1708248388592,DOC 3,A11,399704,Strom; Megan C.,0,0,0,0
1708248388592,DOC 3,A12,399707,Strom; Megan C.,0,0,0,0
1708248388592,DOC 3,A13,399714,Strom; Megan C.,0,0,0,0
1708248388592,DOC 3,A14,399721,Strom; Megan C.,0,0,0,0
1708248388592,DOC 3,A15,399765,Strom; Megan C.,0,0,0,0
1708248388592,DOC 3,A16,399766,Strom; Megan C.,0,0,0,0
1708248388592,DOC 3,B01,399786,Strom; Megan C.,0,0,0,0
1708248388592,DOC 3,B02,399787,Strom; Megan C.,0,0,0,0
1708248388592,DOC 3,B03,399788,Strom; Megan C.,0,0,0,0
1708248388592,DOC 3,B04,399845,Strom; Megan C.,0,0,0,0
1708248388592,DOC 3,B05,399846,Strom; Megan C.,0,0,0,0
1708248388592,DOC 3,B06,399895,Strom; Megan C.,0,0,0,0
1708248388592,DOC 3,B07,399916,Strom; Megan C.,0,0,0,0
1708248388592,DOC 3,B08,400073,Strom; Megan C.,0,0,0,0
1708248388592,DOC 3,B09,400074,Strom; Megan C.,0,0,0,0
1708248388592,DOC 3,B10,400076,Strom; Megan C.,0,0,0,0
1708248388592,DOC 3,B11,400077,Strom; Megan C.,0,0,0,0
1708248388592,DOC 3,B12,400078,Strom; Megan C.,0,0,0,0
1708248388592,DOC 3,B13,400079,Strom; Megan C.,0,0,0,0
1708248388592,DOC 3,B14,400080,Strom; Megan C.,0,0,0,0
1708248388592,DOC 3,B15,400081,Strom; Megan C.,0,0,0,0
1708248388592,DOC 3,B16,400082,Strom; Megan C.,0,0,0,0
1708248388592,DOC 3,C01,400084,Chapman; Dillon,0,0,0,0
1708248388592,DOC 3,C02,400085,Chapman; Dillon,0,0,0,0
1708248388592,DOC 3,C03,400086,Chapman; Dillon,0,0,0,0
1708248388592,DOC 3,C04,400087,Chapman; Dillon,0,0,0,0
1708248388592,DOC 3,C05,400113,Chapman; Dillon,0,0,0,0
1708248388592,DOC 3,C06,400114,Chapman; Dillon,0,0,0,0
1708248388592,DOC 3,C07,400117,Chapman; Dillon,0,0,0,0
1708248388592,DOC 3,C08,400118,Chapman; Dillon,0,0,0,0
1708248388592,DOC 3,C09,400119,Chapman; Dillon,0,0,0,0
1708248388592,DOC 3,C10,400121,Chapman; Dillon,0,0,0,0
1708248388592,DOC 3,C11,400122,Chapman; Dillon,0,0,0,0
1708248388592,DOC 3,C12,400126,Chapman; Dillon,0,0,0,0
1708248388592,DOC 3,C13,400157,Chapman; Dillon,0,0,0,0
1708248388592,DOC 3,C14,400240,Chapman; Dillon,0,0,0,0
1708248388592,DOC 3,C15,400241,Chapman; Dillon,0,0,0,0
1708248388592,DOC 3,C16,400242,Chapman; Dillon,0,0,0,0
1708248388592,DOC 3,D01,400253,Chapman; Dillon,0,0,0,0
1708248388592,DOC 3,D02,400294,Chapman; Dillon,0,0,0,0
1708248388592,DOC 3,D03,400295,Chapman; Dillon,0,0,0,0
1708248388592,DOC 3,D04,400430,Chapman; Dillon,0,0,0,0
1708248388592,DOC 3,D05,400438,Chapman; Dillon,0,0,0,0
1708248388592,DOC 3,D06,400439,Chapman; Dillon,0,0,0,0
1708248388592,DOC 3,D07,400441,Chapman; Dillon,0,0,0,0
1708248388592,DOC 3,D08,400442,Chapman; Dillon,0,0,0,0
1708248388592,DOC 3,D09,400443,Chapman; Dillon,0,0,0,0
1708248388592,DOC 3,D10,400445,Chapman; Dillon,0,0,0,0
1708248388592,DOC 3,D11,400446,Chapman; Dillon,0,0,0,0
1708248388592,DOC 3,D12,400447,Chapman; Dillon,0,0,0,0
1708248388592,DOC 3,D13,400448,Chapman; Dillon,0,0,0,0
1708248388592,DOC 3,D14,400646,Chapman; Dillon,0,0,0,0
1708248388592,DOC 3,D15,400647,Chapman; Dillon,0,0,0,0
1708248388592,DOC 3,D16,400648,Chapman; Dillon,0,0,0,0
1708248389123,DOC 100D,A00,400649,Pass; Natalye Joann,22,0,25,3
1708248389123,DOC 100D,B00,400650,Pass; Natalye Joann,25,0,25,0
1708248389655,DSC 10,A01,398041,Tiefenbruck; Janine LoBue,142,0,147,5
1708248389655,DSC 10,B01,398180,Tiefenbruck; Janine LoBue,144,0,147,3
1708248389655,DSC 10,C01,398400,Tiefenbruck; Janine LoBue,143,0,147,4
1708248390180,DSC 20,A01,398415,Langlois; Marina,200,0,200,0
1708248390706,DSC 30,A01,398436,Langlois; Marina,156,0,158,2
1708248390706,DSC 30,B01,398439,Langlois; Marina,144,0,150,6
1708248391236,DSC 40A,A01,398441,Rampure; Suraj,123,0,125,2
1708248391236,DSC 40A,B01,398443,Rampure; Suraj,125,0,125,0
1708248391761,DSC 40B,A01,398445,Staff,150,0,150,0
1708248392289,DSC 80,A01,398470,Lau; Samuel Ethan,70,0,70,0
1708248392289,DSC 80,B01,398541,Lau; Samuel Ethan,68,0,70,2
1708248392815,DSC 95,A01,398650,Rampure; Suraj,50,0,50,0
1708248393345,DSC 100,A01,398683,Salimi; Babak,147,0,150,3
1708248393872,DSC 102,A01,398708,Jin; Haojian,145,0,150,5
1708248394419,DSC 106,A01,398711,Wilber; Jared Dane,146,0,149,3
1708248394946,DSC 140A,A01,398724,Eldridge; Justin Matthew,98,0,100,2
1708248394946,DSC 140A,B01,479346,Ustun; Tevfik Berk,50,0,50,0
1708248395472,DSC 140B,A01,398726,Weng; Tsui-Wei (lily),144,0,150,6
1708248396016,DSC 190,A01,398738,Silberman; Jack,20,0,20,0
1708248396016,DSC 190,B01,479475,Ustun; Tevfik Berk,29,0,30,1
1708248396016,DSC 190,C01,481341,Rahman; Tauhidur,50,0,50,0
1708248396610,DSC 197,001,494360,Eldridge; Justin Matthew,9999,0,9999,0
1708248397137,DSC 214,A00,477322,Staff,22,0,60,38
1708248397664,DSC 231,A01,398863,Gupta; Rajesh K.,60,0,60,0
1708248398191,DSC 232R,A01,487133,Solares; Edwin A,39,0,60,21
1708248398721,DSC 240,A00,398957,Belkin; Mikhail,74,0,90,16
1708248399772,DSC 243,A00,398958,Ma; Yian,59,0,60,1
1708248400301,DSC 245,A00,398959,Huang; Biwei,42,0,60,18
1708248400828,DSC 253,A00,398960,Shang; Jingbo,0,0,30,30
1708248401354,DSC 258R,A01,398962,Shang; Jingbo,43,0,60,17
1708248401880,DSC 267R,A01,398964,Staff,56,0,60,4
1708248402417,DSC 291,A00,398965,Belkin; Mikhail,90,0,90,0
1708248402417,DSC 291,B00,398966,Weng; Tsui-Wei (lily),90,0,90,0
1708248402417,DSC 291,C00,398997,Staff,60,0,60,0
1708248402417,DSC 291,D00,398998,Zhang; Hao,40,0,40,0
1708248402417,DSC 291,E00,477386,Staff,50,0,50,0
1708248402945,DSC 293,A00,477388,Ustun; Tevfik Berk,9990,0,9999,9
1708248403476,DSC 295,A00,480826,Danks; David J,30,0,40,10
1708248404004,DSE 220,A00,398034,Dasgupta; Sanjoy,20,0,20,0
1708248404530,DSE 230,A00,398035,Nguyen; Mai Huong,20,0,20,0
1708248405058,DSE 260B,A00,398037,Altintas De Callaf; Ilkay,20,0,20,0
1708248405589,DSGN 1,A01,408210,Klemmer; Scott R,46,0,50,4
1708248405589,DSGN 1,A02,408245,Klemmer; Scott R,47,0,50,3
1708248406116,DSGN 119,A00,407467,Hollan; James D. & Xia; Haijun,76,0,90,14
1708248406642,DSGN 160,A00,494371,Aronoff-Spencer; Eliah Sea,15,0,20,5
1708248407168,DSGN 219,A00,474323,Hollan; James D. & Xia; Haijun,15,0,15,0
1708248407695,ECE 5,A01,428645,Morris; Karcher William,21,0,24,3
1708248407695,ECE 5,A02,428646,Morris; Karcher William,24,0,24,0
1708248407695,ECE 5,A03,428647,Morris; Karcher William,24,0,24,0
1708248407695,ECE 5,A04,428648,Morris; Karcher William,24,0,24,0
1708248408221,ECE 15,A01,428650,Sahay; Rajeev,119,0,120,1
1708248408747,ECE 16,A01,428652,Wang; Edward Jay,22,0,30,8
1708248409273,ECE 17,A01,428654,Sahay; Rajeev,48,0,60,12
1708248409806,ECE 25,A50,428657,Dey; Sujit,30,0,30,0
1708248409806,ECE 25,A51,428658,Dey; Sujit,30,0,30,0
1708248410333,ECE 30,A50,428674,Mir Arabbaygi; Siavash,28,0,30,2
1708248410333,ECE 30,A51,428675,Mir Arabbaygi; Siavash,28,0,30,2
1708248410333,ECE 30,A52,428676,Mir Arabbaygi; Siavash,28,0,30,2
1708248410333,ECE 30,A53,428679,Mir Arabbaygi; Siavash,29,0,30,1
1708248410333,ECE 30,A54,428680,Mir Arabbaygi; Siavash,30,0,30,0
1708248410860,ECE 35,A50,428684,Taur; Yuan,29,0,30,1
1708248410860,ECE 35,A51,428685,Taur; Yuan,30,0,30,0
1708248410860,ECE 35,A52,428686,Taur; Yuan,30,0,30,0
1708248410860,ECE 35,A53,428687,Taur; Yuan,29,0,30,1
1708248411386,ECE 45,A01,428689,Zeger; Kenneth A.,137,0,150,13
1708248411933,ECE 65,A50,428701,Baghdadchi; Saharnaz,28,0,30,2
1708248411933,ECE 65,A51,428742,Baghdadchi; Saharnaz,29,0,30,1
1708248411933,ECE 65,A52,428743,Baghdadchi; Saharnaz,30,0,30,0
1708248411933,ECE 65,A53,428754,Baghdadchi; Saharnaz,26,0,30,4
1708248411933,ECE 65,A54,428796,Baghdadchi; Saharnaz,30,0,30,0
1708248411933,ECE 65,A55,428797,Baghdadchi; Saharnaz,29,0,30,1
1708248411933,ECE 65,A56,428803,Baghdadchi; Saharnaz,30,0,30,0
1708248412463,ECE 100,A01,428978,Baghdadchi; Saharnaz,29,0,30,1
1708248412463,ECE 100,A02,428988,Baghdadchi; Saharnaz,30,0,30,0
1708248412463,ECE 100,A03,428989,Baghdadchi; Saharnaz,29,0,30,1
1708248412463,ECE 100,A04,429008,Baghdadchi; Saharnaz,29,0,30,1
1708248413005,ECE 101,A01,429017,Bharadia; Dinesh,57,0,60,3
1708248413005,ECE 101,A02,429019,Bharadia; Dinesh,60,0,60,0
1708248413531,ECE 103,A01,429027,Kuzum; Duygu,74,0,75,1
1708248414058,ECE 107,A01,429055,Fullerton; Eric E,73,0,75,2
1708248414824,ECE 108,A01,429068,Kang; Mingu,53,0,60,7
1708248415351,ECE 109,A01,429085,Orlitsky; Alon,98,0,100,2
1708248415351,ECE 109,A02,429098,Orlitsky; Alon,96,0,100,4
1708248415878,ECE 111,A01,429132,Turakhia; Yatish Girish,173,0,180,7
1708248416409,ECE 115,A01,429314,Yip; Michael,22,0,26,4
1708248416938,ECE 123,A01,429327,Sievenpiper; Daniel F.,56,0,60,4
1708248417485,ECE 125B,A50,429397,Esmaili; Gholamreza,23,0,24,1
1708248417485,ECE 125B,A51,429627,Esmaili; Gholamreza,23,0,24,1
1708248418012,ECE 134,A00,429630,Ng; Tse Nga,50,0,50,0
1708248418540,ECE 136L,A01,429634,Dayeh; Shadi Ahmad,3,0,5,2
1708248418540,ECE 136L,A02,429636,Dayeh; Shadi Ahmad,3,0,5,2
1708248418540,ECE 136L,A03,429637,Dayeh; Shadi Ahmad,5,0,5,0
1708248418540,ECE 136L,A04,429641,Dayeh; Shadi Ahmad,5,0,5,0
1708248419070,ECE 139,A00,429642,Nomura; Kenji,17,0,20,3
1708248419604,ECE 140B,A01,455349,Khoshabeh; Ramsin & Gessner; Richard K.,19,0,24,5
1708248419604,ECE 140B,A02,455351,Khoshabeh; Ramsin & Gessner; Richard K.,23,0,24,1
1708248419604,ECE 140B,A03,455354,Khoshabeh; Ramsin & Gessner; Richard K.,21,0,22,1
1708248420133,ECE 141B,A01,455355,Gessner; Richard K.,48,0,50,2
1708248420660,ECE 148,A01,492803,Silberman; Jack,0,0,0,0
1708248421191,ECE 153,A01,429655,Naghizadeh Ardabili; Parin,94,0,100,6
1708248421717,ECE 157A,A01,429657,Bharadia; Dinesh,22,0,25,3
1708248422243,ECE 158B,A01,429659,Zhang; Xinyu,14,0,20,6
1708248422785,ECE 161C,A00,429660,Cosman; Pamela C.,58,0,60,2
1708248423325,ECE 163,A00,429664,Hsueh; Tzu-Chien,95,0,100,5
1708248423866,ECE 165,A51,429672,Mercier; Patrick Philip,20,0,30,10
1708248423866,ECE 165,A52,429673,Mercier; Patrick Philip,22,0,30,8
1708248423866,ECE 165,A53,429674,Mercier; Patrick Philip,30,0,30,0
1708248423866,ECE 165,A54,429675,Mercier; Patrick Philip,30,0,30,0
1708248424394,ECE 171A,A01,429813,Zheng; Yang,96,0,100,4
1708248424923,ECE 175B,A01,429886,Xie; Pengtao,72,0,75,3
1708248425451,ECE 183,A01,430023,Mookherjea; Shayan,26,0,30,4
1708248425984,ECE 185,A01,430025,Papen; George C.,19,0,20,1
1708248426515,ECE 191,A00,430039,Zhang; Xinyu,30,0,30,0
1708248427058,ECE 196,A00,430040,Morris; Karcher William,18,0,24,6
1708248427058,ECE 196,B00,430045,Morris; Karcher William,23,0,24,1
1708248427584,ECE 198,001,430052,Nguyen; Truong Quang,9999,0,9999,0
1708248428247,ECE 200,001,438659,Atanasov; Nikolay A.,9999,0,9999,0
1708248428247,ECE 200,002,438660,Bharadia; Dinesh,9999,0,9999,0
1708248428247,ECE 200,003,438668,Cheng; Chung Kuan,9999,0,9999,0
1708248428247,ECE 200,004,438845,Cosman; Pamela C.,9999,0,9999,0
1708248428247,ECE 200,005,438846,Dayeh; Shadi Ahmad,9999,0,9999,0
1708248428247,ECE 200,006,438847,Fainman; Yeshaiahu,9999,0,9999,0
1708248428247,ECE 200,007,438848,Ford; Joseph Earl,9999,0,9999,0
1708248428247,ECE 200,008,438849,Franceschetti; Massimo,9999,0,9999,0
1708248428247,ECE 200,009,438850,Fullerton; Eric E,9999,0,9999,0
1708248428247,ECE 200,010,438851,Galton; Ian A,9999,0,9999,0
1708248428247,ECE 200,011,438852,Gilja; Vikash,9999,0,9999,0
1708248428247,ECE 200,012,438853,Hall; Drew A.,9999,0,9999,0
1708248428247,ECE 200,013,438854,Hsueh; Tzu-Chien,9999,0,9999,0
1708248428247,ECE 200,014,438855,Javidi; Tara,9999,0,9999,0
1708248428247,ECE 200,015,438865,Kahng; Andrew Byun,9999,0,9999,0
1708248428247,ECE 200,016,438866,Kim; Young-Han,9999,0,9999,0
1708248428247,ECE 200,017,438876,Koushanfar; Farinaz,9999,0,9999,0
1708248428247,ECE 200,018,438877,Kuzum; Duygu,9999,0,9999,0
1708248428247,ECE 200,019,438934,Le; Hanh-Phuc,9999,0,9999,0
1708248428247,ECE 200,020,438954,Lin; Bill,9999,0,9999,0
1708248428247,ECE 200,021,438955,Liu; Zhaowei,9999,0,9999,0
1708248428247,ECE 200,022,438957,Lo; Yu-Hwa,9999,0,9999,0
1708248428247,ECE 200,023,439086,Lomakin; Vitaliy,9999,0,9999,0
1708248428247,ECE 200,024,439087,Mercier; Patrick Philip,9999,0,9999,0
1708248428247,ECE 200,025,439088,Meyer; Florian,9999,0,9999,0
1708248428247,ECE 200,026,439090,Milstein; Laurence B.,9999,0,9999,0
1708248428247,ECE 200,027,439208,Mir Arabbaygi; Siavash,9999,0,9999,0
1708248428247,ECE 200,028,439209,Mookherjea; Shayan,9999,0,9999,0
1708248428247,ECE 200,029,439210,Morris; Karcher William,9999,0,9999,0
1708248428247,ECE 200,030,439211,Ng; Tse Nga,9999,0,9999,0
1708248428247,ECE 200,031,439219,Nguyen; Truong Quang,9999,0,9999,0
1708248428247,ECE 200,032,439220,Nomura; Kenji,9999,0,9999,0
1708248428247,ECE 200,033,439221,Orlitsky; Alon,9999,0,9999,0
1708248428247,ECE 200,034,439222,Pal; Piya,9999,0,9999,0
1708248428247,ECE 200,035,439223,Papen; George C.,9999,0,9999,0
1708248428247,ECE 200,036,439224,Radic; Stojan,9999,0,9999,0
1708248428247,ECE 200,037,439225,Rao; Bhaskar D.,9999,0,9999,0
1708248428247,ECE 200,038,439227,Rao; Ramesh R,9999,0,9999,0
1708248428247,ECE 200,039,439231,Rebeiz; Gabriel,9999,0,9999,0
1708248428247,ECE 200,040,439232,Sanford; John R,9999,0,9999,0
1708248428247,ECE 200,041,439302,Siegel; Paul H.,9999,0,9999,0
1708248428247,ECE 200,042,439303,Sievenpiper; Daniel F.,9999,0,9999,0
1708248428247,ECE 200,043,439305,Sworder; David D.,9999,0,9999,0
1708248428247,ECE 200,044,439306,Taur; Yuan,9999,0,9999,0
1708248428247,ECE 200,045,439419,Touri; Behrouz,9999,0,9999,0
1708248428247,ECE 200,046,439425,Trivedi; Mohan M.,9999,0,9999,0
1708248428247,ECE 200,047,439538,Vasconcelos; Nuno,9999,0,9999,0
1708248428247,ECE 200,048,439546,Wang; Xiaolong,9999,0,9999,0
1708248428247,ECE 200,049,439549,Xie; Pengtao,9999,0,9999,0
1708248428247,ECE 200,050,439551,Yip; Michael,9999,0,9999,0
1708248428247,ECE 200,051,439553,Zeger; Kenneth A.,9999,0,9999,0
1708248428247,ECE 200,052,439554,Zhang; Xinyu,9999,0,9999,0
1708248428247,ECE 200,053,439555,Zheng; Yang,9999,0,9999,0
1708248428247,ECE 200,054,439557,Turakhia; Yatish Girish,9999,0,9999,0
1708248428247,ECE 200,055,439558,Kang; Mingu,9999,0,9999,0
1708248428247,ECE 200,056,439560,Shi; Yuanyuan,9999,0,9999,0
1708248428247,ECE 200,057,439564,Wang; Edward Jay,9999,0,9999,0
1708248428247,ECE 200,058,439565,Antipa; Nicholas A,9999,0,9999,0
1708248428247,ECE 200,059,439566,Zheng; Yang,9999,0,9999,0
1708248428247,ECE 200,060,492991,Yu; Paul K L,9999,0,9999,0
1708248428247,ECE 200,061,492992,Ndao; Abdoulaye,9999,0,9999,0
1708248428247,ECE 200,062,493019,Naghizadeh Ardabili; Parin,9999,0,9999,0
1708248428247,ECE 200,063,493033,Sahay; Rajeev,9999,0,9999,0
1708248428773,ECE 208,A00,430053,Mir Arabbaygi; Siavash,0,0,0,0
1708248429299,ECE 212CN,A00,430054,Liu; Zhaowei,0,0,0,0
1708248429825,ECE 222C,A00,430055,Lomakin; Vitaliy,0,0,0,0
1708248430352,ECE 227,A00,430057,Franceschetti; Massimo,0,0,0,0
1708248430883,ECE 228,A00,430078,Shi; Yuanyuan,0,0,0,0
1708248431410,ECE 230C,A00,430079,Yu; Paul K L,0,0,0,0
1708248431935,ECE 235,A00,430081,Taur; Yuan,0,0,0,0
1708248432461,ECE 236B,A00,430082,Lo; Yu-Hwa,0,0,0,0
1708248432994,ECE 240C,A00,430083,Mookherjea; Shayan,0,0,0,0
1708248433521,ECE 250,A00,430115,Touri; Behrouz,0,0,0,0
1708248434053,ECE 251B,A00,430166,Vasconcelos; Manuela,0,0,0,0
1708248434578,ECE 258B,A00,430167,Milstein; Laurence B.,0,0,0,0
1708248435106,ECE 260C,A00,430168,Eldon; John,0,0,0,0
1708248435631,ECE 264B,A00,430169,Galton; Ian A,0,0,0,0
1708248436161,ECE 265B,A00,430170,Gudem; Prasad S.S.,0,0,0,0
1708248436686,ECE 266,A01,430273,Hall; Drew A.,0,0,0,0
1708248437213,ECE 271C,A00,430283,Vasconcelos; Nuno,0,0,0,0
1708248437739,ECE 272A,A01,430340,Poveda Fonseca; Jorge,0,0,0,0
1708248438269,ECE 273,A00,430352,Wang; Jun-Kun,0,0,0,0
1708248438795,ECE 276B,A00,430353,Atanasov; Nikolay A.,0,0,0,0
1708248439327,ECE 284,A00,430385,Wang; Edward,0,0,0,0
1708248440092,ECE 285,A00,430386,Wang; Xiaolong,0,0,0,0
1708248440092,ECE 285,B00,430387,Antipa; Nicholas A,0,0,0,0
1708248440619,ECON 1,A01,409576,Crane; Meredith Helen,87,0,100,13
1708248440619,ECON 1,A02,409577,Crane; Meredith Helen,96,0,100,4
1708248440619,ECON 1,A03,409578,Crane; Meredith Helen,97,0,100,3
1708248441145,ECON 2,A01,409580,Candido; Maria Teresa,70,0,75,5
1708248441672,ECON 3,A01,409582,Crane; Meredith Helen,109,0,120,11
1708248441672,ECON 3,A02,409583,Crane; Meredith Helen,114,0,115,1
1708248441672,ECON 3,A03,409584,Crane; Meredith Helen,110,0,115,5
1708248442203,ECON 4,A01,409586,Levkoff; Steven B.,88,0,92,4
1708248442203,ECON 4,A02,409587,Levkoff; Steven B.,89,0,90,1
1708248442736,ECON 5,A01,409589,Dai; Yinlin,53,0,58,5
1708248442736,ECON 5,A02,409590,Dai; Yinlin,56,0,58,2
1708248442736,ECON 5,A03,409591,Dai; Yinlin,54,0,54,0
1708248442736,ECON 5,A04,409593,Dai; Yinlin,55,0,55,0
1708248442736,ECON 5,B01,409595,Dai; Yinlin,57,0,58,1
1708248442736,ECON 5,B02,409596,Dai; Yinlin,49,0,49,0
1708248442736,ECON 5,B03,409597,Dai; Yinlin,59,0,59,0
1708248442736,ECON 5,B04,409598,Dai; Yinlin,55,0,55,0
1708248442736,ECON 5,C01,487209,Staff,40,0,45,5
1708248443281,ECON 100A,A01,409600,Famulari; Melissa,94,0,100,6
1708248443281,ECON 100A,A02,409601,Famulari; Melissa,98,0,100,2
1708248443281,ECON 100A,A03,409604,Famulari; Melissa,98,0,100,2
1708248443281,ECON 100A,B01,409610,Famulari; Melissa,76,0,80,4
1708248443807,ECON 100AH,A00,409612,Famulari; Melissa,19,0,20,1
1708248444334,ECON 100B,A01,409614,Grigoryan; Aram,109,0,120,11
1708248444334,ECON 100B,A02,409616,Grigoryan; Aram,117,0,120,3
1708248444334,ECON 100B,B01,409626,Grigoryan; Aram,47,0,50,3
1708248444334,ECON 100B,B02,409627,Grigoryan; Aram,49,0,50,1
1708248444865,ECON 100C,A01,409629,Levkoff; Steven B.,144,0,146,2
1708248444865,ECON 100C,B01,409632,Levkoff; Steven B.,143,0,146,3
1708248445393,ECON 106,A00,409633,Bowen; T. Renee,90,0,90,0
1708248445927,ECON 109T,A00,409634,Trevino; Isabel,18,0,20,2
1708248446458,ECON 110A,A01,409637,Staff,68,0,75,7
1708248446986,ECON 110B,A01,409663,Herreno Lopera; Juan,119,0,125,6
1708248446986,ECON 110B,A02,409682,Herreno Lopera; Juan,125,0,125,0
1708248446986,ECON 110B,B01,409734,Herreno Lopera; Juan,99,0,100,1
1708248447521,ECON 120A,A01,409739,Candido; Maria Teresa,84,0,90,6
1708248447521,ECON 120A,A02,409740,Candido; Maria Teresa,87,0,90,3
1708248447521,ECON 120A,B01,409742,Candido; Maria Teresa,85,0,90,5
1708248447521,ECON 120A,B02,409743,Candido; Maria Teresa,90,0,90,0
1708248448054,ECON 120B,A01,409748,Ma; Xinwei,128,0,130,2
1708248448054,ECON 120B,A02,409754,Ma; Xinwei,128,0,130,2
1708248448054,ECON 120B,B01,409756,Ma; Xinwei,26,0,40,14
1708248448601,ECON 120C,A01,409758,Sun; Yixiao,141,0,146,5
1708248448601,ECON 120C,B01,409762,Sun; Yixiao,144,0,146,2
1708248449146,ECON 129,A00,409763,Eckert; Fabian Paul,44,0,50,6
1708248449676,ECON 134,A00,409764,Gelber; Alexander Michael,45,0,50,5
1708248449676,ECON 134,B00,409765,Gelber; Alexander Michael,49,0,50,1
1708248450201,ECON 137,A00,409766,Niehaus; Paul,19,0,20,1
1708248450786,ECON 142,A00,409767,Trevino; Isabel,39,0,40,1
1708248450786,ECON 142,B00,409768,Trevino; Isabel,38,0,40,2
1708248451313,ECON 164,A00,409771,Muralidharan; Karthik,119,0,120,1
1708248451846,ECON 172A,A01,409773,Newhouse; Herbert S,67,0,75,8
1708248452381,ECON 172B,A01,409775,Newhouse; Herbert S,74,0,75,1
1708248452381,ECON 172B,B01,409777,Newhouse; Herbert S,71,0,75,4
1708248453439,ECON 191A,A00,409780,Cullen; Julie,20,0,20,0
1708248453971,ECON 200C,A00,409782,Du; Songzi,34,0,35,1
1708248454498,ECON 210C,A00,409784,Herreno Lopera; Juan & Wieland; Johannes Friedrich,35,0,35,0
1708248455029,ECON 220C,A00,409785,Sun; Yixiao,35,0,35,0
1708248455560,ECON 220F,A00,409786,Carson; Richard T,27,0,30,3
1708248456090,ECON 221,A00,409787,Zhu; Ying,25,0,25,0
1708248456618,ECON 241,A00,409788,Muralidharan; Karthik,18,0,20,2
1708248457145,ECON 243,A00,409789,Niehaus; Paul,18,0,20,2
1708248457675,ECON 248,A00,409790,Eckert; Fabian Paul,18,0,20,2
1708248458211,ECON 250C,A00,409791,Arnold; David Hall & Betts; Julian,25,0,25,0
1708248458740,ECON 268,A00,409792,Jacobsen; Mark,24,0,25,1
1708248459268,ECON 281,A00,409793,Meckel; Katherine Hunter,19,0,20,1
1708248459268,ECON 281,B00,409794,Herreno Lopera; Juan & Wieland; Johannes Friedrich,19,0,20,1
1708248459268,ECON 281,C00,477854,Herreno Lopera; Juan & Wieland; Johannes Friedrich,18,0,20,2
1708248459794,ECON 285,A00,409795,Eckert; Fabian Paul,20,0,20,0
1708248460326,ECON 286,A00,409796,Ma; Xinwei,15,0,15,0
1708248460326,ECON 286,B00,409797,Hamilton; James D.,15,0,15,0
1708248460326,ECON 286,C00,409798,Grigoryan; Aram,15,0,15,0
1708248460326,ECON 286,D00,409799,Niehaus; Paul,15,0,15,0
1708248460852,ECON 296,A00,409800,Eckert; Fabian Paul,20,0,20,0
1708248461379,EDS 31,A00,409801,Bussey; Thomas J,9,0,10,1
1708248461909,EDS 38,A01,409803,Chung; Luz Marina,25,0,25,0
1708248462437,EDS 39,A01,409805,Heinzman; Erica M.,24,0,25,1
1708248462969,EDS 102,A01,409807,Ambo; Theresa Jean,37,0,45,8
1708248463497,EDS 110R,A01,409809,Staff,42,0,50,8
1708248463497,EDS 110R,B01,481358,Staff,20,0,20,0
1708248464029,EDS 111,A00,479044,Wishard Guerra; Alison G.,56,0,60,4
1708248464556,EDS 117,A01,409818,Jones; Gabrielle Anastasia,21,0,23,2
1708248464556,EDS 117,A02,409819,Jones; Gabrielle Anastasia,23,0,23,0
1708248464556,EDS 117,A03,409820,Jones; Gabrielle Anastasia,22,0,23,1
1708248464556,EDS 117,A04,409821,Jones; Gabrielle Anastasia,21,0,21,0
1708248465082,EDS 118,A00,409828,Warstadt; Melissa Fawn,46,0,50,4
1708248465613,EDS 123,A00,409831,Bussey; Thomas J,10,0,10,0
1708248466146,EDS 124AR,A00,419352,Simon; Elizabeth A,82,0,100,18
1708248466146,EDS 124AR,B00,419377,Simon; Elizabeth A,97,0,100,3
1708248466146,EDS 124AR,C00,481485,Simon; Elizabeth A,25,0,25,0
1708248466146,EDS 124AR,D00,481490,Simon; Elizabeth A,25,0,25,0
1708248466673,EDS 124BR,A00,409838,Eguchi; Emi,53,0,75,22
1708248466673,EDS 124BR,B00,481363,Eguchi; Emi,25,0,25,0
1708248467200,EDS 125,A00,409839,Aragon; Maria Jose,48,0,50,2
1708248467727,EDS 126,A01,409843,Jones; Makeba,19,0,25,6
1708248467727,EDS 126,A02,409844,Jones; Makeba,25,0,25,0
1708248467727,EDS 126,A03,409846,Jones; Makeba,25,0,25,0
1708248467727,EDS 126,A04,409847,Jones; Makeba,25,0,25,0
1708248468253,EDS 128B,A01,409851,Pappas; Elizabeth,49,0,50,1
1708248468780,EDS 129C,A01,409906,Millstone; Rachel Diana,44,0,50,6
1708248469315,EDS 130,A01,409954,Mendez; Kathrina Mendoza,14,0,15,1
1708248469315,EDS 130,A02,409955,Mendez; Kathrina Mendoza,24,0,25,1
1708248469315,EDS 130,A03,409956,Mendez; Kathrina Mendoza,20,0,20,0
1708248469842,EDS 133,A01,409961,Bintliff; Amy S.V.,15,0,20,5
1708248469842,EDS 133,A02,409962,Bintliff; Amy S.V.,20,0,20,0
1708248469842,EDS 133,A03,489636,Bintliff; Amy S.V.,15,0,15,0
1708248470368,EDS 136,A01,409964,Chung; Luz Marina,30,0,30,0
1708248470368,EDS 136,A02,409977,Chung; Luz Marina,30,0,30,0
1708248470898,EDS 139,A00,479197,Millstone; Rachel Diana,42,0,50,8
1708248470898,EDS 139,B00,479198,Pappas; Elizabeth,49,0,50,1
1708248470898,EDS 139,C00,479199,Mendez; Kathrina Mendoza,58,0,60,2
1708248470898,EDS 139,D00,479200,Bintliff; Amy S.V.,56,0,60,4
1708248470898,EDS 139,E00,479201,Chung; Luz Marina,59,0,60,1
1708248470898,EDS 139,F00,479202,Bintliff; Amy S.V.,15,0,15,0
1708248470898,EDS 139,G00,479203,Mamas; Christoforos,27,0,30,3
1708248470898,EDS 139,H00,493997,Choi; Bailey Miyeon,28,0,30,2
1708248471423,EDS 141,A00,409979,Mamas; Christoforos,38,0,40,2
1708248471952,EDS 145,A01,409989,Choi; Bailey Miyeon,13,0,15,2
1708248471952,EDS 145,A02,409990,Choi; Bailey Miyeon,15,0,15,0
1708248472479,EDS 180,A00,409991,Chapman; Thandeka K,30,0,30,0
1708248472479,EDS 180,B00,409992,Ambo; Theresa Jean,24,0,25,1
1708248472479,EDS 180,C00,409993,Jones; Gabrielle Anastasia,20,0,20,0
1708248472479,EDS 180,D00,409994,Phuong; Andrew,24,0,24,0
1708248473005,EDS 198,001,487216,Eguchi; Emi,20,0,20,0
1708248473533,EDS 205B,A00,409995,Staff,40,0,45,5
1708248473533,EDS 205B,B00,409997,Staff,42,0,45,3
1708248474063,EDS 232,A00,409999,Hopkins; Megan Beth,9,0,12,3
1708248474589,EDS 255,A00,410001,Phuong; Andrew,14,0,15,1
1708248475119,EDS 257,A00,410003,Datnow; Amanda Lee,14,0,15,1
1708248475645,EDS 282,A00,479192,Daly; Alan J.,16,0,16,0
1708248476173,EDS 287B,A00,479193,Daly; Alan J.,16,0,16,0
1708248476698,EDS 288A,A00,410005,Staff,18,0,18,0
1708248477228,EDS 288C,A00,410007,Staff,18,0,18,0
1708248477755,EDS 289B,A01,410009,Daly; Alan J.,18,0,18,0
1708248478282,EDS 290,A00,410010,Black; Alison Michelle,30,0,30,0
1708248478282,EDS 290,B00,410012,Choi; Bailey Miyeon,29,0,30,1
1708248478282,EDS 290,C00,479205,Heinzman; Erica M.,0,0,0,0
1708248478807,EDS 291B,A01,479195,Daly; Alan J.,16,0,16,0
1708248479333,EDS 293B,A01,410016,Staff,18,0,18,0
1708248479859,EDS 294B,A00,479196,Burrell; Sade Renee,16,0,16,0
1708248480395,EDS 296,001,478927,Ambo; Theresa Jean,0,0,0,0
1708248480395,EDS 296,002,478935,Aragon; Maria Jose,0,0,0,1
1708248480395,EDS 296,003,478936,Chapman; Thandeka K,0,0,0,0
1708248480395,EDS 296,004,478942,Bintliff; Amy S.V.,0,0,0,0
1708248480395,EDS 296,005,478943,Clarke; Sherice Nicole,0,0,0,0
1708248480395,EDS 296,006,478967,Cohen; Shana R,0,0,0,1
1708248480395,EDS 296,007,478968,Datnow; Amanda Lee,0,0,0,0
1708248480395,EDS 296,008,478969,Daly; Alan J.,0,0,0,0
1708248480395,EDS 296,009,478970,Eguchi; Emi,0,0,0,0
1708248480395,EDS 296,010,478971,Fine; Sarah,0,0,0,0
1708248480395,EDS 296,011,478972,Jones; Gabrielle Anastasia,0,0,0,0
1708248480395,EDS 296,012,479020,Jones; Makeba,0,0,0,0
1708248480395,EDS 296,013,479021,Halter; Christopher P.,0,0,0,0
1708248480395,EDS 296,014,479027,Hofstetter; Carolyn,0,0,0,0
1708248480395,EDS 296,015,479028,Hopkins; Megan Beth,0,0,0,0
1708248480395,EDS 296,016,479034,Mamas; Christoforos,0,0,0,0
1708248480395,EDS 296,017,479035,Pollock; Mica,0,0,0,0
1708248480395,EDS 296,018,479036,Wishard Guerra; Alison G.,0,0,0,0
1708248480395,EDS 296,019,494549,Phuong; Andrew,0,0,0,0
1708248480928,EMED 296,001,464428,Singh; Sukhdeep,49,0,50,1
1708248480928,EMED 296,002,464438,Subramony; Rachna,49,0,50,1
1708248480928,EMED 296,003,464490,Staff,50,0,50,0
1708248481456,ENG 10,A00,399006,Evdokimenko; Ekaterina,30,0,30,0
1708248481984,ENG 100D,A00,399084,Ngo; Anh-Thu T.,33,0,50,17
1708248482516,ENG 100DR,A00,479230,Ngo; Anh-Thu T.,29,0,40,11
1708248483046,ENG 100L,A00,399163,Kleissl; Jan,6,0,6,0
1708248483046,ENG 100L,B00,399217,Bratton; Maryann,8,0,8,0
1708248483046,ENG 100L,C00,399218,Yu; Paul K L,8,0,8,0
1708248483046,ENG 100L,D00,399257,Bratton; Maryann,6,0,6,0
1708248483046,ENG 100L,E00,399258,de Oliveira; Mauricio,9,0,10,1
1708248483046,ENG 100L,F00,399314,Bratton; Maryann,7,0,7,0
1708248483046,ENG 100L,G00,399394,Boyle; Mary E. T.,14,0,15,1
1708248483583,ENVR 102,A00,400777,Daly; Heather Marie,19,0,20,1
1708248483583,ENVR 102,B00,400778,Montejo; Carolina,24,0,25,1
1708248483583,ENVR 102,C00,400791,Staff,23,0,25,2
1708248484110,ENVR 140,A01,400813,Siapno; Jacqueline A,12,0,15,3
1708248484110,ENVR 140,A02,400870,Siapno; Jacqueline A,15,0,15,0
1708248484110,ENVR 140,A03,400889,Siapno; Jacqueline A,15,0,15,0
1708248484110,ENVR 140,A04,400890,Siapno; Jacqueline A,15,0,15,0
1708248484641,ENVR 144,A01,400929,Herbst; Matthew,20,0,20,0
1708248485167,ERC 20,A00,400722,Evans; Ivan T,30,0,30,0
1708248485694,ESYS 103,A01,400931,Lerner; Amy M,32,0,34,2
1708248485694,ESYS 103,A02,400934,Lerner; Amy M,34,0,34,0
1708248485694,ESYS 103,A03,400938,Lerner; Amy M,28,0,34,6
1708248485694,ESYS 103,A04,400939,Lerner; Amy M,33,0,34,1
1708248485694,ESYS 103,A05,400940,Lerner; Amy M,34,0,34,0
1708248485694,ESYS 103,A06,400941,Lerner; Amy M,33,0,34,1
1708248486227,ESYS 187C,A01,400945,Hetherington; Elizabeth Dorsey,28,0,40,12
1708248486227,ESYS 187C,A02,400946,Hetherington; Elizabeth Dorsey,39,0,40,1
1708248486754,ETHN 3R,A01,400948,Streeby; Shelley,21,0,25,4
1708248486754,ETHN 3R,A02,401220,Streeby; Shelley,24,0,25,1
1708248486754,ETHN 3R,A03,401231,Streeby; Shelley,22,0,25,3
1708248486754,ETHN 3R,A04,401236,Streeby; Shelley,23,0,25,2
1708248486754,ETHN 3R,A05,401241,Streeby; Shelley,21,0,25,4
1708248486754,ETHN 3R,A06,401311,Streeby; Shelley,21,0,25,4
1708248486754,ETHN 3R,A07,401318,Streeby; Shelley,25,0,25,0
1708248486754,ETHN 3R,A08,401319,Streeby; Shelley,25,0,25,0
1708248486754,ETHN 3R,A09,401397,Streeby; Shelley,25,0,25,0
1708248486754,ETHN 3R,A10,401398,Streeby; Shelley,25,0,25,0
1708248486754,ETHN 3R,A11,401399,Streeby; Shelley,24,0,25,1
1708248486754,ETHN 3R,A12,401518,Streeby; Shelley,25,0,25,0
1708248486754,ETHN 3R,A13,401551,Streeby; Shelley,24,0,25,1
1708248486754,ETHN 3R,A14,401552,Streeby; Shelley,23,0,25,2
1708248487281,ETHN 30,A01,401554,Fuste; Jose Ignacio,24,0,25,1
1708248487281,ETHN 30,A02,401555,Fuste; Jose Ignacio,25,0,25,0
1708248487281,ETHN 30,A03,401556,Fuste; Jose Ignacio,25,0,25,0
1708248487281,ETHN 30,A04,401557,Fuste; Jose Ignacio,25,0,25,0
1708248487807,ETHN 100C,A00,401558,Museus; Samuel David,36,0,40,4
1708248488333,ETHN 101TV,A01,401560,Marez; Curtis F.,21,0,25,4
1708248488333,ETHN 101TV,A02,401564,Marez; Curtis F.,25,0,25,0
1708248488860,ETHN 108,A00,401584,Hankins; Sarah E.,25,0,29,4
1708248489386,ETHN 113A,A00,401657,Werner; Bradley T.,15,0,15,0
1708248489912,ETHN 114B,A00,401724,Frank; Ross H.,19,0,20,1
1708248490438,ETHN 120D,A01,401848,Alvarez; Luis A,8,0,10,2
1708248490438,ETHN 120D,A02,401853,Alvarez; Luis A,10,0,10,0
1708248490964,ETHN 125R,A00,401858,Sasaki; Christen T,39,0,50,11
1708248491494,ETHN 126,A00,401865,Tran; Ly Thi Hai,39,0,40,1
1708248492020,ETHN 127,A00,401866,Martin Sandino; Amanda Maria Yoland,24,0,25,1
1708248492546,ETHN 137,A00,401867,Martin Sandino; Amanda Maria Yoland,19,0,19,0
1708248493073,ETHN 139,A00,401992,Perreira; Christopher Michael,25,0,25,0
1708248493603,ETHN 143,A00,402059,Marez; Curtis F.,39,0,40,1
1708248494129,ETHN 144M,A00,402060,Jolivette; Andrew J,62,0,65,3
1708248494653,ETHN 150,A00,402158,Taylor-Garcia; Daphne,16,0,18,2
1708248495182,ETHN 153,A00,402160,Martinez-Matsuda; Veronica,24,0,25,1
1708248495708,ETHN 179,A00,402165,Richards; Stephanie F,23,0,25,2
1708248496239,ETHN 183,A00,402217,Steelman; Katherine Wallis,16,0,16,0
1708248496766,ETHN 186,A00,402313,Perez; Roy,15,0,15,0
1708248497294,ETHN 189,A00,479226,Museus; Samuel David,29,0,30,1
1708248497822,ETHN 196H,A00,402314,Espiritu; Yen,0,0,0,0
1708248497822,ETHN 196H,B00,402325,Perreira; Christopher Michael,0,0,0,0
1708248497822,ETHN 196H,C00,402344,Perez; Roy,0,0,0,0
1708248497822,ETHN 196H,D00,402345,Streeby; Shelley,0,0,0,0
1708248497822,ETHN 196H,E00,402346,Taylor-Garcia; Daphne,0,0,0,0
1708248498352,ETHN 200C,A00,402358,Fuste; Jose Ignacio,19,0,20,1
1708248498881,ETHN 230,A00,402359,Streeby; Shelley,16,0,20,4
1708248499406,ETHN 291,A00,402363,Perreira; Christopher Michael,16,0,20,4
1708248499934,EXPR 100,A00,477778,Staff,9999,0,9999,0
1708248500462,EXPR 105,A00,477779,Staff,9999,0,9999,0
1708248500987,EXPR 201,A00,477780,Staff,9999,0,9999,0
1708248501516,EXPR 205,A00,477781,Staff,9999,0,9999,0
1708248502041,FILM 87,A00,402794,Rahimi; Babak,19,0,20,1
1708248502041,FILM 87,B00,402796,Rahimi; Babak,20,0,20,0
1708248502041,FILM 87,C00,402821,Havis; Allan,19,0,20,1
1708248502572,FMPH 95,A00,481734,Larsen; Britta Ann,0,0,0,2
1708248503104,FMPH 101,A00,404648,Tan; Gene Brian,31,0,40,9
1708248503632,FMPH 102,A01,404692,Rana; Brinda Kanti,25,0,28,3
1708248503632,FMPH 102,A02,404714,Rana; Brinda Kanti,28,0,28,0
1708248503632,FMPH 102,B01,404739,Rana; Brinda Kanti,26,0,28,2
1708248503632,FMPH 102,B02,404746,Rana; Brinda Kanti,28,0,28,0
1708248504213,FMPH 110,A00,404747,Campbell; Chadwick Karl,52,0,55,3
1708248504213,FMPH 110,B00,404789,Zoumas-Morse; Christine E.,24,0,30,6
1708248504738,FMPH 120,A00,404792,Nguyen-Grozavu; France T.,48,0,60,12
1708248505265,FMPH 130,A00,404859,Gould; Carlos Francisco,49,0,55,6
1708248505265,FMPH 130,B00,479047,Ciborowski; Haley Minae,52,0,55,3
1708248505797,FMPH 155,A00,404864,Fielding-Miller; Rebecca,65,0,65,0
1708248506323,FMPH 161,A00,404865,Zoumas-Morse; Christine E.,27,0,35,8
1708248506853,FMPH 191,A00,404866,Eikey; Elizabeth Victoria,35,0,35,0
1708248507389,FMPH 194,A00,404938,Larsen; Britta Ann,0,0,0,0
1708248507389,FMPH 194,B00,404939,Marquez; Becky,0,0,0,0
1708248507389,FMPH 194,C00,404949,Nguyen-Grozavu; France T.,0,0,0,0
1708248507389,FMPH 194,D00,404950,Stone; Matthew David,0,0,0,0
1708248507389,FMPH 194,E00,404958,White; Anne Elizabeth Clar,0,0,0,0
1708248507389,FMPH 194,F00,404969,Zoumas-Morse; Christine E.,0,0,0,0
1708248507916,FMPH 223,A00,404977,Vaida; Florin,7,0,26,19
1708248508444,FMPH 225,A00,404978,Zou; Jingjing,0,0,0,0
1708248512006,FMPH 291,A00,404992,Salem; Rany Mansour,15,0,15,0
1708248512006,FMPH 291,C00,405005,Schwartzman; Armin,0,0,0,10
1708248512006,FMPH 291,D00,479113,Shadyab; Aladdin Hassan,0,0,0,0
1708248512006,FMPH 291,E00,479114,Shadyab; Aladdin Hassan,0,0,0,0
1708248512006,FMPH 291,F00,479115,Wynn; Adriane Michelle,0,0,0,3
1708248512006,FMPH 291,G00,479116,Xu; Ronghui,0,0,0,10
1708248512006,FMPH 291,H00,479119,Vaida; Florin,0,0,0,2
1708248512533,FPM 258C,A00,405129,Chen; Brian Hwa-Yang,11,0,15,4
1708248513060,FPM 259C,A00,405130,Nguyen; Annie Lu & Araneta; Maria Rosario Gorrez,4,0,5,1
1708248513590,FPM 278,A00,405131,Strong; David R,13,0,15,2
1708248514117,FPM 280C,A01,405133,Banegas; Matthew Patrick,10,0,10,0
1708248514644,FPM 296,001,464651,Johnson; Michelle Lee,49,0,50,1
1708248514644,FPM 296,002,464652,Staff,50,0,50,0
1708248514644,FPM 296,003,464653,Staff,50,0,50,0
1708248515174,FPM 297,001,479175,Vaida; Florin,9999,0,9999,0
1708248515174,FPM 297,002,494007,Strong; David R,9999,0,9999,0
1708248515174,FPM 297,003,494364,Bazzi; Angela Robertson,9999,0,9999,0
1708248515707,GLBH 20,A00,405134,Elwardani; Nile Regina,143,0,146,3
1708248516236,GLBH 100,A00,405135,Bhavsar; Radhika,68,0,70,2
1708248516236,GLBH 100,B00,477773,Villarino; Margarita,39,0,44,5
1708248516236,GLBH 100,C00,477855,Jenkins; Janis A.,20,0,20,0
1708248516236,GLBH 100,D00,481337,Mishra; Jyoti,40,0,40,0
1708248516766,GLBH 101,A00,405136,Sloane; Julia Kathryn,40,0,40,0
1708248517294,GLBH 107,A00,405137,Wilson; Brenda K,63,0,70,7
1708248517821,GLBH 111,A01,486865,Burgos; Jose L.,0,0,0,0
1708248517821,GLBH 111,B01,486867,Burgos; Jose L.,0,0,0,0
1708248518347,GLBH 114W,A00,405138,Walkover; Lillian B,17,0,17,0
1708248518877,GLBH 118,A00,405140,Wilson; Brenda K,31,0,32,1
1708248519404,GLBH 147,A00,405141,Stewart; Alexander B,40,0,40,0
1708248519937,GLBH 148,A00,405142,Olivas Hernandez; Olga Lid,93,0,100,7
1708248520473,GLBH 150B,A00,486855,Sanchez; Giselle,0,0,0,0
1708248521000,GLBH 181,A00,405154,Burgos; Jose L.,211,0,216,5
1708248521530,GLBH 215,A00,479241,Walkover; Lillian B,18,0,18,0
1708248522057,GLBH 260,A00,480722,Elwardani; Nile Regina,18,0,18,0
1708248522587,GSS 20,A00,405155,Siapno; Jacqueline A,25,0,30,5
1708248523114,GSS 25,A00,405156,Batarseh; Amanda Alicia,24,0,30,6
1708248523641,HDS 1,A01,405160,Reese; Clarissa Jane,25,0,25,0
1708248523641,HDS 1,A02,405168,Reese; Clarissa Jane,25,0,25,0
1708248523641,HDS 1,A03,405169,Reese; Clarissa Jane,22,0,25,3
1708248523641,HDS 1,A04,405170,Reese; Clarissa Jane,24,0,25,1
1708248523641,HDS 1,A05,405171,Reese; Clarissa Jane,23,0,25,2
1708248523641,HDS 1,A06,405172,Reese; Clarissa Jane,24,0,25,1
1708248523641,HDS 1,A07,405173,Reese; Clarissa Jane,24,0,25,1
1708248524168,HDS 60,A01,405175,Warstadt; Melissa Fawn,34,0,35,1
1708248524168,HDS 60,A02,405176,Warstadt; Melissa Fawn,33,0,35,2
1708248524695,HDS 95,A00,405177,Staff,38,0,40,2
1708248525220,HDS 120,A00,405178,Staff,0,0,0,0
1708248525747,HDS 122,A00,405179,Rodriguez; Victoria Calip,64,0,75,11
1708248526274,HDS 150,A00,405180,Staff,20,0,20,0
1708248526274,HDS 150,B00,405181,Staff,20,0,20,0
1708248526274,HDS 150,C00,405182,Staff,20,0,20,0
1708248526806,HDS 181,A01,405185,Bjorklund; Peter,30,0,30,0
1708248527336,HDS 191,A01,405187,Reese; Clarissa Jane,40,0,40,0
1708248527336,HDS 191,B01,405194,Staff,25,0,25,0
1708248527862,HIAF 113,A00,403736,Prestholdt; Jeremy,74,0,75,1
1708248528390,HIAF 114,A00,403738,Gyamfi; Bright,49,0,50,1
1708248528916,HIEA 132,A00,403740,Kletzer; Benjamin Nathan,25,0,30,5
1708248529446,HIEA 154,A00,403741,Henry; Todd A.,62,0,64,2
1708248529977,HIEU 139,A00,403742,Strasser; Ulrike,52,0,56,4
1708248530504,HIEU 171,A00,403743,Hansen; Jan Eric,62,0,64,2
1708248531033,HIEU 176,A00,403744,Hertz; Deborah,14,0,15,1
1708248531563,HIEU 183,A00,403800,Gallant; Thomas W.,15,0,15,0
1708248532094,HIEU 276,A00,403862,Hertz; Deborah,0,0,0,0
1708248532632,HIGL 127,A00,403802,Ivey; James Alexander,56,0,56,0
1708248533158,HIGR 201,A00,494372,Pineda De Avila; Nydia,9,0,10,1
1708248533686,HIGR 205,A00,403863,Strasser; Ulrike,11,0,15,4
1708248534212,HIGR 217C,A00,403864,Lu; Weijing,9,0,10,1
1708248534737,HIGR 239,A00,403865,Serlin; David,4,0,5,1
1708248535262,HIGR 240,A00,403875,Gates; Kelly,2,0,5,3
1708248535789,HILA 101,A00,403818,LeNeave; Kimiko Nicole,62,0,64,2
1708248536316,HILA 119,A00,403819,Kozameh; Sara J,47,0,50,3
1708248536844,HILA 144,A00,403821,Kozameh; Sara J,50,0,50,0
1708248537393,HILD 2C,A01,402843,Hendrickson; Gerald M.,31,0,32,1
1708248537393,HILD 2C,A02,403030,Hendrickson; Gerald M.,31,0,32,1
1708248537393,HILD 2C,A03,403042,Hendrickson; Gerald M.,32,0,32,0
1708248537393,HILD 2C,A04,403048,Hendrickson; Gerald M.,30,0,32,2
1708248537393,HILD 2C,A05,403049,Hendrickson; Gerald M.,32,0,32,0
1708248537393,HILD 2C,A06,403098,Hendrickson; Gerald M.,32,0,32,0
1708248537952,HILD 7C,A01,403501,Bermudez; Rosie Cano,27,0,32,5
1708248537952,HILD 7C,A02,403513,Bermudez; Rosie Cano,30,0,32,2
1708248537952,HILD 7C,A03,403570,Bermudez; Rosie Cano,32,0,32,0
1708248537952,HILD 7C,A04,403572,Bermudez; Rosie Cano,32,0,32,0
1708248537952,HILD 7C,A05,403587,Bermudez; Rosie Cano,32,0,32,0
1708248537952,HILD 7C,A06,403588,Bermudez; Rosie Cano,32,0,32,0
1708248537952,HILD 7C,A07,403589,Bermudez; Rosie Cano,29,0,32,3
1708248537952,HILD 7C,A08,403590,Bermudez; Rosie Cano,32,0,32,0
1708248537952,HILD 7C,A09,403601,Bermudez; Rosie Cano,30,0,32,2
1708248537952,HILD 7C,A10,403602,Bermudez; Rosie Cano,32,0,32,0
1708248537952,HILD 7C,A11,403603,Bermudez; Rosie Cano,32,0,32,0
1708248537952,HILD 7C,A12,403604,Bermudez; Rosie Cano,32,0,32,0
1708248538483,HILD 12,A01,403607,Henry; Todd A.,32,0,32,0
1708248538483,HILD 12,A02,403608,Henry; Todd A.,31,0,32,1
1708248538483,HILD 12,A03,403609,Henry; Todd A.,32,0,32,0
1708248538483,HILD 12,A04,403699,Henry; Todd A.,32,0,32,0
1708248538483,HILD 12,A05,403700,Henry; Todd A.,32,0,32,0
1708248538483,HILD 12,A06,403701,Henry; Todd A.,32,0,32,0
1708248539011,HILD 30,A01,403703,Soleiman; Matthew Teymour,29,0,32,3
1708248539011,HILD 30,A02,403704,Soleiman; Matthew Teymour,30,0,32,2
1708248539542,HINE 118,A00,403822,Kayali; Hasan,50,0,50,0
1708248540068,HISC 119,A00,403823,Golan; Tal,26,0,30,4
1708248540593,HISC 123,A00,403839,Pineda De Avila; Nydia,45,0,50,5
1708248541124,HITO 87,A00,403707,Patterson; Patrick H.,15,0,15,0
1708248541124,HITO 87,B00,403709,Patterson; Patrick H.,15,0,15,0
1708248541124,HITO 87,C00,403735,Schneewind; Sarah,15,0,15,0
1708248541652,HITO 100,B00,403841,Klann; Mary Cameron,24,0,25,1
1708248542182,HITO 170,A00,403842,Watts; Edward J.,8,0,10,2
1708248542713,HITO 193,A00,455333,Hill; Seth J,0,0,0,0
1708248543239,HIUS 114A,A00,403843,Lewandoski; Julia Mavis,52,0,56,4
1708248543770,HIUS 120D,A01,403854,Alvarez; Luis A,8,0,10,2
1708248543770,HIUS 120D,A02,403855,Alvarez; Luis A,10,0,10,0
1708248544296,HIUS 136,A00,403857,Martinez-Matsuda; Veronica,21,0,25,4
1708248544824,HIUS 144,A00,403858,Martinez-Matsuda; Veronica,55,0,56,1
1708248544824,HIUS 144,B00,403859,Vandevelde; Kenneth Joseph,54,0,56,2
1708248544824,HIUS 144,C00,403860,Klann; Mary Cameron,52,0,56,4
1708248544824,HIUS 144,D00,403861,Lewandoski; Julia Mavis,55,0,56,1
1708248545413,HUM 2,A01,422723,Watts; Edward J.,16,0,16,0
1708248545413,HUM 2,A02,422735,Watts; Edward J.,15,0,16,1
1708248545413,HUM 2,A03,422736,Watts; Edward J.,15,0,16,1
1708248545413,HUM 2,A04,422737,Watts; Edward J.,16,0,16,0
1708248545413,HUM 2,A05,422738,Watts; Edward J.,15,0,16,1
1708248545413,HUM 2,A06,422760,Watts; Edward J.,15,0,16,1
1708248545413,HUM 2,A07,422778,Watts; Edward J.,16,0,16,0
1708248545413,HUM 2,A08,422793,Watts; Edward J.,16,0,16,0
1708248545413,HUM 2,A09,422794,Watts; Edward J.,16,0,16,0
1708248545413,HUM 2,A10,422795,Watts; Edward J.,16,0,16,0
1708248545413,HUM 2,B01,422805,Markman; Kristina,13,0,16,3
1708248545413,HUM 2,B02,422806,Markman; Kristina,14,0,16,2
1708248545413,HUM 2,B03,422807,Markman; Kristina,14,0,16,2
1708248545413,HUM 2,B04,422808,Markman; Kristina,16,0,16,0
1708248545413,HUM 2,B05,422809,Markman; Kristina,16,0,16,0
1708248545413,HUM 2,B06,422842,Markman; Kristina,16,0,16,0
1708248545413,HUM 2,B07,422843,Markman; Kristina,15,0,16,1
1708248545413,HUM 2,B08,422848,Markman; Kristina,16,0,16,0
1708248545413,HUM 2,B09,422850,Markman; Kristina,15,0,16,1
1708248545413,HUM 2,B10,422851,Markman; Kristina,12,0,16,4
1708248545413,HUM 2,B11,422852,Markman; Kristina,15,0,16,1
1708248545413,HUM 2,B12,422853,Markman; Kristina,16,0,16,0
1708248545413,HUM 2,C01,422855,Rodriguez; Bretton Sigfred,15,0,16,1
1708248545413,HUM 2,C02,422856,Rodriguez; Bretton Sigfred,16,0,16,0
1708248545413,HUM 2,C03,422859,Rodriguez; Bretton Sigfred,15,0,16,1
1708248545413,HUM 2,C04,423106,Rodriguez; Bretton Sigfred,12,0,16,4
1708248545413,HUM 2,C05,423107,Rodriguez; Bretton Sigfred,15,0,16,1
1708248545413,HUM 2,C06,423108,Rodriguez; Bretton Sigfred,14,0,16,2
1708248545413,HUM 2,C07,423109,Rodriguez; Bretton Sigfred,15,0,16,1
1708248545413,HUM 2,C08,423110,Rodriguez; Bretton Sigfred,15,0,16,1
1708248545413,HUM 2,C09,423133,Rodriguez; Bretton Sigfred,14,0,16,2
1708248545413,HUM 2,C10,423134,Rodriguez; Bretton Sigfred,14,0,16,2
1708248545413,HUM 2,C11,423135,Rodriguez; Bretton Sigfred,16,0,16,0
1708248545413,HUM 2,C12,423136,Rodriguez; Bretton Sigfred,15,0,16,1
1708248545413,HUM 2,C13,423137,Rodriguez; Bretton Sigfred,16,0,16,0
1708248545413,HUM 2,C14,423138,Rodriguez; Bretton Sigfred,16,0,16,0
1708248545413,HUM 2,D01,423140,West; Geoffrey Scott,13,0,16,3
1708248545413,HUM 2,D02,423141,West; Geoffrey Scott,15,0,16,1
1708248545413,HUM 2,D03,423142,West; Geoffrey Scott,15,0,16,1
1708248545413,HUM 2,D04,423143,West; Geoffrey Scott,14,0,16,2
1708248545413,HUM 2,D05,423144,West; Geoffrey Scott,16,0,16,0
1708248545413,HUM 2,D06,423145,West; Geoffrey Scott,16,0,16,0
1708248545413,HUM 2,D07,423146,West; Geoffrey Scott,16,0,16,0
1708248545413,HUM 2,D08,423158,West; Geoffrey Scott,16,0,16,0
1708248545413,HUM 2,D09,423169,West; Geoffrey Scott,16,0,16,0
1708248545413,HUM 2,D10,423174,West; Geoffrey Scott,16,0,16,0
1708248545413,HUM 2,D11,423175,West; Geoffrey Scott,16,0,16,0
1708248545413,HUM 2,D12,423179,West; Geoffrey Scott,15,0,16,1
1708248545413,HUM 2,D13,423188,West; Geoffrey Scott,15,0,16,1
1708248545413,HUM 2,D14,423204,West; Geoffrey Scott,16,0,16,0
1708248545967,HUM 5,A01,423221,Lyon; Antony J.,26,0,30,4
1708248545967,HUM 5,A02,423232,Lyon; Antony J.,24,0,30,6
1708248545967,HUM 5,A03,423237,Lyon; Antony J.,18,0,30,12
1708248545967,HUM 5,A04,423240,Lyon; Antony J.,25,0,30,5
1708248545967,HUM 5,A05,423242,Lyon; Antony J.,28,0,30,2
1708248545967,HUM 5,A06,423244,Lyon; Antony J.,23,0,30,7
1708248545967,HUM 5,A07,423247,Lyon; Antony J.,27,0,30,3
1708248545967,HUM 5,A08,423254,Lyon; Antony J.,27,0,30,3
1708248545967,HUM 5,B01,423286,Patterson; Patrick H.,28,0,30,2
1708248545967,HUM 5,B02,423291,Patterson; Patrick H.,29,0,30,1
1708248545967,HUM 5,B03,423294,Patterson; Patrick H.,28,0,30,2
1708248545967,HUM 5,B04,423297,Patterson; Patrick H.,29,0,30,1
1708248545967,HUM 5,B05,423313,Patterson; Patrick H.,30,0,30,0
1708248545967,HUM 5,B06,423318,Patterson; Patrick H.,30,0,30,0
1708248545967,HUM 5,B07,423362,Patterson; Patrick H.,29,0,30,1
1708248545967,HUM 5,B08,423363,Patterson; Patrick H.,29,0,30,1
1708248545967,HUM 5,C01,423365,Caldwell; Michael Alan,23,0,30,7
1708248545967,HUM 5,C02,423474,Caldwell; Michael Alan,24,0,30,6
1708248545967,HUM 5,C03,423528,Caldwell; Michael Alan,30,0,30,0
1708248545967,HUM 5,C04,423529,Caldwell; Michael Alan,27,0,30,3
1708248545967,HUM 5,C05,423545,Caldwell; Michael Alan,30,0,30,0
1708248545967,HUM 5,C06,423546,Caldwell; Michael Alan,30,0,30,0
1708248545967,HUM 5,C07,423547,Caldwell; Michael Alan,29,0,30,1
1708248545967,HUM 5,C08,423548,Caldwell; Michael Alan,28,0,30,2
1708248546495,INTL 101,A01,404350,Day; Joel Keith,23,0,25,2
1708248546495,INTL 101,A02,404356,Day; Joel Keith,25,0,25,0
1708248546495,INTL 101,A03,404357,Day; Joel Keith,24,0,25,1
1708248546495,INTL 101,A04,404360,Day; Joel Keith,25,0,25,0
1708248547023,INTL 102,A01,404375,Fisk; David Lee,25,0,25,0
1708248547023,INTL 102,A02,404376,Fisk; David Lee,22,0,25,3
1708248547023,INTL 102,A03,404377,Fisk; David Lee,20,0,25,5
1708248547023,INTL 102,A04,404381,Fisk; David Lee,25,0,25,0
1708248547567,INTL 190,A00,404396,Samphantharak; Krislert,24,0,25,1
1708248547567,INTL 190,B00,404402,McIntosh; Justin Daniel,24,0,25,1
1708248547567,INTL 190,C00,404403,Vos; Stacie N.,24,0,25,1
1708248547567,INTL 190,D00,404404,Nadkarni; Vidya,24,0,25,1
1708248547567,INTL 190,E00,404407,Scott; Jeffrey F,25,0,25,0
1708248547567,INTL 190,F00,404409,Auerbach; Bradford C,25,0,25,0
1708248547567,INTL 190,G00,404442,Auerbach; Bradford C,25,0,25,0
1708248547567,INTL 190,H00,404465,Segui; Alan S,25,0,25,0
1708248547567,INTL 190,I00,404481,Segui; Alan S,25,0,25,0
1708248548138,JAPN 10C,A01,403881,Iwamoto; Naoki,15,0,15,0
1708248548138,JAPN 10C,B01,403884,McKee; Mayumi Mochizuki,15,0,15,0
1708248548138,JAPN 10C,C01,403887,Sato; Kyoko,10,0,10,0
1708248548138,JAPN 10C,C02,403888,Sato; Kyoko,10,0,10,0
1708248548138,JAPN 10C,D01,403890,Inada; Minori,8,0,10,2
1708248548138,JAPN 10C,D02,403891,Inada; Minori,10,0,10,0
1708248548138,JAPN 10C,E01,403893,Sato; Kyoko,10,0,10,0
1708248548138,JAPN 10C,E02,403894,Sato; Kyoko,10,0,10,0
1708248548138,JAPN 10C,F01,403896,McKee; Mayumi Mochizuki,10,0,10,0
1708248548138,JAPN 10C,F02,403897,McKee; Mayumi Mochizuki,10,0,10,0
1708248548138,JAPN 10C,G01,403899,Homma; Kunihiko,10,0,10,0
1708248548138,JAPN 10C,G02,403900,Homma; Kunihiko,10,0,10,0
1708248548138,JAPN 10C,H01,403902,Maruyama; Rie,10,0,10,0
1708248548138,JAPN 10C,H02,403903,Maruyama; Rie,9,0,10,1
1708248548138,JAPN 10C,I01,403905,Inada; Minori,10,0,10,0
1708248548138,JAPN 10C,I02,403906,Inada; Minori,9,0,10,1
1708248548138,JAPN 10C,J01,403915,Iwamoto; Naoki,10,0,10,0
1708248548138,JAPN 10C,J02,403916,Iwamoto; Naoki,9,0,10,1
1708248548138,JAPN 10C,K01,403918,Ross; Kayoko F,10,0,10,0
1708248548138,JAPN 10C,K02,403928,Ross; Kayoko F,10,0,10,0
1708248548138,JAPN 10C,L01,403935,Homma; Kunihiko,9,0,10,1
1708248548138,JAPN 10C,L02,403936,Homma; Kunihiko,10,0,10,0
1708248548138,JAPN 10C,M02,403939,Kamioka; Sachiko,13,0,15,2
1708248548138,JAPN 10C,N01,479041,Iwamoto; Naoki,15,0,15,0
1708248548665,JAPN 10CR,A01,403982,Inada; Minori,12,0,12,0
1708248548665,JAPN 10CR,A02,403983,Inada; Minori,12,0,12,0
1708248549202,JAPN 20C,A01,403988,Homma; Kunihiko,10,0,12,2
1708248549202,JAPN 20C,B02,404029,Kamioka; Sachiko,10,0,12,2
1708248549202,JAPN 20C,C01,404033,Takeda; Izumi,8,0,12,4
1708248549202,JAPN 20C,D02,404114,Kamioka; Sachiko,11,0,12,1
1708248549202,JAPN 20C,E01,404135,Simpson; Junko Tokuda,12,0,12,0
1708248549749,JAPN 130C,A01,404144,Maruyama; Rie,9,0,9,0
1708248549749,JAPN 130C,A02,404145,Maruyama; Rie,9,0,9,0
1708248549749,JAPN 130C,B01,404147,Simpson; Junko Tokuda,8,0,9,1
1708248549749,JAPN 130C,B02,404148,Simpson; Junko Tokuda,9,0,9,0
1708248550274,JAPN 135C,A00,404176,Ross; Kayoko F,16,0,16,0
1708248550274,JAPN 135C,B00,404253,Takeda; Izumi,14,0,16,2
1708248550801,JAPN 140C,A00,404255,Sato; Kyoko,18,0,20,2
1708248551331,JAPN 150C,A00,404258,McKee; Mayumi Mochizuki,14,0,14,0
1708248551857,JAPN 190,A00,404260,Miyao; Daisuke,17,0,20,3
1708248552389,JAPN 196B,001,487237,Turner; Christena L.,9999,0,9999,0
1708248552937,JWSP 3,A01,404485,Shuster; Alana,20,0,20,0
1708248553468,LATI 10,A01,405201,Kennemore; Amy Michelle,27,0,30,3
1708248553468,LATI 10,A02,405202,Kennemore; Amy Michelle,27,0,30,3
1708248553468,LATI 10,A03,405208,Kennemore; Amy Michelle,28,0,30,2
1708248553993,LATI 50,A01,405214,Kokinis; Troy Andreas,34,0,35,1
1708248553993,LATI 50,A02,405215,Kokinis; Troy Andreas,34,0,35,1
1708248554519,LATI 130,A01,482880,Alvarez; Camila Huerta,29,0,30,1
1708248555051,LATI 160,A01,477482,Kokinis; Troy Andreas,30,0,30,0
1708248555596,LATI 180,A00,405221,Kennemore; Amy Michelle,28,0,30,2
1708248555596,LATI 180,B00,405222,Mostajo; Lorena,30,0,30,0
1708248556122,LIAB 1C,A00,405278,Saab; Dima,13,0,14,1
1708248556122,LIAB 1C,B00,405279,Saab; Dima,11,0,14,3
1708248556668,LIAB 1CX,A00,405281,Akjeje; Abdelhak,19,0,20,1
1708248556668,LIAB 1CX,B00,405291,Akjeje; Abdelhak,20,0,20,0
1708248557196,LIAB 1F,A00,482814,El Cheddadi; Youniss,14,0,14,0
1708248557770,LIDS 19,001,492979,Goodall; Grant Todd,9999,0,9999,0
1708248557770,LIDS 19,002,492980,Goodall; Grant Todd,9999,0,9999,0
1708248557770,LIDS 19,003,492981,Goodall; Grant Todd,9999,0,9999,0
1708248557770,LIDS 19,004,492982,Goodall; Grant Todd,9999,0,9999,0
1708248557770,LIDS 19,005,492983,Goodall; Grant Todd,9999,0,9999,0
1708248557770,LIDS 19,006,492984,Goodall; Grant Todd,9999,0,9999,0
1708248557770,LIDS 19,007,492985,Goodall; Grant Todd,9999,0,9999,0
1708248557770,LIDS 19,008,492986,Goodall; Grant Todd,9999,0,9999,0
1708248557770,LIDS 19,009,492987,Goodall; Grant Todd,9999,0,9999,0
1708248557770,LIDS 19,010,492988,Goodall; Grant Todd,9999,0,9999,0
1708248557770,LIDS 19,011,492989,Goodall; Grant Todd,9999,0,9999,0
1708248557770,LIDS 19,012,492990,Goodall; Grant Todd,9999,0,9999,0
1708248558311,LIFR 1A,A00,405299,Van Moer; Vinciane G,13,0,14,1
1708248558311,LIFR 1A,B00,405300,Van Moer; Vinciane G,13,0,14,1
1708248558311,LIFR 1A,C00,405301,Van Moer; Vinciane G,13,0,14,1
1708248558311,LIFR 1A,D00,405307,Van Moer; Vinciane G,14,0,14,0
1708248558836,LIFR 1AX,A00,405308,Van Moer; Vinciane G,27,0,28,1
1708248558836,LIFR 1AX,B00,405309,Van Moer; Vinciane G,27,0,28,1
1708248559364,LIFR 1C,A00,405310,Van Moer; Vinciane G,14,0,14,0
1708248559364,LIFR 1C,B00,405311,Van Moer; Vinciane G,12,0,14,2
1708248559364,LIFR 1C,C00,405325,Van Moer; Vinciane G,13,0,14,1
1708248559364,LIFR 1C,D00,405326,Van Moer; Vinciane G,11,0,14,3
1708248559890,LIFR 1CX,A00,405332,Van Moer; Vinciane G,25,0,28,3
1708248559890,LIFR 1CX,B00,405333,Van Moer; Vinciane G,27,0,28,1
1708248560417,LIFR 1D,A00,405334,Van Moer; Vinciane G,13,0,14,1
1708248560417,LIFR 1D,B00,405335,Van Moer; Vinciane G,13,0,14,1
1708248560417,LIFR 1D,C00,405336,Van Moer; Vinciane G,13,0,14,1
1708248560417,LIFR 1D,D00,405337,Van Moer; Vinciane G,13,0,14,1
1708248560997,LIFR 1DX,A00,405338,Van Moer; Vinciane G,25,0,28,3
1708248560997,LIFR 1DX,B00,405394,Van Moer; Vinciane G,27,0,28,1
1708248561523,LIFR 11,001,405395,Goodall; Grant Todd,999,0,999,0
1708248562048,LIGM 1C,A00,405398,Fischer-Grunski; Eva K,12,0,14,2
1708248562048,LIGM 1C,B00,405400,Fischer-Grunski; Eva K,13,0,14,1
1708248562048,LIGM 1C,C00,405403,Fischer-Grunski; Eva K,13,0,14,1
1708248562048,LIGM 1C,D00,405404,Fischer-Grunski; Eva K,13,0,14,1
1708248562578,LIGM 1CX,A00,405407,Fischer-Grunski; Eva K,27,0,28,1
1708248562578,LIGM 1CX,B00,405408,Fischer-Grunski; Eva K,26,0,28,2
1708248563107,LIGM 11,001,405464,Goodall; Grant Todd,999,0,999,0
1708248563639,LIGN 8,A00,411133,McIntosh; Justin Daniel,232,0,240,8
1708248564164,LIGN 17,A00,411141,Kehler; Andrew Scott,287,0,300,13
1708248565709,LIGN 101,A01,411144,Staff,28,0,30,2
1708248565709,LIGN 101,A02,411147,Staff,29,0,30,1
1708248565709,LIGN 101,A03,411154,Staff,27,0,30,3
1708248565709,LIGN 101,A04,411163,Staff,29,0,30,1
1708248566253,LIGN 120,A01,411165,Ackerman; Farrell,28,0,30,2
1708248566253,LIGN 120,A02,411177,Ackerman; Farrell,23,0,27,4
1708248566778,LIGN 130,A01,411223,Staff,29,0,30,1
1708248566778,LIGN 130,A02,411231,Staff,30,0,30,0
1708248566778,LIGN 130,A03,411232,Staff,29,0,30,1
1708248567305,LIGN 141,A00,411276,Rose; Sharon,37,0,40,3
1708248567836,LIGN 144,A00,411277,Lott; Margaret S.,22,0,24,2
1708248568362,LIGN 148,A00,411278,Mayberry; Rachel,71,0,75,4
1708248568894,LIGN 165,A00,411279,Bergen; Leon,41,0,70,29
1708248569421,LIGN 168,A01,411281,Styler; William Francis,65,0,70,5
1708248569948,LIGN 175,A00,482816,Rodriguez Aispuro; Alejandro,35,0,40,5
1708248570473,LIGN 230,A00,411293,Caponigro; Ivano,19,0,20,1
1708248571015,LIGN 238,A00,411308,Bergen; Benjamin,20,0,20,0
1708248571540,LIGN 252,A00,411309,Bergen; Leon,28,0,30,2
1708248572072,LIGN 256,A00,411310,Nakashole; Ndapandula,0,0,5,5
1708248572600,LIGN 272,A00,482887,Kluender; Robert,10,0,10,0
1708248573133,LIHL 112P,A00,405228,Pagkalinawan; Leticia Cant,27,0,28,1
1708248573659,LIHL 114P,A00,405229,Nguyen; Hoan Thi,26,0,28,2
1708248574188,LIHL 117P,A00,405256,Sadegholvad; Elham,27,0,28,1
1708248574717,LIHL 118,A00,405257,Chen; Areana Yen,28,0,28,0
1708248575243,LIHL 124P,A00,405262,Nguyen; Hoan Thi,28,0,28,0
1708248575768,LIHL 132P,A00,405263,Pagkalinawan; Leticia Cant,28,0,28,0
1708248576294,LIHL 134P,A00,405269,Nguyen; Hoan Thi,28,0,28,0
1708248576821,LIHL 138,A00,405270,Chen; Areana Yen,27,0,28,1
1708248577347,LIIT 1C,A00,405465,Carnelos; Chiara,12,0,14,2
1708248577347,LIIT 1C,B00,405466,Carnelos; Chiara,14,0,14,0
1708248577873,LIIT 1CX,A00,405594,Carnelos; Chiara,28,0,28,0
1708248578401,LIPO 1C,A00,405595,Paladini; Denise,13,0,14,1
1708248578401,LIPO 1C,B00,405596,Paladini; Denise,14,0,14,0
1708248578933,LIPO 1CX,A00,405597,De Abreu; Cassia,28,0,28,0
1708248579466,LISL 1A,C00,405600,Lott; Margaret S.,13,0,14,1
1708248579466,LISL 1A,D00,405601,Lott; Margaret S.,10,0,14,4
1708248579466,LISL 1A,E00,405602,Lott; Margaret S.,13,0,14,1
1708248579466,LISL 1A,F00,405603,Lott; Margaret S.,13,0,14,1
1708248579992,LISL 1AR,A00,480605,Lott; Margaret S.,13,0,15,2
1708248579992,LISL 1AR,B00,480606,Lott; Margaret S.,14,0,15,1
1708248580522,LISL 1AX,A00,405754,Lott; Margaret S.,26,0,28,2
1708248580522,LISL 1AX,B00,405755,Lott; Margaret S.,23,0,28,5
1708248581066,LISL 1C,A00,405776,Lott; Margaret S.,13,0,14,1
1708248581066,LISL 1C,B00,405779,Lott; Margaret S.,14,0,14,0
1708248581066,LISL 1C,C00,405785,Lott; Margaret S.,14,0,14,0
1708248581066,LISL 1C,D00,405787,Lott; Margaret S.,9,0,14,5
1708248581066,LISL 1C,E00,405827,Lott; Margaret S.,12,0,14,2
1708248581066,LISL 1C,F00,405830,Lott; Margaret S.,13,0,14,1
1708248581613,LISL 1CX,A00,405844,Lott; Margaret S.,25,0,28,3
1708248581613,LISL 1CX,B00,405848,Lott; Margaret S.,25,0,28,3
1708248581613,LISL 1CX,C00,405849,Lott; Margaret S.,28,0,28,0
1708248582142,LISL 1D,A00,405850,Lott; Margaret S.,8,0,14,6
1708248582142,LISL 1D,B00,405851,Lott; Margaret S.,13,0,14,1
1708248582142,LISL 1D,C00,405852,Lott; Margaret S.,10,0,14,4
1708248582673,LISL 1DX,A00,405854,Lott; Margaret S.,17,0,22,5
1708248582673,LISL 1DX,B00,405855,Lott; Margaret S.,18,0,22,4
1708248583205,LISP 1A,001,405856,Munoz Sanchez; Alicia,11,0,14,3
1708248583205,LISP 1A,002,405857,Munoz Sanchez; Alicia,13,0,14,1
1708248583205,LISP 1A,003,405858,Munoz Sanchez; Alicia,14,0,14,0
1708248583205,LISP 1A,004,405861,Munoz Sanchez; Alicia,14,0,14,0
1708248583733,LISP 1AX,001,405862,Munoz Sanchez; Alicia,28,0,28,0
1708248583733,LISP 1AX,002,405863,Munoz Sanchez; Alicia,25,0,28,3
1708248584268,LISP 1C,001,405864,Munoz Sanchez; Alicia,13,0,14,1
1708248584268,LISP 1C,002,405865,Munoz Sanchez; Alicia,12,0,14,2
1708248584268,LISP 1C,003,405879,Munoz Sanchez; Alicia,12,0,14,2
1708248584268,LISP 1C,004,405880,Munoz Sanchez; Alicia,13,0,14,1
1708248584268,LISP 1C,005,405881,Munoz Sanchez; Alicia,12,0,14,2
1708248584268,LISP 1C,006,405882,Munoz Sanchez; Alicia,12,0,14,2
1708248584268,LISP 1C,007,405904,Munoz Sanchez; Alicia,14,0,14,0
1708248584268,LISP 1C,008,405905,Munoz Sanchez; Alicia,14,0,14,0
1708248584268,LISP 1C,009,405908,Munoz Sanchez; Alicia,14,0,14,0
1708248584268,LISP 1C,010,405917,Munoz Sanchez; Alicia,13,0,14,1
1708248584801,LISP 1CX,001,405922,Munoz Sanchez; Alicia,24,0,28,4
1708248584801,LISP 1CX,002,405990,Munoz Sanchez; Alicia,26,0,28,2
1708248584801,LISP 1CX,003,406007,Munoz Sanchez; Alicia,27,0,28,1
1708248584801,LISP 1CX,004,406008,Munoz Sanchez; Alicia,25,0,28,3
1708248584801,LISP 1CX,005,406015,Munoz Sanchez; Alicia,26,0,28,2
1708248585362,LISP 1D,001,406016,Munoz Sanchez; Alicia,12,0,14,2
1708248585362,LISP 1D,002,406017,Munoz Sanchez; Alicia,13,0,14,1
1708248585362,LISP 1D,003,406018,Munoz Sanchez; Alicia,14,0,14,0
1708248585362,LISP 1D,004,406019,Munoz Sanchez; Alicia,11,0,14,3
1708248585362,LISP 1D,005,406020,Munoz Sanchez; Alicia,13,0,14,1
1708248585362,LISP 1D,006,406021,Munoz Sanchez; Alicia,10,0,14,4
1708248585362,LISP 1D,007,406022,Munoz Sanchez; Alicia,13,0,14,1
1708248585362,LISP 1D,008,406023,Munoz Sanchez; Alicia,13,0,14,1
1708248585362,LISP 1D,009,406024,Munoz Sanchez; Alicia,11,0,14,3
1708248585362,LISP 1D,010,406025,Munoz Sanchez; Alicia,12,0,14,2
1708248585362,LISP 1D,011,406026,Munoz Sanchez; Alicia,13,0,14,1
1708248585362,LISP 1D,012,406027,Munoz Sanchez; Alicia,13,0,14,1
1708248585362,LISP 1D,013,406028,Munoz Sanchez; Alicia,12,0,14,2
1708248585362,LISP 1D,014,406029,Munoz Sanchez; Alicia,12,0,14,2
1708248585362,LISP 1D,015,406030,Munoz Sanchez; Alicia,10,0,14,4
1708248585362,LISP 1D,016,406031,Munoz Sanchez; Alicia,14,0,14,0
1708248585362,LISP 1D,017,406032,Munoz Sanchez; Alicia,14,0,14,0
1708248585362,LISP 1D,018,406033,Munoz Sanchez; Alicia,12,0,14,2
1708248585362,LISP 1D,019,406034,Munoz Sanchez; Alicia,13,0,14,1
1708248585362,LISP 1D,020,406035,Munoz Sanchez; Alicia,14,0,14,0
1708248585362,LISP 1D,021,406036,Munoz Sanchez; Alicia,13,0,14,1
1708248585362,LISP 1D,022,406037,Munoz Sanchez; Alicia,14,0,14,0
1708248585362,LISP 1D,023,406038,Munoz Sanchez; Alicia,14,0,14,0
1708248585362,LISP 1D,024,406039,Munoz Sanchez; Alicia,13,0,14,1
1708248585928,LISP 1DX,001,406040,Munoz Sanchez; Alicia,28,0,28,0
1708248585928,LISP 1DX,002,406041,Munoz Sanchez; Alicia,27,0,28,1
1708248585928,LISP 1DX,003,406127,Munoz Sanchez; Alicia,24,0,28,4
1708248585928,LISP 1DX,004,406128,Munoz Sanchez; Alicia,17,0,28,11
1708248585928,LISP 1DX,005,406418,Munoz Sanchez; Alicia,24,0,28,4
1708248585928,LISP 1DX,006,406536,Munoz Sanchez; Alicia,27,0,28,1
1708248585928,LISP 1DX,007,406561,Munoz Sanchez; Alicia,24,0,28,4
1708248585928,LISP 1DX,008,406576,Munoz Sanchez; Alicia,25,0,28,3
1708248585928,LISP 1DX,009,406679,Munoz Sanchez; Alicia,28,0,28,0
1708248585928,LISP 1DX,010,406691,Munoz Sanchez; Alicia,26,0,28,2
1708248585928,LISP 1DX,011,406692,Munoz Sanchez; Alicia,28,0,28,0
1708248585928,LISP 1DX,012,406693,Munoz Sanchez; Alicia,28,0,28,0
1708248586454,LISP 17,001,406694,Munoz Sanchez; Alicia,18,0,20,2
1708248586983,LISP 18,001,406695,Munoz Sanchez; Alicia,20,0,20,0
1708248587510,LTAM 105,A00,412520,Ruiz; Ariana,28,0,40,12
1708248588052,LTCH 101,A00,479214,Zhu; Ping,39,0,40,1
1708248588585,LTCS 87,A00,492906,Nguyen; Hoang Tan,20,0,20,0
1708248588585,LTCS 87,B00,492907,Nguyen; Hoang Tan,20,0,20,0
1708248589117,LTCS 150,A00,412543,Liao; Ping H,39,0,40,1
1708248589648,LTCS 225,A00,412819,Mendoza; Andrea,14,0,15,1
1708248590190,LTCS 250,A00,412821,Lee; Jin-Kyung,15,0,15,0
1708248590715,LTEA 110B,A00,412548,Liao; Ping H,60,0,60,0
1708248591243,LTEA 120A,A00,479216,Zhu; Ping,36,0,40,4
1708248591770,LTEA 120C,A00,412552,Fiss; Geraldine Anna,295,0,300,5
1708248592299,LTEA 132,A00,412561,Mendoza; Andrea,51,0,60,9
1708248592826,LTEA 141,A00,412565,Lee; Jin-Kyung,37,0,40,3
1708248593354,LTEN 23,A01,411317,Vijay; Ameeth Varma,24,0,25,1
1708248593354,LTEN 23,A02,411318,Vijay; Ameeth Varma,24,0,25,1
1708248593354,LTEN 23,A03,411371,Vijay; Ameeth Varma,25,0,25,0
1708248593354,LTEN 23,A04,411375,Vijay; Ameeth Varma,24,0,25,1
1708248593904,LTEN 28,A01,411632,Blanco; John D,25,0,25,0
1708248593904,LTEN 28,A02,411697,Blanco; John D,25,0,25,0
1708248593904,LTEN 28,A03,411698,Blanco; John D,25,0,25,0
1708248593904,LTEN 28,A04,411709,Blanco; John D,25,0,25,0
1708248593904,LTEN 28,A05,411719,Blanco; John D,25,0,25,0
1708248593904,LTEN 28,A06,411744,Blanco; John D,25,0,25,0
1708248593904,LTEN 28,A07,411780,Blanco; John D,25,0,25,0
1708248593904,LTEN 28,A08,411820,Blanco; John D,25,0,25,0
1708248594431,LTEN 110,A00,486891,Vitkus; Daniel J.,38,0,40,2
1708248594964,LTEN 144,A00,412570,Vijay; Ameeth Varma,39,0,40,1
1708248595499,LTEN 180,A00,412581,Perreira; Christopher Michael,18,0,25,7
1708248596027,LTEN 181,A00,412582,Mukherjee; Silpa,55,0,60,5
1708248596554,LTEN 245,A00,412824,Johnson; Sara E.,13,0,15,2
1708248597082,LTEN 259,A00,412825,Streeby; Shelley,13,0,15,2
1708248597610,LTEU 111,A00,412588,Kontje; Todd Curtis,38,0,40,2
1708248598138,LTEU 140,A00,480172,De Marchi Gherini; Adriana,36,0,37,1
1708248598670,LTEU 141,A00,412592,Cohen; Alain J. J.,40,0,40,0
1708248599202,LTFR 2A,A01,411996,Ploye; Catherine,25,0,25,0
1708248599728,LTFR 2C,A00,411997,Ploye; Catherine,24,0,25,1
1708248600268,LTFR 142,A00,412597,Zhiri; Oumelbanine,20,0,20,0
1708248600800,LTGK 3,A00,412001,Murray; Kourtney Kristine,30,0,30,0
1708248601330,LTGM 2C,A00,412002,Fischer-Grunski; Eva K,25,0,25,0
1708248601885,LTKO 1C,A01,412029,Cho; Hye Jin,24,0,25,1
1708248601885,LTKO 1C,B01,412164,Cho; Hye Jin,23,0,25,2
1708248601885,LTKO 1C,C01,412168,Cho; Hye Jin,25,0,25,0
1708248601885,LTKO 1C,D01,412353,Yim; Nancy,24,0,25,1
1708248601885,LTKO 1C,E01,412372,Yim; Nancy,25,0,25,0
1708248602411,LTKO 2C,A01,412374,Yim; Nancy,21,0,25,4
1708248603960,LTKO 130P,A00,412601,Lee; Jeyseon,25,0,25,0
1708248604489,LTKO 135,A00,412606,Lee; Jeyseon,25,0,25,0
1708248605016,LTLA 3,A00,412375,Murray; Kourtney Kristine,36,0,40,4
1708248605542,LTRU 1C,A01,412491,Wells; Patricia Rebecca,24,0,25,1
1708248606069,LTRU 104A,A01,412614,Wells; Patricia Rebecca,20,0,20,0
1708248606613,LTSP 2A,A01,412493,Lampell; Toni,24,0,25,1
1708248607162,LTSP 2B,A01,412497,Lampell; Toni,22,0,25,3
1708248607162,LTSP 2B,B01,479218,Lampell; Toni,24,0,25,1
1708248607692,LTSP 2C,A01,412499,Mastromartino; Alexandra L,23,0,25,2
1708248608222,LTSP 2D,A00,412500,Dominguez; Noelia,24,0,25,1
1708248608754,LTSP 2E,A00,412501,Mastromartino; Alexandra L,24,0,25,1
1708248608754,LTSP 2E,B00,412502,Mastromartino; Alexandra L,25,0,25,0
1708248609287,LTSP 87,A00,479212,Bessett; Ryan Matthew,20,0,20,0
1708248609813,LTSP 100B,A00,412619,Dominguez; Noelia,25,0,25,0
1708248609813,LTSP 100B,B00,412623,Dominguez; Noelia,24,0,25,1
1708248610345,LTSP 116,A00,412628,Blanco; John D,28,0,30,2
1708248610872,LTSP 135A,A00,412631,Parra; Max,27,0,30,3
1708248611399,LTSP 174,A00,479213,Staff,28,0,30,2
1708248611925,LTTH 115,A00,412632,Kontje; Todd Curtis,35,0,40,5
1708248612456,LTTH 210C,A00,412826,Batarseh; Amanda Alicia,14,0,15,1
1708248612983,LTTH 255,A00,412827,Ali; Mohammad Kazim,13,0,15,2
1708248613509,LTTH 260,A00,412828,Kim; Joo Ok,30,0,30,0
1708248614041,LTWL 19C,A00,412503,Kelting; Edward William,40,0,40,0
1708248614566,LTWL 101,A00,412633,Kelting; Edward William,39,0,40,1
1708248615097,LTWL 114,A00,412656,Fiss; Geraldine Anna,60,0,60,0
1708248615624,LTWL 123,A00,412674,Lampert-Weissig; Lisa,31,0,40,9
1708248616155,LTWL 172,A00,412729,De Marchi Gherini; Adriana,37,0,40,3
1708248616760,LTWL 183,A00,412731,Cohen; Alain J. J.,38,0,40,2
1708248617291,LTWL 184,A00,479219,Mukherjee; Silpa,38,0,40,2
1708248617816,LTWL 194A,A00,489635,Vijay; Ameeth Varma,27,0,31,4
1708248618348,LTWR 8A,A01,412505,Springer; Anna Joy,24,0,25,1
1708248618348,LTWR 8A,A02,412506,Springer; Anna Joy,24,0,25,1
1708248618348,LTWR 8A,A03,412507,Springer; Anna Joy,25,0,25,0
1708248618348,LTWR 8A,A04,412508,Springer; Anna Joy,23,0,25,2
1708248618878,LTWR 8C,A01,412511,Forbes; Camille,23,0,25,2
1708248618878,LTWR 8C,A02,412512,Forbes; Camille,25,0,25,0
1708248618878,LTWR 8C,A03,412514,Forbes; Camille,25,0,25,0
1708248618878,LTWR 8C,A04,412519,Forbes; Camille,24,0,25,1
1708248619406,LTWR 100,A00,412734,Forbes; Camille,7,0,15,8
1708248619936,LTWR 113,A00,412816,Carroll; Amy Sara,28,0,30,2
1708248620462,LTWR 114,A00,412817,Springer; Anna Joy,23,0,30,7
1708248620992,LTWR 126,A00,412818,Hoang; Lily Kim,25,0,30,5
1708248621523,LTWR 215,A00,412880,Carroll; Amy Sara,19,0,20,1
1708248622054,MAE 3,A01,435606,Qi; Huihui,16,0,20,4
1708248622054,MAE 3,A02,435607,Qi; Huihui,15,0,20,5
1708248622054,MAE 3,A03,435608,Qi; Huihui,19,0,20,1
1708248622054,MAE 3,B01,435618,Delson; Nathan Joseph & Mullin; Jennifer S,20,0,20,0
1708248622054,MAE 3,B02,435626,Delson; Nathan Joseph & Mullin; Jennifer S,20,0,20,0
1708248622054,MAE 3,B03,435666,Delson; Nathan Joseph & Mullin; Jennifer S,20,0,20,0
1708248622054,MAE 3,B04,435679,Delson; Nathan Joseph & Mullin; Jennifer S,20,0,20,0
1708248622054,MAE 3,B05,494545,Delson; Nathan Joseph & Mullin; Jennifer S,20,0,20,0
1708248622580,MAE 8,A01,435688,Pham; Hieu Tan,197,0,200,3
1708248623107,MAE 30B,A00,435689,Lubarda; Marko,128,0,130,2
1708248623107,MAE 30B,B00,435701,Ghazinejad; Maziar,117,0,130,13
1708248623638,MAE 101B,A00,435702,Saintillan; David,146,0,150,4
1708248623638,MAE 101B,B00,435703,Nomura; Keiko K.,138,0,146,8
1708248624164,MAE 101C,A00,435704,Sadeghizadeh; Zahra,53,0,65,12
1708248624691,MAE 101D,A00,435705,Chen; Renkun,14,0,20,6
1708248625223,MAE 105,A00,435706,Becker; Janet Maria,115,0,120,5
1708248625751,MAE 107,A00,435707,Lindsey; Stephanie,48,0,50,2
1708248625751,MAE 107,B00,435708,Davidson; Michael R,55,0,60,5
1708248626278,MAE 119,A00,435710,Hidalgo-Gonzalez; Patricia,100,0,120,20
1708248626805,MAE 120,A00,435722,Arefiev; Alexey,49,0,65,16
1708248627333,MAE 125,A00,435723,Kleissl; Jan,60,0,65,5
1708248627859,MAE 131A,A00,435724,Qi; Huihui,119,0,125,6
1708248627859,MAE 131A,B00,435725,Meyers; Marc,123,0,125,2
1708248628399,MAE 143B,A00,435726,Morimoto; Tania,114,0,120,6
1708248628399,MAE 143B,B00,435727,Herbert; Sylvia Lee,117,0,120,3
1708248628399,MAE 143B,C00,435728,Diagne; Mamadou Lamine,108,0,120,12
1708248628925,MAE 145,A00,435729,Martinez; Sonia,41,0,60,19
1708248629452,MAE 148,A01,492802,Silberman; Jack,14,0,24,10
1708248629983,MAE 150,A00,435730,Pham; Hieu Tan,52,0,60,8
1708248630509,MAE 152,A00,435731,Llewellyn Smith; Stefan G.,14,0,14,0
1708248630509,MAE 152,B00,435747,Llewellyn Smith; Stefan G.,12,0,14,2
1708248630509,MAE 152,C00,435748,Llewellyn Smith; Stefan G.,12,0,14,2
1708248630509,MAE 152,D00,435749,Llewellyn Smith; Stefan G.,8,0,14,6
1708248630509,MAE 152,E00,435750,Llewellyn Smith; Stefan G.,13,0,14,1
1708248631045,MAE 155B,A01,435752,Hwang; John T,36,0,50,14
1708248631045,MAE 155B,B01,435768,Anderson; Mark Ronald,27,0,50,23
1708248631045,MAE 155B,C01,494006,Saha; Abhishek,0,0,0,0
1708248631572,MAE 156B,A01,435770,Tustaniwskyj; Jerry I,33,0,40,7
1708248631572,MAE 156B,B01,435772,Ghazinejad; Maziar,35,0,40,5
1708248631572,MAE 156B,C01,435774,Delson; Nathan Joseph,38,0,40,2
1708248631572,MAE 156B,D01,435776,Saha; Abhishek,31,0,40,9
1708248632099,MAE 166,A00,435777,Fullerton; Eric E,44,0,50,6
1708248632632,MAE 170,A01,435779,Lubarda; Marko,30,0,32,2
1708248632632,MAE 170,A02,435780,Lubarda; Marko,27,0,32,5
1708248632632,MAE 170,A03,435781,Lubarda; Marko,32,0,32,0
1708248632632,MAE 170,A04,435782,Lubarda; Marko,31,0,32,1
1708248632632,MAE 170,A05,435783,Lubarda; Marko,29,0,32,3
1708248632632,MAE 170,A06,435784,Lubarda; Marko,30,0,32,2
1708248632632,MAE 170,B01,435786,Evdokimenko; Ekaterina,23,0,24,1
1708248632632,MAE 170,B02,435787,Evdokimenko; Ekaterina,20,0,24,4
1708248632632,MAE 170,B03,435788,Evdokimenko; Ekaterina,23,0,24,1
1708248632632,MAE 170,B04,435789,Evdokimenko; Ekaterina,23,0,24,1
1708248632632,MAE 170,B05,435790,Evdokimenko; Ekaterina,19,0,24,5
1708248632632,MAE 170,B06,435791,Evdokimenko; Ekaterina,23,0,24,1
1708248633160,MAE 180,A00,479477,Sadeghizadeh; Zahra,56,0,60,4
1708248633688,MAE 184,A00,435792,Anderson; Mark Ronald,7,0,50,43
1708248634217,MAE 190,A00,435793,Beg; Farhat N.,17,0,20,3
1708248634217,MAE 190,B00,479209,Gerardo; Hortense Flotilde,12,0,15,3
1708248634744,MAE 202,A00,435794,Bandaru; Prabhakar,32,0,70,38
1708248635276,MAE 205,A00,435804,Hwang; John T & Tynan; George Robert & Seshadri; Kalyanasundaram & Rangamani; Padmini & Bandaru; Prabhakar,9990,0,9999,9
1708248635810,MAE 207,A00,435805,Beg; Farhat N.,9,0,10,1
1708248635810,MAE 207,B00,435815,Campbell; Edward Michael,6,0,10,4
1708248635810,MAE 207,C00,477499,Gerardo; Hortense Flotilde,6,0,30,24
1708248636336,MAE 209,A00,435816,Scholtes Acevedo; Claire,25,0,30,5
1708248636862,MAE 210C,A00,435817,Becker; Janet Maria,22,0,30,8
1708248637388,MAE 211,A00,435818,Seshadri; Kalyanasundaram,20,0,30,10
1708248637916,MAE 214A,A00,435819,Sarkar; Sutanu,27,0,35,8
1708248638442,MAE 217C,A00,435820,Marinoni; Alessandro,10,0,10,0
1708248638973,MAE 221C,A00,435821,Seshadri; Kalyanasundaram,9,0,15,6
1708248639499,MAE 221D,A00,435822,Poulikakos; Lisa Voula,23,0,30,7
1708248640032,MAE 224A,A00,435823,Pawlak; Geno Ronald,5,0,10,5
1708248640562,MAE 227,A00,435824,Hidalgo-Gonzalez; Patricia,21,0,35,14
1708248641088,MAE 231A,A00,435825,Boechler; Nicholas Sebastia,14,0,30,16
1708248641621,MAE 240,A00,435826,Rosengren; Aaron,19,0,30,11
1708248642152,MAE 242,A00,435827,Martinez; Sonia,0,0,45,45
1708248642683,MAE 249,A00,435842,Tolley; Michael Thomas,0,0,35,35
1708248643209,MAE 253,A00,435891,Staff,24,0,25,1
1708248643741,MAE 256,A00,435949,Coimbra; Carlos F.,6,0,10,4
1708248644268,MAE 263,A00,435987,Rangamani; Padmini,10,0,10,0
1708248644792,MAE 266,A00,435988,Evdokimenko; Ekaterina,7,0,30,23
1708248645319,MAE 271C,A00,435990,Arzt; Eduard,10,0,10,0
1708248645845,MAE 281B,A00,435991,Cortes; Jorge,9,0,25,16
1708248646374,MAE 288A,A00,435998,McEneaney; William Michael,6,0,40,34
1708248646900,MAE 288B,A00,435999,Bitmead; Robert R.,41,0,45,4
1708248647432,MAE 290C,A00,436008,Schmidt; Oliver,26,0,30,4
1708248647958,MAE 294C,A01,436010,Young; William Roy,19,0,20,1
1708248648486,MATH 2,A01,431271,Staff,31,0,35,4
1708248648486,MATH 2,B01,431273,Staff,29,0,35,6
1708248648486,MATH 2,C01,431275,Staff,31,0,35,4
1708248649019,MATH 3C,A01,431277,Safii; Soheil,12,0,15,3
1708248649019,MATH 3C,A02,431278,Safii; Soheil,12,0,15,3
1708248649019,MATH 3C,A03,431279,Safii; Soheil,12,0,15,3
1708248649019,MATH 3C,A04,431280,Safii; Soheil,15,0,15,0
1708248649019,MATH 3C,A05,431281,Safii; Soheil,14,0,15,1
1708248649019,MATH 3C,A06,431282,Safii; Soheil,15,0,15,0
1708248649548,MATH 10A,A01,431284,Bowers; Adam R.,20,0,30,10
1708248649548,MATH 10A,A02,431285,Bowers; Adam R.,18,0,30,12
1708248649548,MATH 10A,A03,431369,Bowers; Adam R.,28,0,30,2
1708248649548,MATH 10A,A04,431395,Bowers; Adam R.,27,0,30,3
1708248649548,MATH 10A,A05,431450,Bowers; Adam R.,28,0,30,2
1708248649548,MATH 10A,A06,431508,Bowers; Adam R.,30,0,30,0
1708248649548,MATH 10A,B01,431572,Kowalenko; Ethan J,24,0,30,6
1708248649548,MATH 10A,B02,431573,Kowalenko; Ethan J,29,0,30,1
1708248649548,MATH 10A,B03,431574,Kowalenko; Ethan J,30,0,30,0
1708248649548,MATH 10A,B04,431576,Kowalenko; Ethan J,30,0,30,0
1708248649548,MATH 10A,B05,431577,Kowalenko; Ethan J,30,0,30,0
1708248649548,MATH 10A,B06,431583,Kowalenko; Ethan J,30,0,30,0
1708248650078,MATH 10B,A01,431595,Habib; Yousaf,29,0,36,7
1708248650078,MATH 10B,A02,431597,Habib; Yousaf,35,0,36,1
1708248650078,MATH 10B,A03,431669,Habib; Yousaf,37,0,37,0
1708248650078,MATH 10B,A04,431670,Habib; Yousaf,36,0,37,1
1708248650078,MATH 10B,A05,431671,Habib; Yousaf,70,0,70,0
1708248650078,MATH 10B,B01,431673,Habib; Yousaf,25,0,33,8
1708248650078,MATH 10B,B02,431712,Habib; Yousaf,33,0,33,0
1708248650078,MATH 10B,B03,431713,Habib; Yousaf,33,0,33,0
1708248650078,MATH 10B,B04,431714,Habib; Yousaf,33,0,33,0
1708248650078,MATH 10B,B05,431715,Habib; Yousaf,60,0,60,0
1708248650078,MATH 10B,C01,431717,Bach; Quang Tran,57,0,60,3
1708248650078,MATH 10B,C02,431718,Bach; Quang Tran,18,0,34,16
1708248650078,MATH 10B,C03,431719,Bach; Quang Tran,34,0,34,0
1708248650078,MATH 10B,C04,431720,Bach; Quang Tran,33,0,34,1
1708248650078,MATH 10B,C05,431721,Bach; Quang Tran,32,0,34,2
1708248650078,MATH 10B,D01,431723,Staff,28,0,34,6
1708248650078,MATH 10B,D02,431724,Staff,34,0,34,0
1708248650078,MATH 10B,D03,431725,Staff,34,0,34,0
1708248650078,MATH 10B,D04,431726,Staff,34,0,34,0
1708248650078,MATH 10B,D05,431727,Staff,57,0,60,3
1708248650612,MATH 10C,A01,431741,Staff,94,0,96,2
1708248650612,MATH 10C,A02,431742,Staff,39,0,40,1
1708248650612,MATH 10C,B01,431744,Staff,95,0,96,1
1708248650612,MATH 10C,B02,431746,Staff,27,0,40,13
1708248650612,MATH 10C,C01,431748,Pardo Guerra; Sebastian,30,0,40,10
1708248650612,MATH 10C,C02,431885,Pardo Guerra; Sebastian,40,0,40,0
1708248650612,MATH 10C,C03,431895,Pardo Guerra; Sebastian,32,0,33,1
1708248650612,MATH 10C,C04,431896,Pardo Guerra; Sebastian,32,0,32,0
1708248651141,MATH 11,A01,431933,Rava; Denise,82,0,100,18
1708248651141,MATH 11,A02,431960,Rava; Denise,66,0,70,4
1708248651141,MATH 11,A03,431971,Rava; Denise,39,0,40,1
1708248651141,MATH 11,B01,432053,Staff,99,0,100,1
1708248651141,MATH 11,B02,432064,Staff,37,0,45,8
1708248651141,MATH 11,B03,432073,Staff,44,0,45,1
1708248651670,MATH 18,A01,432082,Mackall; Eoin Travis,65,0,70,5
1708248651670,MATH 18,A02,432086,Mackall; Eoin Travis,68,0,70,2
1708248651670,MATH 18,B01,432089,Suk; Andrew Hoon,39,0,40,1
1708248651670,MATH 18,B02,432090,Suk; Andrew Hoon,35,0,40,5
1708248651670,MATH 18,B03,432091,Suk; Andrew Hoon,33,0,40,7
1708248651670,MATH 18,B04,432092,Suk; Andrew Hoon,30,0,40,10
1708248651670,MATH 18,B05,432093,Suk; Andrew Hoon,34,0,35,1
1708248651670,MATH 18,B06,432094,Suk; Andrew Hoon,33,0,35,2
1708248651670,MATH 18,B07,432095,Suk; Andrew Hoon,98,0,100,2
1708248651670,MATH 18,B08,432096,Suk; Andrew Hoon,100,0,100,0
1708248651670,MATH 18,B09,432097,Suk; Andrew Hoon,98,0,100,2
1708248651670,MATH 18,B10,432098,Suk; Andrew Hoon,69,0,70,1
1708248652198,MATH 20A,A01,432101,Briones; Jor-el Thomas Caparas,30,0,40,10
1708248652198,MATH 20A,A02,432102,Briones; Jor-el Thomas Caparas,98,0,100,2
1708248652198,MATH 20A,B01,432104,Briones; Jor-el Thomas Caparas,99,0,100,1
1708248652198,MATH 20A,B02,432105,Briones; Jor-el Thomas Caparas,40,0,40,0
1708248652730,MATH 20B,A01,432107,Quarfoot; David James,33,0,35,2
1708248652730,MATH 20B,A02,432108,Quarfoot; David James,18,0,35,17
1708248652730,MATH 20B,A03,432109,Quarfoot; David James,32,0,35,3
1708248652730,MATH 20B,A04,432110,Quarfoot; David James,34,0,35,1
1708248652730,MATH 20B,A05,432331,Quarfoot; David James,26,0,32,6
1708248652730,MATH 20B,A06,432411,Quarfoot; David James,31,0,32,1
1708248652730,MATH 20B,B01,432413,Mackall; Eoin Travis,62,0,65,3
1708248652730,MATH 20B,B02,432443,Mackall; Eoin Travis,65,0,65,0
1708248652730,MATH 20B,B03,432444,Mackall; Eoin Travis,60,0,60,0
1708248652730,MATH 20B,B04,432471,Mackall; Eoin Travis,60,0,60,0
1708248653268,MATH 20C,A01,432473,Ohm; Ko Woon,26,0,38,12
1708248653268,MATH 20C,A02,432474,Ohm; Ko Woon,36,0,38,2
1708248653268,MATH 20C,A03,432475,Ohm; Ko Woon,34,0,37,3
1708248653268,MATH 20C,A04,432546,Ohm; Ko Woon,36,0,37,1
1708248653268,MATH 20C,A05,432550,Ohm; Ko Woon,88,0,90,2
1708248653268,MATH 20C,B01,432568,Ohm; Ko Woon,43,0,45,2
1708248653268,MATH 20C,B02,432594,Ohm; Ko Woon,40,0,45,5
1708248653268,MATH 20C,B03,432609,Ohm; Ko Woon,85,0,90,5
1708248653268,MATH 20C,C01,432613,Cheng; Hsiao-Bing,67,0,70,3
1708248653268,MATH 20C,C02,432614,Cheng; Hsiao-Bing,68,0,70,2
1708248653268,MATH 20C,C03,432615,Cheng; Hsiao-Bing,70,0,70,0
1708248653268,MATH 20C,D01,432617,Cheng; Hsiao-Bing,69,0,70,1
1708248653268,MATH 20C,D02,432618,Cheng; Hsiao-Bing,68,0,70,2
1708248653268,MATH 20C,D03,432619,Cheng; Hsiao-Bing,70,0,70,0
1708248653806,MATH 20D,A01,432622,Hammock; Frances H,58,0,60,2
1708248653806,MATH 20D,A02,432623,Hammock; Frances H,58,0,60,2
1708248653806,MATH 20D,A03,432658,Hammock; Frances H,35,0,35,0
1708248653806,MATH 20D,A04,432660,Hammock; Frances H,35,0,35,0
1708248653806,MATH 20D,B01,432702,Hammock; Frances H,66,0,70,4
1708248653806,MATH 20D,B02,432703,Hammock; Frances H,70,0,70,0
1708248653806,MATH 20D,B03,432766,Hammock; Frances H,30,0,30,0
1708248653806,MATH 20D,B04,432782,Hammock; Frances H,20,0,30,10
1708248653806,MATH 20D,C01,432811,Sheng; Hongyi,60,0,60,0
1708248653806,MATH 20D,C02,432931,Sheng; Hongyi,60,0,60,0
1708248653806,MATH 20D,C03,432945,Sheng; Hongyi,28,0,30,2
1708248653806,MATH 20D,C04,432949,Sheng; Hongyi,30,0,30,0
1708248654340,MATH 20E,A01,433007,Eggers; John Dietrich,70,0,80,10
1708248654340,MATH 20E,A02,433070,Eggers; John Dietrich,77,0,80,3
1708248654340,MATH 20E,A03,433079,Eggers; John Dietrich,32,0,35,3
1708248654340,MATH 20E,B01,433092,Staff,86,0,90,4
1708248654340,MATH 20E,B02,433093,Staff,90,0,90,0
1708248654340,MATH 20E,C01,433237,Bach; Quang Tran,52,0,60,8
1708248654340,MATH 20E,C02,433238,Bach; Quang Tran,69,0,70,1
1708248654340,MATH 20E,C03,433239,Bach; Quang Tran,70,0,70,0
1708248654865,MATH 31CH,A01,433241,Rabin; Jeffrey Mark,35,0,35,0
1708248655393,MATH 95,A00,433242,Stevens; Laura Jeanne,30,0,30,0
1708248655919,MATH 100C,A01,433244,Pollack; Aaron,31,0,35,4
1708248655919,MATH 100C,A02,433245,Pollack; Aaron,35,0,35,0
1708248656446,MATH 102,A01,433298,Ophir; Amit,29,0,30,1
1708248656446,MATH 102,A02,433369,Ophir; Amit,30,0,30,0
1708248656446,MATH 102,A03,433373,Ophir; Amit,30,0,30,0
1708248656446,MATH 102,A04,433374,Ophir; Amit,29,0,30,1
1708248656446,MATH 102,B01,433572,Zhang; Ming,28,0,30,2
1708248656446,MATH 102,B02,433732,Zhang; Ming,30,0,30,0
1708248656446,MATH 102,B03,433733,Zhang; Ming,30,0,30,0
1708248656446,MATH 102,B04,433734,Zhang; Ming,29,0,30,1
1708248656974,MATH 103B,A01,433793,Lu; Yunze,23,0,30,7
1708248656974,MATH 103B,A02,433795,Lu; Yunze,30,0,30,0
1708248656974,MATH 103B,A03,433830,Lu; Yunze,28,0,30,2
1708248656974,MATH 103B,B01,433845,Lahiri; Aranya,24,0,30,6
1708248656974,MATH 103B,B02,433846,Lahiri; Aranya,28,0,30,2
1708248656974,MATH 103B,B03,433847,Lahiri; Aranya,27,0,30,3
1708248657506,MATH 109,A01,433849,Aycock; Jon Merrill,6,0,10,4
1708248657506,MATH 109,A02,433850,Aycock; Jon Merrill,9,0,10,1
1708248657506,MATH 109,B01,433852,Klevdal; Christian Sleek,10,0,10,0
1708248657506,MATH 109,B02,433859,Klevdal; Christian Sleek,10,0,10,0
1708248657506,MATH 109,C01,433861,Treuer; John N,5,0,10,5
1708248657506,MATH 109,C02,433862,Treuer; John N,10,0,10,0
1708248657506,MATH 109,D01,433864,Treuer; John N,8,0,10,2
1708248657506,MATH 109,D02,433865,Treuer; John N,8,0,10,2
1708248657506,MATH 109,E01,433868,Sheng; Hongyi,10,0,10,0
1708248657506,MATH 109,E02,433869,Sheng; Hongyi,19,0,20,1
1708248658037,MATH 110,A01,433871,Pillai; Mohandas K,24,0,35,11
1708248658037,MATH 110,A02,433872,Pillai; Mohandas K,33,0,35,2
1708248658565,MATH 112B,A01,480683,Komarova; Natalia,27,0,27,0
1708248659092,MATH 120B,A01,433885,Xiao; Ming,32,0,35,3
1708248659092,MATH 120B,A02,433886,Xiao; Ming,34,0,35,1
1708248659618,MATH 121B,A01,433888,Stevens; Laura Jeanne,29,0,30,1
1708248660150,MATH 140B,A01,433890,Seward; Brandon M.,31,0,35,4
1708248660150,MATH 140B,A02,433891,Seward; Brandon M.,35,0,35,0
1708248660681,MATH 140C,A01,433895,Spolaor; Luca,32,0,35,3
1708248660681,MATH 140C,A02,433896,Spolaor; Luca,35,0,35,0
1708248661219,MATH 142B,A01,433966,Eggers; John Dietrich,25,0,35,10
1708248661219,MATH 142B,A02,434063,Eggers; John Dietrich,32,0,35,3
1708248661219,MATH 142B,B01,434071,Sanchez; Anthony,32,0,35,3
1708248661219,MATH 142B,B02,434083,Sanchez; Anthony,34,0,35,1
1708248661219,MATH 142B,C01,434094,Kunnawalkam Elayavalli; Sr,31,0,35,4
1708248661219,MATH 142B,C02,434095,Kunnawalkam Elayavalli; Sr,34,0,35,1
1708248661752,MATH 144,A01,434097,Cloninger; Alexander,30,0,30,0
1708248662284,MATH 150B,A01,434104,Parise; Davide,33,0,35,2
1708248662811,MATH 152,A01,434107,Grier; Daniel T,20,0,40,20
1708248663346,MATH 154,A01,434109,Wesley; William J,31,0,35,4
1708248663346,MATH 154,A02,434119,Wesley; William J,35,0,35,0
1708248663346,MATH 154,A03,434120,Wesley; William J,35,0,35,0
1708248663346,MATH 154,A04,434121,Wesley; William J,34,0,35,1
1708248663346,MATH 154,B01,434126,Aliabadi Sr.; Mohsen,26,0,35,9
1708248663346,MATH 154,B02,434127,Aliabadi Sr.; Mohsen,34,0,35,1
1708248663346,MATH 154,B03,434138,Aliabadi Sr.; Mohsen,35,0,35,0
1708248663346,MATH 154,B04,434139,Aliabadi Sr.; Mohsen,35,0,35,0
1708248663874,MATH 163,A01,434144,Bowers; Adam R.,0,0,5,5
1708248664410,MATH 170A,A01,434148,Nag; Panchali,36,0,36,0
1708248664410,MATH 170A,A02,434149,Nag; Panchali,36,0,36,0
1708248664410,MATH 170A,A03,434150,Nag; Panchali,36,0,37,1
1708248664410,MATH 170A,A04,434151,Nag; Panchali,36,0,36,0
1708248664938,MATH 170B,A01,434155,Huang; Lei,31,0,35,4
1708248664938,MATH 170B,A02,434160,Huang; Lei,35,0,35,0
1708248664938,MATH 170B,A03,434161,Huang; Lei,35,0,35,0
1708248664938,MATH 170B,A04,434162,Huang; Lei,35,0,35,0
1708248665464,MATH 170C,A01,434176,Leok; Melvin,30,0,35,5
1708248665464,MATH 170C,A02,434300,Leok; Melvin,34,0,35,1
1708248665991,MATH 171B,A01,434576,Nie; Jiawang,25,0,35,10
1708248665991,MATH 171B,A02,434583,Nie; Jiawang,35,0,35,0
1708248665991,MATH 171B,A03,434584,Nie; Jiawang,35,0,35,0
1708248665991,MATH 171B,A04,434609,Nie; Jiawang,35,0,35,0
1708248666523,MATH 180A,A01,434638,Gartland; Christopher John,29,0,30,1
1708248666523,MATH 180A,A02,434821,Gartland; Christopher John,28,0,30,2
1708248666523,MATH 180A,A03,434833,Gartland; Christopher John,24,0,30,6
1708248666523,MATH 180A,A04,434839,Gartland; Christopher John,30,0,30,0
1708248666523,MATH 180A,A05,434843,Gartland; Christopher John,30,0,30,0
1708248666523,MATH 180A,A06,434895,Gartland; Christopher John,30,0,30,0
1708248667050,MATH 180B,A01,435085,Gartland; Christopher John,30,0,35,5
1708248667050,MATH 180B,A02,435086,Gartland; Christopher John,35,0,35,0
1708248667050,MATH 180B,A03,435087,Gartland; Christopher John,34,0,35,1
1708248667050,MATH 180B,A04,435088,Gartland; Christopher John,35,0,35,0
1708248667579,MATH 180C,A01,435090,Carfagnini; Marco,29,0,35,6
1708248667579,MATH 180C,A02,435091,Carfagnini; Marco,35,0,35,0
1708248667579,MATH 180C,A03,435092,Carfagnini; Marco,32,0,35,3
1708248667579,MATH 180C,A04,435113,Carfagnini; Marco,35,0,35,0
1708248668113,MATH 181A,A01,435279,Zhang; Danna,30,0,35,5
1708248668113,MATH 181A,A02,435300,Zhang; Danna,35,0,35,0
1708248668113,MATH 181A,A03,435301,Zhang; Danna,21,0,35,14
1708248668113,MATH 181A,A04,435302,Zhang; Danna,31,0,35,4
1708248668641,MATH 181B,A01,435315,Rava; Denise,33,0,35,2
1708248668641,MATH 181B,A02,435316,Rava; Denise,32,0,35,3
1708248668641,MATH 181B,A03,435317,Rava; Denise,33,0,35,2
1708248668641,MATH 181B,A04,435318,Rava; Denise,35,0,35,0
1708248669165,MATH 183,A01,435320,Quarfoot; David James,26,0,35,9
1708248669165,MATH 183,A02,435321,Quarfoot; David James,35,0,35,0
1708248669165,MATH 183,A03,435322,Quarfoot; David James,32,0,35,3
1708248669165,MATH 183,A04,435323,Quarfoot; David James,34,0,35,1
1708248669165,MATH 183,A05,435327,Quarfoot; David James,34,0,35,1
1708248669165,MATH 183,A06,435329,Quarfoot; David James,33,0,35,2
1708248669692,MATH 184,A01,435337,Verstraete; Jacques Allan,32,0,35,3
1708248669692,MATH 184,A02,435338,Verstraete; Jacques Allan,35,0,35,0
1708248669692,MATH 184,A03,435339,Verstraete; Jacques Allan,34,0,35,1
1708248669692,MATH 184,A04,435347,Verstraete; Jacques Allan,30,0,35,5
1708248670279,MATH 185,A01,435432,Arias-Castro; Ery,15,0,30,15
1708248670279,MATH 185,A02,435436,Arias-Castro; Ery,30,0,30,0
1708248670279,MATH 185,A03,435437,Arias-Castro; Ery,30,0,30,0
1708248670279,MATH 185,A04,435438,Arias-Castro; Ery,30,0,30,0
1708248670806,MATH 187A,A01,435443,Agrawal; Shishir,16,0,30,14
1708248670806,MATH 187A,A02,435444,Agrawal; Shishir,30,0,30,0
1708248670806,MATH 187A,A03,435503,Agrawal; Shishir,28,0,30,2
1708248670806,MATH 187A,A04,435507,Agrawal; Shishir,30,0,30,0
1708248670806,MATH 187A,A05,435554,Agrawal; Shishir,22,0,30,8
1708248670806,MATH 187A,A06,435558,Agrawal; Shishir,28,0,30,2
1708248671336,MATH 187B,A01,435570,Bucur; Alina Ioana,24,0,35,11
1708248671336,MATH 187B,A02,435571,Bucur; Alina Ioana,35,0,35,0
1708248671875,MATH 188,A01,435573,Kunnawalkam Elayavalli; Sr,35,0,35,0
1708248672403,MATH 189,A01,435577,Vishwanath; Siddharth,0,0,10,10
1708248672403,MATH 189,A02,435594,Vishwanath; Siddharth,0,0,10,10
1708248672403,MATH 189,A03,435595,Vishwanath; Siddharth,0,0,10,10
1708248672403,MATH 189,A04,435596,Vishwanath; Siddharth,0,0,10,10
1708248672403,MATH 189,A05,480706,Vishwanath; Siddharth,2,0,10,8
1708248672403,MATH 189,A06,481362,Vishwanath; Siddharth,6,0,10,4
1708248672935,MATH 200C,A00,430388,Bucur; Alina Ioana,15,0,15,0
1708248673461,MATH 202C,A00,430389,Rhoades; Brendon Patrick,15,0,15,0
1708248673986,MATH 203C,A00,430390,Izadi; Elham,15,0,15,0
1708248674516,MATH 204C,A00,430391,Sorensen; Claus M,15,0,15,0
1708248675045,MATH 208,A00,430392,Izadi; Elham,8,0,10,2
1708248675571,MATH 209,A00,430393,Pollack; Aaron,10,0,10,0
1708248676099,MATH 211A,A00,430394,Salehi Golsefidy; Alireza,10,0,10,0
1708248676626,MATH 211B,A00,430395,Seward; Brandon M.,10,0,10,0
1708248677150,MATH 212B,A01,480692,Komarova; Natalia,5,0,5,0
1708248677677,MATH 216C,A00,430429,Saab; Rayan,13,0,15,2
1708248678203,MATH 217,A00,430430,Li; Bo,13,0,15,2
1708248678728,MATH 218,A00,430431,Li; Bo,8,0,10,2
1708248679258,MATH 220C,A00,430432,Xiao; Ming,15,0,15,0
1708248679784,MATH 240C,A00,430433,Ebenfelt; Peter F,14,0,15,1
1708248680314,MATH 241B,A00,430434,Ioana; Adrian,14,0,15,1
1708248680840,MATH 243,A00,430435,Kunnawalkam Elayavalli; Sr,9,0,10,1
1708248681364,MATH 248,A00,430436,Bejenaru; Ioan,9,0,10,1
1708248681893,MATH 251C,A00,430437,Wenzl; Hans G,15,0,15,0
1708248682420,MATH 258,A00,430438,Spolaor; Luca,10,0,10,0
1708248682950,MATH 261C,A00,430439,Manners; Frederick,14,0,15,1
1708248683476,MATH 262A,A00,430440,Warnke; Lutz Peter,14,0,15,1
1708248684006,MATH 268,A00,430441,Buss; Samuel R,10,0,10,0
1708248684533,MATH 269,A00,430442,Rhoades; Brendon Patrick & Warnke; Lutz Peter,10,0,10,0
1708248685065,MATH 270C,A00,430445,Cheng; Li-Tien,15,0,15,0
1708248685591,MATH 273B,A00,430452,Zhu; Yuhua,15,0,15,0
1708248686119,MATH 276,A00,430458,Mc Culloch; Andrew Douglas & Amaro; Rommie E,0,0,0,0
1708248686652,MATH 277A,A00,430464,Dumitriu; Ioana,14,0,15,1
1708248687178,MATH 278A,A00,430470,Cheng; Li-Tien,9,0,10,1
1708248687712,MATH 278B,A00,430471,Cloninger; Alexander,10,0,10,0
1708248688239,MATH 278C,A00,430472,Nie; Jiawang,9,0,10,1
1708248688770,MATH 280C,A00,430485,Schweinsberg; Jason,13,0,15,2
1708248689296,MATH 281C,A00,430496,Arias-Castro; Ery,8,0,15,7
1708248689821,MATH 284,A00,430503,Xu; Ronghui,11,0,15,4
1708248690350,MATH 287C,A00,430520,Zhang; Danna,14,0,15,1
1708248690876,MATH 288,A00,430527,Carfagnini; Marco,9,0,10,1
1708248691402,MATH 289A,A00,430541,Novak; Jonathan I,14,0,15,1
1708248691934,MATH 290C,A00,430548,Roberts; Justin Deritter,13,0,15,2
1708248692461,MATH 292,A00,430660,Lu; Yunze,10,0,10,0
1708248692993,MATH 294,A00,430678,Fitzsimmons; Patrick J,11,0,15,4
1708248693520,MATH 295,A00,430692,Bejenaru; Ioan,15,0,15,0
1708248694051,MATH 297,001,430721,Gamst; Anthony Collins,0,0,0,0
1708248694581,MATS 200,A00,414457,Graeve; Olivia A,9995,0,9999,4
1708248695109,MATS 201C,A00,414465,Arzt; Eduard,38,0,50,12
1708248695639,MATS 236,A00,414466,Staff,17,0,20,3
1708248696166,MATS 252,A00,414467,Evdokimenko; Ekaterina,42,0,45,3
1708248696692,MATS 261B,A00,414468,Qiao; Yu,17,0,25,8
1708248697218,MATS 295,A00,414469,Graeve; Olivia A,9999,0,9999,0
1708248697218,MATS 295,B00,478858,Kummel; Andrew C,9999,0,9999,0
1708248697753,MCWP 40,001,414476,Montejo; Carolina,19,0,20,1
1708248697753,MCWP 40,004,414480,Wastal; Carrie King,13,0,15,2
1708248697753,MCWP 40,005,414481,Wastal; Carrie King,10,0,15,5
1708248697753,MCWP 40,006,414482,Wastal; Carrie King,12,0,15,3
1708248697753,MCWP 40,007,414483,Wastal; Carrie King,13,0,15,2
1708248697753,MCWP 40,008,414484,Wastal; Carrie King,15,0,15,0
1708248697753,MCWP 40,009,414487,Wastal; Carrie King,12,0,15,3
1708248697753,MCWP 40,014,414505,Staff,20,0,20,0
1708248697753,MCWP 40,015,494362,Wastal; Carrie King,14,0,15,1
1708248698302,MCWP 50,002,414534,Bartulis; Jason Michael,20,0,20,0
1708248698302,MCWP 50,003,414536,Bartulis; Jason Michael,20,0,20,0
1708248698302,MCWP 50,004,414538,Krone; Jarret,16,0,20,4
1708248698302,MCWP 50,005,414539,Krone; Jarret,19,0,20,1
1708248698302,MCWP 50,006,414540,Smith; Haydee Marie,16,0,20,4
1708248698302,MCWP 50,007,414544,Compas; Sean Matthew,14,0,20,6
1708248698302,MCWP 50,008,414549,Redela; Pamela Morgan,20,0,20,0
1708248698302,MCWP 50,011,414557,Carter; Andrea L,16,0,20,4
1708248698302,MCWP 50,012,414592,Silva; Kelly B,20,0,20,0
1708248698302,MCWP 50,013,414593,Silva; Kelly B,19,0,20,1
1708248698302,MCWP 50,014,414594,Carter; Andrea L,20,0,20,0
1708248698302,MCWP 50,016,414596,Morshed; Michael James,14,0,20,6
1708248698302,MCWP 50,017,414598,Morshed; Michael James,17,0,20,3
1708248698302,MCWP 50,019,414601,Redela; Pamela Morgan,17,0,20,3
1708248698302,MCWP 50,020,414606,Carter; Jennifer A,20,0,20,0
1708248698302,MCWP 50,021,414607,Carter; Jennifer A,19,0,20,1
1708248698302,MCWP 50,022,414649,Compas; Sean Matthew,11,0,20,9
1708248698302,MCWP 50,023,414650,Smith; Haydee Marie,20,0,20,0
1708248698302,MCWP 50,024,414651,Nies; Laurie Elizabeth,19,0,20,1
1708248698302,MCWP 50,025,414655,Nies; Laurie Elizabeth,18,0,20,2
1708248698302,MCWP 50,026,414656,Pham; Vincent Minhduc,19,0,20,1
1708248698302,MCWP 50,027,414657,Pham; Vincent Minhduc,20,0,20,0
1708248698302,MCWP 50,028,414668,Morshed; Michael James,16,0,20,4
1708248698302,MCWP 50,029,414669,Morshed; Michael James,19,0,20,1
1708248698832,MCWP 50R,A00,486838,Miller; Elizabeth Deen,19,0,20,1
1708248698832,MCWP 50R,B00,486843,Miller; Elizabeth Deen,16,0,20,4
1708248698832,MCWP 50R,C00,486844,Miller; Elizabeth Deen,19,0,20,1
1708248699359,MCWP 125,A00,414670,Wilson; Marion E.,20,0,20,0
1708248699359,MCWP 125,B00,414674,Guillen; Melinda,20,0,20,0
1708248699359,MCWP 125,C00,414678,Guillen; Melinda,20,0,20,0
1708248699359,MCWP 125,D00,414682,Guillen; Melinda,20,0,20,0
1708248699885,MED 231,A00,476440,Hurst; Samantha,7,0,7,0
1708248700414,MED 246,A00,492785,Gordts; Philip & Varki; Ajit P & Lewis; Amanda Lark & Godula; Kamil & Gagneux; Pascal & Esko; Jeffrey D. & Bode; Lars,10,0,10,0
1708248700941,MED 262,A00,492942,Koola; Jejo David,28,0,30,2
1708248701467,MED 267,A01,492789,Hogarth; Michael Andrew,25,0,30,5
1708248701993,MED 275,A00,464684,Liu; George Yenhsi,10,0,10,0
1708248702519,MED 276,A00,492786,Sitapati; Amy,23,0,25,2
1708248703047,MED 278,A00,492787,Carter; Hannah Kathryn & Mesirov; Jill P. & Curtius; Kathleen Mary,20,0,20,0
1708248703578,MED 296,001,464685,Chi; Neil C.,48,0,50,2
1708248703578,MED 296,002,464686,Hong; Kimberly N,49,0,50,1
1708248703578,MED 296,003,464687,Staff,50,0,50,0
1708248704106,MGT 3,A00,442429,Wagner; Timothy Ryan,95,0,98,3
1708248704637,MGT 4,A01,442443,Levkoff; Steven B.,0,0,5,5
1708248704637,MGT 4,A02,442444,Levkoff; Steven B.,4,0,5,1
1708248705166,MGT 5,A00,442446,Molloie Jr.; William H,184,0,196,12
1708248705695,MGT 12,A00,442447,Lindenberger; Wade Douglas,83,0,100,17
1708248705695,MGT 12,B00,442448,Lindenberger; Wade Douglas,72,0,100,28
1708248705695,MGT 12,C00,442449,Pecore; Joseph P.,88,0,100,12
1708248706221,MGT 16,A00,442452,Buchanan; Harold G,97,0,100,3
1708248706221,MGT 16,B00,442459,Buchanan; Harold G,92,0,100,8
1708248706221,MGT 16,C00,442461,Campbell; Robert Harold,113,0,120,7
1708248706221,MGT 16,D00,442475,Campbell; Robert Harold,118,0,120,2
1708248706749,MGT 18,A00,442477,McKay; Michael J,98,0,98,0
1708248706749,MGT 18,B00,442491,McKay; Michael J,96,0,98,2
1708248706749,MGT 18,C00,442493,McKay; Michael J,98,0,98,0
1708248706749,MGT 18,D00,442503,Chamberlain; Travis Dean,98,0,98,0
1708248707280,MGT 45,A00,442508,Pecore; Joseph P.,147,0,150,3
1708248707280,MGT 45,B00,442510,Pecore; Joseph P.,142,0,150,8
1708248707807,MGT 71,A00,442524,Lee; Hyun Seok,77,0,98,21
1708248708336,MGT 71R,A00,442526,Phiroz; Zal Navroze,77,0,98,21
1708248708862,MGT 100,A00,442541,Wilbur; Kenneth C,82,0,98,16
1708248708862,MGT 100,B00,442542,Wilbur; Kenneth C,89,0,98,9
1708248709394,MGT 103,A00,442543,Eberhard; Craig A,98,0,98,0
1708248709394,MGT 103,B00,442544,Eberhard; Craig A,95,0,98,3
1708248709394,MGT 103,C00,442545,Ehrich; Kristine R,90,0,98,8
1708248709394,MGT 103,D00,442547,Ehrich; Kristine R,96,0,98,2
1708248709394,MGT 103,E00,442548,Ehrich; Kristine R,97,0,98,1
1708248709394,MGT 103,F00,442549,Demill; Burritt,92,0,98,6
1708248709394,MGT 103,G00,442550,Bates; Kenneth Walter,97,0,98,1
1708248709923,MGT 105,A00,442558,Bates; Kenneth Walter,86,0,98,12
1708248710449,MGT 106,A00,442560,Eberhard; Craig A,95,0,98,3
1708248710979,MGT 109,A00,442574,Campbell; Colin Leslie,90,0,98,8
1708248711510,MGT 112,A00,442576,Somasundaram; Tyagarajan,96,0,98,2
1708248711510,MGT 112,B00,442590,Somasundaram; Tyagarajan,94,0,98,4
1708248711510,MGT 112,C00,442592,Zimmermann; Carsten,87,0,98,11
1708248712037,MGT 119,A00,442602,Staff,97,0,98,1
1708248712037,MGT 119,B00,442603,Anderson; Jon Marcus,96,0,98,2
1708248712567,MGT 121B,A00,442606,Klaas; Jeffrey David,94,0,98,4
1708248713095,MGT 128R,A00,442607,Krishnan; Viswanathan,84,0,98,14
1708248713621,MGT 131A,A00,442608,Houskeeper; Robert,148,0,150,2
1708248714151,MGT 131B,A00,442609,Houskeeper; Robert,100,0,100,0
1708248714678,MGT 132,A00,442610,Blakley; Bruce,97,0,98,1
1708248715206,MGT 137,A00,442611,Lindenberger; Wade Douglas,86,0,98,12
1708248715733,MGT 147,A00,442612,Anderson; John Charles,32,0,40,8
1708248716263,MGT 151R,A00,442613,Phiroz; Zal Navroze,92,0,98,6
1708248716793,MGT 153,A00,442650,Perols; Johan Lars,55,0,80,25
1708248717322,MGT 162,A00,442652,Demill; Burritt,81,0,98,17
1708248717322,MGT 162,B00,442654,Demill; Burritt,88,0,98,10
1708248717322,MGT 162,C00,442776,Staff,95,0,98,3
1708248717322,MGT 162,D00,442778,Staff,96,0,98,2
1708248717849,MGT 164,A00,442780,McKay; Mary A,97,0,98,1
1708248717849,MGT 164,B00,442849,McKay; Mary A,96,0,98,2
1708248717849,MGT 164,C00,442917,McKay; Mary A,97,0,98,1
1708248717849,MGT 164,D00,442949,Meyer; Alison Bloomfield,90,0,98,8
1708248718382,MGT 166,A00,443017,Moran; Cathleen L.,95,0,98,3
1708248718382,MGT 166,B00,443045,Moran; Cathleen L.,97,0,98,1
1708248718382,MGT 166,C00,443046,Moran; Cathleen L.,98,0,98,0
1708248718908,MGT 167,A00,443047,Klaas; Jeffrey David,93,0,98,5
1708248719437,MGT 171R,A00,443048,Phiroz; Zal Navroze,86,0,98,12
1708248719964,MGT 172,A00,443049,Hedges; Kathleen & Royal; Rebecca,116,0,120,4
1708248719964,MGT 172,B00,443050,Hedges; Kathleen,95,0,98,3
1708248719964,MGT 172,C00,443051,Zimmermann; Carsten,96,0,98,2
1708248720489,MGT 173,A00,443052,Hayes; Sherry Lorine,92,0,100,8
1708248721015,MGT 175,A00,443053,Gopal; Christopher S.,98,0,98,0
1708248721544,MGT 180,A00,443055,Bliss; Barbara Ann,139,0,150,11
1708248721544,MGT 180,B00,443069,Bliss; Barbara Ann,145,0,150,5
1708248722071,MGT 181,A00,443120,Buchanan; Harold G,147,0,150,3
1708248722597,MGT 183,A00,443121,Banerjee; Snehal,88,0,98,10
1708248723124,MGT 185,A00,443122,Dunn; Louis Jean,90,0,98,8
1708248723707,MGT 187,A00,443133,Dunn; Louis Jean,95,0,100,5
1708248724236,MGT 189,A00,443134,Avenancio-Leon; Carlos,98,0,98,0
1708248724764,MGT 227,A00,479242,Serra Garcia; Marta,19,0,20,1
1708248725298,MGT 259,A00,443135,Oveis; Christopher S,19,0,20,1
1708248725832,MGT 296,001,481416,Gneezy; Ayelet,3,0,3,0
1708248725832,MGT 296,002,481420,Amir; On,3,0,3,0
1708248725832,MGT 296,003,481466,Amir; On & Karmarkar; Uma R,3,0,3,0
1708248725832,MGT 296,004,481468,Liu; Jun,3,0,3,0
1708248725832,MGT 296,005,481469,Misra; Kanishka,3,0,3,0
1708248725832,MGT 296,006,481470,Erat; Sanjiv,3,0,3,0
1708248725832,MGT 296,007,481473,Timmermann; Allan,3,0,3,0
1708248725832,MGT 296,008,481474,Smith; Pamela Karen,3,0,3,0
1708248725832,MGT 296,009,481477,Zhang; Zhe,3,0,3,0
1708248725832,MGT 296,010,481478,Oveis; Christopher S,3,0,3,0
1708248725832,MGT 296,011,481479,Amir; On & Gneezy; Ayelet,3,0,3,0
1708248725832,MGT 296,012,481481,Wilbur; Kenneth C,3,0,3,0
1708248726401,MMW 13,A01,412918,Chang; Edmond Yi-Teh,15,0,16,1
1708248726401,MMW 13,A02,412928,Chang; Edmond Yi-Teh,16,0,16,0
1708248726401,MMW 13,A03,413017,Chang; Edmond Yi-Teh,16,0,16,0
1708248726401,MMW 13,A04,413018,Chang; Edmond Yi-Teh,16,0,16,0
1708248726401,MMW 13,A05,413019,Chang; Edmond Yi-Teh,15,0,16,1
1708248726401,MMW 13,A06,413020,Chang; Edmond Yi-Teh,16,0,16,0
1708248726401,MMW 13,A07,413021,Chang; Edmond Yi-Teh,15,0,16,1
1708248726401,MMW 13,A08,413023,Chang; Edmond Yi-Teh,16,0,16,0
1708248726401,MMW 13,A09,413024,Chang; Edmond Yi-Teh,16,0,16,0
1708248726401,MMW 13,A10,413025,Chang; Edmond Yi-Teh,16,0,16,0
1708248726401,MMW 13,A11,413026,Chang; Edmond Yi-Teh,16,0,16,0
1708248726401,MMW 13,A12,413027,Chang; Edmond Yi-Teh,16,0,16,0
1708248726401,MMW 13,A13,413028,Chang; Edmond Yi-Teh,0,0,0,0
1708248726401,MMW 13,A14,413029,Chang; Edmond Yi-Teh,0,0,0,0
1708248726401,MMW 13,A15,413030,Chang; Edmond Yi-Teh,14,0,16,2
1708248726401,MMW 13,A16,413031,Chang; Edmond Yi-Teh,15,0,16,1
1708248726401,MMW 13,A17,413032,Chang; Edmond Yi-Teh,16,0,16,0
1708248726401,MMW 13,A18,413034,Chang; Edmond Yi-Teh,14,0,16,2
1708248726401,MMW 13,A19,413035,Chang; Edmond Yi-Teh,16,0,16,0
1708248726401,MMW 13,A20,413036,Chang; Edmond Yi-Teh,16,0,16,0
1708248726401,MMW 13,A21,413037,Chang; Edmond Yi-Teh,0,0,0,0
1708248726401,MMW 13,A22,413038,Chang; Edmond Yi-Teh,0,0,0,0
1708248726401,MMW 13,B01,413290,Zhiri; Oumelbanine,15,0,16,1
1708248726401,MMW 13,B02,413291,Zhiri; Oumelbanine,15,0,16,1
1708248726401,MMW 13,B03,413308,Zhiri; Oumelbanine,14,0,16,2
1708248726401,MMW 13,B04,413322,Zhiri; Oumelbanine,14,0,16,2
1708248726401,MMW 13,B05,413343,Zhiri; Oumelbanine,12,0,16,4
1708248726401,MMW 13,B06,413344,Zhiri; Oumelbanine,14,0,16,2
1708248726401,MMW 13,B07,413524,Zhiri; Oumelbanine,16,0,16,0
1708248726401,MMW 13,B08,413584,Zhiri; Oumelbanine,16,0,16,0
1708248726401,MMW 13,B09,413588,Zhiri; Oumelbanine,15,0,16,1
1708248726401,MMW 13,B10,413590,Zhiri; Oumelbanine,16,0,16,0
1708248726401,MMW 13,B11,413779,Zhiri; Oumelbanine,12,0,16,4
1708248726401,MMW 13,B12,413780,Zhiri; Oumelbanine,9,0,16,7
1708248726401,MMW 13,B13,413781,Zhiri; Oumelbanine,0,0,0,0
1708248726401,MMW 13,B14,413782,Zhiri; Oumelbanine,0,0,0,0
1708248726401,MMW 13,B15,413808,Zhiri; Oumelbanine,16,0,16,0
1708248726401,MMW 13,B16,413815,Zhiri; Oumelbanine,15,0,16,1
1708248726401,MMW 13,B17,413816,Zhiri; Oumelbanine,15,0,16,1
1708248726401,MMW 13,B18,413817,Zhiri; Oumelbanine,12,0,16,4
1708248726401,MMW 13,B19,413822,Zhiri; Oumelbanine,16,0,16,0
1708248726401,MMW 13,B20,413823,Zhiri; Oumelbanine,14,0,16,2
1708248726401,MMW 13,B21,413825,Zhiri; Oumelbanine,0,0,0,0
1708248726401,MMW 13,B22,413826,Zhiri; Oumelbanine,0,0,0,0
1708248726401,MMW 13,B23,413827,Zhiri; Oumelbanine,16,0,16,0
1708248726401,MMW 13,B24,413834,Zhiri; Oumelbanine,15,0,16,1
1708248726401,MMW 13,C01,413859,Vitkus; Daniel J.,16,0,16,0
1708248726401,MMW 13,C02,413860,Vitkus; Daniel J.,16,0,16,0
1708248726401,MMW 13,C04,413868,Vitkus; Daniel J.,0,0,0,0
1708248726401,MMW 13,C05,413869,Vitkus; Daniel J.,16,0,16,0
1708248726401,MMW 13,C06,413871,Vitkus; Daniel J.,16,0,16,0
1708248726401,MMW 13,C07,413886,Vitkus; Daniel J.,16,0,16,0
1708248726401,MMW 13,C08,413908,Vitkus; Daniel J.,16,0,16,0
1708248726401,MMW 13,C09,413930,Vitkus; Daniel J.,16,0,16,0
1708248726401,MMW 13,C10,413952,Vitkus; Daniel J.,15,0,16,1
1708248726401,MMW 13,C11,413972,Vitkus; Daniel J.,16,0,16,0
1708248726401,MMW 13,C12,413991,Vitkus; Daniel J.,16,0,16,0
1708248726401,MMW 13,C13,414007,Vitkus; Daniel J.,0,0,0,0
1708248726401,MMW 13,C14,414017,Vitkus; Daniel J.,0,0,0,0
1708248726401,MMW 13,C15,414030,Vitkus; Daniel J.,16,0,16,0
1708248726401,MMW 13,C16,414032,Vitkus; Daniel J.,16,0,16,0
1708248726401,MMW 13,C17,414033,Vitkus; Daniel J.,15,0,16,1
1708248726401,MMW 13,C18,414034,Vitkus; Daniel J.,16,0,16,0
1708248726401,MMW 13,C19,414041,Vitkus; Daniel J.,16,0,16,0
1708248726401,MMW 13,C20,414056,Vitkus; Daniel J.,16,0,16,0
1708248726401,MMW 13,C21,414057,Vitkus; Daniel J.,15,0,16,1
1708248726401,MMW 13,C22,414059,Vitkus; Daniel J.,16,0,16,0
1708248726929,MMW 15,A01,414065,Chang; Edmond Yi-Teh,28,0,28,0
1708248726929,MMW 15,A02,414067,Chang; Edmond Yi-Teh,27,0,28,1
1708248726929,MMW 15,A03,414092,Chang; Edmond Yi-Teh,26,0,28,2
1708248726929,MMW 15,A04,414104,Chang; Edmond Yi-Teh,28,0,28,0
1708248726929,MMW 15,A05,414121,Chang; Edmond Yi-Teh,0,0,0,0
1708248726929,MMW 15,A06,414122,Chang; Edmond Yi-Teh,0,0,0,0
1708248726929,MMW 15,A07,414123,Chang; Edmond Yi-Teh,28,0,28,0
1708248726929,MMW 15,A08,414124,Chang; Edmond Yi-Teh,28,0,28,0
1708248726929,MMW 15,A09,414125,Chang; Edmond Yi-Teh,0,0,0,0
1708248726929,MMW 15,A10,414130,Chang; Edmond Yi-Teh,0,0,0,0
1708248726929,MMW 15,B01,414132,Radcliff; Pamela B.,27,0,28,1
1708248726929,MMW 15,B02,414134,Radcliff; Pamela B.,27,0,28,1
1708248726929,MMW 15,B03,414135,Radcliff; Pamela B.,26,0,28,2
1708248726929,MMW 15,B04,414136,Radcliff; Pamela B.,27,0,28,1
1708248726929,MMW 15,B05,414137,Radcliff; Pamela B.,28,0,28,0
1708248726929,MMW 15,B06,414138,Radcliff; Pamela B.,27,0,28,1
1708248726929,MMW 15,B07,414140,Radcliff; Pamela B.,26,0,28,2
1708248726929,MMW 15,B08,414141,Radcliff; Pamela B.,28,0,28,0
1708248726929,MMW 15,C01,414143,Prestholdt; Jeremy,0,0,0,0
1708248726929,MMW 15,C02,414144,Prestholdt; Jeremy,0,0,0,0
1708248726929,MMW 15,C03,414145,Prestholdt; Jeremy,24,0,28,4
1708248726929,MMW 15,C04,414147,Prestholdt; Jeremy,17,0,28,11
1708248726929,MMW 15,C05,414148,Prestholdt; Jeremy,28,0,28,0
1708248726929,MMW 15,C06,414149,Prestholdt; Jeremy,26,0,28,2
1708248726929,MMW 15,C07,414152,Prestholdt; Jeremy,25,0,28,3
1708248726929,MMW 15,C08,414153,Prestholdt; Jeremy,23,0,28,5
1708248727456,MSED 295,A00,477850,Rabin; Jeffrey Mark,5,0,5,0
1708248727456,MSED 295,B00,477852,Lo; Stanley M.,5,0,5,0
1708248727985,MSED 296C,A00,477853,Staff,14,0,15,1
1708248728518,MUS 1C,A01,416488,Ishov; Alexander Alexandrovich,24,0,25,1
1708248728518,MUS 1C,A02,416502,Ishov; Alexander Alexandrovich,25,0,25,0
1708248728518,MUS 1C,A03,416519,Ishov; Alexander Alexandrovich,25,0,25,0
1708248728518,MUS 1C,A04,416520,Ishov; Alexander Alexandrovich,25,0,25,0
1708248728518,MUS 1C,A05,416521,Ishov; Alexander Alexandrovich,25,0,25,0
1708248729048,MUS 2C,A01,416523,Richards; Stephanie F,30,0,30,0
1708248729580,MUS 2CK,A00,416524,Ohnishi; Takae,15,0,15,0
1708248729580,MUS 2CK,B00,416547,Ohnishi; Takae,15,0,15,0
1708248730109,MUS 2JK,A00,416548,Kenyatta; Kamau,15,0,15,0
1708248730642,MUS 4,A01,416562,Staff,25,0,25,0
1708248730642,MUS 4,A02,416634,Staff,24,0,25,1
1708248730642,MUS 4,A03,416644,Staff,25,0,25,0
1708248730642,MUS 4,A04,416659,Staff,24,0,25,1
1708248730642,MUS 4,A05,416667,Staff,25,0,25,0
1708248730642,MUS 4,A06,416757,Staff,25,0,25,0
1708248730642,MUS 4,A07,416830,Staff,25,0,25,0
1708248730642,MUS 4,A08,416953,Staff,23,0,25,2
1708248730642,MUS 4,A09,417005,Staff,25,0,25,0
1708248730642,MUS 4,A10,417007,Staff,24,0,25,1
1708248731170,MUS 7,A01,417048,Staff,23,0,24,1
1708248731170,MUS 7,A02,417102,Staff,23,0,24,1
1708248731170,MUS 7,A03,417103,Staff,23,0,24,1
1708248731170,MUS 7,A04,417114,Staff,21,0,24,3
1708248731697,MUS 8,A01,417119,Staff,14,0,20,6
1708248731697,MUS 8,A02,417163,Staff,16,0,20,4
1708248731697,MUS 8,A03,417164,Staff,16,0,20,4
1708248731697,MUS 8,A04,417165,Staff,17,0,20,3
1708248731697,MUS 8,A05,417194,Staff,18,0,20,2
1708248731697,MUS 8,A06,417198,Staff,20,0,20,0
1708248732225,MUS 11,A01,417201,Terrazas Perez; Wilfrido D,21,0,25,4
1708248732225,MUS 11,A02,417219,Terrazas Perez; Wilfrido D,23,0,25,2
1708248732225,MUS 11,A03,417220,Terrazas Perez; Wilfrido D,25,0,25,0
1708248732225,MUS 11,A04,417222,Terrazas Perez; Wilfrido D,25,0,25,0
1708248732225,MUS 11,A05,417223,Terrazas Perez; Wilfrido D,24,0,25,1
1708248732225,MUS 11,A06,417295,Terrazas Perez; Wilfrido D,23,0,25,2
1708248732225,MUS 11,A07,417297,Terrazas Perez; Wilfrido D,24,0,25,1
1708248732225,MUS 11,A08,417298,Terrazas Perez; Wilfrido D,25,0,25,0
1708248732751,MUS 12,A01,417300,Guy; Nancy,25,0,25,0
1708248732751,MUS 12,A02,417301,Guy; Nancy,25,0,25,0
1708248732751,MUS 12,A03,417302,Guy; Nancy,25,0,25,0
1708248732751,MUS 12,A04,417303,Guy; Nancy,25,0,25,0
1708248733277,MUS 13,A01,417305,Leslie Santana; Myrta,25,0,25,0
1708248733277,MUS 13,A02,417306,Leslie Santana; Myrta,25,0,25,0
1708248733277,MUS 13,A03,417307,Leslie Santana; Myrta,25,0,25,0
1708248733277,MUS 13,A04,417308,Leslie Santana; Myrta,25,0,25,0
1708248733808,MUS 15,A01,417327,Schaffer; Max Benjamin,18,0,20,2
1708248733808,MUS 15,A02,417331,Schaffer; Max Benjamin,19,0,20,1
1708248733808,MUS 15,A03,417358,Schaffer; Max Benjamin,19,0,20,1
1708248733808,MUS 15,A04,417359,Schaffer; Max Benjamin,17,0,20,3
1708248733808,MUS 15,A05,417360,Schaffer; Max Benjamin,20,0,20,0
1708248733808,MUS 15,A06,417370,Schaffer; Max Benjamin,20,0,20,0
1708248733808,MUS 15,A07,417371,Schaffer; Max Benjamin,17,0,20,3
1708248733808,MUS 15,A08,417372,Schaffer; Max Benjamin,18,0,20,2
1708248733808,MUS 15,A09,417378,Schaffer; Max Benjamin,19,0,20,1
1708248733808,MUS 15,A10,417379,Schaffer; Max Benjamin,19,0,20,1
1708248734337,MUS 17,A01,417381,Staff,22,0,25,3
1708248734337,MUS 17,A02,417406,Staff,24,0,25,1
1708248734337,MUS 17,A03,417420,Staff,24,0,25,1
1708248734337,MUS 17,A04,417594,Staff,24,0,25,1
1708248734337,MUS 17,A05,417595,Staff,25,0,25,0
1708248734337,MUS 17,A06,417605,Staff,21,0,25,4
1708248734337,MUS 17,A07,417606,Staff,25,0,25,0
1708248734337,MUS 17,A08,417627,Staff,25,0,25,0
1708248734337,MUS 17,A09,417628,Staff,21,0,25,4
1708248734337,MUS 17,A10,417629,Staff,24,0,25,1
1708248734337,MUS 17,A11,417630,Staff,25,0,25,0
1708248734337,MUS 17,A12,417631,Staff,24,0,25,1
1708248734337,MUS 17,A13,417632,Staff,25,0,25,0
1708248734337,MUS 17,A14,417633,Staff,25,0,25,0
1708248734868,MUS 32,001,418855,Dresser; Mark Stuart,10,0,10,0
1708248734868,MUS 32,002,418856,Kenyatta; Kamau,9,0,10,1
1708248734868,MUS 32,003,418864,Curtis; Charles Rector,10,0,10,0
1708248734868,MUS 32,004,418865,Carlstrom; Mitchell Kraig,9,0,10,1
1708248734868,MUS 32,005,418868,Terrazas Perez; Wilfrido D,10,0,10,0
1708248734868,MUS 32,006,418869,Ohnishi; Takae,10,0,10,0
1708248734868,MUS 32,007,418872,Burr; Anthony I,10,0,10,0
1708248734868,MUS 32,008,418873,Carlson; Erik Norman,10,0,10,0
1708248734868,MUS 32,009,418874,Blair; Kyle Adam,10,0,10,0
1708248734868,MUS 32,010,418875,Richards; Stephanie F,10,0,10,0
1708248735395,MUS 32V,A00,417634,Narucki; Susan M,10,0,10,0
1708248735395,MUS 32V,B00,417635,Staff,10,0,10,0
1708248735920,MUS 32VM,A00,417636,Staff,15,0,15,0
1708248736449,MUS 33C,A00,417637,Taylor; Alexander Lawther,20,0,20,0
1708248736979,MUS 43,A00,417647,Burr; Anthony I,83,0,90,7
1708248737507,MUS 95D,A00,417919,Staff,40,0,40,0
1708248738033,MUS 95E,A00,417933,Henson; Matthew Alexander,55,0,55,0
1708248738561,MUS 95G,A00,417935,Anderson; Kenneth,387,0,395,8
1708248738561,MUS 95G,B00,417937,Anderson; Kenneth,394,0,395,1
1708248739091,MUS 95JC,A00,417939,Kenyatta; Kamau,30,0,30,0
1708248739618,MUS 95L,A00,417940,Jones; Michael David,50,0,50,0
1708248740145,MUS 95W,A00,417946,Seshadri; Kartik,29,0,30,1
1708248740145,MUS 95W,B00,417948,Seshadri; Kartik,30,0,30,0
1708248740671,MUS 101C,A01,417951,Burr; Anthony I,33,0,35,2
1708248741197,MUS 103C,A00,417952,Davis; Anthony Curtis,14,0,15,1
1708248741724,MUS 103F,A00,417959,Obermueller; Karola,1,0,1,0
1708248742257,MUS 113,A00,418015,Narucki; Susan M,14,0,15,1
1708248742785,MUS 120C,A01,418032,Leslie Santana; Myrta,25,0,25,0
1708248743312,MUS 127,A00,418037,Richards; Stephanie F,92,0,100,8
1708248743839,MUS 130,A00,418047,Ohnishi; Takae,30,0,30,0
1708248744364,MUS 131,A00,418065,Roberts; Matana,30,0,30,0
1708248744893,MUS 132,001,418883,Dresser; Mark Stuart,10,0,10,0
1708248744893,MUS 132,002,418885,Kenyatta; Kamau,10,0,10,0
1708248744893,MUS 132,003,418886,Curtis; Charles Rector,10,0,10,0
1708248744893,MUS 132,004,418887,Carlstrom; Mitchell Kraig,10,0,10,0
1708248744893,MUS 132,005,418888,Jones; Michael David,10,0,10,0
1708248744893,MUS 132,006,418889,Terrazas Perez; Wilfrido D,10,0,10,0
1708248744893,MUS 132,007,418893,Ohnishi; Takae,10,0,10,0
1708248744893,MUS 132,008,418894,Burr; Anthony I,10,0,10,0
1708248744893,MUS 132,009,418896,Carlson; Erik Norman,10,0,10,0
1708248744893,MUS 132,010,418900,Blair; Kyle Adam,10,0,10,0
1708248744893,MUS 132,011,418932,Richards; Stephanie F,10,0,10,0
1708248744893,MUS 132,012,418933,Nourai; Keyarash,10,0,10,0
1708248745419,MUS 132R,A00,418067,Burr; Anthony I,5,0,5,0
1708248745419,MUS 132R,B00,418078,Jones; Michael David,5,0,5,0
1708248745947,MUS 132V,A00,418092,Narucki; Susan M,15,0,15,0
1708248745947,MUS 132V,B00,418096,Staff,15,0,15,0
1708248746472,MUS 134,A00,418098,Staff,40,0,40,0
1708248747000,MUS 137C,A00,418109,Kenyatta; Kamau,25,0,25,0
1708248747525,MUS 143,A00,418123,Burr; Anthony I,33,0,40,7
1708248748056,MUS 150,A00,418127,Davis; Anthony Curtis,28,0,30,2
1708248748587,MUS 151,A00,418129,Hankins; Sarah E.,21,0,30,9
1708248749118,MUS 160B,A00,418172,Staff,11,0,15,4
1708248749118,MUS 160B,B00,418175,Dubnov; Shlomo,14,0,15,1
1708248749647,MUS 172,A01,418178,Staff,36,0,40,4
1708248750173,MUS 174C,A00,418179,Erbe; Tom,24,0,27,3
1708248750699,MUS 175,A00,418247,Smyth; Tamara R.,28,0,30,2
1708248751225,MUS 177,A00,418265,Erbe; Tom,11,0,15,4
1708248751751,MUS 201A,A00,418267,Narucki; Susan M,15,0,15,0
1708248751751,MUS 201A,B00,418268,Dresser; Mark Stuart,13,0,15,2
1708248752276,MUS 203C,A00,418269,Lou; Michelle Siulai,15,0,15,0
1708248752801,MUS 203D,A00,418272,Davis; Anthony Curtis,4,0,5,1
1708248752801,MUS 203D,B00,418275,Obermueller; Karola,5,0,5,0
1708248752801,MUS 203D,C00,418277,Liang; Lei,5,0,5,0
1708248752801,MUS 203D,D00,418323,Lou; Michelle Siulai,5,0,5,0
1708248753330,MUS 204,A00,418324,Obermueller; Karola,24,0,25,1
1708248753856,MUS 205,A00,418325,Cimini; Amy Marie,22,0,25,3
1708248754381,MUS 206,A00,418326,Liang; Lei,13,0,15,2
1708248754381,MUS 206,B00,418327,Roberts; Matana,13,0,15,2
1708248754908,MUS 215C,A00,418328,Cimini; Amy Marie,14,0,15,1
1708248755441,MUS 232,001,418937,Dresser; Mark Stuart,9,0,10,1
1708248755441,MUS 232,002,418969,Kenyatta; Kamau,10,0,10,0
1708248755441,MUS 232,003,418971,Curtis; Charles Rector,10,0,10,0
1708248755441,MUS 232,004,418974,Terrazas Perez; Wilfrido D,10,0,10,0
1708248755441,MUS 232,005,418979,Ohnishi; Takae,10,0,10,0
1708248755441,MUS 232,006,418980,Burr; Anthony I,10,0,10,0
1708248755441,MUS 232,007,418981,Carlson; Erik Norman,10,0,10,0
1708248755441,MUS 232,008,418982,Richards; Stephanie F,10,0,10,0
1708248755441,MUS 232,009,418985,Narucki; Susan M,10,0,10,0
1708248755968,MUS 234,A00,418329,Staff,15,0,15,0
1708248756494,MUS 245,A00,418330,Carlson; Erik Norman,14,0,15,1
1708248757018,MUS 267,A00,418331,Erbe; Tom,15,0,15,0
1708248757543,MUS 270B,A00,418332,Staff,15,0,15,0
1708248758068,MUS 270D,A00,479231,Smyth; Tamara R.,15,0,15,0
1708248758594,NANO 103,A00,414714,Jahed Motlagh; Zeinab,40,0,40,0
1708248759120,NANO 108,A00,414740,Lubarda; Vlado,70,0,70,0
1708248759649,NANO 112,A01,414825,Vazquez Mena; Oscar,70,0,70,0
1708248760176,NANO 115L,A01,414830,Yang; Kesong,37,0,38,1
1708248760176,NANO 115L,B01,414832,Xu; Sheng,35,0,38,3
1708248760701,NANO 120B,A01,414835,Vecchio; Kenneth S,33,0,35,2
1708248760701,NANO 120B,B01,414841,Fenning; David,30,0,35,5
1708248761227,NANO 156,A00,414843,Fullerton; Eric E,24,0,30,6
1708248761753,NANO 158,A00,414844,Luo; Jian,29,0,30,1
1708248762282,NANO 175,A00,414850,Steinmetz; Nicole F,30,0,35,5
1708248762808,NANO 200,A00,414852,Jahed Motlagh; Zeinab,118,0,120,2
1708248763337,NANO 241,A00,414854,Pokorski; Jonathan Kyle,18,0,25,7
1708248763864,NANO 262,A00,414858,Wang; Joseph,50,0,50,0
1708248764394,NANO 271,A00,414862,Cubukcu; Ertugrul,22,0,25,3
1708248764923,NANO 272,A00,414877,Xu; Sheng,42,0,50,8
1708248765447,NANO 279,A00,414878,Liu; Ping,32,0,40,8
1708248765973,NANO 282,A00,414879,Steinmetz; Nicole F,30,0,30,0
1708248766501,NEU 200C,A00,455013,Staff,0,0,0,1
1708248767031,NEU 276,A01,479489,Staff,35,0,36,1
1708248767557,NEU 277,A00,479492,Risbrough; Victoria Blythe,0,0,0,0
1708248768083,NEU 296,001,464921,Evans; Sean Jeffrey,48,0,50,2
1708248768083,NEU 296,002,464922,Staff,50,0,50,0
1708248768083,NEU 296,003,464925,Staff,50,0,50,0
1708248768656,NEUG 221,A00,479490,Zheng; Binhai,15,0,15,0
1708248769182,NEUG 280,A00,479491,Chen; Xu,0,0,0,0
1708248769708,NEUG 296,A00,479493,Bloodgood; Brenda Laurie,9998,0,9999,1
1708248770236,OPTH 296,001,465054,Baxter; Sally Liu,49,0,50,1
1708248770236,OPTH 296,002,465068,Afshari; Natalie,49,0,50,1
1708248770236,OPTH 296,003,465074,Staff,50,0,50,0
1708248770768,ORTH 296,A00,465104,Staff,50,0,50,0
1708248770768,ORTH 296,001,465111,Staff,50,0,50,0
1708248770768,ORTH 296,002,465120,Staff,50,0,50,0
1708248771296,PATH 224,A01,494386,Ross; Camille,11,0,12,1
1708248771827,PATH 296,001,465373,Calcutt; Nigel A,49,0,50,1
1708248771827,PATH 296,002,465374,Staff,50,0,50,0
1708248771827,PATH 296,003,465375,Staff,50,0,50,0
1708248772352,PEDS 296,001,465527,Weiss; Katherine Jean,49,0,50,1
1708248772352,PEDS 296,002,465528,Staff,50,0,50,0
1708248772352,PEDS 296,003,465529,Staff,50,0,50,0
1708248772879,PH 196BH,A01,405158,Binkin; Nancy Jeanne,20,0,20,0
1708248773406,PHAR 219,A00,415016,Ross; Camille,1,0,1,0
1708248773932,PHAR 231,A00,415017,Furnari; Frank,20,0,20,0
1708248773932,PHAR 231,B00,415018,Lopez Ramirez; Miguel Alej,20,0,20,0
1708248774464,PHAR 276,A00,415020,Mc Culloch; Andrew Douglas & Amaro; Rommie E,1,0,1,0
1708248774988,PHAR 295,A00,415022,Brown; Joan Heller,15,0,15,0
1708248775520,PHIL 1,A00,415023,Harrell; Maralee Mae,58,0,60,2
1708248776055,PHIL 10,A01,415026,Grush; Rick Scott,40,0,44,4
1708248776055,PHIL 10,A02,415028,Grush; Rick Scott,42,0,44,2
1708248776055,PHIL 10,A03,415029,Grush; Rick Scott,0,0,0,0
1708248776055,PHIL 10,A04,415031,Grush; Rick Scott,0,0,0,0
1708248776055,PHIL 10,A05,415113,Grush; Rick Scott,43,0,44,1
1708248776055,PHIL 10,A06,415114,Grush; Rick Scott,43,0,44,1
1708248776055,PHIL 10,A07,415116,Grush; Rick Scott,44,0,44,0
1708248776055,PHIL 10,A08,415118,Grush; Rick Scott,43,0,44,1
1708248776587,PHIL 12,A01,415120,McKenzie; Kerry V.,28,0,30,2
1708248776587,PHIL 12,A02,415136,McKenzie; Kerry V.,30,0,30,0
1708248776587,PHIL 12,A03,415137,McKenzie; Kerry V.,27,0,30,3
1708248776587,PHIL 12,A04,415142,McKenzie; Kerry V.,30,0,30,0
1708248777172,PHIL 13,A01,415165,Brink; David O.,25,0,25,0
1708248777172,PHIL 13,A02,415179,Brink; David O.,22,0,25,3
1708248777172,PHIL 13,A03,415185,Brink; David O.,24,0,25,1
1708248777172,PHIL 13,A04,415201,Brink; David O.,25,0,25,0
1708248777172,PHIL 13,A05,415204,Brink; David O.,25,0,25,0
1708248777172,PHIL 13,A06,415220,Brink; David O.,25,0,25,0
1708248777700,PHIL 15,A01,415250,Fulkerson; Matthew Todd,26,0,30,4
1708248777700,PHIL 15,A02,415281,Fulkerson; Matthew Todd,29,0,30,1
1708248778232,PHIL 27,A01,415293,Brandt; Reuven A,20,0,25,5
1708248778232,PHIL 27,A02,415296,Brandt; Reuven A,0,0,0,0
1708248778232,PHIL 27,A03,415332,Brandt; Reuven A,22,0,25,3
1708248778232,PHIL 27,A04,415333,Brandt; Reuven A,22,0,25,3
1708248778232,PHIL 27,A05,415342,Brandt; Reuven A,20,0,25,5
1708248778232,PHIL 27,A06,415384,Brandt; Reuven A,24,0,25,1
1708248778232,PHIL 27,A07,415385,Brandt; Reuven A,25,0,25,0
1708248778232,PHIL 27,A08,415391,Brandt; Reuven A,0,0,0,0
1708248778232,PHIL 27,A09,415406,Brandt; Reuven A,0,0,0,0
1708248778232,PHIL 27,A10,415407,Brandt; Reuven A,0,0,0,0
1708248778767,PHIL 28,A01,415412,Lamey; Andy M.,24,0,25,1
1708248778767,PHIL 28,A02,415470,Lamey; Andy M.,20,0,25,5
1708248778767,PHIL 28,A03,415474,Lamey; Andy M.,0,0,0,0
1708248778767,PHIL 28,A04,415475,Lamey; Andy M.,22,0,25,3
1708248778767,PHIL 28,A05,415487,Lamey; Andy M.,24,0,25,1
1708248778767,PHIL 28,A06,415506,Lamey; Andy M.,21,0,25,4
1708248778767,PHIL 28,A07,415507,Lamey; Andy M.,25,0,25,0
1708248778767,PHIL 28,A08,415508,Lamey; Andy M.,24,0,25,1
1708248778767,PHIL 28,A09,415509,Lamey; Andy M.,25,0,25,0
1708248778767,PHIL 28,A10,415510,Lamey; Andy M.,0,0,0,0
1708248779298,PHIL 33,A01,415521,Hardimon; Michael O.,35,0,35,0
1708248779298,PHIL 33,A02,415522,Hardimon; Michael O.,35,0,35,0
1708248779829,PHIL 60,A00,415523,Marechal; Patricia,55,0,60,5
1708248780354,PHIL 102,A00,415524,Johnson; Monte,37,0,40,3
1708248780884,PHIL 106,A00,415544,Watkins; Eric,40,0,40,0
1708248781416,PHIL 112,A00,415545,Watkins; Eric,34,0,40,6
1708248781941,PHIL 115,A00,415548,Nelkin; Dana Kay,20,0,20,0
1708248782467,PHIL 120,A00,415549,Carr; Jennifer Rose,64,0,65,1
1708248782996,PHIL 134,A00,415552,Carr; Jennifer Rose,40,0,40,0
1708248783521,PHIL 150,A00,415553,Cohen; Jonathan David,38,0,40,2
1708248784048,PHIL 171,A00,415561,Brink; David O.,39,0,40,1
1708248784578,PHIL 172,A00,415563,Lamey; Andy M.,40,0,40,0
1708248785103,PHIL 174,A01,415576,Danks; David J,21,0,25,4
1708248785103,PHIL 174,A02,415582,Danks; David J,22,0,25,3
1708248785103,PHIL 174,A03,415583,Danks; David J,24,0,25,1
1708248785103,PHIL 174,A04,415584,Danks; David J,25,0,25,0
1708248785632,PHIL 175,A00,415585,Shields; Christopher John,40,0,40,0
1708248786159,PHIL 181,A00,415601,Tolley; Clinton,34,0,40,6
1708248786684,PHIL 209B,A00,415655,Serlin; David,4,0,5,1
1708248787213,PHIL 209C,A00,415658,Gates; Kelly,5,0,5,0
1708248787739,PHIL 210,A00,415659,Marechal; Patricia,20,0,20,0
1708248788266,PHIL 230,A00,415661,Grush; Rick Scott,20,0,20,0
1708248788792,PHIL 232,A00,415662,Sher; Gila,20,0,20,0
1708248789317,PHIL 260,A00,415675,Bazargan-Forward; Saba,20,0,20,0
1708248789847,PHIL 277,A00,479176,Tolley; Clinton,9,0,10,1
1708248790375,PHIL 285,A00,415685,Kovaka; Karenc,20,0,20,0
1708248790901,PHIL 287,A00,415697,Marechal; Patricia,5,0,5,0
1708248791430,PHIL 290,001,415701,Nelkin; Dana Kay,9999,0,9999,0
1708248791430,PHIL 290,002,415721,Bazargan-Forward; Saba,9999,0,9999,0
1708248791430,PHIL 290,003,415731,Brandt; Reuven A,9999,0,9999,0
1708248791430,PHIL 290,004,415743,Brink; David O.,9999,0,9999,0
1708248791430,PHIL 290,005,415747,Callender; Craig Adam,9999,0,9999,0
1708248791430,PHIL 290,006,415779,Carr; Jennifer Rose,9999,0,9999,0
1708248791430,PHIL 290,007,415780,Cartwright; Nancy D.,9999,0,9999,0
1708248791430,PHIL 290,008,415781,Cohen; Jonathan David,9999,0,9999,0
1708248791430,PHIL 290,009,415782,Danks; David J,9999,0,9999,0
1708248791430,PHIL 290,010,415783,Fulkerson; Matthew Todd,9999,0,9999,0
1708248791430,PHIL 290,011,415784,Grush; Rick Scott,9999,0,9999,0
1708248791430,PHIL 290,012,415785,Hardimon; Michael O.,9999,0,9999,0
1708248791430,PHIL 290,013,415786,Harrell; Maralee Mae,9999,0,9999,0
1708248791430,PHIL 290,014,415787,Johnson; Monte,9999,0,9999,0
1708248791430,PHIL 290,015,415788,Kovaka; Karenc,9999,0,9999,0
1708248791430,PHIL 290,016,415789,Lamey; Andy M.,9999,0,9999,0
1708248791430,PHIL 290,017,415790,Marechal; Patricia,9999,0,9999,0
1708248791430,PHIL 290,018,415791,McKenzie; Kerry V.,9999,0,9999,0
1708248791430,PHIL 290,019,415792,Rickless; Samuel Charles,9999,0,9999,0
1708248791430,PHIL 290,020,415793,Sher; Gila,9999,0,9999,0
1708248791430,PHIL 290,021,415794,Shields; Christopher John,9999,0,9999,0
1708248791430,PHIL 290,022,415805,Tolley; Clinton,9999,0,9999,0
1708248791430,PHIL 290,023,415806,Vargas; Manuel Rogelio,9999,0,9999,0
1708248791430,PHIL 290,024,415807,Watkins; Eric,9999,0,9999,0
1708248791430,PHIL 290,025,415815,Chen; Keming,9999,0,9999,0
1708248791959,PHIL 295,001,415816,Bazargan-Forward; Saba,9999,0,9999,0
1708248791959,PHIL 295,002,415857,Brandt; Reuven A,9999,0,9999,0
1708248791959,PHIL 295,003,415858,Brink; David O.,9999,0,9999,0
1708248791959,PHIL 295,004,415877,Callender; Craig Adam,9999,0,9999,0
1708248791959,PHIL 295,005,415878,Carr; Jennifer Rose,9999,0,9999,0
1708248791959,PHIL 295,006,415884,Cartwright; Nancy D.,9999,0,9999,0
1708248791959,PHIL 295,007,415885,Chen; Keming,9999,0,9999,0
1708248791959,PHIL 295,008,415891,Cohen; Jonathan David,9999,0,9999,0
1708248791959,PHIL 295,009,415892,Danks; David J,9999,0,9999,0
1708248791959,PHIL 295,010,415937,Fulkerson; Matthew Todd,9999,0,9999,0
1708248791959,PHIL 295,011,415940,Grush; Rick Scott,9999,0,9999,0
1708248791959,PHIL 295,012,415945,Hardimon; Michael O.,9999,0,9999,0
1708248791959,PHIL 295,013,415946,Harrell; Maralee Mae,9999,0,9999,0
1708248791959,PHIL 295,014,415953,Johnson; Monte,9999,0,9999,0
1708248791959,PHIL 295,015,415954,Kovaka; Karenc,9999,0,9999,0
1708248791959,PHIL 295,016,415957,Lamey; Andy M.,9999,0,9999,0
1708248791959,PHIL 295,017,415958,Marechal; Patricia,9999,0,9999,0
1708248791959,PHIL 295,018,415959,McKenzie; Kerry V.,9999,0,9999,0
1708248791959,PHIL 295,019,415960,Nelkin; Dana Kay,9999,0,9999,0
1708248791959,PHIL 295,020,415961,Rickless; Samuel Charles,9999,0,9999,0
1708248791959,PHIL 295,021,415987,Sher; Gila,9999,0,9999,0
1708248791959,PHIL 295,022,416027,Shields; Christopher John,9999,0,9999,0
1708248791959,PHIL 295,023,416030,Tolley; Clinton,9999,0,9999,0
1708248791959,PHIL 295,024,416033,Vargas; Manuel Rogelio,9999,0,9999,0
1708248791959,PHIL 295,025,416034,Watkins; Eric,9999,0,9999,0
1708248792487,PHYA 224,A00,442106,Sandstrom; Karin Marie,30,0,30,0
1708248793020,PHYS 1A,A00,441607,Gilbert; Dylan Paul,346,0,362,16
1708248793550,PHYS 1AL,001,441608,Arlett; Jessica Lynn & Yagil; Avi,30,0,30,0
1708248793550,PHYS 1AL,002,441609,Arlett; Jessica Lynn & Yagil; Avi,28,0,30,2
1708248793550,PHYS 1AL,003,441610,Arlett; Jessica Lynn & Yagil; Avi,26,0,30,4
1708248793550,PHYS 1AL,004,441611,Arlett; Jessica Lynn & Yagil; Avi,29,0,30,1
1708248793550,PHYS 1AL,005,441612,Arlett; Jessica Lynn & Yagil; Avi,28,0,30,2
1708248793550,PHYS 1AL,006,441616,Arlett; Jessica Lynn & Yagil; Avi,28,0,30,2
1708248793550,PHYS 1AL,007,441618,Arlett; Jessica Lynn & Yagil; Avi,26,0,30,4
1708248793550,PHYS 1AL,008,441620,Arlett; Jessica Lynn & Yagil; Avi,29,0,30,1
1708248793550,PHYS 1AL,009,441623,Arlett; Jessica Lynn & Yagil; Avi,29,0,30,1
1708248793550,PHYS 1AL,010,441625,Arlett; Jessica Lynn & Yagil; Avi,29,0,30,1
1708248793550,PHYS 1AL,011,441626,Arlett; Jessica Lynn & Yagil; Avi,29,0,30,1
1708248793550,PHYS 1AL,012,441627,Arlett; Jessica Lynn & Yagil; Avi,29,0,30,1
1708248794077,PHYS 1B,A00,441630,Groisman; Alexander,351,0,362,11
1708248794605,PHYS 1BL,001,441632,Arlett; Jessica Lynn & Yagil; Avi,28,0,30,2
1708248794605,PHYS 1BL,002,441634,Arlett; Jessica Lynn & Yagil; Avi,29,0,30,1
1708248794605,PHYS 1BL,003,441636,Arlett; Jessica Lynn & Yagil; Avi,29,0,30,1
1708248794605,PHYS 1BL,004,441637,Arlett; Jessica Lynn & Yagil; Avi,29,0,30,1
1708248794605,PHYS 1BL,005,441639,Arlett; Jessica Lynn & Yagil; Avi,29,0,30,1
1708248794605,PHYS 1BL,006,441641,Arlett; Jessica Lynn & Yagil; Avi,26,0,30,4
1708248794605,PHYS 1BL,007,441642,Arlett; Jessica Lynn & Yagil; Avi,23,0,30,7
1708248794605,PHYS 1BL,008,441643,Arlett; Jessica Lynn & Yagil; Avi,30,0,30,0
1708248794605,PHYS 1BL,009,441646,Arlett; Jessica Lynn & Yagil; Avi,29,0,30,1
1708248794605,PHYS 1BL,010,441648,Arlett; Jessica Lynn & Yagil; Avi,29,0,30,1
1708248794605,PHYS 1BL,011,441652,Arlett; Jessica Lynn & Yagil; Avi,29,0,30,1
1708248794605,PHYS 1BL,012,441654,Arlett; Jessica Lynn & Yagil; Avi,30,0,30,0
1708248795135,PHYS 1C,A00,441658,Popmintchev; Tenio,587,0,600,13
1708248795135,PHYS 1C,B00,441662,Popmintchev; Tenio,558,0,600,42
1708248795668,PHYS 1CL,001,441664,Arlett; Jessica Lynn & Yagil; Avi,29,0,30,1
1708248795668,PHYS 1CL,002,441665,Arlett; Jessica Lynn & Yagil; Avi,27,0,30,3
1708248795668,PHYS 1CL,003,441666,Arlett; Jessica Lynn & Yagil; Avi,25,0,30,5
1708248795668,PHYS 1CL,004,441667,Arlett; Jessica Lynn & Yagil; Avi,30,0,30,0
1708248795668,PHYS 1CL,005,441668,Arlett; Jessica Lynn & Yagil; Avi,28,0,30,2
1708248795668,PHYS 1CL,006,441669,Arlett; Jessica Lynn & Yagil; Avi,25,0,30,5
1708248795668,PHYS 1CL,007,441671,Arlett; Jessica Lynn & Yagil; Avi,27,0,30,3
1708248795668,PHYS 1CL,008,441673,Arlett; Jessica Lynn & Yagil; Avi,30,0,30,0
1708248795668,PHYS 1CL,009,441674,Arlett; Jessica Lynn & Yagil; Avi,26,0,30,4
1708248795668,PHYS 1CL,010,441676,Arlett; Jessica Lynn & Yagil; Avi,30,0,30,0
1708248795668,PHYS 1CL,011,441677,Arlett; Jessica Lynn & Yagil; Avi,30,0,30,0
1708248795668,PHYS 1CL,012,441683,Arlett; Jessica Lynn & Yagil; Avi,30,0,30,0
1708248795668,PHYS 1CL,013,441685,Arlett; Jessica Lynn & Yagil; Avi,28,0,30,2
1708248795668,PHYS 1CL,014,441687,Arlett; Jessica Lynn & Yagil; Avi,30,0,30,0
1708248795668,PHYS 1CL,015,441689,Arlett; Jessica Lynn & Yagil; Avi,17,0,30,13
1708248795668,PHYS 1CL,016,441692,Arlett; Jessica Lynn & Yagil; Avi,29,0,30,1
1708248795668,PHYS 1CL,017,441696,Arlett; Jessica Lynn & Yagil; Avi,24,0,30,6
1708248795668,PHYS 1CL,018,441698,Arlett; Jessica Lynn & Yagil; Avi,25,0,30,5
1708248795668,PHYS 1CL,019,441702,Arlett; Jessica Lynn & Yagil; Avi,25,0,30,5
1708248795668,PHYS 1CL,020,441705,Arlett; Jessica Lynn & Yagil; Avi,29,0,30,1
1708248795668,PHYS 1CL,021,441706,Arlett; Jessica Lynn & Yagil; Avi,30,0,30,0
1708248795668,PHYS 1CL,022,441707,Arlett; Jessica Lynn & Yagil; Avi,30,0,30,0
1708248795668,PHYS 1CL,023,441708,Arlett; Jessica Lynn & Yagil; Avi,27,0,30,3
1708248795668,PHYS 1CL,024,441710,Arlett; Jessica Lynn & Yagil; Avi,29,0,30,1
1708248795668,PHYS 1CL,025,441711,Arlett; Jessica Lynn & Yagil; Avi,28,0,30,2
1708248795668,PHYS 1CL,026,441712,Arlett; Jessica Lynn & Yagil; Avi,29,0,30,1
1708248795668,PHYS 1CL,027,441713,Arlett; Jessica Lynn & Yagil; Avi,26,0,30,4
1708248795668,PHYS 1CL,028,441714,Arlett; Jessica Lynn & Yagil; Avi,29,0,30,1
1708248795668,PHYS 1CL,029,441715,Arlett; Jessica Lynn & Yagil; Avi,25,0,30,5
1708248795668,PHYS 1CL,030,441717,Arlett; Jessica Lynn & Yagil; Avi,29,0,30,1
1708248795668,PHYS 1CL,031,441718,Arlett; Jessica Lynn & Yagil; Avi,27,0,30,3
1708248795668,PHYS 1CL,032,441721,Arlett; Jessica Lynn & Yagil; Avi,30,0,30,0
1708248795668,PHYS 1CL,033,441724,Arlett; Jessica Lynn & Yagil; Avi,28,0,30,2
1708248795668,PHYS 1CL,034,441726,Arlett; Jessica Lynn & Yagil; Avi,29,0,30,1
1708248795668,PHYS 1CL,035,441728,Arlett; Jessica Lynn & Yagil; Avi,29,0,30,1
1708248795668,PHYS 1CL,036,441729,Arlett; Jessica Lynn & Yagil; Avi,30,0,30,0
1708248795668,PHYS 1CL,037,441730,Arlett; Jessica Lynn & Yagil; Avi,27,0,30,3
1708248795668,PHYS 1CL,038,441732,Arlett; Jessica Lynn & Yagil; Avi,29,0,30,1
1708248795668,PHYS 1CL,039,441733,Arlett; Jessica Lynn & Yagil; Avi,27,0,30,3
1708248795668,PHYS 1CL,040,441734,Arlett; Jessica Lynn & Yagil; Avi,30,0,30,0
1708248795668,PHYS 1CL,041,441735,Arlett; Jessica Lynn & Yagil; Avi,29,0,30,1
1708248795668,PHYS 1CL,042,441766,Arlett; Jessica Lynn & Yagil; Avi,30,0,30,0
1708248795668,PHYS 1CL,043,441768,Arlett; Jessica Lynn & Yagil; Avi,29,0,30,1
1708248795668,PHYS 1CL,044,441770,Arlett; Jessica Lynn & Yagil; Avi,30,0,30,0
1708248796204,PHYS 2A,A01,460308,Bal; Gurleen K,28,0,30,2
1708248796204,PHYS 2A,A02,460320,Bal; Gurleen K,30,0,30,0
1708248796204,PHYS 2A,A03,460321,Bal; Gurleen K,29,0,30,1
1708248796204,PHYS 2A,A04,460325,Bal; Gurleen K,28,0,30,2
1708248796204,PHYS 2A,A05,460326,Bal; Gurleen K,29,0,30,1
1708248796204,PHYS 2A,A06,460327,Bal; Gurleen K,30,0,30,0
1708248796204,PHYS 2A,A07,460495,Bal; Gurleen K,28,0,30,2
1708248796204,PHYS 2A,A08,460535,Bal; Gurleen K,27,0,30,3
1708248796204,PHYS 2A,A09,460536,Bal; Gurleen K,30,0,30,0
1708248796204,PHYS 2A,A10,460537,Bal; Gurleen K,30,0,30,0
1708248796204,PHYS 2A,A11,460538,Bal; Gurleen K,30,0,30,0
1708248796204,PHYS 2A,A12,460539,Bal; Gurleen K,30,0,30,0
1708248796746,PHYS 2B,A01,460620,Barreiro Guerrero; Julio,30,0,30,0
1708248796746,PHYS 2B,A02,460625,Barreiro Guerrero; Julio,30,0,30,0
1708248796746,PHYS 2B,A03,460626,Barreiro Guerrero; Julio,29,0,30,1
1708248796746,PHYS 2B,A04,460716,Barreiro Guerrero; Julio,26,0,30,4
1708248796746,PHYS 2B,A05,460756,Barreiro Guerrero; Julio,29,0,30,1
1708248796746,PHYS 2B,A06,460837,Barreiro Guerrero; Julio,30,0,30,0
1708248796746,PHYS 2B,A07,460865,Barreiro Guerrero; Julio,30,0,30,0
1708248796746,PHYS 2B,A08,460866,Barreiro Guerrero; Julio,30,0,30,0
1708248796746,PHYS 2B,A09,460867,Barreiro Guerrero; Julio,29,0,30,1
1708248796746,PHYS 2B,A10,460868,Barreiro Guerrero; Julio,30,0,30,0
1708248796746,PHYS 2B,A11,460869,Barreiro Guerrero; Julio,30,0,30,0
1708248796746,PHYS 2B,A12,460874,Barreiro Guerrero; Julio,30,0,30,0
1708248796746,PHYS 2B,B01,469381,Barreiro Guerrero; Julio,30,0,30,0
1708248796746,PHYS 2B,B02,469382,Barreiro Guerrero; Julio,29,0,30,1
1708248796746,PHYS 2B,B03,469402,Barreiro Guerrero; Julio,27,0,30,3
1708248796746,PHYS 2B,B04,469403,Barreiro Guerrero; Julio,28,0,30,2
1708248796746,PHYS 2B,B05,469442,Barreiro Guerrero; Julio,30,0,30,0
1708248796746,PHYS 2B,B06,469449,Barreiro Guerrero; Julio,30,0,30,0
1708248796746,PHYS 2B,B07,469450,Barreiro Guerrero; Julio,29,0,30,1
1708248796746,PHYS 2B,B08,469451,Barreiro Guerrero; Julio,30,0,30,0
1708248796746,PHYS 2B,B09,469457,Barreiro Guerrero; Julio,29,0,30,1
1708248796746,PHYS 2B,B10,469460,Barreiro Guerrero; Julio,30,0,30,0
1708248796746,PHYS 2B,B11,469468,Barreiro Guerrero; Julio,30,0,30,0
1708248796746,PHYS 2B,B12,469475,Barreiro Guerrero; Julio,30,0,30,0
1708248797272,PHYS 2BL,A01,441779,Meyertholen; Andrew D.,21,0,24,3
1708248797272,PHYS 2BL,A02,441780,Meyertholen; Andrew D.,17,0,24,7
1708248797272,PHYS 2BL,A03,441781,Meyertholen; Andrew D.,21,0,24,3
1708248797272,PHYS 2BL,A04,441782,Meyertholen; Andrew D.,21,0,24,3
1708248797272,PHYS 2BL,A05,441784,Meyertholen; Andrew D.,23,0,24,1
1708248797272,PHYS 2BL,A06,441786,Meyertholen; Andrew D.,23,0,24,1
1708248797272,PHYS 2BL,A07,441788,Meyertholen; Andrew D.,23,0,24,1
1708248797272,PHYS 2BL,A08,441790,Meyertholen; Andrew D.,24,0,24,0
1708248797272,PHYS 2BL,A09,441792,Meyertholen; Andrew D.,24,0,24,0
1708248797272,PHYS 2BL,A10,441794,Meyertholen; Andrew D.,23,0,24,1
1708248797272,PHYS 2BL,A11,441796,Meyertholen; Andrew D.,22,0,24,2
1708248797272,PHYS 2BL,A12,441798,Meyertholen; Andrew D.,24,0,24,0
1708248797272,PHYS 2BL,A13,441800,Meyertholen; Andrew D.,24,0,24,0
1708248797272,PHYS 2BL,A14,441802,Meyertholen; Andrew D.,24,0,24,0
1708248797272,PHYS 2BL,A15,441804,Meyertholen; Andrew D.,23,0,24,1
1708248797807,PHYS 2C,A01,460540,Tan; Tzer Han,30,0,30,0
1708248797807,PHYS 2C,A02,460541,Tan; Tzer Han,28,0,30,2
1708248797807,PHYS 2C,A03,460542,Tan; Tzer Han,28,0,30,2
1708248797807,PHYS 2C,A04,460543,Tan; Tzer Han,28,0,30,2
1708248797807,PHYS 2C,A05,460544,Tan; Tzer Han,28,0,30,2
1708248797807,PHYS 2C,A06,460545,Tan; Tzer Han,29,0,30,1
1708248797807,PHYS 2C,A07,460553,Tan; Tzer Han,30,0,30,0
1708248797807,PHYS 2C,A08,460561,Tan; Tzer Han,30,0,30,0
1708248797807,PHYS 2C,A09,460562,Tan; Tzer Han,28,0,30,2
1708248797807,PHYS 2C,A10,460563,Tan; Tzer Han,29,0,30,1
1708248797807,PHYS 2C,A11,460567,Tan; Tzer Han,30,0,30,0
1708248797807,PHYS 2C,A12,460568,Tan; Tzer Han,28,0,30,2
1708248798338,PHYS 2CL,A01,441809,Ni; Kaixuan,25,0,28,3
1708248798338,PHYS 2CL,A02,441811,Ni; Kaixuan,27,0,28,1
1708248798338,PHYS 2CL,A03,441814,Ni; Kaixuan,23,0,28,5
1708248798338,PHYS 2CL,A04,441817,Ni; Kaixuan,28,0,28,0
1708248798338,PHYS 2CL,A05,441819,Ni; Kaixuan,26,0,28,2
1708248798338,PHYS 2CL,A06,441820,Ni; Kaixuan,27,0,28,1
1708248798868,PHYS 2D,A01,460569,Sharma; Vivek A.,24,0,25,1
1708248798868,PHYS 2D,A02,460574,Sharma; Vivek A.,24,0,25,1
1708248798868,PHYS 2D,A03,460575,Sharma; Vivek A.,25,0,25,0
1708248799397,PHYS 4B,A01,441829,Grinstein; Benjamin,34,0,38,4
1708248799397,PHYS 4B,A02,441831,Grinstein; Benjamin,30,0,32,2
1708248799397,PHYS 4B,A03,441832,Grinstein; Benjamin,30,0,30,0
1708248799397,PHYS 4B,A04,441833,Grinstein; Benjamin,30,0,30,0
1708248799929,PHYS 4E,A01,441907,Frano Pereira; Alex M,33,0,34,1
1708248799929,PHYS 4E,A02,441958,Frano Pereira; Alex M,34,0,34,0
1708248800457,PHYS 10,A01,441971,Burgasser; Adam Jonathan,118,0,120,2
1708248800984,PHYS 13,A01,441974,Wright; Shelley Adams,61,0,65,4
1708248801510,PHYS 87,A00,486898,Grinstein; Benjamin,19,0,20,1
1708248802037,PHYS 100C,A01,441978,Averitt; Richard Douglas,58,0,60,2
1708248802563,PHYS 105B,A01,441985,Green; Daniel Richard,37,0,40,3
1708248803094,PHYS 120,A01,441995,Arnold; Kam S,40,0,44,4
1708248803094,PHYS 120,A02,442011,Arnold; Kam S,41,0,44,3
1708248803624,PHYS 130A,A01,442032,Parker; Daniel E,74,0,75,1
1708248804149,PHYS 130B,A01,442056,Branson; James G,47,0,50,3
1708248804683,PHYS 139,A00,442057,Jun; Suckjoon,30,0,30,0
1708248804683,PHYS 139,B00,442059,Duarte; Javier Mauricio & Li; Aobo,42,0,50,8
1708248805212,PHYS 140A,A01,442065,Shotwell; Brian,49,0,50,1
1708248805743,PHYS 152B,A01,442067,Hirsch; Jorge Eduardo,17,0,20,3
1708248806272,PHYS 154,A01,442069,Jenkins; Elizabeth,29,0,30,1
1708248806799,PHYS 162,A01,442096,Keating; Brian,64,0,65,1
1708248807324,PHYS 170,A01,486870,Oh; Seungeun,39,0,40,1
1708248807850,PHYS 177,A00,442103,Dudko; Olga,20,0,20,0
1708248808376,PHYS 203B,A01,442132,Fogler; Michael M.,20,0,20,0
1708248808905,PHYS 210A,A01,442143,Hwa; Terence T.,20,0,20,0
1708248809434,PHYS 212C,A01,442200,Chivukula; Raja S,18,0,20,2
1708248809962,PHYS 215C,A00,442201,Intriligator; Kenneth Arthur,19,0,20,1
1708248810488,PHYS 225C,A01,442203,Flauger; Raphael M,19,0,20,1
1708248811018,PHYS 227,A00,442204,Tytler; David Robert,29,0,30,1
1708248811545,PHYS 230,A01,442206,McGreevy; John A.,20,0,20,0
1708248812074,PHYS 239,A00,442207,Goldenfeld; Nigel,20,0,20,0
1708248812074,PHYS 239,B00,442208,Duarte; Javier Mauricio & Li; Aobo,5,0,5,0
1708248812600,PHYS 244,A01,442280,Norman; Michael L,12,0,20,8
1708248813124,PHYS 250,A00,442300,Fogler; Michael M.,50,0,50,0
1708248813649,PHYS 251,A00,442307,Grinstein; Benjamin,20,0,20,0
1708248814175,PHYS 252,A00,442348,Diamond; Patrick H,10,0,10,0
1708248814702,PHYS 253,A00,442349,Theissen; Christopher Alexander,30,0,30,0
1708248815228,PHYS 254,A00,442352,Hwa; Terence T.,30,0,30,0
1708248815755,PHYS 255,A00,442423,Hwa; Terence T.,30,0,30,0
1708248816285,PHYS 258,A00,442426,Theissen; Christopher Alexander,30,0,30,0
1708248816811,PHYS 260,A00,442427,Frano Pereira; Alex M,50,0,50,0
1708248817337,PHYS 277,A00,442428,Dudko; Olga,20,0,20,0
1708248817876,POLI 5D,A01,419010,Dai; Yinlin,5,0,7,2
1708248817876,POLI 5D,A02,419020,Dai; Yinlin,7,0,7,0
1708248817876,POLI 5D,A03,419022,Dai; Yinlin,4,0,6,2
1708248817876,POLI 5D,A04,419040,Dai; Yinlin,5,0,5,0
1708248817876,POLI 5D,B01,419065,Dai; Yinlin,7,0,7,0
1708248817876,POLI 5D,B02,419068,Dai; Yinlin,7,0,7,0
1708248817876,POLI 5D,B03,419069,Dai; Yinlin,6,0,6,0
1708248817876,POLI 5D,B04,419070,Dai; Yinlin,5,0,5,0
1708248817876,POLI 5D,C01,487211,Staff,3,0,5,2
1708248818409,POLI 11D,A01,419072,Desposato; Scott,32,0,34,2
1708248818409,POLI 11D,A02,419073,Desposato; Scott,33,0,34,1
1708248818409,POLI 11D,A03,419082,Desposato; Scott,32,0,34,2
1708248818409,POLI 11D,A04,419123,Desposato; Scott,34,0,34,0
1708248818409,POLI 11D,A05,419124,Desposato; Scott,34,0,34,0
1708248818409,POLI 11D,A06,419125,Desposato; Scott,34,0,34,0
1708248818937,POLI 12D,A01,419127,Gartzke; Erik,29,0,34,5
1708248818937,POLI 12D,A02,419128,Gartzke; Erik,34,0,34,0
1708248818937,POLI 12D,A03,419129,Gartzke; Erik,34,0,34,0
1708248818937,POLI 12D,A04,419130,Gartzke; Erik,34,0,34,0
1708248818937,POLI 12D,A05,419131,Gartzke; Erik,32,0,34,2
1708248818937,POLI 12D,A06,419168,Gartzke; Erik,34,0,34,0
1708248819465,POLI 13DR,A01,477733,Draper; Matthew William,28,0,34,6
1708248819465,POLI 13DR,A02,477734,Draper; Matthew William,32,0,34,2
1708248819465,POLI 13DR,A03,477736,Draper; Matthew William,33,0,34,1
1708248819465,POLI 13DR,A04,477737,Draper; Matthew William,32,0,34,2
1708248819465,POLI 13DR,A05,477739,Draper; Matthew William,31,0,34,3
1708248819465,POLI 13DR,A06,477740,Draper; Matthew William,34,0,34,0
1708248819992,POLI 30D,A01,419179,Desposato; Scott,19,0,28,9
1708248819992,POLI 30D,A02,419180,Desposato; Scott,25,0,28,3
1708248819992,POLI 30D,A03,419181,Desposato; Scott,27,0,28,1
1708248819992,POLI 30D,A04,419182,Desposato; Scott,28,0,28,0
1708248819992,POLI 30D,A05,419187,Desposato; Scott,24,0,28,4
1708248819992,POLI 30D,A06,419189,Desposato; Scott,28,0,28,0
1708248820520,POLI 100E,A00,419191,Pitcher; Kennedy Anell,105,0,115,10
1708248821053,POLI 104P,A00,419192,Orfield; Michael Bennett,183,0,196,13
1708248821580,POLI 104U,A00,419193,Nichter; Maysa,89,0,115,26
1708248822105,POLI 108,A00,419194,Adida; Claire,293,0,295,2
1708248822636,POLI 110C,A00,419195,Soon; Valerie,47,0,50,3
1708248823167,POLI 120D,A00,419207,Hansen; Jan Eric,48,0,50,2
1708248823692,POLI 124A,A00,419209,Fortunato; David,48,0,50,2
1708248824219,POLI 131CR,A00,419211,Hoston; Germaine,41,0,50,9
1708248824219,POLI 131CR,B00,481592,Hoston; Germaine,10,0,10,0
1708248824752,POLI 136A,A00,419212,Roeder; Philip G,111,0,115,4
1708248825288,POLI 140D,A00,419213,Wong; Tak Kei,183,0,192,9
1708248825814,POLI 142D,A00,419214,Gartzke; Erik,227,0,230,3
1708248826345,POLI 145C,A00,419222,Fisk; David Lee,101,0,115,14
1708248826873,POLI 150A,A00,419225,Wong; Tak Kei,218,0,230,12
1708248827406,POLI 170A,A00,419226,Skillman; Rachel Diane,115,0,115,0
1708248827932,POLI 179,A00,419238,Staff,95,0,104,9
1708248828459,POLI 194,A00,455332,Hill; Seth J,0,0,0,0
1708248828989,POLI 194SD,A00,419248,Nichter; Maysa,999,0,999,0
1708248829515,POLI 197SD,001,419258,Nichter; Maysa,999,0,999,0
1708248830043,POLI 203B,A00,419265,Slantchev; Branislav,21,0,25,4
1708248830657,POLI 214R,A00,419275,Hoston; Germaine,23,0,25,2
1708248831184,POLI 219,A00,419289,Soon; Valerie,24,0,25,1
1708248831710,POLI 220A,A00,419299,Ferree; Karen E,21,0,25,4
1708248832240,POLI 233,A00,419333,Adida; Claire,23,0,25,2
1708248832766,POLI 243,A00,479118,Joseph; Michael F,23,0,25,2
1708248833296,POLI 251,A00,419334,Ban; Pamela M,23,0,25,2
1708248833824,POLI 257,A00,419335,Hill; Seth J,25,0,25,0
1708248834369,POLI 273,A00,419336,Mignozzetti; Umberto,16,0,25,9
1708248834899,POLI 280,A00,419337,Hafner-Burton; Emilie,18,0,25,7
1708248835429,POLI 281,A00,419338,Ban; Pamela M,21,0,25,4
1708248835955,POLI 282,A00,419339,Ferree; Karen E,19,0,25,6
1708248836481,POLI 283,A00,419340,Naoi; Megumi,23,0,25,2
1708248837010,POLI 285,A00,419341,Ingham; Sean,25,0,25,0
1708248837536,POLI 286,A00,419342,Mignozzetti; Umberto,23,0,25,2
1708248838061,POLI 288,A00,479174,Fowler; James,13,0,15,2
1708248838587,PSY 296,001,465760,Besterman; Aaron David,49,0,50,1
1708248838587,PSY 296,002,465765,Eyler; Lisa T.,49,0,50,1
1708248838587,PSY 296,003,465767,Patel; Ekta Himanshu,49,0,50,1
1708248840369,PSYC 3R,A00,419378,Pilegard; Celeste Cristine,314,0,325,11
1708248840895,PSYC 7,A00,419384,Powell; Lindsey Jane,288,0,295,7
1708248841485,PSYC 60,A01,460208,Lowe; Angela Beth,31,0,35,4
1708248841485,PSYC 60,A02,460209,Lowe; Angela Beth,28,0,35,7
1708248841485,PSYC 60,A03,460210,Lowe; Angela Beth,35,0,35,0
1708248841485,PSYC 60,A04,460211,Lowe; Angela Beth,33,0,35,2
1708248841485,PSYC 60,A05,460212,Lowe; Angela Beth,34,0,35,1
1708248841485,PSYC 60,A06,460213,Lowe; Angela Beth,35,0,35,0
1708248841485,PSYC 60,A07,460214,Lowe; Angela Beth,33,0,35,2
1708248841485,PSYC 60,B01,460215,Rose; Fred E.,35,0,35,0
1708248841485,PSYC 60,B02,460216,Rose; Fred E.,35,0,35,0
1708248841485,PSYC 60,B03,460218,Rose; Fred E.,35,0,35,0
1708248841485,PSYC 60,B04,460219,Rose; Fred E.,35,0,35,0
1708248841485,PSYC 60,B05,460220,Rose; Fred E.,32,0,35,3
1708248841485,PSYC 60,B06,460221,Rose; Fred E.,35,0,35,0
1708248841485,PSYC 60,B07,460222,Rose; Fred E.,35,0,35,0
1708248842027,PSYC 70,A01,460223,Pilegard; Celeste Cristine,29,0,35,6
1708248842027,PSYC 70,A02,460224,Pilegard; Celeste Cristine,32,0,35,3
1708248842027,PSYC 70,A03,460225,Pilegard; Celeste Cristine,34,0,35,1
1708248842027,PSYC 70,A04,460266,Pilegard; Celeste Cristine,33,0,35,2
1708248842027,PSYC 70,A05,460267,Pilegard; Celeste Cristine,35,0,35,0
1708248842027,PSYC 70,A06,460277,Pilegard; Celeste Cristine,34,0,35,1
1708248842571,PSYC 71,A01,419620,Staff,19,0,21,2
1708248842571,PSYC 71,A02,419662,Staff,20,0,21,1
1708248842571,PSYC 71,B01,419682,Geller; Emma Harlan,24,0,25,1
1708248842571,PSYC 71,B02,419732,Geller; Emma Harlan,26,0,26,0
1708248843097,PSYC 88,A00,419733,Dobkins; Karen R.,47,0,65,18
1708248843623,PSYC 100,A00,419734,Chapman; Eddie Nathaniel,388,0,410,22
1708248844164,PSYC 101,A00,419735,Walker; Caren Michelle,272,0,295,23
1708248844690,PSYC 102,A00,419779,Moranton; Nirelia Melbina-,292,0,295,3
1708248845222,PSYC 104,A00,419880,Fine; Rachel,267,0,295,28
1708248845750,PSYC 105,A00,419946,Lowe; Angela Beth,276,0,295,19
1708248846275,PSYC 111B,A01,419948,Geller; Emma Harlan,35,0,35,0
1708248846801,PSYC 116C,A01,420046,Lang; Ariel,25,0,25,0
1708248847329,PSYC 117,A01,420092,Bajic; Daniel Andrew,25,0,25,0
1708248847858,PSYC 118,A01,420095,Miller; Cory T.,37,0,45,8
1708248848388,PSYC 124,A00,420096,Chapman; Eddie Nathaniel,381,0,410,29
1708248848913,PSYC 127,A00,420097,Dickenson; Janna Alene,14,0,20,6
1708248849439,PSYC 132,A00,420121,Staff,114,0,120,6
1708248849966,PSYC 133R,A01,420172,Golden; Susan S. & Gorman; Michael R.,10,0,16,6
1708248849966,PSYC 133R,A02,420173,Golden; Susan S. & Gorman; Michael R.,16,0,16,0
1708248849966,PSYC 133R,A03,420175,Golden; Susan S. & Gorman; Michael R.,16,0,16,0
1708248849966,PSYC 133R,A04,420249,Golden; Susan S. & Gorman; Michael R.,13,0,16,3
1708248850492,PSYC 134,A00,420311,Kaye; Walter H.,296,0,300,4
1708248851033,PSYC 137,A00,420312,Lin; Chujun,292,0,295,3
1708248851563,PSYC 144,A00,420313,Wixted; John T,287,0,295,8
1708248852092,PSYC 147,A00,420315,Wong; Lauren Hitomi,120,0,146,26
1708248852619,PSYC 164,A00,420328,Kaplan; Paul,259,0,295,36
1708248853148,PSYC 172,A00,420336,Dickenson; Janna Alene,294,0,300,6
1708248853678,PSYC 178,A00,420337,Glaser; Dale,131,0,146,15
1708248854208,PSYC 179,A00,420338,Lacefield; Katharine I,257,0,328,71
1708248854734,PSYC 181,A00,420339,Anagnostaras; Stephan,333,0,350,17
1708248855258,PSYC 184,A00,420367,Wilson; Brent M,275,0,295,20
1708248855784,PSYC 188,A00,420368,Lacefield; Katharine I,234,0,300,66
1708248856314,PSYC 190,A00,420378,Barner; David A.,374,0,395,21
1708248856857,PSYC 193,B00,420626,Brashier; Nadia Marie,215,0,216,1
1708248856857,PSYC 193,C00,420643,Gremel; Christina M,33,0,35,2
1708248857406,PSYC 193L,A01,420817,Brown; Sandra A,65,0,65,0
1708248857406,PSYC 193L,B01,420830,Staff,26,0,30,4
1708248857406,PSYC 193L,C01,420832,Staff,49,0,49,0
1708248857406,PSYC 193L,D01,420834,Staff,27,0,30,3
1708248857406,PSYC 193L,E01,493996,Aron; Adam,24,0,24,0
1708248857952,PSYC 194C,A01,420905,Heyman; Gail D.,1,0,1,0
1708248858480,PSYC 205,A00,420906,Harris; Christine Renee,17,0,20,3
1708248859008,PSYC 218,A00,420907,Brady; Timothy Francis,11,0,20,9
1708248859534,PSYC 224,A00,420908,Gremel; Christina M,30,0,30,0
1708248860063,PSYC 242,A00,421469,Walker; Caren Michelle,27,0,30,3
1708248860588,PSYC 247,A00,421473,Walker; Caren Michelle,14,0,20,6
1708248861114,PSYC 270C,A00,421554,Dobkins; Karen R.,13,0,20,7
1708248861647,PSYC 272,A00,421561,Gentner; Tim,20,0,20,0
1708248862174,PSYC 274,A00,421564,McCullough; Michael E,29,0,30,1
1708248862701,PSYC 275,A00,421620,Staff,23,0,30,7
1708248863229,PSYC 276,A00,421622,McCullough; Michael E,14,0,20,6
1708248863755,PSYC 280,A00,421623,Serences; John Thomas,76,0,85,9
1708248864336,PSYC 296,001,421667,Anagnostaras; Stephan,9999,0,9999,0
1708248864336,PSYC 296,002,421773,Aron; Adam,9999,0,9999,0
1708248864336,PSYC 296,003,421794,Mukku; Dhananjaya,9999,0,9999,0
1708248864336,PSYC 296,004,421795,Barner; David A.,9998,0,9999,1
1708248864336,PSYC 296,005,421796,Schachner; Adena,9999,0,9999,0
1708248864336,PSYC 296,006,421797,Brown; Sandra A,9999,0,9999,0
1708248864336,PSYC 296,007,421798,Chapman; Eddie Nathaniel,9999,0,9999,0
1708248864336,PSYC 296,008,421799,Dickenson; Janna Alene,9999,0,9999,0
1708248864336,PSYC 296,009,421800,Dobkins; Karen R.,9998,0,9999,1
1708248864336,PSYC 296,010,421801,Fan; Judith Ellen,9999,0,9999,0
1708248864336,PSYC 296,011,421803,Ferreira; Victor,9999,0,9999,0
1708248864336,PSYC 296,012,421814,Geller; Emma Harlan,9998,0,9999,1
1708248864336,PSYC 296,013,422102,Gentner; Tim,9999,0,9999,0
1708248864336,PSYC 296,014,422103,Gorman; Michael R.,9999,0,9999,0
1708248864336,PSYC 296,015,422104,Gremel; Christina M,9999,0,9999,0
1708248864336,PSYC 296,016,422106,Harris; Christine Renee,9999,0,9999,0
1708248864336,PSYC 296,017,422107,Heyman; Gail D.,9999,0,9999,0
1708248864336,PSYC 296,018,422108,McCullough; Michael E,9999,0,9999,0
1708248864336,PSYC 296,019,422109,Mc Kenzie; Craig R.M.,9999,0,9999,0
1708248864336,PSYC 296,020,422122,Miller; Cory T.,9999,0,9999,0
1708248864336,PSYC 296,021,422123,Pashler; Harold E,9999,0,9999,0
1708248864336,PSYC 296,022,422124,Pilegard; Celeste Cristine,9999,0,9999,0
1708248864336,PSYC 296,023,422125,Powell; Lindsey Jane,9999,0,9999,0
1708248864336,PSYC 296,025,422127,Rickard; Timothy C.,9998,0,9999,1
1708248864336,PSYC 296,026,422128,Serences; John Thomas,9998,0,9999,1
1708248864336,PSYC 296,027,422130,Walker; Caren Michelle,9998,0,9999,1
1708248864336,PSYC 296,028,422132,Winkielman; Piotr,9999,0,9999,0
1708248864336,PSYC 296,029,422134,Wixted; John T,9996,0,9999,3
1708248864336,PSYC 296,030,422146,Brady; Timothy Francis,9998,0,9999,1
1708248864336,PSYC 296,031,422154,Carver; Leslie J.,9999,0,9999,0
1708248864336,PSYC 296,032,422161,Lin; Chujun,9999,0,9999,0
1708248864336,PSYC 296,033,422169,Brashier; Nadia Marie,9998,0,9999,1
1708248864336,PSYC 296,034,422177,Oesch; Nicholas W,9999,0,9999,0
1708248864861,RAD 296,001,465795,Staff,50,0,50,0
1708248864861,RAD 296,002,465796,Staff,50,0,50,0
1708248864861,RAD 296,003,465797,Staff,50,0,50,0
1708248865390,RELI 150,A00,419353,Rahimi; Babak,37,0,40,3
1708248865922,REV 87,A00,422721,Lyon; Antony J.,19,0,20,1
1708248866451,RMAS 296,001,465827,Murphy; James D,49,0,50,1
1708248866451,RMAS 296,002,465828,Staff,50,0,50,0
1708248866451,RMAS 296,003,465831,Staff,50,0,50,0
1708248866979,RMED 296,001,466791,Staff,50,0,50,0
1708248866979,RMED 296,002,466792,Staff,50,0,50,0
1708248866979,RMED 296,003,466793,Staff,50,0,50,0
1708248867506,SE 3,A01,446938,Van Den Einde; Yael Dahlia,50,0,52,2
1708248867506,SE 3,A02,446942,Van Den Einde; Yael Dahlia,49,0,52,3
1708248867506,SE 3,A03,446948,Van Den Einde; Yael Dahlia,52,0,53,1
1708248867506,SE 3,A04,446965,Van Den Einde; Yael Dahlia,53,0,53,0
1708248868033,SE 9,A01,447015,Kuester; Falko,30,0,34,4
1708248868033,SE 9,A02,447017,Kuester; Falko,33,0,33,0
1708248868033,SE 9,A03,447022,Kuester; Falko,31,0,33,2
1708248868563,SE 101B,A01,447040,Kosmatka; John B,55,0,56,1
1708248869094,SE 105,A01,447042,Qiao; Yu,118,0,120,2
1708248869628,SE 110A,A01,467467,Asaro; Robert J,56,0,56,0
1708248870153,SE 110B,A00,447045,Zhu; Qiang,122,0,125,3
1708248870680,SE 130B,A01,447049,Chadha; Mayank,92,0,100,8
1708248871206,SE 131A,A01,447059,Krysl; Petr,102,0,110,8
1708248871731,SE 132,A01,447078,Chen; Jiun-Shyan,48,0,50,2
1708248872260,SE 140B,A01,447086,Restrepo; Jose,29,0,34,5
1708248872260,SE 140B,A02,447123,Restrepo; Jose,21,0,33,12
1708248872260,SE 140B,A03,447124,Restrepo; Jose,30,0,33,3
1708248872785,SE 143B,A01,447133,Tehrani; Mehran,11,0,15,4
1708248872785,SE 143B,A02,447134,Tehrani; Mehran,13,0,15,2
1708248873313,SE 150A,A01,447136,Uang; Chia-Ming,94,0,100,6
1708248873855,SE 150B,A01,447214,Morrison; Machel Leigh,49,0,50,1
1708248874386,SE 151B,A00,447215,Shing; P. Benson,71,0,75,4
1708248874932,SE 160B,A01,467468,Kim; Hyunsun Alicia,91,0,100,9
1708248875462,SE 165,A00,447238,Farrar; Charles R.,9,0,10,1
1708248875990,SE 184,A00,447253,Hutchinson; Tara,20,0,20,0
1708248876518,SE 202,A00,447392,Kosmatka; John B,25,0,30,5
1708248877048,SE 204,A00,447482,Todd; Michael,12,0,20,8
1708248877574,SE 206,A00,447483,Conte; Joel P,30,0,30,0
1708248878105,SE 213,A00,447499,Palermo; Alessandro,17,0,30,13
1708248878631,SE 215,A00,447500,Zhu; Qiang,34,0,45,11
1708248879159,SE 222,A00,447507,Elgamal; Ahmed,30,0,30,0
1708248879688,SE 227,A00,447576,Hutchinson; Tara,20,0,25,5
1708248880216,SE 244,A00,447577,Elgamal; Ahmed,29,0,30,1
1708248880746,SE 247,A00,447580,Hutchinson; Tara,0,0,5,5
1708248881275,SE 251B,A00,447612,Qiao; Yu,15,0,25,10
1708248881801,SE 253B,A00,447613,Kim; Hyonny,28,0,30,2
1708248882345,SE 260B,A00,447614,Kim; Hyunsun Alicia,10,0,10,0
1708248882873,SE 265,A00,447615,Farrar; Charles R.,20,0,25,5
1708248883398,SE 266,A00,447616,Loh; Chin Hsiung,23,0,25,2
1708248884452,SE 280,A00,447650,Krysl; Petr,22,0,25,3
1708248884978,SE 281,A01,447658,Kuester; Falko,12,0,30,18
1708248885562,SE 290,A00,447659,Qiao; Yu,78,0,100,22
1708248886108,SE 296,001,447666,Asaro; Robert J,9999,0,9999,0
1708248886108,SE 296,002,447669,Chen; Jiun-Shyan,9999,0,9999,0
1708248886108,SE 296,003,447689,Conte; Joel P,9999,0,9999,0
1708248886108,SE 296,004,447690,Elgamal; Ahmed,9999,0,9999,0
1708248886108,SE 296,005,447728,Hutchinson; Tara,9999,0,9999,0
1708248886108,SE 296,006,447733,Jandaghi Semnani; Shabnam,9999,0,9999,0
1708248886108,SE 296,007,447734,Kim; Hyonny,9999,0,9999,0
1708248886108,SE 296,008,447737,Kim; Hyunsun Alicia,9999,0,9999,0
1708248886108,SE 296,009,447738,Kosmatka; John B,9999,0,9999,0
1708248886108,SE 296,010,447739,Krysl; Petr,9999,0,9999,0
1708248886108,SE 296,011,447740,Kuester; Falko,9999,0,9999,0
1708248886108,SE 296,012,447741,Lanza Di Scalea; Francesco,9999,0,9999,0
1708248886108,SE 296,013,447742,Loh; Kenneth J. H.,9999,0,9999,0
1708248886108,SE 296,014,447745,McCartney; John Scott,9999,0,9999,0
1708248886108,SE 296,015,447747,Morrison; Machel Leigh,9999,0,9999,0
1708248886108,SE 296,016,447749,Mosqueda; Gilberto,9999,0,9999,0
1708248886108,SE 296,017,447874,Qiao; Yu,9999,0,9999,0
1708248886108,SE 296,018,447875,Restrepo; Jose,9999,0,9999,0
1708248886108,SE 296,019,447886,Shing; P. Benson,9999,0,9999,0
1708248886108,SE 296,020,447887,Todd; Michael,9999,0,9999,0
1708248886108,SE 296,021,447888,Tomac; Ingrid,9999,0,9999,0
1708248886108,SE 296,022,447889,Tsampras; Georgios,9999,0,9999,0
1708248886108,SE 296,023,447890,Uang; Chia-Ming,9999,0,9999,0
1708248886108,SE 296,024,447931,Van Den Einde; Yael Dahlia,9999,0,9999,0
1708248886108,SE 296,025,447932,Zhu; Qiang,9999,0,9999,0
1708248886108,SE 296,026,448007,Tehrani; Mehran,9999,0,9999,0
1708248886108,SE 296,027,448008,Palermo; Alessandro,9999,0,9999,0
1708248886108,SE 296,028,492941,Farrar; Charles R.,9998,0,9999,1
1708248886639,SIO 10,A00,446025,Borsa; Adrian Antal,573,0,590,17
1708248887168,SIO 16,A00,446031,Gee; Jeffrey S,119,0,120,1
1708248887694,SIO 50,A01,446057,Cook; Geoffrey W,19,0,22,3
1708248887694,SIO 50,A02,446058,Cook; Geoffrey W,21,0,22,1
1708248888218,SIO 75,A00,446060,Norris; Richard D.,32,0,35,3
1708248888751,SIO 87,A00,479215,Feddersen; Falk & Morzfeld; Matthias,20,0,20,0
1708248888751,SIO 87,B00,489613,Cook; Geoffrey W,19,0,20,1
1708248888751,SIO 87,C00,489620,Cook; Geoffrey W,20,0,20,0
1708248889277,SIO 90,A00,446061,Staff,61,0,70,9
1708248889812,SIO 113,A01,446064,May; David Alexander,27,0,30,3
1708248890864,SIO 128,A00,446115,Bartlett; Douglas H,110,0,120,10
1708248891397,SIO 135,A01,446153,Fricker; Helen A.,16,0,17,1
1708248891397,SIO 135,A02,446156,Fricker; Helen A.,14,0,18,4
1708248891941,SIO 136,A01,446159,Kacev; David & Wegner; Nicholas Craig & Bartlett; Douglas H,31,0,33,2
1708248891941,SIO 136,A02,446160,Kacev; David & Wegner; Nicholas Craig & Bartlett; Douglas H,33,0,33,0
1708248892468,SIO 139,A00,446164,Kacev; David,66,0,70,4
1708248892995,SIO 141,A01,446173,Pomeroy; Robert S.,11,0,12,1
1708248893524,SIO 143,A01,446175,Andersson; Andreas Jerry,20,0,30,10
1708248894056,SIO 145,A01,446181,Choy; Carolyn Anela,6,0,18,12
1708248894584,SIO 152,A01,446184,Van Allen; Emily Joyce,8,0,10,2
1708248894584,SIO 152,A02,479204,Van Allen; Emily Joyce,10,0,10,0
1708248895116,SIO 153,A01,446188,Capaldi; Tomas,24,0,26,2
1708248895642,SIO 160,A00,446189,Stegman; David,21,0,25,4
1708248896171,SIO 164,A00,446193,Staff,27,0,35,8
1708248896699,SIO 173,A00,446194,Lutsko; Nicholas J.,28,0,30,2
1708248897228,SIO 174,A00,446197,Aluwihare; Lihini & Russell; Lynn M.,26,0,30,4
1708248897755,SIO 181,A01,446200,Tresguerres; Martin,18,0,25,7
1708248897755,SIO 181,A02,446201,Tresguerres; Martin,23,0,25,2
1708248897755,SIO 181,A03,446209,Tresguerres; Martin,24,0,25,1
1708248897755,SIO 181,A04,446211,Tresguerres; Martin,24,0,25,1
1708248897755,SIO 181,A05,446223,Tresguerres; Martin,24,0,25,1
1708248897755,SIO 181,A06,446236,Tresguerres; Martin,24,0,25,1
1708248898281,SIO 192,A00,479211,Gerwick; William Henry,20,0,20,0
1708248898809,SIO 194,A00,455340,Hill; Seth J,0,0,0,0
1708248899333,SIOB 262,A00,446243,Gerwick; William Henry,23,0,25,2
1708248899859,SIOB 269,A00,446244,Staff,19,0,20,1
1708248900384,SIOB 270,A01,446261,Allen; Andrew Ellis & Petrik; Colleen Mary,18,0,20,2
1708248900911,SIOB 278,A00,446273,Arcila; Dahiana K,13,0,15,2
1708248900911,SIOB 278,B00,481742,Aburto Oropeza; Marco Octavio,18,0,20,2
1708248901456,SIOB 279,A00,446286,Franks; Peter,31,0,35,4
1708248901987,SIOB 291,A00,446292,Hechinger; Ryan F.,20,0,20,0
1708248902517,SIOB 296,A00,446293,Mongiardino Koch; Nicolas,16,0,20,4
1708248903044,SIOB 297,A00,446294,Allen; Eric,66,0,70,4
1708248903573,SIOC 202B,A00,446312,Stramski; Dariusz & Gabriel; Anne Alice-Agnes,17,0,20,3
1708248904103,SIOC 203C,A01,446314,Young; William Roy,5,0,5,0
1708248904630,SIOC 207C,A00,492798,Vasconcelos; Manuela,5,0,5,0
1708248905155,SIOC 208,A00,446315,Merrifield; Mark A,16,0,20,4
1708248905700,SIOC 209,A00,478924,Werner; Bradley T.,11,0,15,4
1708248905700,SIOC 209,B00,479224,Watson-Parris; Duncan,15,0,25,10
1708248905700,SIOC 209,C00,480739,Ricke; Katharine L,24,0,24,0
1708248906231,SIOC 212B,A01,446324,Cessi; Paola,40,0,40,0
1708248906758,SIOC 217C,A00,446325,Lutsko; Nicholas J.,25,0,25,0
1708248907286,SIOC 220,A00,446326,Rudnick; Daniel Lars,13,0,15,2
1708248907812,SIOC 224,A00,446327,Eisenman; Ian,20,0,25,5
1708248908339,SIOC 228,A00,446328,Shi; Yuanyuan,1,0,10,9
1708248908869,SIOC 235,A00,446342,Xie; Shang-Ping,14,0,15,1
1708248909413,SIOC 251,A00,446343,Evan; Amato Tomas,19,0,20,1
1708248909946,SIOG 200B,A00,446344,Gabriel; Anne Alice-Agnes,9,0,10,1
1708248910475,SIOG 221,A00,446354,Parnell-Turner; Ross Ernes,29,0,30,1
1708248911006,SIOG 227B,A00,446355,Laske; Gabi & Shearer; Peter M,19,0,20,1
1708248911533,SIOG 228,A00,446356,Van Allen; Emily Joyce,7,0,20,13
1708248912061,SIOG 230,A00,446359,Constable; Catherine G,25,0,25,0
1708248912592,SIOG 232,A00,446360,Constable; Catherine G & Constable; Steven C,37,0,40,3
1708248913119,SIOG 234,A00,446361,Sandwell; David T,15,0,15,0
1708248913658,SIOG 236,A01,477658,Fricker; Helen A.,5,0,5,0
1708248913658,SIOG 236,A02,477685,Fricker; Helen A.,3,0,5,2
1708248914193,SIOG 239,A00,446362,Gabriel; Anne Alice-Agnes,19,0,20,1
1708248914193,SIOG 239,B00,481507,May; David Alexander,6,0,6,0
1708248914193,SIOG 239,C00,486863,Fialko; Yuri A.,15,0,15,0
1708248914721,SIOG 268,A00,446364,Barbeau; Katherine,12,0,15,3
1708248915247,SOCE 194,A00,455341,Hill; Seth J,0,0,0,0
1708248915777,SOCG 204,A00,446551,Ng; Kwai,0,0,8,8
1708248916303,SOCG 206,A00,446552,Alvarez; Camila Huerta,4,0,8,4
1708248916833,SOCG 214,A00,446553,Raudenbush; Danielle,3,0,8,5
1708248917380,SOCG 255B,A00,446602,Serlin; David,2,0,5,3
1708248917909,SOCG 255C,A00,446813,Gates; Kelly,3,0,5,2
1708248918441,SOCG 290,A00,446910,Thorpe; Charles Robert,0,0,10,10
1708248918441,SOCG 290,B00,446911,Goldman; Harvey Stern,1,0,10,9
1708248918441,SOCG 290,C00,446914,Lampland; Martha,5,0,10,5
1708248918988,SOCI 2,A01,446373,Rogers; Julia Ellen,28,0,30,2
1708248918988,SOCI 2,A02,446374,Rogers; Julia Ellen,29,0,30,1
1708248918988,SOCI 2,A03,446382,Rogers; Julia Ellen,29,0,30,1
1708248918988,SOCI 2,A04,446384,Rogers; Julia Ellen,30,0,30,0
1708248918988,SOCI 2,A05,446389,Rogers; Julia Ellen,30,0,30,0
1708248918988,SOCI 2,A06,446393,Rogers; Julia Ellen,29,0,30,1
1708248919553,SOCI 20,A01,446396,Calderon-Zaks; Michael Aar,33,0,34,1
1708248919553,SOCI 20,A02,446409,Calderon-Zaks; Michael Aar,34,0,34,0
1708248920095,SOCI 40,A01,446417,Raudenbush; Danielle,30,0,32,2
1708248920095,SOCI 40,A02,446419,Raudenbush; Danielle,31,0,32,1
1708248920095,SOCI 40,A03,446434,Raudenbush; Danielle,31,0,32,1
1708248920095,SOCI 40,A04,446436,Raudenbush; Danielle,28,0,32,4
1708248920095,SOCI 40,A05,446441,Raudenbush; Danielle,29,0,32,3
1708248920095,SOCI 40,A06,446445,Raudenbush; Danielle,32,0,32,0
1708248920627,SOCI 60,A01,446461,Sutton; April Marie,30,0,32,2
1708248920627,SOCI 60,A02,446468,Sutton; April Marie,30,0,32,2
1708248920627,SOCI 60,A03,446469,Sutton; April Marie,26,0,32,6
1708248920627,SOCI 60,A04,446471,Sutton; April Marie,31,0,32,1
1708248921154,SOCI 100,A01,446480,Payne; Christine Anna,28,0,30,2
1708248921154,SOCI 100,A02,446491,Payne; Christine Anna,29,0,30,1
1708248921154,SOCI 100,A03,446492,Payne; Christine Anna,28,0,30,2
1708248921154,SOCI 100,A04,446493,Payne; Christine Anna,27,0,30,3
1708248921680,SOCI 103M,A00,481672,Kilpatrick; Kevin,27,0,28,1
1708248922207,SOCI 104,A00,446494,Turner; Christena L.,28,0,30,2
1708248922733,SOCI 104Q,A00,446495,Rogers; Julia Ellen,27,0,30,3
1708248923260,SOCI 106,A00,446496,Payne; Christine Anna,25,0,30,5
1708248923786,SOCI 107,A00,446497,Staff,30,0,30,0
1708248924314,SOCI 109,A00,446498,Rona-Tas; Akos,20,0,25,5
1708248924839,SOCI 111,A00,446499,Ribas Norris; Janet Vanesa,54,0,56,2
1708248925369,SOCI 114,A00,446500,Lampland; Martha,73,0,75,2
1708248925900,SOCI 117,A01,446502,Jones; Gabrielle Anastasia,14,0,17,3
1708248925900,SOCI 117,A02,446516,Jones; Gabrielle Anastasia,17,0,17,0
1708248925900,SOCI 117,A03,458787,Jones; Gabrielle Anastasia,17,0,17,0
1708248925900,SOCI 117,A04,458835,Jones; Gabrielle Anastasia,19,0,19,0
1708248926425,SOCI 120T,A00,446518,Staff,56,0,56,0
1708248926954,SOCI 123,A00,446519,Staff,79,0,80,1
1708248927483,SOCI 125,A00,487186,Calderon-Zaks; Michael Aar,55,0,56,1
1708248928009,SOCI 126,A01,446532,Jones; Makeba,15,0,15,0
1708248928009,SOCI 126,A02,446533,Jones; Makeba,15,0,15,0
1708248928009,SOCI 126,A03,458839,Jones; Makeba,15,0,15,0
1708248928009,SOCI 126,A04,458840,Jones; Makeba,15,0,15,0
1708248928539,SOCI 133,A00,446534,Calderon-Zaks; Michael Aar,53,0,56,3
1708248929065,SOCI 135,A00,486886,Ruiz; Jonathan Joseph,55,0,56,1
1708248929596,SOCI 136,A00,486887,Ruiz; Jonathan Joseph,56,0,56,0
1708248930121,SOCI 139,A00,446535,Ribas Norris; Janet Vanesa,78,0,80,2
1708248930647,SOCI 140J,A00,446537,Estefan; Michel,75,0,100,25
1708248931176,SOCI 142,A00,477639,Crofts; Christine,43,0,50,7
1708248931702,SOCI 146,A00,446538,Summers; Valerie R.,113,0,120,7
1708248932228,SOCI 151,A00,446540,Goldman; Harvey Stern,56,0,56,0
1708248932755,SOCI 156,A00,446541,Ostovany; Khashayar,55,0,56,1
1708248933281,SOCI 157,A00,446542,Jules-Rosette; Bennetta W.,28,0,28,0
1708248933809,SOCI 159,A00,494493,Estefan; Michel,93,0,96,3
1708248934334,SOCI 161,A00,477638,Staff,45,0,45,0
1708248934865,SOCI 162,A00,477642,Staff,54,0,55,1
1708248935407,SOCI 165,A00,446543,Rona-Tas; Akos,49,0,56,7
1708248935931,SOCI 171,A00,446544,Thorpe; Charles Robert,56,0,56,0
1708248936456,SOCI 173,A00,482888,Crofts; Christine,92,0,100,8
1708248936987,SOCI 180,A00,446545,Ostovany; Khashayar,55,0,56,1
1708248937514,SOCI 183,A00,446546,Sutton; April Marie,43,0,45,2
1708248938044,SOCI 185,A00,494495,Staff,30,0,30,0
1708248938591,SOCI 188D,A00,446549,Kokinis; Troy Andreas,24,0,25,1
1708248939174,SOCI 198RA,001,446550,Ng; Kwai,30,0,30,0
1708248939702,SOMC 224C,A00,466928,Bhakta; Savita Ganapathi,160,0,160,0
1708248940233,SOMC 229,A00,466925,Hoang; Mai Phuong,160,0,160,0
1708248940759,SOMC 240,A00,466937,Coyne; Christopher John,150,0,150,0
1708248941285,SOMC 242,A00,466931,Kline; Ahnika Sarah,160,0,160,0
1708248941812,SOMC 244,A00,466939,Mandel; Jess,150,0,150,0
1708248942343,SOMC 245C,A01,466935,Noel; Geoffroy Pierre Jean,160,0,160,0
1708248942869,SOMC 246C,A00,487163,Eyler; Lisa T.,160,0,160,0
1708248943396,SOMC 247C,A50,466950,Calcutt; Nigel A,160,0,160,0
1708248943921,SOMC 248C,A00,466936,Joshi; Weena Erin,160,0,160,0
1708248944447,SOMC 255C,A00,466951,Allison; Matthew,160,0,160,0
1708248944978,SPPH 161R,A01,476600,Chambers; Christina D,99,0,100,1
1708248945509,SPPH 263B,A01,460901,Hook; Vivian Yuan-Ho,25,0,25,0
1708248946035,SPPS 200A,A00,460907,Luli; Alex J,99,0,99,0
1708248946559,SPPS 200B,A00,460928,Luli; Alex J,99,0,99,0
1708248947090,SPPS 200C,A00,460934,Luli; Alex J,95,0,99,4
1708248947616,SPPS 203,A00,460955,Painter; Nathan A.,83,0,99,16
1708248948144,SPPS 205,A01,460978,Bandeira; Nuno Filipe Cabrita,64,0,80,16
1708248948670,SPPS 209,A00,460979,Bounthavong; Mark,94,0,99,5
1708248949196,SPPS 210,001,460980,Gustafsson; Asa Birgitta,99,0,99,0
1708248949721,SPPS 211A,A00,460987,Ferguson; Fleur,85,0,99,14
1708248950252,SPPS 211B,A00,460991,Ferguson; Fleur,96,0,99,3
1708248950778,SPPS 211C,A00,460992,Ferguson; Fleur,95,0,99,4
1708248951307,SPPS 211D,A00,460993,Tsunoda; Shirley M.,99,0,99,0
1708248951834,SPPS 212C,A01,460995,Saunders; Ila Maewal,95,0,99,4
1708248952360,SPPS 213C,A00,460996,Awdishu; Linda,95,0,99,4
1708248952889,SPPS 218B,A00,460997,Mandyam; Chitra,95,0,99,4
1708248953417,SPPS 225,A01,460999,Reed; Chantal,83,0,99,16
1708248953943,SPPS 236,A00,461000,Reid; Erin G.,96,0,99,3
1708248954469,SPPS 237,A00,461002,Mimoto; Mizuho Stacy,96,0,99,3
1708248955001,SPPS 238,A00,461041,Beyhan; Sinem,96,0,99,3
1708248955527,SPPS 241,A01,461122,Tsunoda; Shirley M.,83,0,99,16
1708248956054,SPPS 249,A00,461123,Brandl; Katharina,96,0,99,3
1708248956583,SPPS 250,A00,461126,Tsunoda; Shirley M.,45,0,50,5
1708248957113,SPPS 251,A00,461127,Chen; Timothy,99,0,99,0
1708248957642,SPPS 252,A00,461128,Abdul-Mutakabbir; Jacinda,74,0,80,6
1708248958168,SPPS 254,A00,481670,Shapiro; Desiree Nicolette,77,0,80,3
1708248958694,SPPS 261,A00,461129,Chambers; Christina D,93,0,99,6
1708248959221,SPPS 278,A00,459983,Fricovsky; Eduardo Santiago,98,0,99,1
1708248959748,SPPS 280,A00,461259,Fricovsky; Eduardo Santiago,19,0,20,1
1708248960273,SPPS 283,A00,461283,Tsunoda; Shirley M.,96,0,99,3
1708248960802,SURG 261,A00,466973,Staff,50,0,50,0
1708248961337,SURG 296,001,467004,Agha Hosseini; Ava,49,0,50,1
1708248961337,SURG 296,002,467005,Hinchcliff; Katharine Moss,49,0,50,1
1708248961337,SURG 296,003,467006,Eliceiri; Brian,49,0,50,1
1708248961879,SYN 1,001,448577,Bishop; Graham,19,0,20,1
1708248961879,SYN 1,002,448578,Iatarola; Briana Marie,19,0,20,1
1708248961879,SYN 1,003,448579,Browne; Emily,20,0,20,0
1708248961879,SYN 1,004,448580,Vega; Adrian,20,0,20,0
1708248961879,SYN 1,005,448581,Browne; Emily,20,0,20,0
1708248961879,SYN 1,006,448582,Rock; Martin,20,0,20,0
1708248961879,SYN 1,007,448583,Rock; Martin,20,0,20,0
1708248961879,SYN 1,008,448584,Iatarola; Briana Marie,19,0,20,1
1708248961879,SYN 1,009,448585,Bishop; Graham,20,0,20,0
1708248961879,SYN 1,010,448586,Bishop; Graham,20,0,20,0
1708248961879,SYN 1,011,448587,Gladstein; Jill M,15,0,15,0
1708248961879,SYN 1,012,448588,Meyer; Leslie Rose,20,0,20,0
1708248961879,SYN 1,013,448589,Rosenberg; Ryan Glenn,20,0,20,0
1708248961879,SYN 1,014,448627,Rosenberg; Ryan Glenn,19,0,20,1
1708248961879,SYN 1,015,448630,Atkinson; Arthur Laird,20,0,20,0
1708248961879,SYN 1,016,448651,Hom; Kirstyn Courtney,20,0,20,0
1708248961879,SYN 1,017,448652,Difruscio; Mark,20,0,20,0
1708248961879,SYN 1,018,448669,Hom; Kirstyn Courtney,20,0,20,0
1708248961879,SYN 1,019,448674,Hom; Kirstyn Courtney,18,0,20,2
1708248961879,SYN 1,020,448675,Atkinson; Arthur Laird,20,0,20,0
1708248961879,SYN 1,021,448678,Gladstein; Jill M,15,0,15,0
1708248961879,SYN 1,022,448682,Iatarola; Briana Marie,20,0,20,0
1708248961879,SYN 1,023,448691,Birberick; Brittany Celest,20,0,20,0
1708248961879,SYN 1,024,448751,Birberick; Brittany Celest,20,0,20,0
1708248961879,SYN 1,027,448766,Deavenport; James Cary,19,0,20,1
1708248961879,SYN 1,028,448767,Meyer; Leslie Rose,20,0,20,0
1708248961879,SYN 1,029,448775,Tawater; Hanna Jean,20,0,20,0
1708248961879,SYN 1,030,448777,Tawater; Hanna Jean,20,0,20,0
1708248961879,SYN 1,031,448792,Deavenport; James Cary,20,0,20,0
1708248961879,SYN 1,032,480169,Tawater; Hanna Jean,18,0,20,2
1708248962408,SYN 1R,001,448793,Difruscio; Mark,20,0,20,0
1708248962408,SYN 1R,004,449146,Difruscio; Mark,20,0,20,0
1708248962936,SYN 100,A01,449148,Staff,11,0,15,4
1708248962936,SYN 100,A02,449149,Staff,15,0,15,0
1708248962936,SYN 100,B01,449164,Gladstein; Jill M,0,0,0,0
1708248962936,SYN 100,B02,449166,Gladstein; Jill M,0,0,0,1
1708248962936,SYN 100,C01,449244,Staff,7,0,15,8
1708248962936,SYN 100,C02,449274,Staff,13,0,15,2
1708248962936,SYN 100,D01,449278,Staff,20,0,20,0
1708248962936,SYN 100,D02,449279,Staff,20,0,20,0
1708248962936,SYN 100,E01,449281,Rock; Martin,9,0,15,6
1708248962936,SYN 100,E02,449282,Rock; Martin,14,0,15,1
1708248962936,SYN 100,F01,449304,Browne; Emily,12,0,15,3
1708248962936,SYN 100,F02,449306,Browne; Emily,14,0,15,1
1708248962936,SYN 100,I01,449390,Gormally; Brenna,0,0,0,0
1708248962936,SYN 100,I02,449391,Gormally; Brenna,0,0,0,0
1708248962936,SYN 100,J01,449401,Atkinson; Arthur Laird,11,0,15,4
1708248962936,SYN 100,J02,449402,Atkinson; Arthur Laird,14,0,15,1
1708248962936,SYN 100,K01,449404,Deavenport; James Cary,11,0,15,4
1708248962936,SYN 100,K02,449405,Deavenport; James Cary,14,0,15,1
1708248962936,SYN 100,L01,449408,Rosenberg; Ryan Glenn,10,0,15,5
1708248962936,SYN 100,L02,449420,Rosenberg; Ryan Glenn,15,0,15,0
1708248963466,SYN 150,001,450016,Vega; Adrian,19,0,19,0
1708248963466,SYN 150,003,450031,Birberick; Brittany Celest,20,0,20,0
1708248963991,SYN 150R,001,494950,Vega; Adrian,20,0,20,0
1708248964517,SYN 198,001,494388,Staff,9999,0,9999,0
1708248965052,TDAC 1,A00,450042,Walsh; Kim C.,14,0,20,6
1708248965052,TDAC 1,B00,450043,Walsh; Kim C.,11,0,20,9
1708248965052,TDAC 1,C00,450044,Walsh; Kim C.,15,0,20,5
1708248965052,TDAC 1,D00,486830,Basso; Beatrice,20,0,20,0
1708248965052,TDAC 1,E00,492912,Walsh; Kim C.,15,0,20,5
1708248965052,TDAC 1,F00,492936,Walsh; Kim C.,18,0,20,2
1708248965582,TDAC 101,A00,450895,Celik; Aysan Karagasli,18,0,20,2
1708248966108,TDAC 102,A00,450904,Walsh; Kim C.,20,0,20,0
1708248966108,TDAC 102,B00,450916,Harting; Carla Kelso,20,0,20,0
1708248966637,TDAC 108,A00,450917,Buescher; Stephen W.,18,0,20,2
1708248967165,TDAC 109,A00,450924,Blair; Kyle Adam,20,0,20,0
1708248967692,TDAC 122,A00,451025,Perry; Lamar,30,0,30,0
1708248967692,TDAC 122,B00,480845,Perry; Lamar,30,0,30,0
1708248968224,TDAC 123,A00,451026,Buescher; Stephen W.,30,0,30,0
1708248968224,TDAC 123,B00,451028,Celik; Aysan Karagasli,30,0,30,0
1708248968224,TDAC 123,C00,480851,Perry; Lamar,30,0,30,0
1708248968750,TDDE 101,A00,451030,Guirguis; Mark C,18,0,20,2
1708248969277,TDDE 112,A00,451032,Staff,20,0,20,0
1708248969802,TDDE 130,A00,451033,Guirguis; Mark C,19,0,20,1
1708248970332,TDDE 132,A00,451034,Guirguis; Mark C,20,0,20,0
1708248970857,TDDE 169A,A00,481304,Petrovich; Victoria A.,19,0,20,1
1708248971384,TDDM 1,A00,450045,Weinberg; Sadie,27,0,30,3
1708248971911,TDDM 101,A00,451067,Staff,29,0,30,1
1708248972435,TDDR 101,A00,451068,Powell; Lora,29,0,34,5
1708248972961,TDDR 102,A00,451069,Powell; Lora,19,0,20,1
1708248973490,TDDR 111,A00,451070,Castro; Robert Jess,15,0,16,1
1708248973490,TDDR 111,B00,451071,Castro; Robert Jess,15,0,16,1
1708248974016,TDDR 190,A00,451073,Perry; Lamar,1,0,1,0
1708248974547,TDGE 1,A01,450047,Salovey; Todd,20,0,20,0
1708248974547,TDGE 1,A02,450048,Salovey; Todd,20,0,20,0
1708248974547,TDGE 1,A03,450085,Salovey; Todd,18,0,20,2
1708248974547,TDGE 1,A04,450093,Salovey; Todd,20,0,20,0
1708248974547,TDGE 1,A05,450096,Salovey; Todd,19,0,20,1
1708248974547,TDGE 1,A06,450132,Salovey; Todd,16,0,20,4
1708248975074,TDGE 25,A00,450236,Harting; Carla Kelso,12,0,20,8
1708248975074,TDGE 25,B00,450240,Harting; Carla Kelso,16,0,20,4
1708248975074,TDGE 25,C00,450243,Harting; Carla Kelso,14,0,20,6
1708248975074,TDGE 25,D00,450388,Harting; Carla Kelso,16,0,20,4
1708248975604,TDGE 100,A01,451098,Salovey; Todd,24,0,25,1
1708248975604,TDGE 100,A02,451099,Salovey; Todd,24,0,25,1
1708248976135,TDGE 124,A00,451122,Fulton; Julia,168,0,200,32
1708248976662,TDGE 125,A00,480853,Havis; Allan,197,0,200,3
1708248976662,TDGE 125,B00,480886,Staff,216,0,220,4
1708248977190,TDGE 133,A00,481097,Brill; Robert L.,20,0,20,0
1708248977718,TDGE 196B,A00,493144,Barricelli; Marc Alexander,1,0,1,0
1708248977718,TDGE 196B,B00,493148,Buescher; Stephen W.,2,0,2,0
1708248977718,TDGE 196B,C00,493151,Burelle; Julie Sara Veronique,1,0,1,0
1708248977718,TDGE 196B,D00,493189,Castro; Robert Jess,2,0,2,0
1708248977718,TDGE 196B,E00,493190,Guirguis; Mark C,1,0,1,0
1708248977718,TDGE 196B,F00,493240,Iizuka; Naomi Hisako,1,0,1,0
1708248977718,TDGE 196B,G00,493241,Perry; Lamar,1,0,1,0
1708248977718,TDGE 196B,H00,493249,Powell; Lora,1,0,1,0
1708248977718,TDGE 196B,I00,493296,Stein; Deborah Isobel,6,0,6,0
1708248978244,TDGR 213C,A00,451385,Buescher; Stephen W.,10,0,10,0
1708248978786,TDGR 220A,A00,451386,Barricelli; Marc Alexander,10,0,10,0
1708248979316,TDGR 239,A00,451387,Blair; Kyle Adam,10,0,10,0
1708248979840,TDGR 240,A00,481306,Portes; Elizabeth Marie,5,0,5,0
1708248980369,TDGR 245,A00,451388,Perry; Lamar,7,0,7,0
1708248980893,TDGR 250,A00,451395,Iizuka; Naomi Hisako,8,0,10,2
1708248981418,TDGR 251,A00,451397,Iizuka; Naomi Hisako,9,0,10,1
1708248981418,TDGR 251,B00,451398,Stein; Deborah Isobel,9,0,10,1
1708248981944,TDGR 257B,A00,451399,Finch; Michael S,8,0,10,2
1708248982469,TDGR 278,A00,481307,Petrovich; Victoria A.,4,0,5,1
1708248983004,TDGR 279,A00,451400,Bokovikova; Alina V,9,0,10,1
1708248983004,TDGR 279,B00,451401,Brill; Robert L.,10,0,10,0
1708248983004,TDGR 279,C00,451402,Petrovich; Victoria A.,10,0,10,0
1708248983004,TDGR 279,D00,451403,McElver; Robert Harrison,10,0,10,0
1708248983004,TDGR 279,E00,451404,Kuhl; Christopher August,10,0,10,0
1708248983532,TDGR 286,A00,451405,Knox; Leila Elizabeth,9,0,10,1
1708248984059,TDGR 288,A00,451406,Powell; Lora,6,0,7,1
1708248984592,TDGR 292,A00,451407,Power; Jade Yukana,10,0,10,0
1708248984592,TDGR 292,B00,451408,Mehrishi; Rishika,10,0,10,0
1708248985119,TDGR 293,001,451417,Power; Jade Yukana,7,0,7,0
1708248985119,TDGR 293,002,451418,Burelle; Julie Sara Veronique,7,0,7,0
1708248985119,TDGR 293,003,451419,Yapp; Hentyle T,7,0,7,0
1708248985119,TDGR 293,005,451421,Anderson; Mysia Anyse,7,0,7,0
1708248985644,TDGR 294,001,451429,Burelle; Julie Sara Veronique,7,0,7,0
1708248985644,TDGR 294,002,451431,Power; Jade Yukana,7,0,7,0
1708248985644,TDGR 294,003,451432,Yapp; Hentyle T,7,0,7,0
1708248986170,TDGR 295,A00,451433,Barricelli; Marc Alexander,10,0,10,0
1708248986694,TDGR 296,A00,451489,Powell; Lora,6,0,7,1
1708248986694,TDGR 296,B00,451497,Porter; Lisa,6,0,7,1
1708248987226,TDHD 175,A00,451123,Jun; Grace Shin Hae,40,0,40,0
1708248987753,TDHD 176,A00,451124,Caligagan; Maria T.,40,0,40,0
1708248988280,TDHT 10,A00,450409,Power; Jade Yukana,20,0,20,0
1708248988280,TDHT 10,B00,450450,Power; Jade Yukana,19,0,20,1
1708248988808,TDHT 23,A01,450546,Salimi; Rana,24,0,24,0
1708248988808,TDHT 23,A02,450549,Salimi; Rana,22,0,24,2
1708248988808,TDHT 23,A03,450553,Salimi; Rana,24,0,24,0
1708248989334,TDHT 101,A00,451125,Anderson; Mysia Anyse,25,0,25,0
1708248989334,TDHT 101,B00,451126,Mehrishi; Rishika,23,0,25,2
1708248989877,TDHT 104,A00,451225,Basso; Beatrice,22,0,25,3
1708248990404,TDHT 109,A01,451227,Anderson; Mysia Anyse,25,0,25,0
1708248990937,TDHT 122,A00,451228,Power; Jade Yukana,21,0,25,4
1708248991462,TDMV 1,A00,450558,Caligagan; Maria T.,15,0,30,15
1708248991992,TDMV 2,A00,450627,Anabo; Cherry,24,0,30,6
1708248992572,TDMV 3,A00,450630,Arcidiacono; Kristin,37,0,40,3
1708248993098,TDMV 11,A00,481244,Fyall; DauntÉ Edward,30,0,30,0
1708248993629,TDMV 20,A00,450789,Smith; Alison D,38,0,40,2
1708248994158,TDMV 110,A00,451229,Caligagan; Maria T.,28,0,30,2
1708248994686,TDMV 111,A00,451234,Smith; Alison D,28,0,30,2
1708248995218,TDMV 120,A00,451260,Weinberg; Sadie,30,0,30,0
1708248995218,TDMV 120,B00,451261,Sammartano; Tonnie,30,0,30,0
1708248995747,TDMV 122,A00,451262,Staff,28,0,30,2
1708248996275,TDMV 123,A00,451263,Duran; Marcos Antonio,28,0,30,2
1708248996803,TDMV 130,A00,451272,Mack; Kara Shanai',30,0,30,0
1708248997331,TDMV 138,A00,451275,Jun; Grace Shin Hae,4,0,30,26
1708248997859,TDMV 140,A00,451276,Lima; Paulo Henrique,40,0,40,0
1708248997859,TDMV 140,B00,451308,Power; Jade Yukana,39,0,40,1
1708248997859,TDMV 140,C00,451371,Caligagan; Tony,40,0,40,0
1708248997859,TDMV 140,D00,451373,Corrales; Joseph Bernales,28,0,30,2
1708248998387,TDMV 141,A00,451374,Caligagan; Tony,26,0,30,4
1708248998916,TDMV 142,A00,451375,Blanco; Juan Carlos,26,0,40,14
1708248999446,TDMV 143,A00,451376,Fyall; DauntÉ Edward,39,0,40,1
1708248999975,TDMV 144,A00,451377,Anabo; Cherry,39,0,40,1
1708249000501,TDMV 149,A00,451378,Jun; Grace Shin Hae,36,0,40,4
1708249001026,TDPF 162,A00,451379,Alvarez; Ana Maria,40,0,40,0
1708249001551,TDPR 6,A01,450799,Guirguis; Mark C,50,0,50,0
1708249001551,TDPR 6,A02,450801,Guirguis; Mark C,50,0,50,0
1708249002077,TDPR 102,A00,451380,Guirguis; Mark C,20,0,20,0
1708249002607,TDPR 104,A00,451381,Powell; Lora,15,0,15,0
1708249003139,TDPW 1,A00,450808,Stein; Deborah Isobel,14,0,15,1
1708249003139,TDPW 1,B00,450864,Stein; Deborah Isobel,13,0,15,2
1708249003139,TDPW 1,C00,450865,Stein; Deborah Isobel,15,0,15,0
1708249003139,TDPW 1,D00,450868,Stein; Deborah Isobel,13,0,15,2
1708249003139,TDPW 1,E00,450874,Stein; Deborah Isobel,14,0,15,1
1708249003665,TDPW 102,A00,451382,Staff,18,0,20,2
1708249004193,TDPW 104,A00,481182,Staff,17,0,20,3
1708249004719,TDTR 10,A00,450881,Wilson; Terry A.,28,0,30,2
1708249005244,TDTR 15,A00,450882,Smith; Alison D,30,0,30,0
1708249005770,TMC 15,A00,479039,Hemans; Patricia Ann Benitez,25,0,25,0
1708249006297,TMC 87,A00,479049,Solomon; Amanda Lee Albaniel,20,0,20,0
1708249006826,UROL 296,001,467060,Anger; Jennifer Tash,49,0,50,1
1708249006826,UROL 296,002,467061,Staff,50,0,50,0
1708249007352,USP 3,A01,458852,Martin; Isaac,34,0,35,1
1708249007352,USP 3,A02,458853,Martin; Isaac,35,0,35,0
1708249007352,USP 3,A03,458861,Martin; Isaac,34,0,35,1
1708249007352,USP 3,A04,458862,Martin; Isaac,32,0,35,3
1708249007877,USP 4,A00,451772,Schwaller; Nora Louise,19,0,25,6
1708249008403,USP 5,A01,458863,Shenkman; Michael Thomas,33,0,35,2
1708249008403,USP 5,A02,458864,Shenkman; Michael Thomas,31,0,35,4
1708249008931,USP 15,A01,458931,Staff,33,0,35,2
1708249008931,USP 15,A02,459024,Staff,31,0,35,4
1708249009457,USP 25,A00,451786,Sun; Feiyang,57,0,60,3
1708249009985,USP 100,A00,451787,Moses; Kelema Lee,55,0,60,5
1708249010511,USP 108,A00,477594,Martin; Isaac,25,0,25,0
1708249011036,USP 119,A00,477595,Schwaller; Nora Louise,23,0,25,2
1708249011566,USP 124,A00,451790,Hinds; Juli Beth,62,0,70,8
1708249012093,USP 128B,A01,451910,Lewis; Leslie R,12,0,13,1
1708249012620,USP 142B,A01,451954,Lewis; Leslie R,24,0,25,1
1708249013146,USP 142C,A00,451977,Lerner; Amy M,0,0,0,0
1708249013675,USP 145,A00,451999,Yaghmaee; Saman,140,0,146,6
1708249014199,USP 150,A00,452165,Staff,44,0,50,6
1708249014724,USP 151,A00,452166,Staff,49,0,50,1
1708249015250,USP 152A,A01,459025,Weaver; Todd D,25,0,25,0
1708249015250,USP 152A,A02,459074,Weaver; Todd D,24,0,25,1
1708249015776,USP 152B,A00,452224,Moeder; Nathan L,21,0,25,4
1708249016308,USP 153,A00,452339,Shenkman; Michael Thomas,50,0,50,0
1708249016836,USP 158A,A00,452410,Sun; Feiyang,25,0,25,0
1708249017367,USP 159B,A00,452411,Gherini; Paul Pier-Carlo,6,0,8,2
1708249017893,USP 160,A00,452412,Wartell; Julie Dara,25,0,25,0
1708249018419,USP 164,A00,452413,Moses; Kelema Lee,22,0,25,3
1708249018944,USP 165C,A00,452442,Frank; Lawrence Douglas,20,0,20,0
1708249019471,USP 169,A00,452598,Bajaj; Ravi Siddharth,32,0,35,3
1708249020003,USP 170,A00,477593,Entezam; Maryam,60,0,60,0
1708249020531,USP 172,A00,452676,Peerson; Susan,19,0,25,6
1708249021060,USP 175,A00,452848,Velasco; Diego,18,0,20,2
1708249021589,USP 177A,A00,453084,Velasco; Diego,21,0,25,4
1708249022115,USP 177B,A00,453127,Peerson; Susan,22,0,25,3
1708249022642,USP 183,A00,453128,Sutton; April Marie,19,0,20,1
1708249023171,USP 188B,A00,453187,Pezzoli; Keith,30,0,30,0
1708249023696,USP 190,A00,453234,Pezzoli; Keith,0,0,0,1
1708249024227,USP 191B,A00,453240,Polat; Soydan Alihan,18,0,20,2
1708249024756,USP 193,A00,453251,Bussell; Mirle Rabinowitz,24,0,25,1
1708249025282,USP 194,A00,455342,Hill; Seth J,0,0,0,0
1708249025808,USP 265C,A00,453264,Frank; Lawrence Douglas,10,0,10,0
1708249026335,VIS 3,A01,453427,Staff,25,0,25,0
1708249026335,VIS 3,A02,453428,Staff,15,0,25,10
1708249026335,VIS 3,A03,453429,Staff,25,0,25,0
1708249026335,VIS 3,A04,453430,Staff,21,0,25,4
1708249026335,VIS 3,A05,453431,Staff,25,0,25,0
1708249026335,VIS 3,A06,453432,Staff,23,0,25,2
1708249026335,VIS 3,A07,453433,Staff,17,0,25,8
1708249026335,VIS 3,A08,453434,Staff,23,0,25,2
1708249026335,VIS 3,A09,453435,Staff,21,0,25,4
1708249026335,VIS 3,A10,453436,Staff,23,0,25,2
1708249026863,VIS 9,A00,453437,Camargo; William,116,0,146,30
1708249027390,VIS 10,A00,453438,Kiratli; Solen,189,0,200,11
1708249027918,VIS 21B,A01,453440,Shen; Kuiyi,31,0,32,1
1708249027918,VIS 21B,A02,453441,Shen; Kuiyi,31,0,32,1
1708249027918,VIS 21B,A03,453442,Shen; Kuiyi,31,0,32,1
1708249027918,VIS 21B,A04,453443,Shen; Kuiyi,32,0,32,0
1708249027918,VIS 21B,A05,453444,Shen; Kuiyi,32,0,32,0
1708249027918,VIS 21B,A06,453452,Shen; Kuiyi,32,0,32,0
1708249027918,VIS 21B,A07,453468,Shen; Kuiyi,30,0,32,2
1708249027918,VIS 21B,A08,453587,Shen; Kuiyi,32,0,32,0
1708249028453,VIS 22,A01,453589,Rose; Jordan M,32,0,32,0
1708249028453,VIS 22,A02,453590,Rose; Jordan M,32,0,32,0
1708249028453,VIS 22,A03,453615,Rose; Jordan M,31,0,32,1
1708249028453,VIS 22,A04,453616,Rose; Jordan M,32,0,32,0
1708249028453,VIS 22,A05,453617,Rose; Jordan M,30,0,32,2
1708249028453,VIS 22,A06,453618,Rose; Jordan M,30,0,32,2
1708249028453,VIS 22,A07,453620,Rose; Jordan M,32,0,32,0
1708249028453,VIS 22,A08,453621,Rose; Jordan M,32,0,32,0
1708249028453,VIS 22,A09,453635,Rose; Jordan M,32,0,32,0
1708249028453,VIS 22,A10,453636,Rose; Jordan M,32,0,32,0
1708249028979,VIS 31,A00,453637,Dominguez; Ricardo,133,0,146,13
1708249029506,VIS 41,A01,453644,D'Elena-Tweed; Jessica Erin,23,0,25,2
1708249029506,VIS 41,A02,453645,D'Elena-Tweed; Jessica Erin,22,0,25,3
1708249029506,VIS 41,A03,453646,D'Elena-Tweed; Jessica Erin,25,0,25,0
1708249029506,VIS 41,A04,453647,D'Elena-Tweed; Jessica Erin,18,0,25,7
1708249029506,VIS 41,A05,453648,D'Elena-Tweed; Jessica Erin,25,0,25,0
1708249029506,VIS 41,A06,453650,D'Elena-Tweed; Jessica Erin,24,0,25,1
1708249030038,VIS 70N,A01,453652,Garnett; Mariah J,21,0,22,1
1708249030038,VIS 70N,A02,453653,Garnett; Mariah J,21,0,22,1
1708249030038,VIS 70N,A03,453654,Garnett; Mariah J,22,0,22,0
1708249030038,VIS 70N,A04,453657,Garnett; Mariah J,22,0,22,0
1708249030038,VIS 70N,A05,453662,Garnett; Mariah J,20,0,22,2
1708249030038,VIS 70N,A06,453663,Garnett; Mariah J,22,0,22,0
1708249030568,VIS 83,A00,453664,Kester; Grant,137,0,146,9
1708249031095,VIS 101A,A00,453666,Cruz; Edwin Teddy,10,0,15,5
1708249031626,VIS 102,A00,453668,Cruz; Edwin Teddy,81,0,85,4
1708249032157,VIS 105A,A00,453669,Adler; Amy,29,0,30,1
1708249032690,VIS 105B,A00,453738,Herc-Balaszek; Malgorzata,25,0,30,5
1708249032690,VIS 105B,B00,453739,Staff,27,0,30,3
1708249033219,VIS 106A,A00,453740,Staff,22,0,25,3
1708249033744,VIS 106B,A00,453741,De Luca; Mara Julia,20,0,25,5
1708249034271,VIS 106C,A00,453746,Vangenderen; Monique Luise,11,0,15,4
1708249034801,VIS 107A,A00,453747,Gregoire; Mathieu,19,0,25,6
1708249035331,VIS 107B,A00,453748,Dean; Danielle Adobi,23,0,25,2
1708249035860,VIS 110A,A00,453749,Adler; Amy,13,0,15,2
1708249036386,VIS 110E,A00,453798,Gregoire; Mathieu,14,0,15,1
1708249036914,VIS 110F,A00,453799,Staff,15,0,15,0
1708249037441,VIS 110N,A00,453803,Dean; Danielle Adobi,15,0,15,0
1708249037973,VIS 123B,A00,453804,Gaines; Malik Julian,75,0,75,0
1708249038500,VIS 125BN,A00,453813,Welchman; John C.,75,0,75,0
1708249039031,VIS 126P,A00,453814,Wardwell; Mariana Razo,74,0,75,1
1708249039556,VIS 128E,A00,453815,Staff,75,0,75,0
1708249040081,VIS 129E,A00,453855,Shen; Kuiyi,12,0,15,3
1708249040617,VIS 131,A00,453859,Trigilio; Michael,12,0,15,3
1708249040617,VIS 131,B00,479342,Mangolte; Babette,15,0,15,0
1708249041146,VIS 133A,A00,454231,Barbosa; Erika Katrina,13,0,15,2
1708249041672,VIS 134,A00,454232,Yoldas; Pinar,59,0,75,16
1708249042199,VIS 141B,A00,454233,Stalbaum; Brett,12,0,15,3
1708249042725,VIS 145B,A00,454234,Alexander; Amy J,14,0,15,1
1708249042725,VIS 145B,B00,454235,Kiratli; Solen,8,0,15,7
1708249043252,VIS 147A,A01,454237,Stalbaum; Brett,20,0,22,2
1708249043252,VIS 147A,A02,454238,Stalbaum; Brett,18,0,22,4
1708249043778,VIS 157,A01,454240,Cartwright; Lisa,32,0,34,2
1708249043778,VIS 157,A02,454241,Cartwright; Lisa,32,0,34,2
1708249044304,VIS 159,A01,454243,Akten; Mehmet,34,0,34,0
1708249044304,VIS 159,A02,454244,Akten; Mehmet,32,0,34,2
1708249044304,VIS 159,A03,454300,Akten; Mehmet,30,0,34,4
1708249044304,VIS 159,A04,454301,Akten; Mehmet,33,0,34,1
1708249044304,VIS 159,A05,454302,Akten; Mehmet,30,0,34,4
1708249044304,VIS 159,A06,454307,Akten; Mehmet,33,0,34,1
1708249044304,VIS 159,A07,454308,Akten; Mehmet,34,0,34,0
1708249044304,VIS 159,A08,454309,Akten; Mehmet,33,0,34,1
1708249044829,VIS 160B,A00,454310,Alexander; Amy J,13,0,15,2
1708249044829,VIS 160B,B00,454311,Akten; Mehmet,14,0,15,1
1708249044829,VIS 160B,C00,454312,Stone; Patricia,12,0,15,3
1708249045356,VIS 164,A00,454313,Cross; Brian R,19,0,22,3
1708249045356,VIS 164,B00,454314,Camargo; William,22,0,22,0
1708249045936,VIS 165,A00,454315,Erdmann; Dean,22,0,22,0
1708249046462,VIS 167,A00,454316,Staff,18,0,22,4
1708249046989,VIS 169A,A00,454317,Mostajo; Lorena,21,0,22,1
1708249047514,VIS 171,A00,454318,Nakayama; Yue,21,0,22,1
1708249048040,VIS 174,A00,454319,Staff,19,0,22,3
1708249048569,VIS 177,A00,454320,Cho; Erica,21,0,22,1
1708249049096,VIS 178,A00,454321,Staff,0,0,0,0
1708249049624,VIS 179,A00,454322,Erdmann; Dean,22,0,22,0
1708249050147,VIS 180A,A00,454323,Nakayama; Yue,21,0,22,1
1708249050672,VIS 180B,A00,454341,Cross; Brian R,20,0,22,2
1708249051198,VIS 183A,A00,454342,Cho; Erica,17,0,22,5
1708249051729,VIS 185,A00,454343,Miller; Nicole L,18,0,22,4
1708249052255,VIS 190,A00,454360,Crandall; Jordan,15,0,15,0
1708249052255,VIS 190,B00,454361,D'Elena-Tweed; Jessica Erin,10,0,15,5
1708249052785,VIS 202,A00,454369,Miller; Nicole L,12,0,15,3
1708249053309,VIS 203,A00,454370,Garnett; Mariah J,8,0,15,7
1708249053834,VIS 206,A00,454376,Kester; Grant,10,0,15,5
1708249054360,VIS 208,A00,454377,Moss; Ceci,15,0,15,0
1708249054889,VIS 211,A00,454413,Segade; Alexandro Abraham,0,0,0,2
1708249055416,VIS 243,A00,454429,Rose; Jordan M,5,0,15,10
1708249055944,VIS 255,A00,454430,Welchman; John C.,8,0,15,7
1708249056474,VIS 262,A00,454431,Yoldas; Pinar,11,0,15,4
1708249057003,WCWP 10A,001,454442,Uriarte; Emma,17,0,20,3
1708249057003,WCWP 10A,002,454443,Uriarte; Emma,14,0,20,6
1708249057003,WCWP 10A,003,454479,Uriarte; Emma,19,0,20,1
1708249057003,WCWP 10A,004,454480,Staff,0,0,0,0
1708249057003,WCWP 10A,005,454484,Staff,0,0,0,0
1708249057003,WCWP 10A,006,454485,Staff,0,0,0,0
1708249057003,WCWP 10A,007,454487,Staff,0,0,0,0
1708249057003,WCWP 10A,008,454488,Susi; Natalie,14,0,20,6
1708249057003,WCWP 10A,009,454489,Staff,0,0,0,0
1708249057003,WCWP 10A,010,454490,Staff,0,0,0,0
1708249057537,WCWP 10B,001,454492,Ornelas; Tricia,20,0,20,0
1708249057537,WCWP 10B,002,454501,Ornelas; Tricia,20,0,20,0
1708249057537,WCWP 10B,003,454565,Gagnon; Jeffrey C,2,0,20,18
1708249057537,WCWP 10B,004,454604,Ornelas; Tricia,16,0,20,4
1708249057537,WCWP 10B,005,454668,Staff,16,0,16,0
1708249057537,WCWP 10B,006,454724,Staff,16,0,16,0
1708249057537,WCWP 10B,007,454725,Staff,14,0,16,2
1708249057537,WCWP 10B,008,454768,Staff,0,0,0,0
1708249057537,WCWP 10B,009,454769,Staff,0,0,0,0
1708249057537,WCWP 10B,010,454770,Staff,0,0,0,0
1708249057537,WCWP 10B,011,454771,Dhir; Simrita,16,0,20,4
1708249057537,WCWP 10B,012,454772,Dhir; Simrita,16,0,20,4
1708249057537,WCWP 10B,013,454773,Merryman; Walter,17,0,20,3
1708249057537,WCWP 10B,014,454774,Dhir; Simrita,18,0,20,2
1708249057537,WCWP 10B,015,454775,Merryman; Walter,17,0,20,3
1708249057537,WCWP 10B,016,454776,Merryman; Walter,18,0,20,2
1708249057537,WCWP 10B,017,454777,Welji; Haleema Nazir,14,0,16,2
1708249057537,WCWP 10B,018,478868,Staff,16,0,16,0
1708249057537,WCWP 10B,019,478869,Staff,0,0,0,0
1708249057537,WCWP 10B,020,478876,Staff,0,0,0,0
1708249057537,WCWP 10B,021,478877,Staff,0,0,0,0
1708249057537,WCWP 10B,022,478887,Staff,0,0,0,0
1708249057537,WCWP 10B,023,478889,Staff,16,0,16,0
1708249057537,WCWP 10B,024,478892,Staff,0,0,0,0
1708249057537,WCWP 10B,025,478907,Staff,0,0,0,0
1708249058065,WCWP 100,A00,454800,McCleary; Keith Long,20,0,20,0
1708249058065,WCWP 100,B00,454804,McCleary; Keith Long,20,0,20,0
1708249058065,WCWP 100,C00,454822,Twohig; Niall Ivan,19,0,20,1
1708249058065,WCWP 100,D00,454855,Young; Mark T,20,0,20,0
1708249058065,WCWP 100,E00,454860,Twohig; Niall Ivan,20,0,20,0
1708249058065,WCWP 100,F00,454932,Young; Mark T,20,0,20,0
1708249058065,WCWP 100,G00,454933,Young; Mark T,20,0,20,0
1708249058590,WES 207,A00,454941,Kastner; Ryan Charles,20,0,20,0
1708249059116,WES 265,A00,454942,Staff,19,0,20,1
1708249060906,AAS 10,A01,392963,Butler; Elizabeth Annette,34,0,34,0
1708249060906,AAS 10,A02,392965,Butler; Elizabeth Annette,33,0,34,1
1708249061432,AAS 170,A00,392977,Butler; Elizabeth Annette,31,0,32,1
1708249061958,AAS 198,001,479182,Childs; Dennis R.,20,0,20,0
1708249062482,AESE 261,A00,387945,Staff,33,0,33,0
1708249063008,AESE 278D,A00,387953,Staff,33,0,33,0
1708249063534,AESE 278E,A00,387954,Staff,33,0,33,0
1708249064060,AESE 279A,A00,387956,Staff,33,0,33,0
1708249064586,AIP 197P,001,494494,Goldfarb; Brian,9999,0,9999,0
1708249065113,ANAR 100,A00,387884,Shtienberg; Gilad,15,0,16,1
1708249065639,ANAR 104,A01,387886,Tamberino; Anthony Thomas,21,0,25,4
1708249066165,ANAR 111,A00,387888,Staff,36,0,36,0
1708249066693,ANAR 115,A00,387889,Shtienberg; Gilad,36,0,36,0
1708249067222,ANAR 120,A00,387890,Staff,36,0,36,0
1708249067746,ANAR 155,A00,387891,Braswell; Geoffrey E.,15,0,25,10
1708249068274,ANAR 164,A00,387892,Staff,32,0,35,3
1708249068799,ANBI 100,A00,489626,Fox; Patrick Keolu Ozer,39,0,40,1
1708249069328,ANBI 111,A00,387893,Hrvoj Mihic; Branka,37,0,40,3
1708249070390,ANBI 144,A00,387896,Wilder; Linnea Lorene,72,0,75,3
1708249070920,ANBI 149,A00,489628,Non; Amy L,0,0,0,0
1708249071449,ANBI 173,A00,387897,Wilder; Linnea Lorene,74,0,75,1
1708249071977,ANBI 174,A00,489627,Strum; Shirley C.,13,0,15,2
1708249072503,ANES 296,001,463968,Gabriel; Rodney A,49,0,50,1
1708249072503,ANES 296,002,463969,Staff,50,0,50,0
1708249072503,ANES 296,003,463970,Staff,50,0,50,0
1708249073028,ANSC 100,A00,387898,Bialecki; Jon Anthony,40,0,40,0
1708249073554,ANSC 101,A00,387900,Sloane; Julia Kathryn,34,0,40,6
1708249074079,ANSC 117,A00,387901,Martin Sandino; Amanda Maria Yoland,13,0,15,2
1708249074607,ANSC 134,A00,387902,Staff,38,0,40,2
1708249075133,ANSC 137,A00,387903,Stewart; Alexander B,80,0,80,0
1708249075663,ANSC 138,A00,387904,Parish; Steven Martin,14,0,15,1
1708249076194,ANSC 142,A00,387905,Stone; Annika Britt,34,0,40,6
1708249076720,ANSC 147,A00,387906,Stewart; Alexander B,40,0,40,0
1708249077251,ANSC 148,A00,387907,Olivas Hernandez; Olga Lid,92,0,92,0
1708249077777,ANSC 186,A00,387910,Hankins; Joseph D.,28,0,30,2
1708249078304,ANTH 2,A01,387863,Marchetto; Maria Carolina,37,0,40,3
1708249078304,ANTH 2,A02,387864,Marchetto; Maria Carolina,40,0,40,0
1708249078304,ANTH 2,A03,387865,Marchetto; Maria Carolina,36,0,40,4
1708249078304,ANTH 2,A04,387866,Marchetto; Maria Carolina,39,0,40,1
1708249078831,ANTH 3,A01,387868,Stroth; Luke Reyneri,28,0,30,2
1708249078831,ANTH 3,A02,387869,Stroth; Luke Reyneri,29,0,30,1
1708249078831,ANTH 3,A03,387870,Stroth; Luke Reyneri,30,0,30,0
1708249078831,ANTH 3,A04,387871,Stroth; Luke Reyneri,29,0,30,1
1708249079357,ANTH 10,A00,387872,Stewart; Alexander B,80,0,80,0
1708249079881,ANTH 21,A01,387874,Stone; Annika Britt,40,0,40,0
1708249079881,ANTH 21,A02,387875,Stone; Annika Britt,40,0,40,0
1708249079881,ANTH 21,A03,387876,Stone; Annika Britt,40,0,40,0
1708249079881,ANTH 21,A04,387877,Stone; Annika Britt,39,0,40,1
1708249080478,ANTH 23,A01,387879,Staff,40,0,40,0
1708249080478,ANTH 23,A02,387880,Staff,40,0,40,0
1708249080478,ANTH 23,A03,387881,Staff,40,0,40,0
1708249080478,ANTH 23,A04,387882,Staff,40,0,40,0
1708249081006,ANTH 24,A00,387883,Pedersen; David,40,0,40,0
1708249081536,ANTH 103,A00,387911,Staff,343,0,350,7
1708249082066,ANTH 105,A00,387912,Staff,73,0,75,2
1708249082598,ANTH 112,A00,387913,Staff,23,0,25,2
1708249083124,ANTH 120,A00,479486,Parish; Steven Martin,28,0,30,2
1708249083651,ANTH 128B,A01,387923,Lewis; Leslie R,12,0,12,0
1708249084176,ANTH 192,A00,387925,Varma; Saiba,20,0,20,0
1708249084707,ANTH 196C,A00,387927,Varma; Saiba,15,0,15,0
1708249085233,ANTH 212,A00,387931,Marchetto; Maria Carolina,25,0,25,0
1708249085233,ANTH 212,B00,479487,Semendeferi; Ekaterini,25,0,25,0
1708249085760,ANTH 220,A00,387932,Csordas; Thomas J.,9,0,12,3
1708249086286,ANTH 230,001,493297,Goldstein; Paul S,18,0,20,2
1708249086815,ANTH 260,A00,479223,Jenkins; Janis A.,25,0,25,0
1708249087346,ANTH 272,A00,387936,Serlin; David,5,0,5,0
1708249087876,ANTH 273,A00,387938,Gates; Kelly,5,0,5,0
1708249088402,ANTH 288,A00,387940,Braswell; Geoffrey E.,25,0,25,0
1708249088953,ANTH 295,001,493298,Algaze; Guillermo,3,0,3,0
1708249088953,ANTH 295,002,493299,Brenner; Suzanne A,3,0,3,0
1708249088953,ANTH 295,003,493300,Csordas; Thomas J.,3,0,3,0
1708249088953,ANTH 295,004,493422,Fox; Patrick Keolu Ozer,3,0,3,0
1708249088953,ANTH 295,005,493472,Gagneux; Pascal,3,0,3,0
1708249088953,ANTH 295,006,493515,Goldstein; Paul S,3,0,3,0
1708249088953,ANTH 295,007,493592,Hankins; Joseph D.,3,0,3,0
1708249088953,ANTH 295,008,493631,Jassal; Aftab,3,0,3,0
1708249088953,ANTH 295,009,493639,Jenkins; Janis A.,3,0,3,0
1708249088953,ANTH 295,010,493657,Kaiser; Bronwyn Nicole,3,0,3,0
1708249088953,ANTH 295,011,493692,Kang; Byung Chu,3,0,3,0
1708249088953,ANTH 295,012,493758,Marchetto; Maria Carolina,3,0,3,0
1708249088953,ANTH 295,013,493761,Non; Amy L,3,0,3,0
1708249088953,ANTH 295,014,493762,Pedersen; David,3,0,3,0
1708249088953,ANTH 295,015,493825,Rivera-Collazo; Isabel C,3,0,3,0
1708249088953,ANTH 295,016,493826,Varma; Saiba,3,0,3,0
1708249088953,ANTH 295,017,493828,Yeh; Rihan Wen Xin,3,0,3,0
1708249089485,ANTH 296,001,493830,Braswell; Geoffrey E.,3,0,3,0
1708249089485,ANTH 296,002,493836,Marchetto; Maria Carolina,3,0,3,0
1708249089485,ANTH 296,003,493838,Rivera-Collazo; Isabel C,3,0,3,0
1708249089485,ANTH 296,004,493840,Varma; Saiba,3,0,3,0
1708249089485,ANTH 296,005,493842,Algaze; Guillermo,3,0,3,0
1708249089485,ANTH 296,006,493845,Brenner; Suzanne A,3,0,3,0
1708249089485,ANTH 296,007,493846,Csordas; Thomas J.,3,0,3,0
1708249089485,ANTH 296,008,493907,Fox; Patrick Keolu Ozer,3,0,3,0
1708249089485,ANTH 296,009,493949,Gagneux; Pascal,3,0,3,0
1708249089485,ANTH 296,010,493960,Goldstein; Paul S,3,0,3,0
1708249089485,ANTH 296,011,493961,Hankins; Joseph D.,3,0,3,0
1708249089485,ANTH 296,012,493962,Jassal; Aftab,3,0,3,0
1708249089485,ANTH 296,013,493963,Jenkins; Janis A.,3,0,3,0
1708249089485,ANTH 296,014,493964,Kaiser; Bronwyn Nicole,3,0,3,0
1708249089485,ANTH 296,015,493965,Kang; Byung Chu,3,0,3,0
1708249089485,ANTH 296,016,493966,Levy; Thomas E,3,0,3,0
1708249089485,ANTH 296,017,493967,Non; Amy L,3,0,3,0
1708249089485,ANTH 296,018,493968,Pedersen; David,3,0,3,0
1708249089485,ANTH 296,019,493969,Postero; Nancy Grey,3,0,3,0
1708249089485,ANTH 296,020,493970,Semendeferi; Ekaterini,3,0,3,0
1708249089485,ANTH 296,021,493971,Yeh; Rihan Wen Xin,3,0,3,0
1708249090013,AUD 236,A00,480192,Harris; Jeffrey Paul,12,0,12,0
1708249090539,AUD 260,A00,480227,Spriggs; Meghan K,12,0,12,0
1708249091064,AUD 272,A00,480367,Zettner; Erika,12,0,12,0
1708249091594,AUD 275,A00,480369,Zettner; Erika,12,0,12,0
1708249092121,AUD 284,A00,480370,Zettner; Erika,12,0,12,0
1708249092121,AUD 284,B00,480372,Spriggs; Meghan K,12,0,12,0
1708249092649,AUD 291,A00,480374,Zettner; Erika,12,0,12,0
1708249093174,AUD 296,A00,480375,Zettner; Erika,12,0,12,0
1708249093174,AUD 296,B00,480376,Harris; Jeffrey Paul,12,0,12,0
1708249093174,AUD 296,C00,480377,Ryan; Allen F.,12,0,12,0
1708249093703,AWP 3,002,387672,Given; William Allan,9,0,9,0
1708249093703,AWP 3,003,387678,Staff,5,0,5,0
1708249093703,AWP 3,004,387681,Staff,0,0,0,0
1708249093703,AWP 3,007,387784,West; Geoffrey Scott,4,0,5,1
1708249093703,AWP 3,009,387786,Kolodezh; Samuel,5,0,5,0
1708249093703,AWP 3,010,387787,Gilbert; Peter W,5,0,5,0
1708249094228,AWP 4A,001,387791,Staff,12,0,12,0
1708249094228,AWP 4A,002,387792,Staff,0,0,0,0
1708249094765,AWP 4B,001,387793,Bolin; Jillian,0,0,0,0
1708249094765,AWP 4B,002,387794,Bolin; Jillian,0,0,0,0
1708249094765,AWP 4B,003,387795,Bauer; Holly Jean,0,0,0,0
1708249094765,AWP 4B,004,387796,Vaughn; Kelsey Sara,0,0,0,0
1708249094765,AWP 4B,005,387797,Vaughn; Kelsey Sara,0,0,0,0
1708249094765,AWP 4B,007,387799,Ajo; Frances Margaret,0,0,0,0
1708249094765,AWP 4B,008,387800,Ajo; Frances Margaret,0,0,0,0
1708249094765,AWP 4B,009,387801,Hall; Graham T,0,0,0,0
1708249094765,AWP 4B,010,387802,Hall; Graham T,0,0,0,0
1708249094765,AWP 4B,011,387803,Heiser; Jerrod A,0,0,0,0
1708249094765,AWP 4B,012,387804,Heiser; Jerrod A,0,0,0,0
1708249094765,AWP 4B,013,387805,Jones; William Jadie,0,0,0,0
1708249094765,AWP 4B,014,387806,Jones; William Jadie,0,0,0,0
1708249094765,AWP 4B,015,387807,Christie; Veronica Ann,0,0,0,0
1708249094765,AWP 4B,016,387808,Christie; Veronica Ann,0,0,0,0
1708249094765,AWP 4B,019,387820,Falcon; Jennifer A,0,0,0,0
1708249094765,AWP 4B,020,387821,Falcon; Jennifer A,0,0,0,0
1708249094765,AWP 4B,021,387822,Eastin; Schuyler E.,0,0,0,0
1708249094765,AWP 4B,023,387824,Coulter; Jane Elisabeth,0,0,0,0
1708249094765,AWP 4B,025,387826,O'Neil; Courtney L,0,0,0,0
1708249094765,AWP 4B,026,387827,O'Neil; Courtney L,0,0,0,0
1708249094765,AWP 4B,027,387828,Tsurska Svetina; Olena,0,0,0,0
1708249094765,AWP 4B,028,387829,Tsurska Svetina; Olena,0,0,0,0
1708249094765,AWP 4B,029,387830,Spicer; Jacqueline,0,0,0,0
1708249094765,AWP 4B,030,387831,Spicer; Jacqueline,0,0,0,0
1708249094765,AWP 4B,031,387832,Steinberg; Stacy A,0,0,0,0
1708249094765,AWP 4B,032,387833,Steinberg; Stacy A,0,0,0,0
1708249094765,AWP 4B,033,387834,Chandler; Bailee Daniele,0,0,0,0
1708249094765,AWP 4B,034,387835,Chandler; Bailee Daniele,0,0,0,0
1708249094765,AWP 4B,035,387836,Tiernan; Christa Michelle,0,0,0,0
1708249094765,AWP 4B,036,387837,Tiernan; Christa Michelle,0,0,0,0
1708249094765,AWP 4B,037,387840,Gardella; Alexander Drew,0,0,0,0
1708249094765,AWP 4B,038,387841,Gardella; Alexander Drew,0,0,0,0
1708249094765,AWP 4B,039,387857,Zimmerman; Guy,0,0,0,0
1708249094765,AWP 4B,040,387858,Zimmerman; Guy,0,0,0,0
1708249094765,AWP 4B,041,387859,Zroka; Amy Liane,0,0,0,0
1708249094765,AWP 4B,042,387860,Zroka; Amy Liane,0,0,0,0
1708249095289,BENG 87,A00,489656,Sah; Robert Lie-Yuan,20,0,20,0
1708249095289,BENG 87,B00,489657,Sah; Robert Lie-Yuan,20,0,20,0
1708249095289,BENG 87,C00,494754,Omens; Jeffrey Howard,20,0,20,0
1708249095816,BENG 100,A01,387959,Alexandrov; Ludmil B,26,0,28,2
1708249095816,BENG 100,A02,387960,Alexandrov; Ludmil B,26,0,28,2
1708249095816,BENG 100,A03,387984,Alexandrov; Ludmil B,26,0,28,2
1708249095816,BENG 100,A04,387985,Alexandrov; Ludmil B,25,0,28,3
1708249095816,BENG 100,A05,387986,Alexandrov; Ludmil B,27,0,28,1
1708249096342,BENG 102,A00,387987,Chapelin; Fanny,55,0,56,1
1708249096873,BENG 103B,A00,387993,Fraley; Stephanie I.,116,0,120,4
1708249097402,BENG 112B,A01,388053,Shi; Lingyan,26,0,30,4
1708249097402,BENG 112B,A02,388054,Shi; Lingyan,29,0,30,1
1708249097931,BENG 125,A00,388055,Hasty; Jeff M,120,0,160,40
1708249098457,BENG 133,A01,388866,Mali; Prashant Gulab Ram,36,0,40,4
1708249098988,BENG 140B,A01,388884,Cabrales; Pedro,28,0,30,2
1708249098988,BENG 140B,A02,388885,Cabrales; Pedro,30,0,30,0
1708249098988,BENG 140B,A03,388886,Cabrales; Pedro,26,0,30,4
1708249099517,BENG 160,A50,388889,Aguado; Brian Alberto,23,0,25,2
1708249099517,BENG 160,A51,388919,Aguado; Brian Alberto,25,0,25,0
1708249099517,BENG 160,A52,388920,Aguado; Brian Alberto,25,0,25,0
1708249100103,BENG 168,A01,388961,Khojah; Reem I,30,0,30,0
1708249100633,BENG 172,A50,389087,Omens; Jeffrey Howard & Cabrales; Pedro,15,0,20,5
1708249100633,BENG 172,A51,389088,Omens; Jeffrey Howard & Cabrales; Pedro,14,0,20,6
1708249101163,BENG 182,A01,389128,Bafna; Vineet,28,0,30,2
1708249101693,BENG 186A,A00,389130,Kwon; Ester Jihae,105,0,120,15
1708249102218,BENG 187A,A00,389289,Taylor Amos; Alyssa C,157,0,170,13
1708249102748,BENG 187D,A00,389290,Taylor Amos; Alyssa C,33,0,60,27
1708249102748,BENG 187D,B00,389300,Taylor Amos; Alyssa C,51,0,60,9
1708249102748,BENG 187D,C00,389302,Taylor Amos; Alyssa C,35,0,60,25
1708249103278,BENG 189,A00,389303,Contijoch; Francisco,26,0,30,4
1708249103804,BENG 193,A00,389328,Engler; Adam J.,0,0,0,0
1708249104333,BENG 196,A00,436038,Engler; Adam J.,9999,0,9999,0
1708249104860,BENG 197,A00,436081,Engler; Adam J.,9999,0,9999,0
1708249105386,BENG 203,A00,389385,Bafna; Vineet & Zhong; Sheng,20,0,20,0
1708249105912,BENG 207,A00,389386,Kwon; Ester Jihae,10,0,40,30
1708249105912,BENG 207,B00,389400,Taylor Amos; Alyssa C,8,0,30,22
1708249105912,BENG 207,C00,389432,Khojah; Reem I,20,0,40,20
1708249106441,BENG 209,A00,389456,Scholtes Acevedo; Claire,30,0,30,0
1708249106966,BENG 213,A00,389496,Palsson; Bernhard O.,16,0,20,4
1708249108019,BENG 224,A00,389515,Staff,0,0,0,0
1708249108549,BENG 226,A01,479043,Schmid-Schoenbein; Geert W,7,0,30,23
1708249109079,BENG 227,A00,389591,Fraley; Stephanie I.,56,0,120,64
1708249109610,BENG 230C,A00,389810,Mc Culloch; Andrew Douglas,43,0,90,47
1708249110134,BENG 232,A01,390161,Sah; Robert Lie-Yuan,6,0,50,44
1708249110660,BENG 233,A00,390290,Shah; Sameer B,33,0,50,17
1708249111193,BENG 234,A00,390291,Silva; Gabriel,21,0,56,35
1708249111720,BENG 235,A00,390318,Bintu; Bogdan,16,0,40,24
1708249112248,BENG 276,A00,390357,Mc Culloch; Andrew Douglas & Amaro; Rommie E,0,0,0,0
1708249112774,BENG 280C,A01,390443,McVeigh; Elliot R.,45,0,56,11
1708249113301,BENG 281,A00,390444,Kravets; Vira V.,50,0,110,60
1708249113827,BENG 283,A00,390445,Komives; Elizabeth A,4,0,4,0
1708249114352,BENG 292,A01,390623,Ross; Camille,20,0,20,0
1708249114877,BENG 294C,A00,390709,Engler; Adam J.,17,0,20,3
1708249115404,BENG 295,A00,436300,Watson; John Thomas,9999,0,9999,0
1708249115933,BGGN 205,A00,423656,Daugherty; Matthew Dorton,47,0,60,13
1708249116458,BGGN 207,A01,423703,Ross; Camille,0,0,0,0
1708249116984,BGGN 215,A00,423704,Petrie; Katherine Lynn,22,0,30,8
1708249117511,BGGN 216,A01,423855,Mueller; Liam O'Connor,37,0,50,13
1708249118036,BGGN 218,A00,423861,David; Michael,19,0,30,11
1708249118562,BGGN 223,A00,423862,Bier; Ethan,17,0,35,18
1708249119093,BGGN 230,A00,423863,Taylor; Susan S.,8,0,15,7
1708249119623,BGGN 232,A00,423864,Briggs; Steven & Troemel; Emily Ruth,25,0,30,5
1708249120154,BGGN 239,A01,424014,Kronenberg; Mitchell E.,30,0,30,0
1708249120684,BGGN 240,A01,424016,Juavinett; Ashley Lauren,0,0,6,6
1708249121211,BGGN 248,A00,424017,Halpain; Shelley,26,0,30,4
1708249121736,BGGN 249C,A00,424052,Staff,33,0,33,0
1708249122262,BGGN 250,A01,424091,Zou; Yimin,7,0,8,1
1708249122793,BGGN 252,A01,424093,Sejnowski; Terrence J,4,0,6,2
1708249123325,BGGN 255,A00,424094,Root; Cory Matthew,29,0,30,1
1708249123855,BGGN 262,A01,424096,Villa Rodriguez; Elizabeth,30,0,30,0
1708249124387,BGGN 267,A01,424099,Benna; Marcus K & Aljadeff; Johnatan,5,0,6,1
1708249124917,BGGN 270,A00,477483,Juavinett; Ashley Lauren,67,0,75,8
1708249125514,BGGN 271,001,481745,Ackerman; Susan,9998,0,9999,1
1708249125514,BGGN 271,002,481746,Akbari; Omar Sultan,9999,0,9999,0
1708249125514,BGGN 271,003,481747,Allen; Nicola J,9999,0,9999,0
1708249125514,BGGN 271,004,481748,Banegas; Matthew Patrick,9999,0,9999,0
1708249125514,BGGN 271,005,481749,Breen; Ellen C.,9998,0,9999,1
1708249125514,BGGN 271,006,481750,Briggs; Steven,9998,0,9999,1
1708249125514,BGGN 271,007,481751,Bui; Jack D,9999,0,9999,0
1708249125514,BGGN 271,008,481762,Busch; Wolfgang,9999,0,9999,0
1708249125514,BGGN 271,009,481763,Castle; Michael James,9999,0,9999,0
1708249125514,BGGN 271,010,481764,Chang; John Tzu-yu,9999,0,9999,0
1708249125514,BGGN 271,011,481765,Chen; Ju,9998,0,9999,1
1708249125514,BGGN 271,012,481766,Chen; Xu,9999,0,9999,0
1708249125514,BGGN 271,013,481767,Cheng; Christine Shiang-Ling,9999,0,9999,0
1708249125514,BGGN 271,014,481768,Cherqui; Stephanie,9999,0,9999,0
1708249125514,BGGN 271,015,481769,Cho; Yoshitake,9999,0,9999,0
1708249125514,BGGN 271,016,481770,Church; Kellie Breen,9998,0,9999,1
1708249125514,BGGN 271,017,481771,Cleland; Elsa Eleanor,9999,0,9999,0
1708249125514,BGGN 271,018,481779,Cohen; Shiran,9998,0,9999,1
1708249125514,BGGN 271,019,481814,Cook-Andersen; Heidi Leigh,9999,0,9999,0
1708249125514,BGGN 271,020,481815,Cooke; James Edward,9999,0,9999,0
1708249125514,BGGN 271,021,481816,Coufal; Nicole Gabriele,9998,0,9999,1
1708249125514,BGGN 271,022,481818,Crotty Alexander; Laura E,9999,0,9999,0
1708249125514,BGGN 271,023,481819,Daugherty; Matthew Dorton,9998,0,9999,1
1708249125514,BGGN 271,024,481820,De Guglielmo; Giordano,9998,0,9999,1
1708249125514,BGGN 271,025,481821,Doherty; Taylor Alan,9998,0,9999,1
1708249125514,BGGN 271,026,481822,Dulawa; Stephanie Carole,9999,0,9999,0
1708249125514,BGGN 271,027,481823,Esko; Jeffrey D.,9998,0,9999,1
1708249125514,BGGN 271,028,481824,Feldstein; Ariel E,9998,0,9999,1
1708249125514,BGGN 271,029,481825,Friedman; Rick Adam,9999,0,9999,0
1708249125514,BGGN 271,030,481826,Furnari; Frank,9999,0,9999,0
1708249125514,BGGN 271,031,481829,Ghosh; Pradipta,9998,0,9999,1
1708249125514,BGGN 271,032,481830,Gleeson; Joseph Gerard,9999,0,9999,0
1708249125514,BGGN 271,033,481831,Golden; Susan S.,9998,0,9999,1
1708249125514,BGGN 271,034,481832,Goren; Alon M,9998,0,9999,1
1708249125514,BGGN 271,035,481834,Gustafsson; Asa Birgitta,9999,0,9999,0
1708249125514,BGGN 271,036,481836,Hamdoun; Amr,9999,0,9999,0
1708249125514,BGGN 271,037,481837,Hao; Nan,9999,0,9999,0
1708249125514,BGGN 271,038,481840,Holway; David A.,9998,0,9999,1
1708249125514,BGGN 271,039,481841,Huffaker; Alisa,9998,0,9999,1
1708249125514,BGGN 271,040,481843,Sebat; Lilia Mikhailovna,9998,0,9999,1
1708249125514,BGGN 271,041,481889,Ideker; Trey,9999,0,9999,0
1708249125514,BGGN 271,042,481890,Jiang; Qingfei,9998,0,9999,1
1708249125514,BGGN 271,043,482311,Jin; Yishi,9999,0,9999,0
1708249125514,BGGN 271,044,482334,Joiner; William J.,9999,0,9999,0
1708249125514,BGGN 271,045,482353,Kaech; Susan Michelle,9998,0,9999,1
1708249125514,BGGN 271,046,482378,Karin; Michael,9999,0,9999,0
1708249125514,BGGN 271,047,482379,Kleinfeld; David,9999,0,9999,0
1708249125514,BGGN 271,048,482413,Koffler; Yacov,9999,0,9999,0
1708249125514,BGGN 271,049,482414,Komiyama; Takaki,9999,0,9999,0
1708249125514,BGGN 271,050,482415,Kryazhimskiy; Sergey A,9999,0,9999,0
1708249125514,BGGN 271,051,482416,Lawson; Mark Andrew,9999,0,9999,0
1708249125514,BGGN 271,052,482417,Lee; Yun Sok,9999,0,9999,0
1708249125514,BGGN 271,053,482451,Leutgeb; Stefan,9998,0,9999,1
1708249125514,BGGN 271,054,482452,Lo; Stanley M.,9999,0,9999,0
1708249125514,BGGN 271,055,482453,Lu; Pengzhe,9998,0,9999,1
1708249125514,BGGN 271,056,482454,Lykke-Andersen; Jens,9998,0,9999,1
1708249125514,BGGN 271,057,482456,McDonnell; Lisa Marie,9999,0,9999,0
1708249125514,BGGN 271,058,482461,McHugh; Colleen A,9998,0,9999,1
1708249125514,BGGN 271,059,482478,Meharena; Hiruy Sibhatu,9999,0,9999,0
1708249125514,BGGN 271,060,482497,Morris; Gerald P,9999,0,9999,0
1708249125514,BGGN 271,061,482499,Mukamel; Eran A,9998,0,9999,1
1708249125514,BGGN 271,062,482535,Muotri; Alysson,9999,0,9999,0
1708249125514,BGGN 271,063,482551,Muroyama; Andrew David,9999,0,9999,0
1708249125514,BGGN 271,064,482552,Neal; Sonya E,9999,0,9999,0
1708249125514,BGGN 271,065,482618,Nieh; James Charles,9999,0,9999,0
1708249125514,BGGN 271,066,482619,O'Donoghue; Anthony John,9999,0,9999,0
1708249125514,BGGN 271,067,482626,Pantham; Priyadarshini,9999,0,9999,0
1708249125514,BGGN 271,068,482633,Parast; Mana,9999,0,9999,0
1708249125514,BGGN 271,069,482634,Perry; Michael William,9999,0,9999,0
1708249125514,BGGN 271,070,482639,Pride; David Tevis,9999,0,9999,0
1708249125514,BGGN 271,071,482645,Pruneda-Paz; Jose L.,9999,0,9999,0
1708249125514,BGGN 271,072,482648,Rana; Tariq,9999,0,9999,0
1708249125514,BGGN 271,073,482650,Risbrough; Victoria Blythe,9999,0,9999,0
1708249125514,BGGN 271,074,482655,Rissman; Robert Andrew,9999,0,9999,0
1708249125514,BGGN 271,075,482656,Rosenfeld; Michael G,9999,0,9999,0
1708249125514,BGGN 271,076,482657,Saier; Milton H.,9999,0,9999,0
1708249125514,BGGN 271,077,482663,Sander; Maike,9999,0,9999,0
1708249125514,BGGN 271,078,482664,Schenk; Simon,9999,0,9999,0
1708249125514,BGGN 271,079,482665,Schoeneberg; Johannes,9998,0,9999,1
1708249125514,BGGN 271,080,482666,Schroeder; Julian I,9998,0,9999,1
1708249125514,BGGN 271,081,482667,Shaner; Nathan C.,9999,0,9999,0
1708249125514,BGGN 271,082,482668,Sheikh; Farah,9999,0,9999,0
1708249125514,BGGN 271,083,482669,Shurin; Jonathan,9999,0,9999,0
1708249125514,BGGN 271,084,482675,Sigurdson; Christina,9999,0,9999,0
1708249125514,BGGN 271,085,482676,Smith; David M.,9999,0,9999,0
1708249125514,BGGN 271,086,482677,Steinmetz; Nicole F,9999,0,9999,0
1708249125514,BGGN 271,087,482692,Su; Chih-Ying,9999,0,9999,0
1708249125514,BGGN 271,088,482694,Suel; Gurol Mehmet,9999,0,9999,0
1708249125514,BGGN 271,089,482695,Telese; Francesca,9999,0,9999,0
1708249125514,BGGN 271,090,482745,Thackray; Varykina G.,9999,0,9999,0
1708249125514,BGGN 271,091,482746,Towers; Christina Garlingt,9999,0,9999,0
1708249125514,BGGN 271,092,482747,Troemel; Emily Ruth,9997,0,9999,2
1708249125514,BGGN 271,093,482748,Tye; Kay M,9999,0,9999,0
1708249125514,BGGN 271,094,482749,Valdez-Jasso; Daniela,9998,0,9999,1
1708249125514,BGGN 271,095,482750,Wahlin; Karl Jonas,9997,0,9999,2
1708249125514,BGGN 271,096,482751,Welsbie; Derek,9999,0,9999,0
1708249125514,BGGN 271,097,482752,Wilkinson; Miles Frome,9999,0,9999,0
1708249125514,BGGN 271,098,482754,Yaksh; Tony L.,9999,0,9999,0
1708249125514,BGGN 271,099,482760,Yang; Jing,9999,0,9999,0
1708249125514,BGGN 271,100,482761,Yeo; Eugene Wei-Ming,9998,0,9999,1
1708249125514,BGGN 271,101,482763,Ying; Wei,9999,0,9999,0
1708249125514,BGGN 271,102,482764,Zarrinpar; Amir,9999,0,9999,0
1708249125514,BGGN 271,103,482765,Zengler; Karsten B,9999,0,9999,0
1708249125514,BGGN 271,104,482766,Zhang; Dong-Er,9999,0,9999,0
1708249125514,BGGN 271,105,482768,Zhao; Yunde,9999,0,9999,0
1708249125514,BGGN 271,106,482776,Zheng; Binhai,9999,0,9999,0
1708249125514,BGGN 271,107,482777,Zheng; Ye,9998,0,9999,1
1708249125514,BGGN 271,108,482806,Zuniga; Elina I,9999,0,9999,0
1708249126044,BGGN 273,A01,424101,Mueller; Liam O'Connor,43,0,50,7
1708249126570,BGGN 280,A00,424102,Ernst; Andreas,3,0,5,2
1708249126570,BGGN 280,C00,481361,Amaro; Rommie E,2,0,5,3
1708249127102,BGGN 281,A00,424103,Desai; Arshad & Oegema; Karen,0,0,5,5
1708249127628,BGGN 283,A00,424104,Rivera; Fabian Chavez,0,0,5,5
1708249127628,BGGN 283,B00,424105,Russell; Alistair B,4,0,5,1
1708249127628,BGGN 283,D00,424107,Wildonger; Jill Cathleen,1,0,5,4
1708249128155,BGGN 284,A00,424108,Glasgow; Stacey Marie,2,0,5,3
1708249128681,BGGN 285,A00,424109,Chisholm; Andrew D.,1,0,5,4
1708249128681,BGGN 285,B00,424110,Farley; Emma Kristen,2,0,5,3
1708249129213,BGGN 295,A00,424120,Tour; Ella,10,0,30,20
1708249129739,BGJC 204,A00,424138,Lu; Li-Fan & Chang; John Tzu-yu,9998,0,9999,1
1708249130266,BGJC 215,A00,424139,Cooke; James Edward & Lo; Stanley M.,10,0,10,0
1708249130812,BGRD 200,001,485528,Ackerman; Susan,9998,0,9999,1
1708249130812,BGRD 200,002,485529,Akbari; Omar Sultan,9999,0,9999,0
1708249130812,BGRD 200,003,485530,Allen; Eric,9999,0,9999,0
1708249130812,BGRD 200,004,485531,Allen; Nicola J,9999,0,9999,0
1708249130812,BGRD 200,005,485533,Amaro; Rommie E,9999,0,9999,0
1708249130812,BGRD 200,006,485535,Augustine; Vineet,9999,0,9999,0
1708249130812,BGRD 200,007,485536,Ayres; Janelle Samantha,9999,0,9999,0
1708249130812,BGRD 200,008,485538,Banegas; Matthew Patrick,9999,0,9999,0
1708249130812,BGRD 200,009,485539,Banghart; Matthew Ryan,9999,0,9999,0
1708249130812,BGRD 200,010,485542,Benna; Marcus K,9999,0,9999,0
1708249130812,BGRD 200,011,485543,Bennett; Eric J,9999,0,9999,0
1708249130812,BGRD 200,012,485545,Bloodgood; Brenda Laurie,9999,0,9999,0
1708249130812,BGRD 200,013,485546,Breen; Ellen C.,9998,0,9999,1
1708249130812,BGRD 200,014,485548,Briggs; Steven,9998,0,9999,1
1708249130812,BGRD 200,015,485549,Bui; Jack D,9999,0,9999,0
1708249130812,BGRD 200,016,485552,Busch; Wolfgang,9999,0,9999,0
1708249130812,BGRD 200,017,485621,Callaway; Edward M,9999,0,9999,0
1708249130812,BGRD 200,018,485622,Castle; Michael James,9999,0,9999,0
1708249130812,BGRD 200,019,485623,Chaim; Isaac,9999,0,9999,0
1708249130812,BGRD 200,020,485624,Chang; John Tzu-yu,9999,0,9999,0
1708249130812,BGRD 200,021,485625,Chen; Ju,9999,0,9999,0
1708249130812,BGRD 200,022,485626,Chen; Xu,9999,0,9999,0
1708249130812,BGRD 200,023,485627,Cheng; Christine Shiang-Ling,9999,0,9999,0
1708249130812,BGRD 200,024,485632,Cherqui; Stephanie,9999,0,9999,0
1708249130812,BGRD 200,025,485633,Cho; Yoshitake,9999,0,9999,0
1708249130812,BGRD 200,026,485634,Church; Kellie Breen,9999,0,9999,0
1708249130812,BGRD 200,027,485635,Cleland; Elsa Eleanor,9999,0,9999,0
1708249130812,BGRD 200,028,485636,Cohen; Shiran,9998,0,9999,1
1708249130812,BGRD 200,029,485639,Cook-Andersen; Heidi Leigh,9999,0,9999,0
1708249130812,BGRD 200,030,485686,Cooke; James Edward,9999,0,9999,0
1708249130812,BGRD 200,031,485688,Cooper; Kimberly Lynn,9999,0,9999,0
1708249130812,BGRD 200,032,485689,Coufal; Nicole Gabriele,9998,0,9999,1
1708249130812,BGRD 200,033,485690,Crotty Alexander; Laura E,9999,0,9999,0
1708249130812,BGRD 200,034,485691,Staff,9999,0,9999,0
1708249130812,BGRD 200,035,485692,De Guglielmo; Giordano,9999,0,9999,0
1708249130812,BGRD 200,036,485693,De Silva; Shermin,9999,0,9999,0
1708249130812,BGRD 200,037,485694,Desai; Arshad,9999,0,9999,0
1708249130812,BGRD 200,038,485695,Dickinson; Alexandra Jazz,9999,0,9999,0
1708249130812,BGRD 200,039,485717,Doherty; Taylor Alan,9998,0,9999,1
1708249130812,BGRD 200,040,485720,Dulawa; Stephanie Carole,9999,0,9999,0
1708249130812,BGRD 200,041,485721,Ecker; Joseph R,9999,0,9999,0
1708249130812,BGRD 200,042,485760,Engle; Dannielle D,9999,0,9999,0
1708249130812,BGRD 200,043,485761,Ernst; Andreas,9998,0,9999,1
1708249130812,BGRD 200,044,485766,Esko; Jeffrey D.,9998,0,9999,1
1708249130812,BGRD 200,045,485905,Evans; Ronald M,9999,0,9999,0
1708249130812,BGRD 200,046,485907,Staff,9999,0,9999,0
1708249130812,BGRD 200,047,485918,Feldstein; Ariel E,9998,0,9999,1
1708249130812,BGRD 200,048,485938,Friedman; Rick Adam,9999,0,9999,0
1708249130812,BGRD 200,049,485986,Furnari; Frank,9999,0,9999,0
1708249130812,BGRD 200,050,486018,Gage; Fred H,9999,0,9999,0
1708249130812,BGRD 200,051,486139,George; Monique Leana,9999,0,9999,0
1708249130812,BGRD 200,052,486140,Ghosh; Pradipta,9998,0,9999,1
1708249130812,BGRD 200,053,486141,Glass; Christopher,9998,0,9999,1
1708249130812,BGRD 200,054,486142,Gleeson; Joseph Gerard,9999,0,9999,0
1708249130812,BGRD 200,055,486143,Golden; Susan S.,9999,0,9999,0
1708249130812,BGRD 200,056,486144,Goldrath; Ananda,9999,0,9999,0
1708249130812,BGRD 200,057,486145,Goren; Alon M,9998,0,9999,1
1708249130812,BGRD 200,058,486146,Gustafsson; Asa Birgitta,9999,0,9999,0
1708249130812,BGRD 200,059,486164,Gutkind; Jorge Silvio,9999,0,9999,0
1708249130812,BGRD 200,060,486203,Hamdoun; Amr,9999,0,9999,0
1708249130812,BGRD 200,061,486204,Hampton; Randolph Y.,9999,0,9999,0
1708249130812,BGRD 200,062,486205,Hao; Nan,9999,0,9999,0
1708249130812,BGRD 200,063,486206,Staff,9999,0,9999,0
1708249130812,BGRD 200,064,486207,Hasty; Jeff M,9999,0,9999,0
1708249130812,BGRD 200,065,486208,Hollern; Daniel Patrick,9999,0,9999,0
1708249130812,BGRD 200,066,486209,Holway; David A.,9997,0,9999,2
1708249130812,BGRD 200,067,486214,Huffaker; Alisa,9998,0,9999,1
1708249130812,BGRD 200,068,486215,Hui; Enfu,9999,0,9999,0
1708249130812,BGRD 200,069,486216,Hwa; Terence T.,9999,0,9999,0
1708249130812,BGRD 200,070,486217,Sebat; Lilia Mikhailovna,9998,0,9999,1
1708249130812,BGRD 200,071,486218,Ideker; Trey,9999,0,9999,0
1708249130812,BGRD 200,072,486219,Jackrel; Sara,9998,0,9999,1
1708249130812,BGRD 200,073,486224,Jiang; Qingfei,9998,0,9999,1
1708249130812,BGRD 200,074,486225,Jin; Yishi,9999,0,9999,0
1708249130812,BGRD 200,075,486226,Joiner; William J.,9999,0,9999,0
1708249130812,BGRD 200,076,486227,Jun; Suckjoon,9999,0,9999,0
1708249130812,BGRD 200,077,486228,Kadonaga; James T,9998,0,9999,1
1708249130812,BGRD 200,078,486229,Kaech; Susan Michelle,9997,0,9999,2
1708249130812,BGRD 200,079,486237,Karin; Michael,9999,0,9999,0
1708249130812,BGRD 200,080,486238,Kleinfeld; David,9999,0,9999,0
1708249130812,BGRD 200,081,486239,Knight; Robin,9999,0,9999,0
1708249130812,BGRD 200,082,486335,Koffler; Yacov,9999,0,9999,0
1708249130812,BGRD 200,083,486336,Komiyama; Takaki,9999,0,9999,0
1708249130812,BGRD 200,084,486337,Kosuri; Pallav,9999,0,9999,0
1708249130812,BGRD 200,085,486353,Kryazhimskiy; Sergey A,9999,0,9999,0
1708249130812,BGRD 200,086,486354,Kurle; Carolyn M.,9999,0,9999,0
1708249130812,BGRD 200,087,486355,Law; Julie A,9999,0,9999,0
1708249130812,BGRD 200,088,486356,Lawson; Mark Andrew,9999,0,9999,0
1708249130812,BGRD 200,089,486357,Lee; Kuo Fen,9999,0,9999,0
1708249130812,BGRD 200,090,486376,Lee; Yun Sok,9999,0,9999,0
1708249130812,BGRD 200,091,486413,Leutgeb; Jill K.,9999,0,9999,0
1708249130812,BGRD 200,092,486414,Leutgeb; Stefan,9998,0,9999,1
1708249130812,BGRD 200,093,486415,Lim; Byungkook,9999,0,9999,0
1708249130812,BGRD 200,094,486419,Lo; Stanley M.,9999,0,9999,0
1708249130812,BGRD 200,095,486420,Looger; Loren Lee,9999,0,9999,0
1708249130812,BGRD 200,096,486422,Lovett-Barron; Matthew Rod,9999,0,9999,0
1708249130812,BGRD 200,097,486423,Lu; Li-Fan,9998,0,9999,1
1708249130812,BGRD 200,098,486424,Lu; Pengzhe,9998,0,9999,1
1708249130812,BGRD 200,099,486425,Lykke-Andersen; Jens,9998,0,9999,1
1708249130812,BGRD 200,100,486426,Lyumkis; Dmitry Evgenievich,9999,0,9999,0
1708249130812,BGRD 200,101,486427,Madigan; Cressida Ariana,9999,0,9999,0
1708249130812,BGRD 200,102,486428,Staff,9999,0,9999,0
1708249130812,BGRD 200,103,486429,Mayfield; Stephen P.,9998,0,9999,1
1708249130812,BGRD 200,104,486430,McDonnell; Lisa Marie,9999,0,9999,0
1708249130812,BGRD 200,105,486620,McHugh; Colleen A,9998,0,9999,1
1708249130812,BGRD 200,106,486621,Meharena; Hiruy Sibhatu,9999,0,9999,0
1708249130812,BGRD 200,107,486622,Staff,9999,0,9999,0
1708249130812,BGRD 200,108,486681,Morris; Gerald P,9999,0,9999,0
1708249130812,BGRD 200,109,486682,Mukamel; Eran A,9998,0,9999,1
1708249130812,BGRD 200,110,486683,Muotri; Alysson,9999,0,9999,0
1708249130812,BGRD 200,111,486684,Muroyama; Andrew David,9999,0,9999,0
1708249130812,BGRD 200,112,486687,Murre; Cornelis,9999,0,9999,0
1708249130812,BGRD 200,113,486691,Neal; Sonya E,9999,0,9999,0
1708249130812,BGRD 200,114,486692,Nieh; James Charles,9998,0,9999,1
1708249130812,BGRD 200,115,486693,Nimmerjahn; Axel,9999,0,9999,0
1708249130812,BGRD 200,116,486694,Nizet; Victor F.,9999,0,9999,0
1708249130812,BGRD 200,117,486695,O'Donoghue; Anthony John,9999,0,9999,0
1708249130812,BGRD 200,118,486706,Oegema; Karen,9999,0,9999,0
1708249130812,BGRD 200,119,486708,O'Shea; Clodagh,9999,0,9999,0
1708249130812,BGRD 200,120,486709,Pantham; Priyadarshini,9999,0,9999,0
1708249130812,BGRD 200,121,486715,Parast; Mana,9999,0,9999,0
1708249130812,BGRD 200,122,486716,Pasquinelli; Amy,9998,0,9999,1
1708249130812,BGRD 200,123,486718,Pekkurnaz Banghart; Gulcin,9999,0,9999,0
1708249130812,BGRD 200,124,486720,Perry; Michael William,9999,0,9999,0
1708249130812,BGRD 200,125,486721,Pfaff; Samuel,9999,0,9999,0
1708249130812,BGRD 200,126,486723,Pogliano; Joseph,9999,0,9999,0
1708249130812,BGRD 200,127,486724,Pogliano; Kit J.,9999,0,9999,0
1708249130812,BGRD 200,128,486727,Pride; David Tevis,9999,0,9999,0
1708249130812,BGRD 200,129,486728,Pruneda-Paz; Jose L.,9999,0,9999,0
1708249130812,BGRD 200,130,486733,Staff,9999,0,9999,0
1708249130812,BGRD 200,131,486734,Rana; Tariq,9999,0,9999,0
1708249130812,BGRD 200,132,486736,Reck-Peterson; Samara L,9999,0,9999,0
1708249130812,BGRD 200,133,486738,Rennison; Diana,9999,0,9999,0
1708249130812,BGRD 200,134,486741,Rifkin; Scott,9999,0,9999,0
1708249130812,BGRD 200,135,486743,Risbrough; Victoria Blythe,9999,0,9999,0
1708249130812,BGRD 200,136,486749,Rissman; Robert Andrew,9999,0,9999,0
1708249130812,BGRD 200,137,486750,Rivera; Fabian Chavez,9999,0,9999,0
1708249130812,BGRD 200,138,486753,Root; Cory Matthew,9999,0,9999,0
1708249130812,BGRD 200,139,486760,Rosenfeld; Michael G,9998,0,9999,1
1708249130812,BGRD 200,140,486763,Russell; Alistair B,9999,0,9999,0
1708249130812,BGRD 200,141,486766,Saier; Milton H.,9999,0,9999,0
1708249130812,BGRD 200,142,486768,Sander; Maike,9999,0,9999,0
1708249130812,BGRD 200,143,486770,Saphire; Erica Ollmann,9999,0,9999,0
1708249130812,BGRD 200,144,486771,Schenk; Simon,9999,0,9999,0
1708249130812,BGRD 200,145,486774,Schoeneberg; Johannes,9999,0,9999,0
1708249130812,BGRD 200,146,486777,Schroeder; Julian I,9998,0,9999,1
1708249130812,BGRD 200,147,486783,Shah; Sameer B,9999,0,9999,0
1708249130812,BGRD 200,148,486784,Shaner; Nathan C.,9999,0,9999,0
1708249130812,BGRD 200,149,486785,Shaw; Reuben,9999,0,9999,0
1708249130812,BGRD 200,150,486786,Sheikh; Farah,9999,0,9999,0
1708249130812,BGRD 200,151,486787,Staff,9999,0,9999,0
1708249130812,BGRD 200,152,486788,Signer; Robert,9999,0,9999,0
1708249130812,BGRD 200,153,486789,Sigurdson; Christina,9999,0,9999,0
1708249130812,BGRD 200,154,486790,Smith; David M.,9999,0,9999,0
1708249130812,BGRD 200,155,486791,Soncin; Francesca,9999,0,9999,0
1708249130812,BGRD 200,156,486792,Steinmetz; Nicole F,9999,0,9999,0
1708249130812,BGRD 200,157,486793,Su; Chih-Ying,9999,0,9999,0
1708249130812,BGRD 200,158,486794,Suel; Gurol Mehmet,9999,0,9999,0
1708249130812,BGRD 200,159,486795,Sun; Xin,9999,0,9999,0
1708249130812,BGRD 200,160,486796,Telese; Francesca,9999,0,9999,0
1708249130812,BGRD 200,161,486797,Thackray; Varykina G.,9999,0,9999,0
1708249130812,BGRD 200,162,486798,Towers; Christina Garlingt,9999,0,9999,0
1708249130812,BGRD 200,163,486799,Traver; David,9999,0,9999,0
1708249130812,BGRD 200,164,486800,Troemel; Emily Ruth,9998,0,9999,1
1708249130812,BGRD 200,165,486801,Tye; Kay M,9999,0,9999,0
1708249130812,BGRD 200,166,486802,Valdez-Jasso; Daniela,9998,0,9999,1
1708249130812,BGRD 200,167,486803,Vijayanand; Pandurangan,9999,0,9999,0
1708249130812,BGRD 200,168,486804,Villa Rodriguez; Elizabeth,9999,0,9999,0
1708249130812,BGRD 200,169,486805,Wahlin; Karl Jonas,9997,0,9999,2
1708249130812,BGRD 200,170,486806,Wang; Jean Yin Jen,9999,0,9999,0
1708249130812,BGRD 200,171,486807,Welsbie; Derek,9999,0,9999,0
1708249130812,BGRD 200,172,486808,Wildonger; Jill Cathleen,9998,0,9999,1
1708249130812,BGRD 200,173,486809,Wilkinson; Miles Frome,9999,0,9999,0
1708249130812,BGRD 200,174,486810,Winzeler; Elizabeth A,9999,0,9999,0
1708249130812,BGRD 200,175,486811,Yaksh; Tony L.,9999,0,9999,0
1708249130812,BGRD 200,176,486812,Yang; Jing,9999,0,9999,0
1708249130812,BGRD 200,177,486813,Staff,9999,0,9999,0
1708249130812,BGRD 200,178,486814,Yeo; Eugene Wei-Ming,9998,0,9999,1
1708249130812,BGRD 200,179,486815,Ying; Wei,9999,0,9999,0
1708249130812,BGRD 200,180,486816,Zarrinpar; Amir,9999,0,9999,0
1708249130812,BGRD 200,181,486817,Zengler; Karsten B,9999,0,9999,0
1708249130812,BGRD 200,182,486818,Zhang; Dong-Er,9999,0,9999,0
1708249130812,BGRD 200,183,486819,Zhao; Yunde,9999,0,9999,0
1708249130812,BGRD 200,184,486820,Zheng; Binhai,9999,0,9999,0
1708249130812,BGRD 200,185,486821,Zheng; Ye,9998,0,9999,1
1708249130812,BGRD 200,186,486822,Zuniga; Elina I,9999,0,9999,0
1708249131342,BGSE 200,A00,424140,Tour; Ella & Petrie; Katherine Lynn,9995,0,9999,4
1708249131872,BGSE 205,A00,424177,Bennett; Eric J,49,0,50,1
1708249131872,BGSE 205,B00,424179,Bennett; Eric J,48,0,50,2
1708249131872,BGSE 205,C00,424182,Bennett; Eric J,47,0,50,3
1708249131872,BGSE 205,D00,424184,Bennett; Eric J,46,0,50,4
1708249131872,BGSE 205,E00,424185,Bennett; Eric J,50,0,50,0
1708249132405,BIBC 100,A01,425401,Corbett; Kevin Daniel,150,0,158,8
1708249132405,BIBC 100,B01,477769,Amaro; Rommie E,156,0,158,2
1708249132938,BIBC 102,A01,425425,Bozinovic; Goran,255,0,256,1
1708249132938,BIBC 102,B01,425440,Hampton; Randolph Y.,250,0,256,6
1708249132938,BIBC 102,C01,486849,Flagg; Matthew Paul,62,0,120,58
1708249133465,BIBC 103,A01,425476,Grossman; Emily N,17,0,24,7
1708249133465,BIBC 103,A02,425509,Grossman; Emily N,21,0,24,3
1708249133465,BIBC 103,A03,425530,Grossman; Emily N,18,0,24,6
1708249133465,BIBC 103,A04,425536,Grossman; Emily N,22,0,24,2
1708249133465,BIBC 103,B01,425538,Boumechache; Miyyada,20,0,24,4
1708249133465,BIBC 103,B02,425539,Boumechache; Miyyada,24,0,24,0
1708249133465,BIBC 103,B03,425548,Boumechache; Miyyada,24,0,24,0
1708249133465,BIBC 103,B04,425549,Boumechache; Miyyada,24,0,24,0
1708249133991,BIBC 120,A01,425592,Coleman; Aaron B.,242,0,256,14
1708249134518,BIBC 194,A00,425609,Ernst; Andreas,21,0,27,6
1708249134518,BIBC 194,B00,477632,Saier; Milton H.,26,0,27,1
1708249134518,BIBC 194,C00,481360,Amaro; Rommie E,23,0,27,4
1708249134518,BIBC 194,D00,486852,Flagg; Matthew Paul,21,0,32,11
1708249135056,BICD 100,A01,470377,Troemel; Emily Ruth,127,0,128,1
1708249135056,BICD 100,A02,470378,Troemel; Emily Ruth,126,0,128,2
1708249135056,BICD 100,B01,470409,Reinagel; Pam,59,0,64,5
1708249135056,BICD 100,B02,470413,Reinagel; Pam,62,0,64,2
1708249135056,BICD 100,B03,470464,Reinagel; Pam,64,0,64,0
1708249135056,BICD 100,B04,470468,Reinagel; Pam,63,0,64,1
1708249135056,BICD 100,C01,470469,Beyhan; Sinem,51,0,64,13
1708249135056,BICD 100,C02,470605,Beyhan; Sinem,58,0,64,6
1708249135056,BICD 100,C03,470606,Beyhan; Sinem,60,0,64,4
1708249135056,BICD 100,C04,470607,Beyhan; Sinem,63,0,64,1
1708249135056,BICD 100,D01,477465,Nguyen; Vu Quang,158,0,160,2
1708249135583,BICD 100R,A01,425674,Smith; Laurie,29,0,34,5
1708249135583,BICD 100R,A02,425675,Smith; Laurie,30,0,34,4
1708249135583,BICD 100R,A03,425676,Smith; Laurie,30,0,34,4
1708249136111,BICD 104,A01,425696,Greenspan; Ralph J.,60,0,64,4
1708249136642,BICD 110,A01,470608,Muroyama; Andrew David,264,0,275,11
1708249136642,BICD 110,B01,425721,Ernst; Andreas,245,0,275,30
1708249137169,BICD 112,A01,458177,Cooper; Kimberly Lynn & Traver; David,10,0,32,22
1708249137169,BICD 112,A02,458180,Cooper; Kimberly Lynn & Traver; David,28,0,32,4
1708249137699,BICD 123,A01,425725,Zhao; Yunde,24,0,32,8
1708249138225,BICD 140,A01,425728,Lu; Li-Fan,227,0,240,13
1708249138758,BICD 158,A01,425730,Bier; Ethan,136,0,145,9
1708249139284,BICD 194,A00,425731,Desai; Arshad & Oegema; Karen,18,0,27,9
1708249139284,BICD 194,B00,481735,Wilhelm; James E.,29,0,32,3
1708249139815,BIEB 121,A00,425732,Butler; Shannon Rhey,21,0,32,11
1708249139815,BIEB 121,B00,425733,Butler; Shannon Rhey,24,0,32,8
1708249140340,BIEB 130,A01,425735,Kurle; Carolyn M.,243,0,295,52
1708249140870,BIEB 146,A01,425737,Petrie; Katherine Lynn,366,0,395,29
1708249141397,BIEB 148,A01,470637,Rose; Noah Hartmann,59,0,63,4
1708249141397,BIEB 148,A02,470638,Rose; Noah Hartmann,61,0,63,2
1708249141928,BIEB 154,A01,458184,Stockwell; Sarah R,29,0,30,1
1708249141928,BIEB 154,A02,458186,Stockwell; Sarah R,29,0,30,1
1708249142458,BIEB 176,A01,425741,De Silva; Shermin,56,0,64,8
1708249142985,BIEB 182,A01,458194,Roy; Kaustuv,25,0,32,7
1708249142985,BIEB 182,A02,458215,Roy; Kaustuv,31,0,32,1
1708249143514,BILD 1,A01,424267,Patrick; Gentry,249,0,250,1
1708249143514,BILD 1,B01,424272,Burg; Michael,231,0,250,19
1708249143514,BILD 1,C01,424293,Pickett; Brooke Elizabeth,245,0,250,5
1708249143514,BILD 1,D01,458292,Gonzalez Gamboa; Ivonne,48,0,50,2
1708249143514,BILD 1,D02,458295,Gonzalez Gamboa; Ivonne,50,0,50,0
1708249143514,BILD 1,D03,458296,Gonzalez Gamboa; Ivonne,50,0,50,0
1708249143514,BILD 1,D04,458297,Gonzalez Gamboa; Ivonne,49,0,50,1
1708249143514,BILD 1,D05,458303,Gonzalez Gamboa; Ivonne,50,0,50,0
1708249144045,BILD 2,A01,458304,Reyes Gonzalez; Catalina,53,0,56,3
1708249144045,BILD 2,A02,458307,Reyes Gonzalez; Catalina,55,0,56,1
1708249144045,BILD 2,A03,458313,Reyes Gonzalez; Catalina,55,0,56,1
1708249144045,BILD 2,A04,458320,Reyes Gonzalez; Catalina,56,0,56,0
1708249144045,BILD 2,B01,458324,Reyes Gonzalez; Catalina,47,0,56,9
1708249144045,BILD 2,B02,458327,Reyes Gonzalez; Catalina,54,0,56,2
1708249144045,BILD 2,B03,458339,Reyes Gonzalez; Catalina,56,0,56,0
1708249144045,BILD 2,B04,458340,Reyes Gonzalez; Catalina,56,0,56,0
1708249144045,BILD 2,C01,458387,Park; Ji Young,44,0,49,5
1708249144045,BILD 2,C02,458544,Park; Ji Young,46,0,49,3
1708249144045,BILD 2,C03,458557,Park; Ji Young,47,0,49,2
1708249144045,BILD 2,C04,458563,Park; Ji Young,46,0,49,3
1708249144572,BILD 3,A01,424312,Hammond; LaTisha Marie,331,0,350,19
1708249144572,BILD 3,B01,470107,Stockwell; Sarah R,66,0,70,4
1708249144572,BILD 3,B02,470110,Stockwell; Sarah R,70,0,70,0
1708249144572,BILD 3,B03,470116,Stockwell; Sarah R,70,0,70,0
1708249144572,BILD 3,B04,470123,Stockwell; Sarah R,67,0,70,3
1708249144572,BILD 3,B05,470150,Stockwell; Sarah R,70,0,70,0
1708249144572,BILD 3,C01,470159,Cooper; Kimberly Lynn,67,0,70,3
1708249144572,BILD 3,C02,470160,Cooper; Kimberly Lynn,69,0,70,1
1708249144572,BILD 3,C03,470164,Cooper; Kimberly Lynn,70,0,70,0
1708249144572,BILD 3,C04,470165,Cooper; Kimberly Lynn,69,0,70,1
1708249144572,BILD 3,C05,470374,Cooper; Kimberly Lynn,68,0,70,2
1708249145103,BILD 4,A01,424318,Staff,22,0,24,2
1708249145103,BILD 4,A02,424324,Staff,24,0,24,0
1708249145103,BILD 4,A03,424325,Staff,24,0,24,0
1708249145103,BILD 4,A04,424326,Staff,22,0,24,2
1708249145103,BILD 4,A05,424327,Staff,24,0,24,0
1708249145103,BILD 4,A06,424330,Staff,24,0,24,0
1708249145103,BILD 4,A07,424331,Staff,24,0,24,0
1708249145103,BILD 4,A08,424342,Staff,24,0,24,0
1708249145103,BILD 4,B01,424462,Pickett; Brooke Elizabeth,23,0,24,1
1708249145103,BILD 4,B02,424466,Pickett; Brooke Elizabeth,24,0,24,0
1708249145103,BILD 4,B03,424469,Pickett; Brooke Elizabeth,23,0,24,1
1708249145103,BILD 4,B04,424470,Pickett; Brooke Elizabeth,22,0,24,2
1708249145103,BILD 4,B05,424700,Pickett; Brooke Elizabeth,23,0,24,1
1708249145103,BILD 4,B06,424723,Pickett; Brooke Elizabeth,24,0,24,0
1708249145103,BILD 4,B07,424730,Pickett; Brooke Elizabeth,24,0,24,0
1708249145103,BILD 4,B08,424929,Pickett; Brooke Elizabeth,22,0,24,2
1708249145103,BILD 4,C01,424947,Gonzalez Gamboa; Ivonne,22,0,24,2
1708249145103,BILD 4,C02,424951,Gonzalez Gamboa; Ivonne,23,0,24,1
1708249145103,BILD 4,C03,424991,Gonzalez Gamboa; Ivonne,23,0,24,1
1708249145103,BILD 4,C04,424993,Gonzalez Gamboa; Ivonne,24,0,24,0
1708249145103,BILD 4,C05,424994,Gonzalez Gamboa; Ivonne,24,0,24,0
1708249145103,BILD 4,C06,425209,Gonzalez Gamboa; Ivonne,24,0,24,0
1708249145103,BILD 4,C07,425233,Gonzalez Gamboa; Ivonne,24,0,24,0
1708249145103,BILD 4,C08,425247,Gonzalez Gamboa; Ivonne,24,0,24,0
1708249145629,BILD 60,A01,425326,Hammond; LaTisha Marie,62,0,64,2
1708249146155,BILD 83,A00,425347,Pogliano; Joseph,25,0,30,5
1708249146686,BILD 87,A00,425368,Saier; Milton H.,20,0,20,0
1708249147217,BIMM 100,A01,425744,Cooper; Andrew Michael,303,0,320,17
1708249147217,BIMM 100,B01,425746,Cooper; Andrew Michael,315,0,320,5
1708249147770,BIMM 101,A01,425748,McDonnell; Lisa Marie,8,0,24,16
1708249147770,BIMM 101,A02,425749,McDonnell; Lisa Marie,23,0,24,1
1708249147770,BIMM 101,B01,425751,Day; Christopher D,22,0,24,2
1708249147770,BIMM 101,B02,425752,Day; Christopher D,24,0,24,0
1708249147770,BIMM 101,B03,425753,Day; Christopher D,22,0,24,2
1708249147770,BIMM 101,B04,425754,Day; Christopher D,24,0,24,0
1708249147770,BIMM 101,C01,425756,Rusert; Jessica Marie,16,0,24,8
1708249147770,BIMM 101,C02,425757,Rusert; Jessica Marie,23,0,24,1
1708249147770,BIMM 101,C03,425758,Rusert; Jessica Marie,23,0,24,1
1708249147770,BIMM 101,C04,425759,Rusert; Jessica Marie,23,0,24,1
1708249148302,BIMM 110,A01,425764,Niwa; Maho,55,0,56,1
1708249148302,BIMM 110,A02,425765,Niwa; Maho,56,0,56,0
1708249148302,BIMM 110,A03,425766,Niwa; Maho,56,0,56,0
1708249148302,BIMM 110,A04,425767,Niwa; Maho,55,0,56,1
1708249148829,BIMM 116R,A01,425771,Golden; Susan S. & Gorman; Michael R.,55,0,72,17
1708249148829,BIMM 116R,A02,425772,Golden; Susan S. & Gorman; Michael R.,53,0,72,19
1708249148829,BIMM 116R,A03,425773,Golden; Susan S. & Gorman; Michael R.,66,0,72,6
1708249148829,BIMM 116R,A04,425774,Golden; Susan S. & Gorman; Michael R.,70,0,72,2
1708249149361,BIMM 118,A01,425779,David; Michael,83,0,96,13
1708249149887,BIMM 120,A01,425792,Pirino; Giorgia,203,0,216,13
1708249149887,BIMM 120,B01,470639,Saier; Milton H.,201,0,216,15
1708249150415,BIMM 121,A01,425830,Gustafson-Brown; Cindy,18,0,24,6
1708249150415,BIMM 121,A02,425831,Gustafson-Brown; Cindy,21,0,24,3
1708249150415,BIMM 121,A03,425832,Gustafson-Brown; Cindy,24,0,24,0
1708249150415,BIMM 121,A04,425833,Gustafson-Brown; Cindy,23,0,24,1
1708249150415,BIMM 121,B01,425835,Pirino; Giorgia,18,0,24,6
1708249150415,BIMM 121,B02,425836,Pirino; Giorgia,24,0,24,0
1708249150415,BIMM 121,C01,425838,Park; Ji Young,6,0,24,18
1708249150415,BIMM 121,C02,425839,Park; Ji Young,20,0,24,4
1708249150941,BIMM 134,A01,425841,Burg; Michael,393,0,416,23
1708249151469,BIMM 143,A01,425843,Grant; Barry J,17,0,40,23
1708249151469,BIMM 143,B01,425845,Bozinovic; Goran,33,0,40,7
1708249151995,BIMM 182,A01,455012,Bafna; Vineet,28,0,50,22
1708249152526,BIMM 194,A00,425847,Rivera; Fabian Chavez,24,0,27,3
1708249152526,BIMM 194,B00,425868,Russell; Alistair B,16,0,27,11
1708249152526,BIMM 194,D00,425870,Wildonger; Jill Cathleen,14,0,27,13
1708249153052,BIOM 202,A00,390710,Corbett; Kevin Daniel,93,0,100,7
1708249153632,BIOM 219,A00,390713,Ross; Camille,0,0,0,7
1708249154158,BIOM 231,A00,455099,Furnari; Frank,0,0,0,0
1708249154158,BIOM 231,B00,455100,Lopez Ramirez; Miguel Alej,0,0,0,0
1708249154684,BIOM 242,A00,390714,Hamilton; Bruce Alan,20,0,20,0
1708249155210,BIOM 246,A00,492784,Gordts; Philip & Varki; Ajit P & Lewis; Amanda Lark & Godula; Kamil & Gagneux; Pascal & Esko; Jeffrey D. & Bode; Lars,0,0,0,0
1708249155736,BIOM 252,A00,390715,Ayyagari; Radha,27,0,28,1
1708249156263,BIOM 254,A00,390718,Corbett; Kevin Daniel,14,0,20,6
1708249156793,BIOM 272,A00,390722,Hangauer; Matthew John,16,0,20,4
1708249157320,BIOM 274,A00,390725,Sun; Bryan Kee-Hong,7,0,15,8
1708249157846,BIOM 283,A00,390728,Komives; Elizabeth A,2,0,2,0
1708249158374,BIOM 285,A00,390730,Gaulton; Kyle J,10,0,20,10
1708249158905,BIOM 295,A00,455083,Brown; Joan Heller,0,0,0,0
1708249159440,BIPN 100,A01,425872,Augustine; Vineet,240,0,245,5
1708249159440,BIPN 100,B01,425874,George; Monique Leana,240,0,245,5
1708249159440,BIPN 100,C01,458640,Maita; Isabella Vincenza,44,0,49,5
1708249159440,BIPN 100,C02,458646,Maita; Isabella Vincenza,48,0,49,1
1708249159440,BIPN 100,C03,458714,Maita; Isabella Vincenza,48,0,49,1
1708249159440,BIPN 100,C04,458716,Maita; Isabella Vincenza,48,0,49,1
1708249159440,BIPN 100,C05,458717,Maita; Isabella Vincenza,46,0,49,3
1708249159966,BIPN 105,A01,425877,Armour; Jon Christopher,12,0,21,9
1708249159966,BIPN 105,A02,425878,Armour; Jon Christopher,21,0,21,0
1708249159966,BIPN 105,A03,425879,Armour; Jon Christopher,10,0,21,11
1708249159966,BIPN 105,A04,425880,Armour; Jon Christopher,20,0,21,1
1708249160499,BIPN 120,A01,425882,Cooke; James Edward,371,0,395,24
1708249161031,BIPN 140,A01,425884,Hibbs; Ryan E.,183,0,192,9
1708249161558,BIPN 144,A01,425886,Zou; Yimin,153,0,158,5
1708249162086,BIPN 145,A01,425888,Maita; Isabella Vincenza,41,0,42,1
1708249162086,BIPN 145,B01,425918,Marino; Marc J,37,0,42,5
1708249162086,BIPN 145,B02,425954,Marino; Marc J,40,0,42,2
1708249162617,BIPN 147,A01,426086,Sejnowski; Terrence J,53,0,64,11
1708249163143,BIPN 152,A01,426112,Halpain; Shelley,97,0,128,31
1708249163671,BIPN 162,A01,426120,Juavinett; Ashley Lauren,17,0,30,13
1708249164203,BIPN 164,A01,455010,Benna; Marcus K & Aljadeff; Johnatan,120,0,120,0
1708249164730,BIPN 194,A00,426122,Glasgow; Stacey Marie,20,0,27,7
1708249165259,BISP 170,A00,426158,French; Kathleen Ann,26,0,30,4
1708249165784,BISP 182,A00,426168,Pogliano; Joseph,9999,0,9999,0
1708249166312,BISP 194,A00,426240,Chisholm; Andrew D.,11,0,27,16
1708249166312,BISP 194,B00,426241,Farley; Emma Kristen,25,0,27,2
1708249166839,BNFO 281,A00,427175,Gaasterland; Theresa,85,0,100,15
1708249167367,BNFO 283,A00,427211,Carter; Hannah Kathryn & Chavez; Alejandro,39,0,50,11
1708249167367,BNFO 283,B00,480483,Amariuta-Bartell; Tiffany & Dorrestein; Pieter,21,0,30,9
1708249167892,BNFO 294,B01,427269,Ross; Camille,47,0,50,3
1708249168444,CAT 3,A01,396994,Glaser; Amelia,15,0,15,0
1708249168444,CAT 3,A02,396995,Glaser; Amelia,15,0,15,0
1708249168444,CAT 3,A03,396996,Glaser; Amelia,7,0,15,8
1708249168444,CAT 3,A04,396997,Glaser; Amelia,12,0,15,3
1708249168444,CAT 3,A05,397004,Glaser; Amelia,15,0,15,0
1708249168444,CAT 3,A06,397039,Glaser; Amelia,11,0,15,4
1708249168444,CAT 3,A07,397040,Glaser; Amelia,13,0,15,2
1708249168444,CAT 3,A08,397084,Glaser; Amelia,15,0,15,0
1708249168444,CAT 3,A09,397269,Glaser; Amelia,13,0,15,2
1708249168444,CAT 3,A10,397270,Glaser; Amelia,0,0,15,15
1708249168444,CAT 3,A11,397271,Glaser; Amelia,9,0,15,6
1708249168444,CAT 3,A12,397272,Glaser; Amelia,12,0,15,3
1708249168444,CAT 3,A13,397273,Glaser; Amelia,15,0,15,0
1708249168444,CAT 3,A14,397274,Glaser; Amelia,14,0,15,1
1708249168444,CAT 3,B01,397276,Porter; Lisa,15,0,15,0
1708249168444,CAT 3,B02,397277,Porter; Lisa,15,0,15,0
1708249168444,CAT 3,B03,397278,Porter; Lisa,14,0,15,1
1708249168444,CAT 3,B04,397279,Porter; Lisa,15,0,15,0
1708249168444,CAT 3,B06,397281,Porter; Lisa,15,0,15,0
1708249168444,CAT 3,B07,397291,Porter; Lisa,15,0,15,0
1708249168444,CAT 3,B09,397293,Porter; Lisa,15,0,15,0
1708249168444,CAT 3,B10,397294,Porter; Lisa,15,0,15,0
1708249168444,CAT 3,B11,397295,Porter; Lisa,12,0,15,3
1708249168444,CAT 3,B12,397296,Porter; Lisa,14,0,15,1
1708249168444,CAT 3,B13,397297,Porter; Lisa,11,0,15,4
1708249168444,CAT 3,B14,397298,Porter; Lisa,15,0,15,0
1708249168444,CAT 3,B15,397299,Porter; Lisa,15,0,15,0
1708249168444,CAT 3,B16,397300,Porter; Lisa,15,0,15,0
1708249168444,CAT 3,C01,397302,Marchisotto; Jennifer Anne,13,0,15,2
1708249168444,CAT 3,C02,397308,Marchisotto; Jennifer Anne,9,0,15,6
1708249168444,CAT 3,C03,397309,Marchisotto; Jennifer Anne,9,0,15,6
1708249168444,CAT 3,C04,397315,Marchisotto; Jennifer Anne,11,0,15,4
1708249168444,CAT 3,C05,397316,Marchisotto; Jennifer Anne,14,0,15,1
1708249168444,CAT 3,C06,397322,Marchisotto; Jennifer Anne,15,0,15,0
1708249168444,CAT 3,C07,397323,Marchisotto; Jennifer Anne,15,0,15,0
1708249168444,CAT 3,C08,397329,Marchisotto; Jennifer Anne,15,0,15,0
1708249168444,CAT 3,C09,397333,Marchisotto; Jennifer Anne,15,0,15,0
1708249168444,CAT 3,C10,397336,Marchisotto; Jennifer Anne,15,0,15,0
1708249168444,CAT 3,C11,397354,Marchisotto; Jennifer Anne,13,0,15,2
1708249168444,CAT 3,C12,397357,Marchisotto; Jennifer Anne,15,0,15,0
1708249168444,CAT 3,C13,397364,Marchisotto; Jennifer Anne,14,0,15,1
1708249168444,CAT 3,C14,397367,Marchisotto; Jennifer Anne,14,0,15,1
1708249168444,CAT 3,C15,397369,Marchisotto; Jennifer Anne,15,0,15,0
1708249168444,CAT 3,C16,397373,Marchisotto; Jennifer Anne,15,0,15,0
1708249168444,CAT 3,C17,397374,Marchisotto; Jennifer Anne,15,0,15,0
1708249168444,CAT 3,C18,397380,Marchisotto; Jennifer Anne,14,0,15,1
1708249168444,CAT 3,D02,397405,Rahimi; Babak,13,0,15,2
1708249168444,CAT 3,D03,397408,Rahimi; Babak,14,0,15,1
1708249168444,CAT 3,D04,397415,Rahimi; Babak,15,0,15,0
1708249168444,CAT 3,D05,397416,Rahimi; Babak,15,0,15,0
1708249168444,CAT 3,D06,397422,Rahimi; Babak,15,0,15,0
1708249168444,CAT 3,D07,397426,Rahimi; Babak,14,0,15,1
1708249168444,CAT 3,D09,397447,Rahimi; Babak,11,0,15,4
1708249168444,CAT 3,D10,397450,Rahimi; Babak,13,0,15,2
1708249168444,CAT 3,D11,397625,Rahimi; Babak,13,0,15,2
1708249168444,CAT 3,D12,397630,Rahimi; Babak,15,0,15,0
1708249168444,CAT 3,D13,397631,Rahimi; Babak,14,0,15,1
1708249168444,CAT 3,D14,397635,Rahimi; Babak,14,0,15,1
1708249168971,CAT 3CE,A01,397642,Bronstein; Phoebe Malan,25,0,25,0
1708249169500,CAT 87,A00,397645,Bronstein; Phoebe Malan,19,0,20,1
1708249170030,CAT 90,A00,480731,Bronstein; Phoebe Malan,20,0,20,0
1708249170557,CAT 124,A01,397662,Knight; Amy,5,0,5,0
1708249170557,CAT 124,A02,397722,Knight; Amy,5,0,5,0
1708249170557,CAT 124,A03,397726,Knight; Amy,5,0,5,0
1708249170557,CAT 124,A04,397829,Knight; Amy,4,0,5,1
1708249171089,CAT 125,001,397832,Popko; Elizabeth Ashley,20,0,20,0
1708249171089,CAT 125,002,397833,Delaville; Romain,20,0,20,0
1708249171089,CAT 125,003,397834,Marchisotto; Jennifer Anne,18,0,20,2
1708249171089,CAT 125,004,397835,Bigham; David Joseph,20,0,20,0
1708249171089,CAT 125,005,397836,Bigham; David Joseph,19,0,20,1
1708249171089,CAT 125,006,397837,Bigham; David Joseph,16,0,20,4
1708249171089,CAT 125,007,397838,Vanderschuit; Maya Alysia,20,0,20,0
1708249171089,CAT 125,008,397839,Vanderschuit; Maya Alysia,20,0,20,0
1708249171089,CAT 125,009,397840,Vanderschuit; Maya Alysia,20,0,20,0
1708249171089,CAT 125,010,397841,Morales; Celeste Georgianna,15,0,16,1
1708249171089,CAT 125,011,397842,Morales; Celeste Georgianna,16,0,16,0
1708249171089,CAT 125,012,397881,Morales; Celeste Georgianna,19,0,20,1
1708249171089,CAT 125,013,397954,Rose; Becca Rae,18,0,20,2
1708249171089,CAT 125,014,397956,Rose; Becca Rae,20,0,20,0
1708249171089,CAT 125,015,397998,Rose; Becca Rae,19,0,20,1
1708249171089,CAT 125,016,397999,Tosun; Adriana,20,0,20,0
1708249171089,CAT 125,017,398001,Tosun; Adriana,20,0,20,0
1708249171089,CAT 125,018,398009,Irwin; Matthew Joseph,19,0,20,1
1708249171089,CAT 125,019,398010,Irwin; Matthew Joseph,18,0,20,2
1708249171089,CAT 125,020,398014,Irwin; Matthew Joseph,20,0,20,0
1708249171622,CAT 125R,A00,398015,Smith; Lauryn Alissa,19,0,20,1
1708249171622,CAT 125R,B00,398016,Smith; Lauryn Alissa,17,0,20,3
1708249171622,CAT 125R,C00,398017,Smith; Lauryn Alissa,19,0,20,1
1708249171622,CAT 125R,D00,398019,Tosun; Adriana,19,0,20,1
1708249171622,CAT 125R,E00,398020,Hyland; Tina Mae,12,0,20,8
1708249171622,CAT 125R,F00,398027,Hyland; Tina Mae,18,0,20,2
1708249171622,CAT 125R,G00,398028,Hyland; Tina Mae,18,0,20,2
1708249172154,CCE 1,A01,396087,Kenley Grounds; Nicole,40,0,40,0
1708249172154,CCE 1,B01,396142,Quijada; David,39,0,40,1
1708249172154,CCE 1,C01,396159,Bigley; Michele Heather,39,0,40,1
1708249172154,CCE 1,D01,396164,Bigley; Michele Heather,40,0,40,0
1708249172154,CCE 1,E01,396166,Lee; Kassandra,40,0,40,0
1708249172154,CCE 1,F01,396168,Lee; Kassandra,40,0,40,0
1708249172154,CCE 1,G01,396170,Staff,40,0,40,0
1708249172154,CCE 1,H01,396172,Staff,40,0,40,0
1708249172683,CENG 101B,A00,392993,Chen; Shaochen,44,0,45,1
1708249173208,CENG 101C,A00,392997,Li; Yanran,148,0,150,2
1708249173736,CENG 113,A00,393000,Chen; Zheng,69,0,70,1
1708249173736,CENG 113,B00,393001,Li; Wan-Lu,69,0,70,1
1708249174264,CENG 124B,A00,393036,Powell; Alyssa & Russ; Benjamin Edward,113,0,120,7
1708249174790,CENG 157,A00,393220,Opatkiewicz; Justin Paul,50,0,57,7
1708249175322,CENG 160,A00,393231,Powell; Alyssa,70,0,80,10
1708249175848,CENG 170,A01,393238,Drews; Aaron,27,0,30,3
1708249176376,CENG 175,A00,393239,Steinmetz; Nicole F,34,0,35,1
1708249176905,CENG 176B,A01,393285,Opatkiewicz; Justin Paul,46,0,52,6
1708249176905,CENG 176B,B01,393629,Zhang; Liangfang,40,0,49,9
1708249177431,CENG 205,A00,393681,Jahed Motlagh; Zeinab,53,0,60,7
1708249177958,CENG 257,A00,393682,Opatkiewicz; Justin Paul,10,0,13,3
1708249178484,CGS 87,A00,489609,Wesling; Megan E.,20,0,20,0
1708249179010,CGS 100B,A00,396181,Whitley; Leila Marie,28,0,30,2
1708249179539,CGS 109,A00,396194,Whitley; Leila Marie,19,0,20,1
1708249180068,CGS 112,A00,396220,Martin Sandino; Amanda Maria Yoland,22,0,25,3
1708249180599,CGS 114,A00,396223,Steelman; Katherine Wallis,14,0,16,2
1708249181125,CGS 116,A00,396295,Staff,19,0,20,1
1708249181651,CGS 117,A00,396306,Martin Sandino; Amanda Maria Yoland,14,0,15,1
1708249182177,CGS 118,A00,396314,Hankins; Joseph D.,28,0,29,1
1708249182704,CGS 128,A00,396366,Whitley; Leila Marie,14,0,15,1
1708249183230,CGS 137,A00,396865,Martin Sandino; Amanda Maria Yoland,16,0,19,3
1708249183759,CGS 150,A00,396901,Taylor-Garcia; Daphne,18,0,18,0
1708249184287,CGS 196B,A00,396904,Lo; Stanley M.,7,0,7,0
1708249184287,CGS 196B,B00,396973,Brenner; Suzanne A,7,0,7,0
1708249184287,CGS 196B,C00,396985,Jones; Makeba,7,0,7,0
1708249184811,CGS 198,001,396987,Anderson; Patrick W.,0,0,0,0
1708249184811,CGS 198,002,396988,Anderson; Patrick W.,0,0,0,0
1708249184811,CGS 198,003,396989,Anderson; Patrick W.,0,0,0,0
1708249184811,CGS 198,004,396990,Anderson; Patrick W.,0,0,0,0
1708249185337,CGS 200,A00,396991,Perez; Roy,0,0,0,3
1708249185865,CHEM 6A,A01,459563,Deshmukh; Lalit,40,0,40,0
1708249185865,CHEM 6A,A02,459564,Deshmukh; Lalit,35,0,40,5
1708249185865,CHEM 6A,A03,459565,Deshmukh; Lalit,31,0,40,9
1708249185865,CHEM 6A,A04,459566,Deshmukh; Lalit,30,0,38,8
1708249185865,CHEM 6A,A05,459567,Deshmukh; Lalit,40,0,40,0
1708249185865,CHEM 6A,A06,459568,Deshmukh; Lalit,37,0,40,3
1708249185865,CHEM 6A,A07,459569,Deshmukh; Lalit,37,0,40,3
1708249185865,CHEM 6A,A08,459570,Deshmukh; Lalit,0,0,0,0
1708249186393,CHEM 6B,A01,467314,Ortony; Julia Helen,39,0,40,1
1708249186393,CHEM 6B,A02,467322,Ortony; Julia Helen,32,0,40,8
1708249186393,CHEM 6B,A03,467323,Ortony; Julia Helen,40,0,40,0
1708249186393,CHEM 6B,A04,467325,Ortony; Julia Helen,31,0,40,9
1708249186393,CHEM 6B,A05,467326,Ortony; Julia Helen,39,0,40,1
1708249186393,CHEM 6B,A06,467346,Ortony; Julia Helen,40,0,40,0
1708249186393,CHEM 6B,B01,467360,Hopkins; Patrycja Anna,35,0,40,5
1708249186393,CHEM 6B,B02,467363,Hopkins; Patrycja Anna,38,0,40,2
1708249186393,CHEM 6B,B03,467364,Hopkins; Patrycja Anna,35,0,40,5
1708249186393,CHEM 6B,B04,467380,Hopkins; Patrycja Anna,40,0,40,0
1708249186393,CHEM 6B,B05,467381,Hopkins; Patrycja Anna,40,0,40,0
1708249186393,CHEM 6B,B06,467382,Hopkins; Patrycja Anna,39,0,40,1
1708249186934,CHEM 6C,A01,468994,Ternansky; Robert J.,39,0,40,1
1708249186934,CHEM 6C,A02,469054,Ternansky; Robert J.,38,0,40,2
1708249186934,CHEM 6C,A03,469065,Ternansky; Robert J.,39,0,40,1
1708249186934,CHEM 6C,A04,469069,Ternansky; Robert J.,40,0,40,0
1708249186934,CHEM 6C,A05,469080,Ternansky; Robert J.,40,0,40,0
1708249186934,CHEM 6C,B01,469318,Ternansky; Robert J.,39,0,40,1
1708249186934,CHEM 6C,B02,469319,Ternansky; Robert J.,40,0,40,0
1708249186934,CHEM 6C,B03,469320,Ternansky; Robert J.,39,0,40,1
1708249186934,CHEM 6C,B04,469321,Ternansky; Robert J.,40,0,40,0
1708249186934,CHEM 6C,B05,469322,Ternansky; Robert J.,40,0,40,0
1708249186934,CHEM 6C,C01,469323,Schurmeier; Kimberly,38,0,40,2
1708249186934,CHEM 6C,C02,469324,Schurmeier; Kimberly,36,0,40,4
1708249186934,CHEM 6C,C03,469325,Schurmeier; Kimberly,38,0,40,2
1708249186934,CHEM 6C,C04,469326,Schurmeier; Kimberly,36,0,40,4
1708249186934,CHEM 6C,C05,469327,Schurmeier; Kimberly,40,0,40,0
1708249186934,CHEM 6C,D01,460183,Schurmeier; Kimberly,39,0,40,1
1708249186934,CHEM 6C,D02,460184,Schurmeier; Kimberly,32,0,40,8
1708249186934,CHEM 6C,D03,460185,Schurmeier; Kimberly,26,0,40,14
1708249186934,CHEM 6C,D04,460186,Schurmeier; Kimberly,38,0,40,2
1708249186934,CHEM 6C,D05,460187,Schurmeier; Kimberly,40,0,40,0
1708249186934,CHEM 6C,E01,460188,Stallings; Dontarie M,24,0,40,16
1708249186934,CHEM 6C,E02,460190,Stallings; Dontarie M,25,0,40,15
1708249186934,CHEM 6C,E03,460191,Stallings; Dontarie M,3,0,20,17
1708249186934,CHEM 6C,E04,460192,Stallings; Dontarie M,36,0,40,4
1708249186934,CHEM 6C,E05,460193,Stallings; Dontarie M,37,0,40,3
1708249187468,CHEM 6CH,A01,459630,Tezcan; Faik,40,0,40,0
1708249187998,CHEM 7L,A01,393998,Jazzar; Rodolphe,0,0,0,3
1708249187998,CHEM 7L,A02,393999,Jazzar; Rodolphe,10,0,24,14
1708249187998,CHEM 7L,A03,394000,Jazzar; Rodolphe,21,0,24,3
1708249187998,CHEM 7L,A04,394001,Jazzar; Rodolphe,22,0,24,2
1708249187998,CHEM 7L,A05,394002,Jazzar; Rodolphe,18,0,24,6
1708249187998,CHEM 7L,A06,394003,Jazzar; Rodolphe,22,0,24,2
1708249187998,CHEM 7L,A07,394004,Jazzar; Rodolphe,18,0,21,3
1708249187998,CHEM 7L,A08,394005,Jazzar; Rodolphe,0,0,0,0
1708249187998,CHEM 7L,A09,394006,Jazzar; Rodolphe,20,0,24,4
1708249187998,CHEM 7L,A10,394007,Jazzar; Rodolphe,24,0,24,0
1708249187998,CHEM 7L,B01,394009,Jazzar; Rodolphe,0,0,0,1
1708249187998,CHEM 7L,B02,394010,Jazzar; Rodolphe,1,0,6,5
1708249187998,CHEM 7L,B03,394011,Jazzar; Rodolphe,15,0,24,9
1708249187998,CHEM 7L,B04,394012,Jazzar; Rodolphe,18,0,21,3
1708249187998,CHEM 7L,B05,394013,Jazzar; Rodolphe,0,0,0,0
1708249187998,CHEM 7L,B06,394014,Jazzar; Rodolphe,15,0,24,9
1708249187998,CHEM 7L,B07,394015,Jazzar; Rodolphe,18,0,24,6
1708249187998,CHEM 7L,B08,394016,Jazzar; Rodolphe,23,0,24,1
1708249187998,CHEM 7L,B09,394017,Jazzar; Rodolphe,24,0,24,0
1708249187998,CHEM 7L,B10,394018,Jazzar; Rodolphe,24,0,24,0
1708249187998,CHEM 7L,C01,394020,Staff,0,0,0,0
1708249187998,CHEM 7L,C02,394021,Staff,21,0,24,3
1708249187998,CHEM 7L,C03,394022,Staff,23,0,24,1
1708249187998,CHEM 7L,C04,394023,Staff,24,0,24,0
1708249187998,CHEM 7L,C05,394024,Staff,0,0,0,0
1708249187998,CHEM 7L,C06,394025,Staff,20,0,24,4
1708249187998,CHEM 7L,C07,394026,Staff,22,0,24,2
1708249187998,CHEM 7L,C08,394027,Staff,23,0,24,1
1708249187998,CHEM 7L,C09,394028,Staff,24,0,24,0
1708249187998,CHEM 7L,C10,394029,Staff,23,0,24,1
1708249188531,CHEM 11,A01,459661,Staff,42,0,44,2
1708249188531,CHEM 11,A02,459664,Staff,44,0,44,0
1708249188531,CHEM 11,A03,459702,Staff,42,0,44,2
1708249188531,CHEM 11,A04,459707,Staff,44,0,44,0
1708249188531,CHEM 11,A05,459708,Staff,43,0,44,1
1708249188531,CHEM 11,A06,459711,Staff,41,0,44,3
1708249189064,CHEM 40A,A01,459576,Albizati; Kim F.,36,0,40,4
1708249189064,CHEM 40A,A02,459577,Albizati; Kim F.,33,0,40,7
1708249189064,CHEM 40A,A03,459578,Albizati; Kim F.,37,0,40,3
1708249189064,CHEM 40A,A04,459579,Albizati; Kim F.,38,0,40,2
1708249189064,CHEM 40A,A05,459580,Albizati; Kim F.,40,0,40,0
1708249189064,CHEM 40A,A06,459581,Albizati; Kim F.,37,0,40,3
1708249189064,CHEM 40A,A07,459582,Albizati; Kim F.,38,0,40,2
1708249189064,CHEM 40A,A08,459588,Albizati; Kim F.,39,0,40,1
1708249189589,CHEM 40B,A01,467442,Weizman; Haim,29,0,40,11
1708249189589,CHEM 40B,A02,467443,Weizman; Haim,33,0,40,7
1708249189589,CHEM 40B,A03,467444,Weizman; Haim,39,0,40,1
1708249189589,CHEM 40B,A04,467445,Weizman; Haim,38,0,40,2
1708249189589,CHEM 40B,A05,467446,Weizman; Haim,39,0,40,1
1708249189589,CHEM 40B,A06,467447,Weizman; Haim,37,0,40,3
1708249189589,CHEM 40B,A07,467448,Weizman; Haim,31,0,40,9
1708249189589,CHEM 40B,A08,467449,Weizman; Haim,40,0,40,0
1708249189589,CHEM 40B,B01,467383,Molinski; Tadeusz,40,0,40,0
1708249189589,CHEM 40B,B02,467384,Molinski; Tadeusz,40,0,40,0
1708249189589,CHEM 40B,B03,467385,Molinski; Tadeusz,40,0,40,0
1708249189589,CHEM 40B,B04,467399,Molinski; Tadeusz,40,0,40,0
1708249189589,CHEM 40B,B05,467400,Molinski; Tadeusz,40,0,40,0
1708249189589,CHEM 40B,B06,467401,Molinski; Tadeusz,40,0,40,0
1708249189589,CHEM 40B,B07,467402,Molinski; Tadeusz,40,0,40,0
1708249189589,CHEM 40B,B08,467404,Molinski; Tadeusz,39,0,40,1
1708249190122,CHEM 41B,A01,459571,Klosterman; Jeremy K,40,0,40,0
1708249190122,CHEM 41B,A02,459572,Klosterman; Jeremy K,36,0,37,1
1708249190122,CHEM 41B,A03,459573,Klosterman; Jeremy K,40,0,40,0
1708249190648,CHEM 41C,A01,459589,Tor; Yitzhak,40,0,40,0
1708249190648,CHEM 41C,A02,459624,Tor; Yitzhak,38,0,40,2
1708249190648,CHEM 41C,A03,459625,Tor; Yitzhak,40,0,40,0
1708249190648,CHEM 41C,A04,459626,Tor; Yitzhak,40,0,40,0
1708249190648,CHEM 41C,A05,459627,Tor; Yitzhak,29,0,29,0
1708249190648,CHEM 41C,A06,459628,Tor; Yitzhak,38,0,40,2
1708249190648,CHEM 41C,A07,459629,Tor; Yitzhak,40,0,40,0
1708249191182,CHEM 43A,A01,394068,Lam; Tin Yiu,12,0,24,12
1708249191182,CHEM 43A,A02,394088,Lam; Tin Yiu,23,0,24,1
1708249191182,CHEM 43A,A03,394092,Lam; Tin Yiu,23,0,24,1
1708249191182,CHEM 43A,A04,394093,Lam; Tin Yiu,21,0,24,3
1708249191182,CHEM 43A,A05,394094,Lam; Tin Yiu,23,0,24,1
1708249191182,CHEM 43A,A06,394096,Lam; Tin Yiu,15,0,24,9
1708249191182,CHEM 43A,A07,394115,Lam; Tin Yiu,20,0,24,4
1708249191182,CHEM 43A,A08,394116,Lam; Tin Yiu,22,0,24,2
1708249191182,CHEM 43A,A09,394117,Lam; Tin Yiu,22,0,24,2
1708249191182,CHEM 43A,A10,394118,Lam; Tin Yiu,20,0,24,4
1708249191182,CHEM 43A,A11,394119,Lam; Tin Yiu,8,0,13,5
1708249191182,CHEM 43A,A12,394120,Lam; Tin Yiu,24,0,24,0
1708249191182,CHEM 43A,A13,394132,Lam; Tin Yiu,24,0,24,0
1708249191182,CHEM 43A,B01,394134,Lam; Tin Yiu,24,0,24,0
1708249191182,CHEM 43A,B02,394135,Lam; Tin Yiu,16,0,24,8
1708249191182,CHEM 43A,B03,394136,Lam; Tin Yiu,13,0,24,11
1708249191182,CHEM 43A,B04,394137,Lam; Tin Yiu,17,0,24,7
1708249191182,CHEM 43A,B05,394138,Lam; Tin Yiu,20,0,24,4
1708249191182,CHEM 43A,B06,394139,Lam; Tin Yiu,19,0,24,5
1708249191182,CHEM 43A,B07,394140,Lam; Tin Yiu,20,0,24,4
1708249191182,CHEM 43A,B08,394141,Lam; Tin Yiu,24,0,24,0
1708249191182,CHEM 43A,B09,394142,Lam; Tin Yiu,20,0,24,4
1708249191182,CHEM 43A,B10,394143,Lam; Tin Yiu,24,0,24,0
1708249191182,CHEM 43A,B11,394145,Lam; Tin Yiu,22,0,24,2
1708249191182,CHEM 43A,B12,394146,Lam; Tin Yiu,23,0,24,1
1708249191708,CHEM 96,A00,394159,Bussey; Thomas J,24,0,25,1
1708249192236,CHEM 100A,A01,394161,Li; Shaowei,16,0,22,6
1708249192236,CHEM 100A,A02,394162,Li; Shaowei,20,0,24,4
1708249192236,CHEM 100A,A03,394163,Li; Shaowei,22,0,24,2
1708249192236,CHEM 100A,A04,394164,Li; Shaowei,24,0,24,0
1708249192236,CHEM 100A,A05,394165,Li; Shaowei,24,0,24,0
1708249192236,CHEM 100A,A06,394166,Li; Shaowei,20,0,22,2
1708249192761,CHEM 100B,A01,394175,Pomeroy; Robert S.,19,0,25,6
1708249193288,CHEM 105A,A01,394177,Young; Mark,31,0,39,8
1708249193288,CHEM 105A,B01,394179,Young; Mark,0,0,0,0
1708249193814,CHEM 108,A01,394181,Staff,14,0,20,6
1708249193814,CHEM 108,A02,394182,Staff,23,0,24,1
1708249193814,CHEM 108,B01,394184,Staff,4,0,20,16
1708249193814,CHEM 108,B02,394185,Staff,23,0,24,1
1708249194345,CHEM 109,A01,394187,Piercy; Marc Anthony,17,0,20,3
1708249194345,CHEM 109,A02,394188,Piercy; Marc Anthony,22,0,24,2
1708249194345,CHEM 109,B01,394193,Piercy; Marc Anthony,12,0,20,8
1708249194345,CHEM 109,B02,394194,Piercy; Marc Anthony,23,0,24,1
1708249194877,CHEM 111,A00,394195,Thiemens; Mark H,97,0,100,3
1708249195404,CHEM 114B,A01,459574,Piercy; Marc Anthony,39,0,45,6
1708249195404,CHEM 114B,A02,459575,Piercy; Marc Anthony,40,0,45,5
1708249195931,CHEM 114C,A01,467286,Komives; Elizabeth A,32,0,44,12
1708249195931,CHEM 114C,A02,467287,Komives; Elizabeth A,42,0,44,2
1708249195931,CHEM 114C,A03,467290,Komives; Elizabeth A,42,0,44,2
1708249195931,CHEM 114C,A04,467295,Komives; Elizabeth A,43,0,44,1
1708249196460,CHEM 114D,A00,394198,Ghosh; Gourisankar,29,0,30,1
1708249196986,CHEM 118,A01,459788,Donoghue; Daniel J.,37,0,40,3
1708249196986,CHEM 118,A02,459800,Donoghue; Daniel J.,37,0,40,3
1708249196986,CHEM 118,A03,459807,Donoghue; Daniel J.,36,0,40,4
1708249196986,CHEM 118,A04,459809,Donoghue; Daniel J.,38,0,40,2
1708249196986,CHEM 118,A05,459811,Donoghue; Daniel J.,37,0,40,3
1708249196986,CHEM 118,A06,459826,Donoghue; Daniel J.,39,0,40,1
1708249197513,CHEM 119,A01,467427,Joseph; Simpson,35,0,40,5
1708249197513,CHEM 119,A02,467441,Joseph; Simpson,0,0,0,0
1708249198045,CHEM 120B,A01,467450,Griffith; Kent,37,0,40,3
1708249198045,CHEM 120B,A02,467451,Griffith; Kent,34,0,40,6
1708249198045,CHEM 120B,A03,467452,Griffith; Kent,35,0,40,5
1708249198572,CHEM 123,A00,394211,Schimpf; Alina M,0,0,0,1
1708249199099,CHEM 125,A00,394217,Tezcan; Faik,18,0,20,2
1708249199629,CHEM 126A,A01,459715,Yong; Haiwang,39,0,40,1
1708249199629,CHEM 126A,A02,459725,Yong; Haiwang,36,0,40,4
1708249200155,CHEM 126B,A01,467405,Tauber; Michael,36,0,40,4
1708249200155,CHEM 126B,A02,467406,Tauber; Michael,39,0,40,1
1708249200155,CHEM 126B,A03,467426,Tauber; Michael,39,0,40,1
1708249200682,CHEM 132,A01,460181,Galperin; Michael,42,0,45,3
1708249200682,CHEM 132,A02,460182,Galperin; Michael,37,0,45,8
1708249201212,CHEM 135,A01,394222,Tauber; Michael,15,0,15,0
1708249201740,CHEM 143B,A01,394229,Klosterman; Jeremy K,16,0,24,8
1708249201740,CHEM 143B,A02,394230,Klosterman; Jeremy K,21,0,24,3
1708249202266,CHEM 156,A00,394231,Romero; Erik Anthony,30,0,30,0
1708249202795,CHEM 157,A00,394232,Tor; Yitzhak,74,0,80,6
1708249203323,CHEM 165,A01,460194,Herzik; Mark Anthony,21,0,25,4
1708249203857,CHEM 167,A01,467296,Deshmukh; Lalit,39,0,40,1
1708249203857,CHEM 167,A02,467297,Deshmukh; Lalit,33,0,40,7
1708249203857,CHEM 167,A03,467298,Deshmukh; Lalit,37,0,40,3
1708249203857,CHEM 167,A04,467312,Deshmukh; Lalit,37,0,40,3
1708249204384,CHEM 173,A00,394284,Young; Mark,48,0,50,2
1708249204913,CHEM 174,A01,455015,Pomeroy; Robert S.,45,0,50,5
1708249205441,CHEM 186,A00,477716,Paesani; Francesco & Gilson; Michael K.,6,0,12,6
1708249205966,CHEM 188,A00,394294,Bussey; Thomas J,19,0,20,1
1708249206493,CHEM 214,A00,394336,Ghosh; Gourisankar,12,0,20,8
1708249207075,CHEM 217,A00,394341,Joseph; Simpson,25,0,30,5
1708249207601,CHEM 221,A00,394425,Taylor; Susan S.,10,0,20,10
1708249208129,CHEM 225,A00,394429,Tezcan; Faik,4,0,10,6
1708249208654,CHEM 227,A00,394430,Schimpf; Alina M,26,0,30,4
1708249210196,CHEM 229,A00,394431,Stauber; Julia Megan,13,0,20,7
1708249210723,CHEM 235,A01,394433,Tauber; Michael,20,0,20,0
1708249211248,CHEM 236,A00,394434,Kummel; Andrew C,14,0,15,1
1708249211778,CHEM 241,A00,394435,Pokorski; Jonathan Kyle,14,0,15,1
1708249212304,CHEM 250,A00,394436,Weizman; Haim,0,0,0,16
1708249212833,CHEM 256,A00,394437,Romero; Erik Anthony,15,0,20,5
1708249213361,CHEM 257,A00,394438,Tor; Yitzhak,23,0,30,7
1708249213894,CHEM 265,A01,460195,Herzik; Mark Anthony,13,0,20,7
1708249214421,CHEM 273,A00,394440,Young; Mark,13,0,20,7
1708249214951,CHEM 276,A00,394441,Mc Culloch; Andrew Douglas & Amaro; Rommie E,0,0,0,0
1708249215477,CHEM 283,A00,394443,Komives; Elizabeth A,2,0,4,2
1708249216004,CHEM 286,A00,477693,Paesani; Francesco & Gilson; Michael K.,26,0,34,8
1708249216530,CHEM 291,A00,394446,Komives; Elizabeth A,20,0,20,0
1708249217058,CHEM 294,A00,394447,Romero; Erik Anthony,50,0,50,0
1708249217584,CHIN 10CD,A01,394453,Liu; Mingming,17,0,17,0
1708249217584,CHIN 10CD,A02,394457,Liu; Mingming,18,0,18,0
1708249218111,CHIN 10CM,A01,394465,Chen; Pei-Chia,11,0,12,1
1708249218111,CHIN 10CM,A02,394466,Chen; Pei-Chia,12,0,12,0
1708249218111,CHIN 10CM,B01,394468,Liu; Mingming,11,0,13,2
1708249218111,CHIN 10CM,B02,394469,Liu; Mingming,13,0,13,0
1708249218638,CHIN 10CN,A01,394581,Xu; Li,14,0,14,0
1708249218638,CHIN 10CN,A02,394582,Xu; Li,14,0,14,0
1708249218638,CHIN 10CN,B01,394585,Xu; Li,14,0,14,0
1708249218638,CHIN 10CN,B02,394586,Xu; Li,13,0,14,1
1708249219168,CHIN 20CD,A01,394591,Wang; Xiao,11,0,12,1
1708249219168,CHIN 20CD,A02,394592,Wang; Xiao,11,0,12,1
1708249219698,CHIN 20CN,A01,394597,Anderson; Qin-Hong,7,0,8,1
1708249219698,CHIN 20CN,A02,394599,Anderson; Qin-Hong,8,0,8,0
1708249219698,CHIN 20CN,B01,394601,Anderson; Qin-Hong,14,0,15,1
1708249220224,CHIN 100CM,A00,394602,Anderson; Qin-Hong,19,0,20,1
1708249220750,CHIN 100CN,A00,394603,Chen; Pei-Chia,24,0,24,0
1708249221279,CHIN 169B,A00,394623,Wang; Xiao,19,0,20,1
1708249221809,CLAS 87,A00,394669,Herbst; Matthew,19,0,20,1
1708249222335,CLAS 121R,A01,394671,Herbst; Matthew,11,0,12,1
1708249222335,CLAS 121R,B01,486854,Herbst; Matthew,8,0,8,0
1708249222868,CLIN 294C,A00,476856,Wierenga; Christina E & Banks; Sarah Jane,20,0,20,0
1708249223394,CLIN 296,001,476768,Brookman; Lauren Irene,94,0,100,6
1708249223394,CLIN 296,002,476855,Brookman; Lauren Irene,10,0,10,0
1708249223920,CLRE 238R,A00,394675,Mehta; Ravindra L.,9998,0,9999,1
1708249224445,CLRE 254,A00,394678,Vaida; Florin,9999,0,9999,0
1708249224976,CLRE 256,A00,394685,Morris; Sheldon,9999,0,9999,0
1708249225505,CLRE 258,A00,394692,Mehta; Ravindra L.,9999,0,9999,0
1708249226032,CLRE 260,A00,394693,Cuomo; Raphael Eduardo,9999,0,9999,0
1708249226559,CLRE 264,A00,394696,Mehta; Ravindra L.,9999,0,9999,0
1708249227101,CLRE 267,A00,394703,Vaida; Florin,9999,0,9999,0
1708249227629,CLRE 297,001,394705,Cuomo; Raphael Eduardo,9999,0,9999,0
1708249228157,CMM 246,A00,492783,Gordts; Philip & Varki; Ajit P & Lewis; Amanda Lark & Godula; Kamil & Gagneux; Pascal & Esko; Jeffrey D. & Bode; Lars,9,0,10,1
1708249228683,CMM 250,A00,492943,Willert; Karl Heinrich,31,0,40,9
1708249229208,COGR 200B,A00,395746,Jack; Caroline Sarah,2,0,5,3
1708249229737,COGR 225B,A00,395750,Serlin; David,1,0,5,4
1708249230264,COGR 225C,A00,395753,Gates; Kelly,1,0,5,4
1708249230789,COGR 275,A00,395943,Goldfarb; Brian,6,0,10,4
1708249230789,COGR 275,B00,396046,Fattal; Alexander Leor,4,0,10,6
1708249230789,COGR 275,C00,396047,Kidman; Shawna F,4,0,10,6
1708249231319,COGR 280,A00,396048,Ahn; Patricia Jeehyun,6,0,10,4
1708249231845,COGS 1,A01,407484,Boyle; Mary E. T.,52,0,60,8
1708249231845,COGS 1,A02,407498,Boyle; Mary E. T.,54,0,60,6
1708249231845,COGS 1,A03,407504,Boyle; Mary E. T.,59,0,60,1
1708249231845,COGS 1,A04,407512,Boyle; Mary E. T.,57,0,60,3
1708249231845,COGS 1,A05,407513,Boyle; Mary E. T.,60,0,60,0
1708249231845,COGS 1,A06,407514,Boyle; Mary E. T.,58,0,60,2
1708249231845,COGS 1,A07,407515,Boyle; Mary E. T.,57,0,57,0
1708249232373,COGS 9,A01,407520,Shannon; Kyle Michael,54,0,60,6
1708249232373,COGS 9,A02,407521,Shannon; Kyle Michael,60,0,60,0
1708249232373,COGS 9,A03,407522,Shannon; Kyle Michael,59,0,60,1
1708249232373,COGS 9,A04,407524,Shannon; Kyle Michael,57,0,60,3
1708249232373,COGS 9,A05,407525,Shannon; Kyle Michael,59,0,60,1
1708249232899,COGS 10,A01,407527,Morgan; Eric,45,0,50,5
1708249232899,COGS 10,A02,407530,Morgan; Eric,46,0,50,4
1708249232899,COGS 10,A03,407531,Morgan; Eric,46,0,50,4
1708249232899,COGS 10,A04,407532,Morgan; Eric,47,0,50,3
1708249232899,COGS 10,A05,407534,Morgan; Eric,47,0,50,3
1708249232899,COGS 10,A06,407539,Morgan; Eric,50,0,50,0
1708249232899,COGS 10,A07,407628,Morgan; Eric,50,0,50,0
1708249233430,COGS 11,A01,407699,Boroditsky; Lera,179,0,180,1
1708249233960,COGS 12,A00,407702,Boroditsky; Lera,75,0,75,0
1708249234492,COGS 14A,A01,407706,Barrera; Steven James,51,0,57,6
1708249234492,COGS 14A,A02,407707,Barrera; Steven James,54,0,57,3
1708249234492,COGS 14A,A03,407712,Barrera; Steven James,0,0,0,1
1708249234492,COGS 14A,A04,407715,Barrera; Steven James,57,0,57,0
1708249234492,COGS 14A,A05,407717,Barrera; Steven James,55,0,56,1
1708249234492,COGS 14A,A06,407718,Barrera; Steven James,52,0,55,3
1708249234492,COGS 14A,A07,407720,Barrera; Steven James,49,0,55,6
1708249235020,COGS 14B,A01,407723,Hoffman; Drew Ellen,52,0,57,5
1708249235020,COGS 14B,A02,407726,Hoffman; Drew Ellen,48,0,55,7
1708249235020,COGS 14B,A03,407727,Hoffman; Drew Ellen,52,0,55,3
1708249235020,COGS 14B,A04,407729,Hoffman; Drew Ellen,52,0,55,3
1708249235020,COGS 14B,A05,407730,Hoffman; Drew Ellen,50,0,55,5
1708249235548,COGS 17,A01,407733,Johnson; Christine M.,50,0,50,0
1708249235548,COGS 17,A02,407734,Johnson; Christine M.,48,0,50,2
1708249235548,COGS 17,A03,407735,Johnson; Christine M.,46,0,50,4
1708249235548,COGS 17,A04,407740,Johnson; Christine M.,47,0,50,3
1708249235548,COGS 17,A05,407745,Johnson; Christine M.,48,0,50,2
1708249235548,COGS 17,A06,407824,Johnson; Christine M.,48,0,50,2
1708249235548,COGS 17,A07,407878,Johnson; Christine M.,50,0,55,5
1708249235548,COGS 17,A08,408015,Johnson; Christine M.,52,0,55,3
1708249236082,COGS 18,A01,408118,Ellis; Shannon Elizabeth,27,0,35,8
1708249236082,COGS 18,A02,408119,Ellis; Shannon Elizabeth,31,0,35,4
1708249236082,COGS 18,A03,408120,Ellis; Shannon Elizabeth,23,0,35,12
1708249236082,COGS 18,A04,408136,Ellis; Shannon Elizabeth,33,0,35,2
1708249236082,COGS 18,A05,408141,Ellis; Shannon Elizabeth,35,0,35,0
1708249236082,COGS 18,A06,408143,Ellis; Shannon Elizabeth,34,0,35,1
1708249236082,COGS 18,A07,408144,Ellis; Shannon Elizabeth,35,0,35,0
1708249236082,COGS 18,A08,408145,Ellis; Shannon Elizabeth,34,0,35,1
1708249236082,COGS 18,A09,408146,Ellis; Shannon Elizabeth,35,0,35,0
1708249236082,COGS 18,B01,408148,Ellis; Shannon Elizabeth,30,0,32,2
1708249236082,COGS 18,B02,408149,Ellis; Shannon Elizabeth,26,0,32,6
1708249236082,COGS 18,B03,408151,Ellis; Shannon Elizabeth,27,0,33,6
1708249236082,COGS 18,B04,408154,Ellis; Shannon Elizabeth,32,0,33,1
1708249236082,COGS 18,B05,408163,Ellis; Shannon Elizabeth,29,0,33,4
1708249236082,COGS 18,B06,408176,Ellis; Shannon Elizabeth,33,0,33,0
1708249236082,COGS 18,B07,408177,Ellis; Shannon Elizabeth,31,0,33,2
1708249236082,COGS 18,B08,408178,Ellis; Shannon Elizabeth,32,0,33,1
1708249236082,COGS 18,B09,408195,Ellis; Shannon Elizabeth,31,0,33,2
1708249236608,COGS 87,A00,408196,Deak; Gedeon O.,20,0,20,0
1708249236608,COGS 87,B00,479478,Fleischer; Jason G,20,0,20,0
1708249237134,COGS 100,A01,408262,Allen; Michael Gordon,54,0,56,2
1708249237134,COGS 100,A02,408263,Allen; Michael Gordon,52,0,56,4
1708249237134,COGS 100,A03,408264,Allen; Michael Gordon,55,0,56,1
1708249237134,COGS 100,A04,408265,Allen; Michael Gordon,56,0,56,0
1708249237134,COGS 100,A05,408266,Allen; Michael Gordon,56,0,56,0
1708249237134,COGS 100,A06,408349,Allen; Michael Gordon,55,0,56,1
1708249237660,COGS 101A,A01,408352,Morgan; Eric,60,0,60,0
1708249237660,COGS 101A,A02,408353,Morgan; Eric,58,0,60,2
1708249237660,COGS 101A,A03,408354,Morgan; Eric,57,0,60,3
1708249237660,COGS 101A,A04,408355,Morgan; Eric,59,0,60,1
1708249238187,COGS 101B,A01,408373,Barrera; Steven James,47,0,50,3
1708249238187,COGS 101B,A02,408380,Barrera; Steven James,46,0,50,4
1708249238187,COGS 101B,A03,408384,Barrera; Steven James,38,0,50,12
1708249238187,COGS 101B,A04,408385,Barrera; Steven James,37,0,50,13
1708249238715,COGS 101C,A01,408387,Trott; Sean Thomas,48,0,50,2
1708249238715,COGS 101C,A02,408388,Trott; Sean Thomas,43,0,50,7
1708249238715,COGS 101C,A03,408389,Trott; Sean Thomas,45,0,50,5
1708249239244,COGS 107A,A01,408396,Boyle; Mary E. T.,54,0,56,2
1708249239244,COGS 107A,A02,408397,Boyle; Mary E. T.,54,0,56,2
1708249239244,COGS 107A,A03,408399,Boyle; Mary E. T.,51,0,56,5
1708249239244,COGS 107A,A04,408409,Boyle; Mary E. T.,50,0,56,6
1708249239244,COGS 107A,A05,408410,Boyle; Mary E. T.,51,0,56,5
1708249239244,COGS 107A,A06,408411,Boyle; Mary E. T.,55,0,56,1
1708249239770,COGS 107B,A01,408413,Mooshagian; Eric Frederick,46,0,50,4
1708249239770,COGS 107B,A02,408414,Mooshagian; Eric Frederick,43,0,50,7
1708249239770,COGS 107B,A03,408428,Mooshagian; Eric Frederick,43,0,50,7
1708249239770,COGS 107B,A04,408434,Mooshagian; Eric Frederick,46,0,50,4
1708249239770,COGS 107B,A05,408435,Mooshagian; Eric Frederick,50,0,50,0
1708249239770,COGS 107B,A06,408446,Mooshagian; Eric Frederick,49,0,50,1
1708249240300,COGS 107C,A01,408500,Chiba; Andrea,51,0,60,9
1708249240300,COGS 107C,A02,408519,Chiba; Andrea,55,0,60,5
1708249240300,COGS 107C,A03,408524,Chiba; Andrea,56,0,60,4
1708249240831,COGS 108,A01,408532,Fleischer; Jason G,45,0,60,15
1708249240831,COGS 108,A02,408543,Fleischer; Jason G,58,0,60,2
1708249240831,COGS 108,A03,408544,Fleischer; Jason G,59,0,60,1
1708249240831,COGS 108,A04,408552,Fleischer; Jason G,32,0,60,28
1708249240831,COGS 108,A05,408554,Fleischer; Jason G,47,0,60,13
1708249240831,COGS 108,A06,408574,Fleischer; Jason G,43,0,60,17
1708249240831,COGS 108,A07,408576,Fleischer; Jason G,56,0,60,4
1708249241360,COGS 112,A01,408682,Hoffman; Drew Ellen,33,0,50,17
1708249241360,COGS 112,A02,408683,Hoffman; Drew Ellen,38,0,50,12
1708249241360,COGS 112,A03,408684,Hoffman; Drew Ellen,48,0,60,12
1708249241887,COGS 122,A01,408695,Dow; Steven P,21,0,50,29
1708249242412,COGS 125,A00,408697,Klemmer; Scott R,36,0,50,14
1708249242938,COGS 126,A01,408787,Hollan; James D.,44,0,50,6
1708249243468,COGS 138,A01,408866,Khosla; Meenakshi,72,0,75,3
1708249243993,COGS 142,A01,408868,Rossano; Federico,49,0,50,1
1708249244522,COGS 144,A01,408950,Rossano; Federico,48,0,50,2
1708249245050,COGS 155,A01,408993,Staff,49,0,50,1
1708249245579,COGS 157,A00,408994,Creel; Sarah,0,0,0,0
1708249246105,COGS 160,A00,409031,Deak; Gedeon O.,20,0,20,0
1708249246631,COGS 175,A01,409035,Rill; Bryan,67,0,75,8
1708249247157,COGS 178,A00,409274,Jernigan; Terry Lynne,68,0,70,2
1708249247682,COGS 179,A00,409278,Staff,40,0,40,0
1708249248213,COGS 184,A01,409317,Johnson; Christine M.,42,0,50,8
1708249248741,COGS 185,A01,409476,Tu; Zhuowen,33,0,50,17
1708249248741,COGS 185,A02,409525,Tu; Zhuowen,45,0,50,5
1708249249272,COGS 188,A01,409527,Fleischer; Jason G,46,0,75,29
1708249249799,COGS 190C,001,409528,Chiba; Andrea,9999,0,9999,0
1708249249799,COGS 190C,002,409530,Fleischer; Jason G,9999,0,9999,0
1708249249799,COGS 190C,003,409531,Boyle; Mary E. T.,9999,0,9999,0
1708249249799,COGS 190C,004,409532,Nitz; Douglas A.,9999,0,9999,0
1708249249799,COGS 190C,005,409535,Rangel; Lara M,9999,0,9999,0
1708249249799,COGS 190C,006,409536,Rossano; Federico,9999,0,9999,0
1708249249799,COGS 190C,007,409537,Deak; Gedeon O.,9999,0,9999,0
1708249249799,COGS 190C,008,409538,Trott; Sean Thomas,9999,0,9999,0
1708249249799,COGS 190C,009,409540,Creel; Sarah,9999,0,9999,0
1708249249799,COGS 190C,010,409541,Voytek; Bradley Thomas,9999,0,9999,0
1708249249799,COGS 190C,011,409542,Greene; Deanna Jacquelyn,9999,0,9999,0
1708249249799,COGS 190C,012,409543,Ellis; Shannon Elizabeth,9999,0,9999,0
1708249249799,COGS 190C,013,409546,Kirsh; David Joel,9999,0,9999,0
1708249250327,COGS 190D,A00,409547,Voytek; Bradley Thomas,20,0,20,0
1708249250852,COGS 194,A00,409548,Hill; Seth J,9999,0,9999,0
1708249251379,COGS 200,A01,406697,Creel; Sarah,0,0,0,0
1708249251905,COGS 205,A00,406698,Chiba; Andrea,20,0,20,0
1708249252431,COGS 209,A00,406699,Mukamel; Eran A,42,0,68,26
1708249252962,COGS 210C,001,406700,Kirsh; David Joel,9999,0,9999,0
1708249252962,COGS 210C,002,406701,Greene; Deanna Jacquelyn,9998,0,9999,1
1708249252962,COGS 210C,003,406702,Xia; Haijun,9999,0,9999,0
1708249252962,COGS 210C,004,406703,Nitz; Douglas A.,9998,0,9999,1
1708249252962,COGS 210C,005,406710,Hollan; James D.,9999,0,9999,0
1708249252962,COGS 210C,006,406713,De Sa; Virginia,9999,0,9999,0
1708249252962,COGS 210C,007,406714,Rossano; Federico,9999,0,9999,0
1708249252962,COGS 210C,008,406740,Kiyonaga; Anastasia,9999,0,9999,0
1708249252962,COGS 210C,009,406745,Guo; Philip J,9998,0,9999,1
1708249252962,COGS 210C,010,406746,Dow; Steven P,9999,0,9999,0
1708249252962,COGS 210C,011,406747,Bergen; Benjamin,9999,0,9999,0
1708249252962,COGS 210C,012,406758,Coulson; Seana M,9999,0,9999,0
1708249253488,COGS 211C,A00,406763,Coulson; Seana M,17,0,20,3
1708249254014,COGS 229,A00,406788,Hollan; James D. & Xia; Haijun,5,0,10,5
1708249254544,COGS 238,A00,406789,Bergen; Benjamin,17,0,20,3
1708249255071,COGS 278,A00,406794,Jernigan; Terry Lynne,18,0,20,2
1708249255606,COMM 10,A01,394711,Schmidt; Thomas Rainer,20,0,24,4
1708249255606,COMM 10,A02,394714,Schmidt; Thomas Rainer,24,0,24,0
1708249255606,COMM 10,A03,394716,Schmidt; Thomas Rainer,24,0,24,0
1708249255606,COMM 10,A04,394717,Schmidt; Thomas Rainer,22,0,24,2
1708249255606,COMM 10,A05,394731,Schmidt; Thomas Rainer,24,0,24,0
1708249255606,COMM 10,A06,394733,Schmidt; Thomas Rainer,24,0,24,0
1708249255606,COMM 10,A07,394740,Schmidt; Thomas Rainer,24,0,24,0
1708249255606,COMM 10,A08,394741,Schmidt; Thomas Rainer,24,0,24,0
1708249255606,COMM 10,A09,394751,Schmidt; Thomas Rainer,23,0,24,1
1708249255606,COMM 10,A10,394779,Schmidt; Thomas Rainer,24,0,24,0
1708249255606,COMM 10,A11,394809,Schmidt; Thomas Rainer,24,0,24,0
1708249255606,COMM 10,A12,394811,Schmidt; Thomas Rainer,24,0,24,0
1708249255606,COMM 10,A13,394818,Schmidt; Thomas Rainer,24,0,24,0
1708249255606,COMM 10,A14,394825,Schmidt; Thomas Rainer,23,0,24,1
1708249255606,COMM 10,A15,394828,Schmidt; Thomas Rainer,24,0,24,0
1708249255606,COMM 10,A16,394829,Schmidt; Thomas Rainer,0,0,0,0
1708249255606,COMM 10,A17,486828,Schmidt; Thomas Rainer,20,0,21,1
1708249256133,COMM 20,A01,394834,McKenna; Denise,69,0,70,1
1708249256660,COMM 80,A01,394849,Campbell; Robert Harold,120,0,120,0
1708249257193,COMM 100C,A01,394957,Kidman; Shawna F,24,0,25,1
1708249257193,COMM 100C,A02,394972,Kidman; Shawna F,25,0,25,0
1708249257193,COMM 100C,A03,394977,Kidman; Shawna F,22,0,25,3
1708249257193,COMM 100C,A04,394981,Kidman; Shawna F,25,0,25,0
1708249257193,COMM 100C,A05,394985,Kidman; Shawna F,24,0,25,1
1708249257193,COMM 100C,A06,394989,Kidman; Shawna F,23,0,25,2
1708249257193,COMM 100C,A07,394993,Kidman; Shawna F,24,0,25,1
1708249257193,COMM 100C,A08,394997,Kidman; Shawna F,23,0,25,2
1708249257193,COMM 100C,A09,394999,Kidman; Shawna F,25,0,25,0
1708249257193,COMM 100C,A10,395018,Kidman; Shawna F,25,0,25,0
1708249257193,COMM 100C,A11,395041,Kidman; Shawna F,24,0,25,1
1708249257193,COMM 100C,A12,395080,Kidman; Shawna F,24,0,25,1
1708249257725,COMM 101,A01,395135,Halm; Gavin Patrick,15,0,15,0
1708249257725,COMM 101,A02,395252,Halm; Gavin Patrick,15,0,15,0
1708249257725,COMM 101,A03,395253,Halm; Gavin Patrick,15,0,15,0
1708249257725,COMM 101,A04,395263,Halm; Gavin Patrick,15,0,15,0
1708249258266,COMM 101D,A00,395264,Martinico; Daniel J,13,0,16,3
1708249258792,COMM 101K,A00,395266,Ahn; Patricia Jeehyun,16,0,18,2
1708249259333,COMM 101N,A00,395267,Martinico; Daniel J,16,0,16,0
1708249259865,COMM 102C,A01,395270,Campion; Camille E,5,0,6,1
1708249259865,COMM 102C,A02,395271,Campion; Camille E,6,0,6,0
1708249259865,COMM 102C,A03,395272,Campion; Camille E,5,0,6,1
1708249260392,COMM 102M,A01,395285,Davis; Zeinabu I.,9,0,10,1
1708249260392,COMM 102M,A02,395288,Davis; Zeinabu I.,8,0,10,2
1708249260924,COMM 103D,A00,395343,Gates; Kelly,34,0,35,1
1708249261506,COMM 107,A00,395461,Serlin; David,33,0,35,2
1708249263051,COMM 109D,A00,395462,Halm; Gavin Patrick,72,0,75,3
1708249263593,COMM 110G,A00,395481,Whitworth-Smith; Andrew C,32,0,35,3
1708249264123,COMM 110M,A00,395482,Harb; Anthony Joseph,34,0,35,1
1708249264653,COMM 111A,A00,487217,Pavon Aramburu; Maria Laur,34,0,35,1
1708249265184,COMM 113T,A00,395516,Fields; Gary,35,0,35,0
1708249265711,COMM 114A,A00,395517,Zilberg; Elana,32,0,35,3
1708249266238,COMM 114B,A00,395523,Zilberg; Elana,19,0,20,1
1708249266765,COMM 114E,A00,487218,Pavon Aramburu; Maria Laur,34,0,35,1
1708249267310,COMM 114W,A00,395524,Walkover; Lillian B,17,0,18,1
1708249267837,COMM 126,A00,479341,Staff,26,0,30,4
1708249268361,COMM 132,A00,481491,Rojo Solis; Juan Jose,0,0,0,0
1708249268890,COMM 134,A00,395578,Abuelhiga; Soraya Jill,28,0,30,2
1708249269416,COMM 143,A00,395579,Rojo Solis; Juan Jose,28,0,30,2
1708249269945,COMM 146,A00,395584,Jack; Caroline Sarah,29,0,30,1
1708249270475,COMM 168,A00,395592,Harb; Anthony Joseph,29,0,30,1
1708249271004,COMM 170,A00,395608,Pavon Aramburu; Maria Laur,30,0,30,0
1708249271533,COMM 173,A00,395609,Alac; Morana,29,0,30,1
1708249272060,COMM 174,A00,395679,Alac; Morana,30,0,30,0
1708249272585,COMM 190,A00,395682,Abuelhiga; Soraya Jill,19,0,23,4
1708249272585,COMM 190,B00,395696,Staff,21,0,23,2
1708249272585,COMM 190,C00,395697,Fattal; Alexander Leor,22,0,23,1
1708249273116,CSE 8A,A50,459200,Miranda; Gregory Joseph,34,0,35,1
1708249273116,CSE 8A,A51,459205,Miranda; Gregory Joseph,34,0,35,1
1708249273116,CSE 8A,A52,459206,Miranda; Gregory Joseph,34,0,35,1
1708249273116,CSE 8A,A53,459212,Miranda; Gregory Joseph,34,0,35,1
1708249273116,CSE 8A,A54,459213,Miranda; Gregory Joseph,34,0,35,1
1708249273116,CSE 8A,A55,459232,Miranda; Gregory Joseph,34,0,35,1
1708249273641,CSE 11,A01,470735,Ochoa; Benjamin Lawrence,180,0,195,15
1708249274169,CSE 12,A01,470744,Cao; Yingjun,189,0,200,11
1708249274169,CSE 12,B01,470752,Miranda; Gregory Joseph,71,0,100,29
1708249274169,CSE 12,B02,470760,Miranda; Gregory Joseph,93,0,100,7
1708249274704,CSE 15L,A01,410174,Solares; Edwin A,6,0,10,4
1708249274704,CSE 15L,B01,410215,Solares; Edwin A,7,0,10,3
1708249274704,CSE 15L,C01,410305,Solares; Edwin A,3,0,10,7
1708249274704,CSE 15L,D01,410400,Solares; Edwin A,1,0,10,9
1708249275229,CSE 20,A01,470765,Minnes Kemp; Mor Mia,145,0,150,5
1708249275777,CSE 21,A01,470776,Jones; Miles E,68,0,73,5
1708249275777,CSE 21,A02,482889,Jones; Miles E,68,0,72,4
1708249276348,CSE 29,A01,494014,Soosai Raj; Adalbert Geral,48,0,50,2
1708249276348,CSE 29,A02,494016,Soosai Raj; Adalbert Geral,40,0,50,10
1708249276348,CSE 29,B01,494018,Shalev; Aaron D,16,0,20,4
1708249276884,CSE 30,A01,470784,Cao; Yingjun,141,0,150,9
1708249276884,CSE 30,B01,467469,Muller; P Keith,98,0,120,22
1708249277424,CSE 87,A00,410528,Moshiri; Niema,20,0,20,0
1708249277970,CSE 90,A00,486885,Minnes Kemp; Mor Mia,0,0,0,0
1708249278515,CSE 91,A00,486872,Minnes Kemp; Mor Mia,0,0,0,0
1708249278515,CSE 91,B00,486873,Minnes Kemp; Mor Mia,0,0,0,0
1708249279039,CSE 95,A00,410529,Minnes Kemp; Mor Mia,50,0,50,0
1708249279570,CSE 100,A01,470792,Sahoo; Debashis,55,0,70,15
1708249280097,CSE 100R,A01,410556,Moshiri; Niema,1,0,40,39
1708249280623,CSE 101,A01,470797,Jones; Miles E,14,0,44,30
1708249280623,CSE 101,A02,482892,Jones; Miles E,32,0,43,11
1708249281151,CSE 105,A01,470800,Micciancio; Daniele,85,0,98,13
1708249281680,CSE 107,A01,467479,Bellare; Mihir,141,0,146,5
1708249282212,CSE 109,A01,459538,Shang; Jingbo,0,0,25,25
1708249282745,CSE 110,A50,459395,Powell; Thomas Allan,49,0,50,1
1708249282745,CSE 110,A51,459512,Powell; Thomas Allan,37,0,50,13
1708249282745,CSE 110,A52,459513,Powell; Thomas Allan,46,0,50,4
1708249282745,CSE 110,A53,459514,Powell; Thomas Allan,48,0,50,2
1708249282745,CSE 110,A54,459515,Powell; Thomas Allan,48,0,50,2
1708249282745,CSE 110,A55,459516,Powell; Thomas Allan,45,0,50,5
1708249282745,CSE 110,A56,459517,Powell; Thomas Allan,47,0,48,1
1708249283271,CSE 112,A50,459518,Powell; Thomas Allan,132,0,146,14
1708249283800,CSE 120,A01,470808,Zhou; Yuan-Yuan,167,0,200,33
1708249284326,CSE 125,A00,410564,Voelker; Geoffrey M.,30,0,30,0
1708249284852,CSE 127,A01,467484,Fernandes; Earlence T,175,0,196,21
1708249285380,CSE 130,A01,467485,Polikarpova; Nadezhda,176,0,192,16
1708249285907,CSE 131,A01,459522,Ding; Yufei,36,0,50,14
1708249286434,CSE 132B,A01,470816,Deutsch; Alin Bernard,60,0,70,10
1708249286959,CSE 140,A01,410606,Orailoglu; Alex,99,0,100,1
1708249286959,CSE 140,B01,410622,Eldon; John,130,0,146,16
1708249287484,CSE 140L,A01,410655,Orailoglu; Alex,98,0,100,2
1708249287484,CSE 140L,B01,410658,Eldon; John,123,0,146,23
1708249288013,CSE 141,A01,467486,Zhao; Jishen,173,0,196,23
1708249288539,CSE 141L,A01,410685,Eldon; John,162,0,196,34
1708249289068,CSE 145,A01,410713,Kastner; Ryan Charles,25,0,25,0
1708249289600,CSE 150B,A01,470824,Gao; Sicun,310,0,362,52
1708249290126,CSE 156,A01,467487,Nakashole; Ndapandula,140,0,192,52
1708249290651,CSE 165,A01,410757,Weibel; Nadir & Schulze; Jurgen P.,40,0,50,10
1708249291183,CSE 168,A01,410759,Ramamoorthi; Ravi,24,0,25,1
1708249291183,CSE 168,A02,410761,Ramamoorthi; Ravi,24,0,25,1
1708249291713,CSE 175,A01,410764,Kumar; Rakesh,48,0,50,2
1708249292244,CSE 182,A01,455011,Bafna; Vineet,47,0,50,3
1708249293008,CSE 185,A01,410895,Gymrek; Melissa Ann,41,0,57,16
1708249293008,CSE 185,A02,479240,Gymrek; Melissa Ann,53,0,58,5
1708249293536,CSE 190,A00,410982,Grier; Daniel T,48,0,50,2
1708249293536,CSE 190,B00,410983,Riek; Laurel D,50,0,50,0
1708249293536,CSE 190,C00,410984,Staff,36,0,50,14
1708249293536,CSE 190,D00,481666,Saha; Barna & Impagliazzo; Russell,27,0,28,1
1708249294062,CSE 203A,A00,410985,Saha; Barna & Impagliazzo; Russell,0,0,0,0
1708249294591,CSE 209A,A00,410986,Grier; Daniel T,0,0,0,0
1708249295123,CSE 209B,A00,410987,Bellare; Mihir,0,0,0,0
1708249295649,CSE 217,A01,459553,Weibel; Nadir,0,0,0,0
1708249296177,CSE 218,A00,410989,Griswold; William G.,0,0,0,0
1708249296708,CSE 219,A00,410990,Hollan; James D. & Xia; Haijun,0,0,0,0
1708249297250,CSE 224,A01,470832,Snoeren; Alex C.,0,0,0,0
1708249297779,CSE 229A,A00,410993,Shalev; Aaron D,0,0,0,0
1708249298305,CSE 229C,A00,410994,Fernandes; Earlence T,0,0,0,0
1708249298830,CSE 231,A01,467488,Jhala; Ranjit,0,0,0,0
1708249299355,CSE 233,A00,410996,Vianu; Victor Dan,0,0,0,0
1708249299886,CSE 237D,A00,410998,Kastner; Ryan Charles,0,0,0,0
1708249300412,CSE 239A,A00,410999,Vianu; Victor Dan,0,0,0,0
1708249300940,CSE 239B,A00,411000,Coblenz; Michael J,0,0,0,0
1708249301467,CSE 240A,A00,411001,Chin; Bryan W.,0,0,0,0
1708249301994,CSE 252D,A00,411004,Chandraker; Manmohan Krishna,0,0,0,0
1708249302520,CSE 256,A00,411005,Nakashole; Ndapandula,0,0,0,0
1708249303049,CSE 260,A01,467491,Chin; Bryan W.,0,0,0,0
1708249303575,CSE 276B,A00,411007,Riek; Laurel D,0,0,0,0
1708249304100,CSE 276F,A01,459554,Su; Hao,0,0,0,0
1708249304626,CSE 283,A00,411009,Bafna; Vineet & Zhong; Sheng,0,0,0,0
1708249305152,CSE 290,A00,411010,Gao; Sicun,0,0,0,0
1708249305152,CSE 290,B00,411011,Chern; Albert Ren-Haur,0,0,0,0
1708249305152,CSE 290,C00,411012,Swanson; Steven James,0,0,0,0
1708249305152,CSE 290,E00,411013,Su; Hao,0,0,0,0
1708249305152,CSE 290,F00,411014,Riek; Laurel D,0,0,0,0
1708249305152,CSE 290,G00,411015,Gymrek; Melissa Ann,0,0,0,0
1708249305152,CSE 290,H00,479239,Dasgupta; Sanjoy & Gymrek; Melissa Ann,0,0,0,0
1708249305152,CSE 290,I00,481669,Bafna; Vineet,0,0,0,0
1708249305152,CSE 290,J00,494949,Paturi; Ramamohan,0,0,0,0
1708249305680,CSE 291,A00,411016,Li; Tzumao,0,0,0,0
1708249305680,CSE 291,B00,411017,Heninger; Nadia A,0,0,0,0
1708249305680,CSE 291,C00,411114,Chern; Albert Ren-Haur,0,0,0,0
1708249305680,CSE 291,D00,411115,Zhang; Yiying,0,0,0,0
1708249305680,CSE 291,E00,411116,Cheng; Chung Kuan,0,0,0,0
1708249305680,CSE 291,G00,411118,Lerner; Sorin,0,0,0,0
1708249305680,CSE 291,I00,481509,Shang; Jingbo,0,0,0,0
1708249305680,CSE 291,J00,494844,Savage; Stefan & Stefan; Deian,50,0,50,0
1708249306256,CSE 293,001,487239,Bafna; Vineet,9999,0,9999,0
1708249306256,CSE 293,002,487240,Bellare; Mihir,9999,0,9999,0
1708249306256,CSE 293,003,487241,Berg-Kirkpatrick; Taylor D,9999,0,9999,0
1708249306256,CSE 293,004,487242,Chandraker; Manmohan Krishna,9999,0,9999,0
1708249306256,CSE 293,005,487243,Cheng; Chung Kuan,9999,0,9999,0
1708249306256,CSE 293,006,487244,Christensen; Henrik I,9999,0,9999,0
1708249306256,CSE 293,007,487245,Coblenz; Michael J,9999,0,9999,0
1708249306256,CSE 293,008,487363,Cottrell; Garrison W,9999,0,9999,0
1708249306256,CSE 293,009,487366,Deutsch; Alin Bernard,9999,0,9999,0
1708249306256,CSE 293,010,487433,Esmaeilzadeh; Hadi,9999,0,9999,0
1708249306256,CSE 293,011,487434,Freund; Yoav,9999,0,9999,0
1708249306256,CSE 293,012,487455,Griswold; William G.,9999,0,9999,0
1708249306256,CSE 293,013,487469,Gymrek; Melissa Ann,9999,0,9999,0
1708249306256,CSE 293,014,487470,Heninger; Nadia A,9999,0,9999,0
1708249306256,CSE 293,015,487471,Impagliazzo; Russell,9999,0,9999,0
1708249306256,CSE 293,016,487472,Jhala; Ranjit,9999,0,9999,0
1708249306256,CSE 293,017,487473,Kahng; Andrew Byun,9999,0,9999,0
1708249306256,CSE 293,018,487474,Kane; Daniel Mertz,9999,0,9999,0
1708249306256,CSE 293,019,487475,Kriegman; David J,9999,0,9999,0
1708249306256,CSE 293,020,487476,Kumar; Arun Kumar,9999,0,9999,0
1708249306256,CSE 293,021,487477,Lerner; Sorin,9999,0,9999,0
1708249306256,CSE 293,022,487478,Lovett; Shachar,9999,0,9999,0
1708249306256,CSE 293,023,487520,McAuley; Julian John,9999,0,9999,0
1708249306256,CSE 293,024,487522,Micciancio; Daniele,9999,0,9999,0
1708249306256,CSE 293,025,487577,Orailoglu; Alex,9999,0,9999,0
1708249306256,CSE 293,026,487586,Pannuto; Patrick William,9999,0,9999,0
1708249306256,CSE 293,027,487598,Paturi; Ramamohan,9999,0,9999,0
1708249306256,CSE 293,028,487604,Polikarpova; Nadezhda,9999,0,9999,0
1708249306256,CSE 293,029,487609,Politz; Joseph Gibbs,9999,0,9999,0
1708249306256,CSE 293,030,487642,Porter; George M,9999,0,9999,0
1708249306256,CSE 293,031,487665,Porter; Leonard Emerson,9999,0,9999,0
1708249306256,CSE 293,032,487689,Ramamoorthi; Ravi,9999,0,9999,0
1708249306256,CSE 293,033,487698,Riek; Laurel D,9999,0,9999,0
1708249306256,CSE 293,034,487712,Sahoo; Debashis,9999,0,9999,0
1708249306256,CSE 293,035,487721,Saul; Lawrence,9999,0,9999,0
1708249306256,CSE 293,036,487735,Savage; Stefan,9999,0,9999,0
1708249306256,CSE 293,037,487744,Schulze; Jurgen P.,9999,0,9999,0
1708249306256,CSE 293,038,487758,Snoeren; Alex C.,9999,0,9999,0
1708249306256,CSE 293,039,487767,Shang; Jingbo,9999,0,9999,0
1708249306256,CSE 293,040,487790,Stefan; Deian,9999,0,9999,0
1708249306256,CSE 293,041,487817,Su; Hao,9999,0,9999,0
1708249306256,CSE 293,042,487827,Swanson; Steven James,9999,0,9999,0
1708249306256,CSE 293,043,487830,Tullsen; Dean Michael,9999,0,9999,0
1708249306256,CSE 293,044,487837,Vaccaro; Kristen Marie,9999,0,9999,0
1708249306256,CSE 293,045,487838,Voelker; Geoffrey M.,9999,0,9999,0
1708249306256,CSE 293,046,487842,Zhao; Jishen,9999,0,9999,0
1708249306256,CSE 293,047,487847,Zhou; Yuan-Yuan,9999,0,9999,0
1708249306256,CSE 293,048,487852,Gao; Sicun,9999,0,9999,0
1708249306256,CSE 293,049,487853,Weibel; Nadir,9999,0,9999,0
1708249306256,CSE 293,050,487854,Gupta; Rajesh K.,9999,0,9999,0
1708249306256,CSE 293,051,487855,Soosai Raj; Adalbert Geral,9999,0,9999,0
1708249306256,CSE 293,052,494373,Zhang; Hao,9999,0,9999,0
1708249306785,CSE 294,A00,411124,Voelker; Geoffrey M.,15,0,15,0
1708249307332,CSS 100,A01,396053,Trott; Sean Thomas,43,0,50,7
1708249307858,CSS 120,A01,479237,Mignozzetti; Umberto,47,0,50,3
1708249307858,CSS 120,A02,479238,Mignozzetti; Umberto,50,0,50,0
1708249308385,CSS 209,A00,396054,Styler; William Francis,21,0,35,14
1708249308920,CSS 296,001,396055,Mignozzetti; Umberto,0,0,0,1
1708249308920,CSS 296,002,396056,Styler; William Francis,0,0,0,1
1708249308920,CSS 296,003,396057,Broz; James Lawrence,0,0,0,2
1708249308920,CSS 296,004,396058,Elliott; Graham,0,0,0,5
1708249308920,CSS 296,005,396059,Sun; Feiyang,0,0,0,0
1708249308920,CSS 296,006,396060,Dewaard; Andrew Michael,0,0,0,0
1708249309449,DDPM 210,A00,400652,Ma; Joseph David,36,0,36,0
1708249309974,DDPM 211,A00,400653,Ma; Joseph David,36,0,36,0
1708249310516,DDPM 214,A00,400720,Ma; Joseph David,36,0,36,0
1708249311041,DERM 296,001,464131,Staff,50,0,50,0
1708249311041,DERM 296,002,464178,Staff,50,0,50,0
1708249311041,DERM 296,003,464181,Staff,50,0,50,0
1708249311671,DOC 3,A01,399409,Strom; Megan C.,0,0,0,0
1708249311671,DOC 3,A02,399414,Strom; Megan C.,0,0,0,0
1708249311671,DOC 3,A03,399432,Strom; Megan C.,0,0,0,0
1708249311671,DOC 3,A04,399461,Strom; Megan C.,0,0,0,0
1708249311671,DOC 3,A05,399470,Strom; Megan C.,0,0,0,0
1708249311671,DOC 3,A06,399476,Strom; Megan C.,0,0,0,0
1708249311671,DOC 3,A07,399547,Strom; Megan C.,0,0,0,0
1708249311671,DOC 3,A08,399548,Strom; Megan C.,0,0,0,0
1708249311671,DOC 3,A09,399675,Strom; Megan C.,0,0,0,0
1708249311671,DOC 3,A10,399687,Strom; Megan C.,0,0,0,0
1708249311671,DOC 3,A11,399704,Strom; Megan C.,0,0,0,0
1708249311671,DOC 3,A12,399707,Strom; Megan C.,0,0,0,0
1708249311671,DOC 3,A13,399714,Strom; Megan C.,0,0,0,0
1708249311671,DOC 3,A14,399721,Strom; Megan C.,0,0,0,0
1708249311671,DOC 3,A15,399765,Strom; Megan C.,0,0,0,0
1708249311671,DOC 3,A16,399766,Strom; Megan C.,0,0,0,0
1708249311671,DOC 3,B01,399786,Strom; Megan C.,0,0,0,0
1708249311671,DOC 3,B02,399787,Strom; Megan C.,0,0,0,0
1708249311671,DOC 3,B03,399788,Strom; Megan C.,0,0,0,0
1708249311671,DOC 3,B04,399845,Strom; Megan C.,0,0,0,0
1708249311671,DOC 3,B05,399846,Strom; Megan C.,0,0,0,0
1708249311671,DOC 3,B06,399895,Strom; Megan C.,0,0,0,0
1708249311671,DOC 3,B07,399916,Strom; Megan C.,0,0,0,0
1708249311671,DOC 3,B08,400073,Strom; Megan C.,0,0,0,0
1708249311671,DOC 3,B09,400074,Strom; Megan C.,0,0,0,0
1708249311671,DOC 3,B10,400076,Strom; Megan C.,0,0,0,0
1708249311671,DOC 3,B11,400077,Strom; Megan C.,0,0,0,0
1708249311671,DOC 3,B12,400078,Strom; Megan C.,0,0,0,0
1708249311671,DOC 3,B13,400079,Strom; Megan C.,0,0,0,0
1708249311671,DOC 3,B14,400080,Strom; Megan C.,0,0,0,0
1708249311671,DOC 3,B15,400081,Strom; Megan C.,0,0,0,0
1708249311671,DOC 3,B16,400082,Strom; Megan C.,0,0,0,0
1708249311671,DOC 3,C01,400084,Chapman; Dillon,0,0,0,0
1708249311671,DOC 3,C02,400085,Chapman; Dillon,0,0,0,0
1708249311671,DOC 3,C03,400086,Chapman; Dillon,0,0,0,0
1708249311671,DOC 3,C04,400087,Chapman; Dillon,0,0,0,0
1708249311671,DOC 3,C05,400113,Chapman; Dillon,0,0,0,0
1708249311671,DOC 3,C06,400114,Chapman; Dillon,0,0,0,0
1708249311671,DOC 3,C07,400117,Chapman; Dillon,0,0,0,0
1708249311671,DOC 3,C08,400118,Chapman; Dillon,0,0,0,0
1708249311671,DOC 3,C09,400119,Chapman; Dillon,0,0,0,0
1708249311671,DOC 3,C10,400121,Chapman; Dillon,0,0,0,0
1708249311671,DOC 3,C11,400122,Chapman; Dillon,0,0,0,0
1708249311671,DOC 3,C12,400126,Chapman; Dillon,0,0,0,0
1708249311671,DOC 3,C13,400157,Chapman; Dillon,0,0,0,0
1708249311671,DOC 3,C14,400240,Chapman; Dillon,0,0,0,0
1708249311671,DOC 3,C15,400241,Chapman; Dillon,0,0,0,0
1708249311671,DOC 3,C16,400242,Chapman; Dillon,0,0,0,0
1708249311671,DOC 3,D01,400253,Chapman; Dillon,0,0,0,0
1708249311671,DOC 3,D02,400294,Chapman; Dillon,0,0,0,0
1708249311671,DOC 3,D03,400295,Chapman; Dillon,0,0,0,0
1708249311671,DOC 3,D04,400430,Chapman; Dillon,0,0,0,0
1708249311671,DOC 3,D05,400438,Chapman; Dillon,0,0,0,0
1708249311671,DOC 3,D06,400439,Chapman; Dillon,0,0,0,0
1708249311671,DOC 3,D07,400441,Chapman; Dillon,0,0,0,0
1708249311671,DOC 3,D08,400442,Chapman; Dillon,0,0,0,0
1708249311671,DOC 3,D09,400443,Chapman; Dillon,0,0,0,0
1708249311671,DOC 3,D10,400445,Chapman; Dillon,0,0,0,0
1708249311671,DOC 3,D11,400446,Chapman; Dillon,0,0,0,0
1708249311671,DOC 3,D12,400447,Chapman; Dillon,0,0,0,0
1708249311671,DOC 3,D13,400448,Chapman; Dillon,0,0,0,0
1708249311671,DOC 3,D14,400646,Chapman; Dillon,0,0,0,0
1708249311671,DOC 3,D15,400647,Chapman; Dillon,0,0,0,0
1708249311671,DOC 3,D16,400648,Chapman; Dillon,0,0,0,0
1708249312197,DOC 100D,A00,400649,Pass; Natalye Joann,22,0,25,3
1708249312197,DOC 100D,B00,400650,Pass; Natalye Joann,25,0,25,0
1708249312745,DSC 10,A01,398041,Tiefenbruck; Janine LoBue,142,0,147,5
1708249312745,DSC 10,B01,398180,Tiefenbruck; Janine LoBue,144,0,147,3
1708249312745,DSC 10,C01,398400,Tiefenbruck; Janine LoBue,143,0,147,4
1708249313271,DSC 20,A01,398415,Langlois; Marina,200,0,200,0
1708249313800,DSC 30,A01,398436,Langlois; Marina,156,0,158,2
1708249313800,DSC 30,B01,398439,Langlois; Marina,144,0,150,6
1708249314330,DSC 40A,A01,398441,Rampure; Suraj,123,0,125,2
1708249314330,DSC 40A,B01,398443,Rampure; Suraj,125,0,125,0
1708249314856,DSC 40B,A01,398445,Staff,150,0,150,0
1708249315391,DSC 80,A01,398470,Lau; Samuel Ethan,70,0,70,0
1708249315391,DSC 80,B01,398541,Lau; Samuel Ethan,68,0,70,2
1708249315918,DSC 95,A01,398650,Rampure; Suraj,50,0,50,0
1708249316516,DSC 100,A01,398683,Salimi; Babak,147,0,150,3
1708249317042,DSC 102,A01,398708,Jin; Haojian,145,0,150,5
1708249317568,DSC 106,A01,398711,Wilber; Jared Dane,146,0,149,3
1708249318095,DSC 140A,A01,398724,Eldridge; Justin Matthew,98,0,100,2
1708249318095,DSC 140A,B01,479346,Ustun; Tevfik Berk,50,0,50,0
1708249318624,DSC 140B,A01,398726,Weng; Tsui-Wei (lily),144,0,150,6
1708249319152,DSC 190,A01,398738,Silberman; Jack,20,0,20,0
1708249319152,DSC 190,B01,479475,Ustun; Tevfik Berk,29,0,30,1
1708249319152,DSC 190,C01,481341,Rahman; Tauhidur,50,0,50,0
1708249319677,DSC 197,001,494360,Eldridge; Justin Matthew,9999,0,9999,0
1708249320203,DSC 214,A00,477322,Staff,22,0,60,38
1708249320731,DSC 231,A01,398863,Gupta; Rajesh K.,60,0,60,0
1708249321261,DSC 232R,A01,487133,Solares; Edwin A,39,0,60,21
1708249321786,DSC 240,A00,398957,Belkin; Mikhail,74,0,90,16
1708249322844,DSC 243,A00,398958,Ma; Yian,59,0,60,1
1708249323369,DSC 245,A00,398959,Huang; Biwei,42,0,60,18
1708249323895,DSC 253,A00,398960,Shang; Jingbo,0,0,30,30
1708249324426,DSC 258R,A01,398962,Shang; Jingbo,43,0,60,17
1708249324956,DSC 267R,A01,398964,Staff,56,0,60,4
1708249325483,DSC 291,A00,398965,Belkin; Mikhail,90,0,90,0
1708249325483,DSC 291,B00,398966,Weng; Tsui-Wei (lily),90,0,90,0
1708249325483,DSC 291,C00,398997,Staff,60,0,60,0
1708249325483,DSC 291,D00,398998,Zhang; Hao,40,0,40,0
1708249325483,DSC 291,E00,477386,Staff,50,0,50,0
1708249326012,DSC 293,A00,477388,Ustun; Tevfik Berk,9990,0,9999,9
1708249326539,DSC 295,A00,480826,Danks; David J,30,0,40,10
1708249327065,DSE 220,A00,398034,Dasgupta; Sanjoy,20,0,20,0
1708249327591,DSE 230,A00,398035,Nguyen; Mai Huong,20,0,20,0
1708249328117,DSE 260B,A00,398037,Altintas De Callaf; Ilkay,20,0,20,0
1708249328643,DSGN 1,A01,408210,Klemmer; Scott R,46,0,50,4
1708249328643,DSGN 1,A02,408245,Klemmer; Scott R,47,0,50,3
1708249329170,DSGN 119,A00,407467,Hollan; James D. & Xia; Haijun,76,0,90,14
1708249329696,DSGN 160,A00,494371,Aronoff-Spencer; Eliah Sea,15,0,20,5
1708249330225,DSGN 219,A00,474323,Hollan; James D. & Xia; Haijun,15,0,15,0
1708249330752,ECE 5,A01,428645,Morris; Karcher William,21,0,24,3
1708249330752,ECE 5,A02,428646,Morris; Karcher William,24,0,24,0
1708249330752,ECE 5,A03,428647,Morris; Karcher William,24,0,24,0
1708249330752,ECE 5,A04,428648,Morris; Karcher William,24,0,24,0
1708249331277,ECE 15,A01,428650,Sahay; Rajeev,119,0,120,1
1708249331804,ECE 16,A01,428652,Wang; Edward Jay,22,0,30,8
1708249332333,ECE 17,A01,428654,Sahay; Rajeev,48,0,60,12
1708249332859,ECE 25,A50,428657,Dey; Sujit,30,0,30,0
1708249332859,ECE 25,A51,428658,Dey; Sujit,30,0,30,0
1708249333386,ECE 30,A50,428674,Mir Arabbaygi; Siavash,28,0,30,2
1708249333386,ECE 30,A51,428675,Mir Arabbaygi; Siavash,28,0,30,2
1708249333386,ECE 30,A52,428676,Mir Arabbaygi; Siavash,28,0,30,2
1708249333386,ECE 30,A53,428679,Mir Arabbaygi; Siavash,29,0,30,1
1708249333386,ECE 30,A54,428680,Mir Arabbaygi; Siavash,30,0,30,0
1708249333914,ECE 35,A50,428684,Taur; Yuan,29,0,30,1
1708249333914,ECE 35,A51,428685,Taur; Yuan,30,0,30,0
1708249333914,ECE 35,A52,428686,Taur; Yuan,30,0,30,0
1708249333914,ECE 35,A53,428687,Taur; Yuan,29,0,30,1
1708249334442,ECE 45,A01,428689,Zeger; Kenneth A.,137,0,150,13
1708249334968,ECE 65,A50,428701,Baghdadchi; Saharnaz,28,0,30,2
1708249334968,ECE 65,A51,428742,Baghdadchi; Saharnaz,29,0,30,1
1708249334968,ECE 65,A52,428743,Baghdadchi; Saharnaz,30,0,30,0
1708249334968,ECE 65,A53,428754,Baghdadchi; Saharnaz,26,0,30,4
1708249334968,ECE 65,A54,428796,Baghdadchi; Saharnaz,30,0,30,0
1708249334968,ECE 65,A55,428797,Baghdadchi; Saharnaz,29,0,30,1
1708249334968,ECE 65,A56,428803,Baghdadchi; Saharnaz,30,0,30,0
1708249335495,ECE 100,A01,428978,Baghdadchi; Saharnaz,29,0,30,1
1708249335495,ECE 100,A02,428988,Baghdadchi; Saharnaz,30,0,30,0
1708249335495,ECE 100,A03,428989,Baghdadchi; Saharnaz,29,0,30,1
1708249335495,ECE 100,A04,429008,Baghdadchi; Saharnaz,29,0,30,1
1708249336027,ECE 101,A01,429017,Bharadia; Dinesh,57,0,60,3
1708249336027,ECE 101,A02,429019,Bharadia; Dinesh,60,0,60,0
1708249336555,ECE 103,A01,429027,Kuzum; Duygu,74,0,75,1
1708249337083,ECE 107,A01,429055,Fullerton; Eric E,73,0,75,2
1708249337608,ECE 108,A01,429068,Kang; Mingu,53,0,60,7
1708249338136,ECE 109,A01,429085,Orlitsky; Alon,98,0,100,2
1708249338136,ECE 109,A02,429098,Orlitsky; Alon,96,0,100,4
1708249338663,ECE 111,A01,429132,Turakhia; Yatish Girish,173,0,180,7
1708249339190,ECE 115,A01,429314,Yip; Michael,22,0,26,4
1708249339721,ECE 123,A01,429327,Sievenpiper; Daniel F.,56,0,60,4
1708249340248,ECE 125B,A50,429397,Esmaili; Gholamreza,23,0,24,1
1708249340248,ECE 125B,A51,429627,Esmaili; Gholamreza,23,0,24,1
1708249340772,ECE 134,A00,429630,Ng; Tse Nga,50,0,50,0
1708249341300,ECE 136L,A01,429634,Dayeh; Shadi Ahmad,3,0,5,2
1708249341300,ECE 136L,A02,429636,Dayeh; Shadi Ahmad,3,0,5,2
1708249341300,ECE 136L,A03,429637,Dayeh; Shadi Ahmad,5,0,5,0
1708249341300,ECE 136L,A04,429641,Dayeh; Shadi Ahmad,5,0,5,0
1708249341830,ECE 139,A00,429642,Nomura; Kenji,17,0,20,3
1708249342364,ECE 140B,A01,455349,Khoshabeh; Ramsin & Gessner; Richard K.,19,0,24,5
1708249342364,ECE 140B,A02,455351,Khoshabeh; Ramsin & Gessner; Richard K.,23,0,24,1
1708249342364,ECE 140B,A03,455354,Khoshabeh; Ramsin & Gessner; Richard K.,21,0,22,1
1708249342893,ECE 141B,A01,455355,Gessner; Richard K.,48,0,50,2
1708249343427,ECE 148,A01,492803,Silberman; Jack,0,0,0,0
1708249343958,ECE 153,A01,429655,Naghizadeh Ardabili; Parin,94,0,100,6
1708249344488,ECE 157A,A01,429657,Bharadia; Dinesh,22,0,25,3
1708249345015,ECE 158B,A01,429659,Zhang; Xinyu,14,0,20,6
1708249345541,ECE 161C,A00,429660,Cosman; Pamela C.,58,0,60,2
1708249346066,ECE 163,A00,429664,Hsueh; Tzu-Chien,95,0,100,5
1708249346600,ECE 165,A51,429672,Mercier; Patrick Philip,20,0,30,10
1708249346600,ECE 165,A52,429673,Mercier; Patrick Philip,22,0,30,8
1708249346600,ECE 165,A53,429674,Mercier; Patrick Philip,30,0,30,0
1708249346600,ECE 165,A54,429675,Mercier; Patrick Philip,30,0,30,0
1708249347130,ECE 171A,A01,429813,Zheng; Yang,96,0,100,4
1708249347661,ECE 175B,A01,429886,Xie; Pengtao,72,0,75,3
1708249348187,ECE 183,A01,430023,Mookherjea; Shayan,26,0,30,4
1708249348718,ECE 185,A01,430025,Papen; George C.,19,0,20,1
1708249349245,ECE 191,A00,430039,Zhang; Xinyu,30,0,30,0
1708249349775,ECE 196,A00,430040,Morris; Karcher William,18,0,24,6
1708249349775,ECE 196,B00,430045,Morris; Karcher William,23,0,24,1
1708249350300,ECE 198,001,430052,Nguyen; Truong Quang,9999,0,9999,0
1708249350855,ECE 200,001,438659,Atanasov; Nikolay A.,9999,0,9999,0
1708249350855,ECE 200,002,438660,Bharadia; Dinesh,9999,0,9999,0
1708249350855,ECE 200,003,438668,Cheng; Chung Kuan,9999,0,9999,0
1708249350855,ECE 200,004,438845,Cosman; Pamela C.,9999,0,9999,0
1708249350855,ECE 200,005,438846,Dayeh; Shadi Ahmad,9999,0,9999,0
1708249350855,ECE 200,006,438847,Fainman; Yeshaiahu,9999,0,9999,0
1708249350855,ECE 200,007,438848,Ford; Joseph Earl,9999,0,9999,0
1708249350855,ECE 200,008,438849,Franceschetti; Massimo,9999,0,9999,0
1708249350855,ECE 200,009,438850,Fullerton; Eric E,9999,0,9999,0
1708249350855,ECE 200,010,438851,Galton; Ian A,9999,0,9999,0
1708249350855,ECE 200,011,438852,Gilja; Vikash,9999,0,9999,0
1708249350855,ECE 200,012,438853,Hall; Drew A.,9999,0,9999,0
1708249350855,ECE 200,013,438854,Hsueh; Tzu-Chien,9999,0,9999,0
1708249350855,ECE 200,014,438855,Javidi; Tara,9999,0,9999,0
1708249350855,ECE 200,015,438865,Kahng; Andrew Byun,9999,0,9999,0
1708249350855,ECE 200,016,438866,Kim; Young-Han,9999,0,9999,0
1708249350855,ECE 200,017,438876,Koushanfar; Farinaz,9999,0,9999,0
1708249350855,ECE 200,018,438877,Kuzum; Duygu,9999,0,9999,0
1708249350855,ECE 200,019,438934,Le; Hanh-Phuc,9999,0,9999,0
1708249350855,ECE 200,020,438954,Lin; Bill,9999,0,9999,0
1708249350855,ECE 200,021,438955,Liu; Zhaowei,9999,0,9999,0
1708249350855,ECE 200,022,438957,Lo; Yu-Hwa,9999,0,9999,0
1708249350855,ECE 200,023,439086,Lomakin; Vitaliy,9999,0,9999,0
1708249350855,ECE 200,024,439087,Mercier; Patrick Philip,9999,0,9999,0
1708249350855,ECE 200,025,439088,Meyer; Florian,9999,0,9999,0
1708249350855,ECE 200,026,439090,Milstein; Laurence B.,9999,0,9999,0
1708249350855,ECE 200,027,439208,Mir Arabbaygi; Siavash,9999,0,9999,0
1708249350855,ECE 200,028,439209,Mookherjea; Shayan,9999,0,9999,0
1708249350855,ECE 200,029,439210,Morris; Karcher William,9999,0,9999,0
1708249350855,ECE 200,030,439211,Ng; Tse Nga,9999,0,9999,0
1708249350855,ECE 200,031,439219,Nguyen; Truong Quang,9999,0,9999,0
1708249350855,ECE 200,032,439220,Nomura; Kenji,9999,0,9999,0
1708249350855,ECE 200,033,439221,Orlitsky; Alon,9999,0,9999,0
1708249350855,ECE 200,034,439222,Pal; Piya,9999,0,9999,0
1708249350855,ECE 200,035,439223,Papen; George C.,9999,0,9999,0
1708249350855,ECE 200,036,439224,Radic; Stojan,9999,0,9999,0
1708249350855,ECE 200,037,439225,Rao; Bhaskar D.,9999,0,9999,0
1708249350855,ECE 200,038,439227,Rao; Ramesh R,9999,0,9999,0
1708249350855,ECE 200,039,439231,Rebeiz; Gabriel,9999,0,9999,0
1708249350855,ECE 200,040,439232,Sanford; John R,9999,0,9999,0
1708249350855,ECE 200,041,439302,Siegel; Paul H.,9999,0,9999,0
1708249350855,ECE 200,042,439303,Sievenpiper; Daniel F.,9999,0,9999,0
1708249350855,ECE 200,043,439305,Sworder; David D.,9999,0,9999,0
1708249350855,ECE 200,044,439306,Taur; Yuan,9999,0,9999,0
1708249350855,ECE 200,045,439419,Touri; Behrouz,9999,0,9999,0
1708249350855,ECE 200,046,439425,Trivedi; Mohan M.,9999,0,9999,0
1708249350855,ECE 200,047,439538,Vasconcelos; Nuno,9999,0,9999,0
1708249350855,ECE 200,048,439546,Wang; Xiaolong,9999,0,9999,0
1708249350855,ECE 200,049,439549,Xie; Pengtao,9999,0,9999,0
1708249350855,ECE 200,050,439551,Yip; Michael,9999,0,9999,0
1708249350855,ECE 200,051,439553,Zeger; Kenneth A.,9999,0,9999,0
1708249350855,ECE 200,052,439554,Zhang; Xinyu,9999,0,9999,0
1708249350855,ECE 200,053,439555,Zheng; Yang,9999,0,9999,0
1708249350855,ECE 200,054,439557,Turakhia; Yatish Girish,9999,0,9999,0
1708249350855,ECE 200,055,439558,Kang; Mingu,9999,0,9999,0
1708249350855,ECE 200,056,439560,Shi; Yuanyuan,9999,0,9999,0
1708249350855,ECE 200,057,439564,Wang; Edward Jay,9999,0,9999,0
1708249350855,ECE 200,058,439565,Antipa; Nicholas A,9999,0,9999,0
1708249350855,ECE 200,059,439566,Zheng; Yang,9999,0,9999,0
1708249350855,ECE 200,060,492991,Yu; Paul K L,9999,0,9999,0
1708249350855,ECE 200,061,492992,Ndao; Abdoulaye,9999,0,9999,0
1708249350855,ECE 200,062,493019,Naghizadeh Ardabili; Parin,9999,0,9999,0
1708249350855,ECE 200,063,493033,Sahay; Rajeev,9999,0,9999,0
1708249351385,ECE 208,A00,430053,Mir Arabbaygi; Siavash,0,0,0,0
1708249351916,ECE 212CN,A00,430054,Liu; Zhaowei,0,0,0,0
1708249352442,ECE 222C,A00,430055,Lomakin; Vitaliy,0,0,0,0
1708249352968,ECE 227,A00,430057,Franceschetti; Massimo,0,0,0,0
1708249353494,ECE 228,A00,430078,Shi; Yuanyuan,0,0,0,0
1708249354020,ECE 230C,A00,430079,Yu; Paul K L,0,0,0,0
1708249354547,ECE 235,A00,430081,Taur; Yuan,0,0,0,0
1708249355074,ECE 236B,A00,430082,Lo; Yu-Hwa,0,0,0,0
1708249355601,ECE 240C,A00,430083,Mookherjea; Shayan,0,0,0,0
1708249356132,ECE 250,A00,430115,Touri; Behrouz,0,0,0,0
1708249356658,ECE 251B,A00,430166,Vasconcelos; Manuela,0,0,0,0
1708249357184,ECE 258B,A00,430167,Milstein; Laurence B.,0,0,0,0
1708249357713,ECE 260C,A00,430168,Eldon; John,0,0,0,0
1708249358240,ECE 264B,A00,430169,Galton; Ian A,0,0,0,0
1708249358769,ECE 265B,A00,430170,Gudem; Prasad S.S.,0,0,0,0
1708249359299,ECE 266,A01,430273,Hall; Drew A.,0,0,0,0
1708249359825,ECE 271C,A00,430283,Vasconcelos; Nuno,0,0,0,0
1708249360354,ECE 272A,A01,430340,Poveda Fonseca; Jorge,0,0,0,0
1708249360881,ECE 273,A00,430352,Wang; Jun-Kun,0,0,0,0
1708249361406,ECE 276B,A00,430353,Atanasov; Nikolay A.,0,0,0,0
1708249361938,ECE 284,A00,430385,Wang; Edward,0,0,0,0
1708249362465,ECE 285,A00,430386,Wang; Xiaolong,0,0,0,0
1708249362465,ECE 285,B00,430387,Antipa; Nicholas A,0,0,0,0
1708249362992,ECON 1,A01,409576,Crane; Meredith Helen,87,0,100,13
1708249362992,ECON 1,A02,409577,Crane; Meredith Helen,96,0,100,4
1708249362992,ECON 1,A03,409578,Crane; Meredith Helen,97,0,100,3
1708249363524,ECON 2,A01,409580,Candido; Maria Teresa,70,0,75,5
1708249364055,ECON 3,A01,409582,Crane; Meredith Helen,109,0,120,11
1708249364055,ECON 3,A02,409583,Crane; Meredith Helen,114,0,115,1
1708249364055,ECON 3,A03,409584,Crane; Meredith Helen,110,0,115,5
1708249364586,ECON 4,A01,409586,Levkoff; Steven B.,88,0,92,4
1708249364586,ECON 4,A02,409587,Levkoff; Steven B.,89,0,90,1
1708249365112,ECON 5,A01,409589,Dai; Yinlin,53,0,58,5
1708249365112,ECON 5,A02,409590,Dai; Yinlin,56,0,58,2
1708249365112,ECON 5,A03,409591,Dai; Yinlin,54,0,54,0
1708249365112,ECON 5,A04,409593,Dai; Yinlin,55,0,55,0
1708249365112,ECON 5,B01,409595,Dai; Yinlin,57,0,58,1
1708249365112,ECON 5,B02,409596,Dai; Yinlin,49,0,49,0
1708249365112,ECON 5,B03,409597,Dai; Yinlin,59,0,59,0
1708249365112,ECON 5,B04,409598,Dai; Yinlin,55,0,55,0
1708249365112,ECON 5,C01,487209,Staff,40,0,45,5
1708249365639,ECON 100A,A01,409600,Famulari; Melissa,94,0,100,6
1708249365639,ECON 100A,A02,409601,Famulari; Melissa,98,0,100,2
1708249365639,ECON 100A,A03,409604,Famulari; Melissa,98,0,100,2
1708249365639,ECON 100A,B01,409610,Famulari; Melissa,76,0,80,4
1708249366167,ECON 100AH,A00,409612,Famulari; Melissa,19,0,20,1
1708249366694,ECON 100B,A01,409614,Grigoryan; Aram,109,0,120,11
1708249366694,ECON 100B,A02,409616,Grigoryan; Aram,117,0,120,3
1708249366694,ECON 100B,B01,409626,Grigoryan; Aram,47,0,50,3
1708249366694,ECON 100B,B02,409627,Grigoryan; Aram,49,0,50,1
1708249367220,ECON 100C,A01,409629,Levkoff; Steven B.,144,0,146,2
1708249367220,ECON 100C,B01,409632,Levkoff; Steven B.,143,0,146,3
1708249367746,ECON 106,A00,409633,Bowen; T. Renee,90,0,90,0
1708249368272,ECON 109T,A00,409634,Trevino; Isabel,18,0,20,2
1708249368798,ECON 110A,A01,409637,Staff,68,0,75,7
1708249369328,ECON 110B,A01,409663,Herreno Lopera; Juan,119,0,125,6
1708249369328,ECON 110B,A02,409682,Herreno Lopera; Juan,125,0,125,0
1708249369328,ECON 110B,B01,409734,Herreno Lopera; Juan,99,0,100,1
1708249369917,ECON 120A,A01,409739,Candido; Maria Teresa,84,0,90,6
1708249369917,ECON 120A,A02,409740,Candido; Maria Teresa,87,0,90,3
1708249369917,ECON 120A,B01,409742,Candido; Maria Teresa,85,0,90,5
1708249369917,ECON 120A,B02,409743,Candido; Maria Teresa,90,0,90,0
1708249370447,ECON 120B,A01,409748,Ma; Xinwei,128,0,130,2
1708249370447,ECON 120B,A02,409754,Ma; Xinwei,128,0,130,2
1708249370447,ECON 120B,B01,409756,Ma; Xinwei,26,0,40,14
1708249370977,ECON 120C,A01,409758,Sun; Yixiao,141,0,146,5
1708249370977,ECON 120C,B01,409762,Sun; Yixiao,144,0,146,2
1708249371503,ECON 129,A00,409763,Eckert; Fabian Paul,44,0,50,6
1708249372030,ECON 134,A00,409764,Gelber; Alexander Michael,45,0,50,5
1708249372030,ECON 134,B00,409765,Gelber; Alexander Michael,49,0,50,1
1708249372555,ECON 137,A00,409766,Niehaus; Paul,19,0,20,1
1708249373087,ECON 142,A00,409767,Trevino; Isabel,39,0,40,1
1708249373087,ECON 142,B00,409768,Trevino; Isabel,38,0,40,2
1708249373619,ECON 164,A00,409771,Muralidharan; Karthik,118,0,120,2
1708249374145,ECON 172A,A01,409773,Newhouse; Herbert S,67,0,75,8
1708249374671,ECON 172B,A01,409775,Newhouse; Herbert S,74,0,75,1
1708249374671,ECON 172B,B01,409777,Newhouse; Herbert S,71,0,75,4
1708249375721,ECON 191A,A00,409780,Cullen; Julie,20,0,20,0
1708249376247,ECON 200C,A00,409782,Du; Songzi,34,0,35,1
1708249376777,ECON 210C,A00,409784,Herreno Lopera; Juan & Wieland; Johannes Friedrich,35,0,35,0
1708249377304,ECON 220C,A00,409785,Sun; Yixiao,35,0,35,0
1708249377833,ECON 220F,A00,409786,Carson; Richard T,27,0,30,3
1708249378363,ECON 221,A00,409787,Zhu; Ying,25,0,25,0
1708249378890,ECON 241,A00,409788,Muralidharan; Karthik,18,0,20,2
1708249379419,ECON 243,A00,409789,Niehaus; Paul,18,0,20,2
1708249379945,ECON 248,A00,409790,Eckert; Fabian Paul,18,0,20,2
1708249380476,ECON 250C,A00,409791,Arnold; David Hall & Betts; Julian,25,0,25,0
1708249381002,ECON 268,A00,409792,Jacobsen; Mark,24,0,25,1
1708249381540,ECON 281,A00,409793,Meckel; Katherine Hunter,19,0,20,1
1708249381540,ECON 281,B00,409794,Herreno Lopera; Juan & Wieland; Johannes Friedrich,19,0,20,1
1708249381540,ECON 281,C00,477854,Herreno Lopera; Juan & Wieland; Johannes Friedrich,18,0,20,2
1708249382069,ECON 285,A00,409795,Eckert; Fabian Paul,20,0,20,0
1708249382595,ECON 286,A00,409796,Ma; Xinwei,15,0,15,0
1708249382595,ECON 286,B00,409797,Hamilton; James D.,15,0,15,0
1708249382595,ECON 286,C00,409798,Grigoryan; Aram,15,0,15,0
1708249382595,ECON 286,D00,409799,Niehaus; Paul,15,0,15,0
1708249383125,ECON 296,A00,409800,Eckert; Fabian Paul,20,0,20,0
1708249383650,EDS 31,A00,409801,Bussey; Thomas J,9,0,10,1
1708249384182,EDS 38,A01,409803,Chung; Luz Marina,25,0,25,0
1708249384706,EDS 39,A01,409805,Heinzman; Erica M.,24,0,25,1
1708249385234,EDS 102,A01,409807,Ambo; Theresa Jean,37,0,45,8
1708249385759,EDS 110R,A01,409809,Staff,42,0,50,8
1708249385759,EDS 110R,B01,481358,Staff,20,0,20,0
1708249386287,EDS 111,A00,479044,Wishard Guerra; Alison G.,56,0,60,4
1708249386813,EDS 117,A01,409818,Jones; Gabrielle Anastasia,21,0,23,2
1708249386813,EDS 117,A02,409819,Jones; Gabrielle Anastasia,23,0,23,0
1708249386813,EDS 117,A03,409820,Jones; Gabrielle Anastasia,22,0,23,1
1708249386813,EDS 117,A04,409821,Jones; Gabrielle Anastasia,21,0,21,0
1708249387339,EDS 118,A00,409828,Warstadt; Melissa Fawn,46,0,50,4
1708249387866,EDS 123,A00,409831,Bussey; Thomas J,10,0,10,0
1708249388395,EDS 124AR,A00,419352,Simon; Elizabeth A,82,0,100,18
1708249388395,EDS 124AR,B00,419377,Simon; Elizabeth A,97,0,100,3
1708249388395,EDS 124AR,C00,481485,Simon; Elizabeth A,25,0,25,0
1708249388395,EDS 124AR,D00,481490,Simon; Elizabeth A,25,0,25,0
1708249388920,EDS 124BR,A00,409838,Eguchi; Emi,53,0,75,22
1708249388920,EDS 124BR,B00,481363,Eguchi; Emi,25,0,25,0
1708249389448,EDS 125,A00,409839,Aragon; Maria Jose,48,0,50,2
1708249389978,EDS 126,A01,409843,Jones; Makeba,19,0,25,6
1708249389978,EDS 126,A02,409844,Jones; Makeba,25,0,25,0
1708249389978,EDS 126,A03,409846,Jones; Makeba,25,0,25,0
1708249389978,EDS 126,A04,409847,Jones; Makeba,25,0,25,0
1708249390507,EDS 128B,A01,409851,Pappas; Elizabeth,49,0,50,1
1708249391032,EDS 129C,A01,409906,Millstone; Rachel Diana,44,0,50,6
1708249391563,EDS 130,A01,409954,Mendez; Kathrina Mendoza,14,0,15,1
1708249391563,EDS 130,A02,409955,Mendez; Kathrina Mendoza,24,0,25,1
1708249391563,EDS 130,A03,409956,Mendez; Kathrina Mendoza,20,0,20,0
1708249392090,EDS 133,A01,409961,Bintliff; Amy S.V.,15,0,20,5
1708249392090,EDS 133,A02,409962,Bintliff; Amy S.V.,20,0,20,0
1708249392090,EDS 133,A03,489636,Bintliff; Amy S.V.,15,0,15,0
1708249392619,EDS 136,A01,409964,Chung; Luz Marina,30,0,30,0
1708249392619,EDS 136,A02,409977,Chung; Luz Marina,30,0,30,0
1708249393146,EDS 139,A00,479197,Millstone; Rachel Diana,42,0,50,8
1708249393146,EDS 139,B00,479198,Pappas; Elizabeth,49,0,50,1
1708249393146,EDS 139,C00,479199,Mendez; Kathrina Mendoza,58,0,60,2
1708249393146,EDS 139,D00,479200,Bintliff; Amy S.V.,56,0,60,4
1708249393146,EDS 139,E00,479201,Chung; Luz Marina,59,0,60,1
1708249393146,EDS 139,F00,479202,Bintliff; Amy S.V.,15,0,15,0
1708249393146,EDS 139,G00,479203,Mamas; Christoforos,27,0,30,3
1708249393146,EDS 139,H00,493997,Choi; Bailey Miyeon,28,0,30,2
1708249393672,EDS 141,A00,409979,Mamas; Christoforos,38,0,40,2
1708249394199,EDS 145,A01,409989,Choi; Bailey Miyeon,13,0,15,2
1708249394199,EDS 145,A02,409990,Choi; Bailey Miyeon,15,0,15,0
1708249394729,EDS 180,A00,409991,Chapman; Thandeka K,30,0,30,0
1708249394729,EDS 180,B00,409992,Ambo; Theresa Jean,24,0,25,1
1708249394729,EDS 180,C00,409993,Jones; Gabrielle Anastasia,20,0,20,0
1708249394729,EDS 180,D00,409994,Phuong; Andrew,24,0,24,0
1708249395254,EDS 198,001,487216,Eguchi; Emi,20,0,20,0
1708249395782,EDS 205B,A00,409995,Staff,40,0,45,5
1708249395782,EDS 205B,B00,409997,Staff,42,0,45,3
1708249396309,EDS 232,A00,409999,Hopkins; Megan Beth,9,0,12,3
1708249396835,EDS 255,A00,410001,Phuong; Andrew,14,0,15,1
1708249397363,EDS 257,A00,410003,Datnow; Amanda Lee,14,0,15,1
1708249397890,EDS 282,A00,479192,Daly; Alan J.,16,0,16,0
1708249398417,EDS 287B,A00,479193,Daly; Alan J.,16,0,16,0
1708249398942,EDS 288A,A00,410005,Staff,18,0,18,0
1708249399466,EDS 288C,A00,410007,Staff,18,0,18,0
1708249399995,EDS 289B,A01,410009,Daly; Alan J.,18,0,18,0
1708249400520,EDS 290,A00,410010,Black; Alison Michelle,30,0,30,0
1708249400520,EDS 290,B00,410012,Choi; Bailey Miyeon,29,0,30,1
1708249400520,EDS 290,C00,479205,Heinzman; Erica M.,0,0,0,0
1708249401047,EDS 291B,A01,479195,Daly; Alan J.,16,0,16,0
1708249401572,EDS 293B,A01,410016,Staff,18,0,18,0
1708249402098,EDS 294B,A00,479196,Burrell; Sade Renee,16,0,16,0
1708249402630,EDS 296,001,478927,Ambo; Theresa Jean,0,0,0,0
1708249402630,EDS 296,002,478935,Aragon; Maria Jose,0,0,0,1
1708249402630,EDS 296,003,478936,Chapman; Thandeka K,0,0,0,0
1708249402630,EDS 296,004,478942,Bintliff; Amy S.V.,0,0,0,0
1708249402630,EDS 296,005,478943,Clarke; Sherice Nicole,0,0,0,0
1708249402630,EDS 296,006,478967,Cohen; Shana R,0,0,0,1
1708249402630,EDS 296,007,478968,Datnow; Amanda Lee,0,0,0,0
1708249402630,EDS 296,008,478969,Daly; Alan J.,0,0,0,0
1708249402630,EDS 296,009,478970,Eguchi; Emi,0,0,0,0
1708249402630,EDS 296,010,478971,Fine; Sarah,0,0,0,0
1708249402630,EDS 296,011,478972,Jones; Gabrielle Anastasia,0,0,0,0
1708249402630,EDS 296,012,479020,Jones; Makeba,0,0,0,0
1708249402630,EDS 296,013,479021,Halter; Christopher P.,0,0,0,0
1708249402630,EDS 296,014,479027,Hofstetter; Carolyn,0,0,0,0
1708249402630,EDS 296,015,479028,Hopkins; Megan Beth,0,0,0,0
1708249402630,EDS 296,016,479034,Mamas; Christoforos,0,0,0,0
1708249402630,EDS 296,017,479035,Pollock; Mica,0,0,0,0
1708249402630,EDS 296,018,479036,Wishard Guerra; Alison G.,0,0,0,0
1708249402630,EDS 296,019,494549,Phuong; Andrew,0,0,0,0
1708249403157,EMED 296,001,464428,Singh; Sukhdeep,49,0,50,1
1708249403157,EMED 296,002,464438,Subramony; Rachna,49,0,50,1
1708249403157,EMED 296,003,464490,Staff,50,0,50,0
1708249403687,ENG 10,A00,399006,Evdokimenko; Ekaterina,30,0,30,0
1708249404212,ENG 100D,A00,399084,Ngo; Anh-Thu T.,33,0,50,17
1708249404737,ENG 100DR,A00,479230,Ngo; Anh-Thu T.,29,0,40,11
1708249405264,ENG 100L,A00,399163,Kleissl; Jan,6,0,6,0
1708249405264,ENG 100L,B00,399217,Bratton; Maryann,8,0,8,0
1708249405264,ENG 100L,C00,399218,Yu; Paul K L,8,0,8,0
1708249405264,ENG 100L,D00,399257,Bratton; Maryann,6,0,6,0
1708249405264,ENG 100L,E00,399258,de Oliveira; Mauricio,9,0,10,1
1708249405264,ENG 100L,F00,399314,Bratton; Maryann,7,0,7,0
1708249405264,ENG 100L,G00,399394,Boyle; Mary E. T.,14,0,15,1
1708249405796,ENVR 102,A00,400777,Daly; Heather Marie,19,0,20,1
1708249405796,ENVR 102,B00,400778,Montejo; Carolina,24,0,25,1
1708249405796,ENVR 102,C00,400791,Staff,23,0,25,2
1708249406326,ENVR 140,A01,400813,Siapno; Jacqueline A,12,0,15,3
1708249406326,ENVR 140,A02,400870,Siapno; Jacqueline A,15,0,15,0
1708249406326,ENVR 140,A03,400889,Siapno; Jacqueline A,15,0,15,0
1708249406326,ENVR 140,A04,400890,Siapno; Jacqueline A,15,0,15,0
1708249406852,ENVR 144,A01,400929,Herbst; Matthew,20,0,20,0
1708249407378,ERC 20,A00,400722,Evans; Ivan T,30,0,30,0
1708249407904,ESYS 103,A01,400931,Lerner; Amy M,32,0,34,2
1708249407904,ESYS 103,A02,400934,Lerner; Amy M,34,0,34,0
1708249407904,ESYS 103,A03,400938,Lerner; Amy M,28,0,34,6
1708249407904,ESYS 103,A04,400939,Lerner; Amy M,33,0,34,1
1708249407904,ESYS 103,A05,400940,Lerner; Amy M,34,0,34,0
1708249407904,ESYS 103,A06,400941,Lerner; Amy M,33,0,34,1
1708249408432,ESYS 187C,A01,400945,Hetherington; Elizabeth Dorsey,28,0,40,12
1708249408432,ESYS 187C,A02,400946,Hetherington; Elizabeth Dorsey,39,0,40,1
1708249408959,ETHN 3R,A01,400948,Streeby; Shelley,21,0,25,4
1708249408959,ETHN 3R,A02,401220,Streeby; Shelley,24,0,25,1
1708249408959,ETHN 3R,A03,401231,Streeby; Shelley,22,0,25,3
1708249408959,ETHN 3R,A04,401236,Streeby; Shelley,23,0,25,2
1708249408959,ETHN 3R,A05,401241,Streeby; Shelley,21,0,25,4
1708249408959,ETHN 3R,A06,401311,Streeby; Shelley,21,0,25,4
1708249408959,ETHN 3R,A07,401318,Streeby; Shelley,25,0,25,0
1708249408959,ETHN 3R,A08,401319,Streeby; Shelley,25,0,25,0
1708249408959,ETHN 3R,A09,401397,Streeby; Shelley,25,0,25,0
1708249408959,ETHN 3R,A10,401398,Streeby; Shelley,25,0,25,0
1708249408959,ETHN 3R,A11,401399,Streeby; Shelley,24,0,25,1
1708249408959,ETHN 3R,A12,401518,Streeby; Shelley,25,0,25,0
1708249408959,ETHN 3R,A13,401551,Streeby; Shelley,24,0,25,1
1708249408959,ETHN 3R,A14,401552,Streeby; Shelley,23,0,25,2
1708249409489,ETHN 30,A01,401554,Fuste; Jose Ignacio,24,0,25,1
1708249409489,ETHN 30,A02,401555,Fuste; Jose Ignacio,25,0,25,0
1708249409489,ETHN 30,A03,401556,Fuste; Jose Ignacio,25,0,25,0
1708249409489,ETHN 30,A04,401557,Fuste; Jose Ignacio,25,0,25,0
1708249410015,ETHN 100C,A00,401558,Museus; Samuel David,36,0,40,4
1708249410547,ETHN 101TV,A01,401560,Marez; Curtis F.,21,0,25,4
1708249410547,ETHN 101TV,A02,401564,Marez; Curtis F.,25,0,25,0
1708249411076,ETHN 108,A00,401584,Hankins; Sarah E.,25,0,29,4
1708249411602,ETHN 113A,A00,401657,Werner; Bradley T.,15,0,15,0
1708249412128,ETHN 114B,A00,401724,Frank; Ross H.,19,0,20,1
1708249412652,ETHN 120D,A01,401848,Alvarez; Luis A,8,0,10,2
1708249412652,ETHN 120D,A02,401853,Alvarez; Luis A,10,0,10,0
1708249413178,ETHN 125R,A00,401858,Sasaki; Christen T,39,0,50,11
1708249413705,ETHN 126,A00,401865,Tran; Ly Thi Hai,39,0,40,1
1708249414234,ETHN 127,A00,401866,Martin Sandino; Amanda Maria Yoland,24,0,25,1
1708249414760,ETHN 137,A00,401867,Martin Sandino; Amanda Maria Yoland,19,0,19,0
1708249415286,ETHN 139,A00,401992,Perreira; Christopher Michael,25,0,25,0
1708249415812,ETHN 143,A00,402059,Marez; Curtis F.,39,0,40,1
1708249416337,ETHN 144M,A00,402060,Jolivette; Andrew J,62,0,65,3
1708249416866,ETHN 150,A00,402158,Taylor-Garcia; Daphne,16,0,18,2
1708249417394,ETHN 153,A00,402160,Martinez-Matsuda; Veronica,24,0,25,1
1708249417922,ETHN 179,A00,402165,Richards; Stephanie F,23,0,25,2
1708249418448,ETHN 183,A00,402217,Steelman; Katherine Wallis,16,0,16,0
1708249418975,ETHN 186,A00,402313,Perez; Roy,15,0,15,0
1708249419505,ETHN 189,A00,479226,Museus; Samuel David,29,0,30,1
1708249420033,ETHN 196H,A00,402314,Espiritu; Yen,0,0,0,0
1708249420033,ETHN 196H,B00,402325,Perreira; Christopher Michael,0,0,0,0
1708249420033,ETHN 196H,C00,402344,Perez; Roy,0,0,0,0
1708249420033,ETHN 196H,D00,402345,Streeby; Shelley,0,0,0,0
1708249420033,ETHN 196H,E00,402346,Taylor-Garcia; Daphne,0,0,0,0
1708249420561,ETHN 200C,A00,402358,Fuste; Jose Ignacio,19,0,20,1
1708249421085,ETHN 230,A00,402359,Streeby; Shelley,16,0,20,4
1708249421615,ETHN 291,A00,402363,Perreira; Christopher Michael,16,0,20,4
1708249422142,EXPR 100,A00,477778,Staff,9999,0,9999,0
1708249422668,EXPR 105,A00,477779,Staff,9999,0,9999,0
1708249423264,EXPR 201,A00,477780,Staff,9999,0,9999,0
1708249423793,EXPR 205,A00,477781,Staff,9999,0,9999,0
1708249424320,FILM 87,A00,402794,Rahimi; Babak,19,0,20,1
1708249424320,FILM 87,B00,402796,Rahimi; Babak,20,0,20,0
1708249424320,FILM 87,C00,402821,Havis; Allan,19,0,20,1
1708249424851,FMPH 95,A00,481734,Larsen; Britta Ann,0,0,0,2
1708249425377,FMPH 101,A00,404648,Tan; Gene Brian,31,0,40,9
1708249425911,FMPH 102,A01,404692,Rana; Brinda Kanti,25,0,28,3
1708249425911,FMPH 102,A02,404714,Rana; Brinda Kanti,28,0,28,0
1708249425911,FMPH 102,B01,404739,Rana; Brinda Kanti,26,0,28,2
1708249425911,FMPH 102,B02,404746,Rana; Brinda Kanti,28,0,28,0
1708249426439,FMPH 110,A00,404747,Campbell; Chadwick Karl,52,0,55,3
1708249426439,FMPH 110,B00,404789,Zoumas-Morse; Christine E.,24,0,30,6
1708249426965,FMPH 120,A00,404792,Nguyen-Grozavu; France T.,48,0,60,12
1708249427492,FMPH 130,A00,404859,Gould; Carlos Francisco,49,0,55,6
1708249427492,FMPH 130,B00,479047,Ciborowski; Haley Minae,52,0,55,3
1708249428020,FMPH 155,A00,404864,Fielding-Miller; Rebecca,65,0,65,0
1708249428546,FMPH 161,A00,404865,Zoumas-Morse; Christine E.,27,0,35,8
1708249429072,FMPH 191,A00,404866,Eikey; Elizabeth Victoria,35,0,35,0
1708249429600,FMPH 194,A00,404938,Larsen; Britta Ann,0,0,0,0
1708249429600,FMPH 194,B00,404939,Marquez; Becky,0,0,0,0
1708249429600,FMPH 194,C00,404949,Nguyen-Grozavu; France T.,0,0,0,0
1708249429600,FMPH 194,D00,404950,Stone; Matthew David,0,0,0,0
1708249429600,FMPH 194,E00,404958,White; Anne Elizabeth Clar,0,0,0,0
1708249429600,FMPH 194,F00,404969,Zoumas-Morse; Christine E.,0,0,0,0
1708249430126,FMPH 223,A00,404977,Vaida; Florin,7,0,26,19
1708249430652,FMPH 225,A00,404978,Zou; Jingjing,0,0,0,0
1708249431183,FMPH 291,A00,404992,Salem; Rany Mansour,15,0,15,0
1708249431183,FMPH 291,C00,405005,Schwartzman; Armin,0,0,0,11
1708249431183,FMPH 291,D00,479113,Shadyab; Aladdin Hassan,0,0,0,0
1708249431183,FMPH 291,E00,479114,Shadyab; Aladdin Hassan,0,0,0,0
1708249431183,FMPH 291,F00,479115,Wynn; Adriane Michelle,0,0,0,3
1708249431183,FMPH 291,G00,479116,Xu; Ronghui,0,0,0,10
1708249431183,FMPH 291,H00,479119,Vaida; Florin,0,0,0,2
1708249431709,FPM 258C,A00,405129,Chen; Brian Hwa-Yang,11,0,15,4
1708249432239,FPM 259C,A00,405130,Nguyen; Annie Lu & Araneta; Maria Rosario Gorrez,4,0,5,1
1708249433055,FPM 278,A00,405131,Strong; David R,13,0,15,2
1708249433588,FPM 280C,A01,405133,Banegas; Matthew Patrick,10,0,10,0
1708249434117,FPM 296,001,464651,Johnson; Michelle Lee,49,0,50,1
1708249434117,FPM 296,002,464652,Staff,50,0,50,0
1708249434117,FPM 296,003,464653,Staff,50,0,50,0
1708249434643,FPM 297,001,479175,Vaida; Florin,9999,0,9999,0
1708249434643,FPM 297,002,494007,Strong; David R,9999,0,9999,0
1708249434643,FPM 297,003,494364,Bazzi; Angela Robertson,9999,0,9999,0
1708249435170,GLBH 20,A00,405134,Elwardani; Nile Regina,143,0,146,3
1708249435698,GLBH 100,A00,405135,Bhavsar; Radhika,68,0,70,2
1708249435698,GLBH 100,B00,477773,Villarino; Margarita,39,0,44,5
1708249435698,GLBH 100,C00,477855,Jenkins; Janis A.,20,0,20,0
1708249435698,GLBH 100,D00,481337,Mishra; Jyoti,40,0,40,0
1708249436224,GLBH 101,A00,405136,Sloane; Julia Kathryn,40,0,40,0
1708249436759,GLBH 107,A00,405137,Wilson; Brenda K,63,0,70,7
1708249437285,GLBH 111,A01,486865,Burgos; Jose L.,0,0,0,0
1708249437285,GLBH 111,B01,486867,Burgos; Jose L.,0,0,0,0
1708249437813,GLBH 114W,A00,405138,Walkover; Lillian B,17,0,17,0
1708249438339,GLBH 118,A00,405140,Wilson; Brenda K,31,0,32,1
1708249438869,GLBH 147,A00,405141,Stewart; Alexander B,40,0,40,0
1708249439400,GLBH 148,A00,405142,Olivas Hernandez; Olga Lid,93,0,100,7
1708249439930,GLBH 150B,A00,486855,Sanchez; Giselle,0,0,0,0
1708249440456,GLBH 181,A00,405154,Burgos; Jose L.,211,0,216,5
1708249440981,GLBH 215,A00,479241,Walkover; Lillian B,18,0,18,0
1708249441507,GLBH 260,A00,480722,Elwardani; Nile Regina,18,0,18,0
1708249442033,GSS 20,A00,405155,Siapno; Jacqueline A,25,0,30,5
1708249442561,GSS 25,A00,405156,Batarseh; Amanda Alicia,24,0,30,6
1708249443088,HDS 1,A01,405160,Reese; Clarissa Jane,25,0,25,0
1708249443088,HDS 1,A02,405168,Reese; Clarissa Jane,25,0,25,0
1708249443088,HDS 1,A03,405169,Reese; Clarissa Jane,22,0,25,3
1708249443088,HDS 1,A04,405170,Reese; Clarissa Jane,24,0,25,1
1708249443088,HDS 1,A05,405171,Reese; Clarissa Jane,23,0,25,2
1708249443088,HDS 1,A06,405172,Reese; Clarissa Jane,24,0,25,1
1708249443088,HDS 1,A07,405173,Reese; Clarissa Jane,24,0,25,1
1708249443614,HDS 60,A01,405175,Warstadt; Melissa Fawn,34,0,35,1
1708249443614,HDS 60,A02,405176,Warstadt; Melissa Fawn,33,0,35,2
1708249444142,HDS 95,A00,405177,Staff,38,0,40,2
1708249444669,HDS 120,A00,405178,Staff,0,0,0,0
1708249445199,HDS 122,A00,405179,Rodriguez; Victoria Calip,64,0,75,11
1708249445725,HDS 150,A00,405180,Staff,20,0,20,0
1708249445725,HDS 150,B00,405181,Staff,20,0,20,0
1708249445725,HDS 150,C00,405182,Staff,20,0,20,0
1708249446250,HDS 181,A01,405185,Bjorklund; Peter,30,0,30,0
1708249446780,HDS 191,A01,405187,Reese; Clarissa Jane,40,0,40,0
1708249446780,HDS 191,B01,405194,Staff,25,0,25,0
1708249447307,HIAF 113,A00,403736,Prestholdt; Jeremy,74,0,75,1
1708249447833,HIAF 114,A00,403738,Gyamfi; Bright,49,0,50,1
1708249448359,HIEA 132,A00,403740,Kletzer; Benjamin Nathan,25,0,30,5
1708249448886,HIEA 154,A00,403741,Henry; Todd A.,62,0,64,2
1708249449411,HIEU 139,A00,403742,Strasser; Ulrike,52,0,56,4
1708249449936,HIEU 171,A00,403743,Hansen; Jan Eric,62,0,64,2
1708249450465,HIEU 176,A00,403744,Hertz; Deborah,14,0,15,1
1708249450992,HIEU 183,A00,403800,Gallant; Thomas W.,15,0,15,0
1708249451521,HIEU 276,A00,403862,Hertz; Deborah,0,0,0,0
1708249452047,HIGL 127,A00,403802,Ivey; James Alexander,56,0,56,0
1708249452575,HIGR 201,A00,494372,Pineda De Avila; Nydia,9,0,10,1
1708249453102,HIGR 205,A00,403863,Strasser; Ulrike,11,0,15,4
1708249453632,HIGR 217C,A00,403864,Lu; Weijing,9,0,10,1
1708249454159,HIGR 239,A00,403865,Serlin; David,4,0,5,1
1708249454685,HIGR 240,A00,403875,Gates; Kelly,2,0,5,3
1708249455214,HILA 101,A00,403818,LeNeave; Kimiko Nicole,62,0,64,2
1708249455740,HILA 119,A00,403819,Kozameh; Sara J,47,0,50,3
1708249456265,HILA 144,A00,403821,Kozameh; Sara J,50,0,50,0
1708249456797,HILD 2C,A01,402843,Hendrickson; Gerald M.,31,0,32,1
1708249456797,HILD 2C,A02,403030,Hendrickson; Gerald M.,31,0,32,1
1708249456797,HILD 2C,A03,403042,Hendrickson; Gerald M.,32,0,32,0
1708249456797,HILD 2C,A04,403048,Hendrickson; Gerald M.,30,0,32,2
1708249456797,HILD 2C,A05,403049,Hendrickson; Gerald M.,32,0,32,0
1708249456797,HILD 2C,A06,403098,Hendrickson; Gerald M.,32,0,32,0
1708249457324,HILD 7C,A01,403501,Bermudez; Rosie Cano,27,0,32,5
1708249457324,HILD 7C,A02,403513,Bermudez; Rosie Cano,30,0,32,2
1708249457324,HILD 7C,A03,403570,Bermudez; Rosie Cano,32,0,32,0
1708249457324,HILD 7C,A04,403572,Bermudez; Rosie Cano,32,0,32,0
1708249457324,HILD 7C,A05,403587,Bermudez; Rosie Cano,32,0,32,0
1708249457324,HILD 7C,A06,403588,Bermudez; Rosie Cano,32,0,32,0
1708249457324,HILD 7C,A07,403589,Bermudez; Rosie Cano,29,0,32,3
1708249457324,HILD 7C,A08,403590,Bermudez; Rosie Cano,32,0,32,0
1708249457324,HILD 7C,A09,403601,Bermudez; Rosie Cano,30,0,32,2
1708249457324,HILD 7C,A10,403602,Bermudez; Rosie Cano,32,0,32,0
1708249457324,HILD 7C,A11,403603,Bermudez; Rosie Cano,32,0,32,0
1708249457324,HILD 7C,A12,403604,Bermudez; Rosie Cano,32,0,32,0
1708249457851,HILD 12,A01,403607,Henry; Todd A.,32,0,32,0
1708249457851,HILD 12,A02,403608,Henry; Todd A.,31,0,32,1
1708249457851,HILD 12,A03,403609,Henry; Todd A.,32,0,32,0
1708249457851,HILD 12,A04,403699,Henry; Todd A.,32,0,32,0
1708249457851,HILD 12,A05,403700,Henry; Todd A.,32,0,32,0
1708249457851,HILD 12,A06,403701,Henry; Todd A.,32,0,32,0
1708249458381,HILD 30,A01,403703,Soleiman; Matthew Teymour,29,0,32,3
1708249458381,HILD 30,A02,403704,Soleiman; Matthew Teymour,30,0,32,2
1708249458906,HINE 118,A00,403822,Kayali; Hasan,50,0,50,0
1708249459432,HISC 119,A00,403823,Golan; Tal,26,0,30,4
1708249459957,HISC 123,A00,403839,Pineda De Avila; Nydia,45,0,50,5
1708249460483,HITO 87,A00,403707,Patterson; Patrick H.,15,0,15,0
1708249460483,HITO 87,B00,403709,Patterson; Patrick H.,15,0,15,0
1708249460483,HITO 87,C00,403735,Schneewind; Sarah,15,0,15,0
1708249461010,HITO 100,B00,403841,Klann; Mary Cameron,24,0,25,1
1708249461536,HITO 170,A00,403842,Watts; Edward J.,8,0,10,2
1708249462062,HITO 193,A00,455333,Hill; Seth J,0,0,0,0
1708249462585,HIUS 114A,A00,403843,Lewandoski; Julia Mavis,52,0,56,4
1708249463120,HIUS 120D,A01,403854,Alvarez; Luis A,8,0,10,2
1708249463120,HIUS 120D,A02,403855,Alvarez; Luis A,10,0,10,0
1708249463647,HIUS 136,A00,403857,Martinez-Matsuda; Veronica,21,0,25,4
1708249464172,HIUS 144,A00,403858,Martinez-Matsuda; Veronica,55,0,56,1
1708249464172,HIUS 144,B00,403859,Vandevelde; Kenneth Joseph,54,0,56,2
1708249464172,HIUS 144,C00,403860,Klann; Mary Cameron,52,0,56,4
1708249464172,HIUS 144,D00,403861,Lewandoski; Julia Mavis,55,0,56,1
1708249464721,HUM 2,A01,422723,Watts; Edward J.,16,0,16,0
1708249464721,HUM 2,A02,422735,Watts; Edward J.,15,0,16,1
1708249464721,HUM 2,A03,422736,Watts; Edward J.,15,0,16,1
1708249464721,HUM 2,A04,422737,Watts; Edward J.,16,0,16,0
1708249464721,HUM 2,A05,422738,Watts; Edward J.,15,0,16,1
1708249464721,HUM 2,A06,422760,Watts; Edward J.,15,0,16,1
1708249464721,HUM 2,A07,422778,Watts; Edward J.,16,0,16,0
1708249464721,HUM 2,A08,422793,Watts; Edward J.,16,0,16,0
1708249464721,HUM 2,A09,422794,Watts; Edward J.,16,0,16,0
1708249464721,HUM 2,A10,422795,Watts; Edward J.,16,0,16,0
1708249464721,HUM 2,B01,422805,Markman; Kristina,13,0,16,3
1708249464721,HUM 2,B02,422806,Markman; Kristina,14,0,16,2
1708249464721,HUM 2,B03,422807,Markman; Kristina,14,0,16,2
1708249464721,HUM 2,B04,422808,Markman; Kristina,16,0,16,0
1708249464721,HUM 2,B05,422809,Markman; Kristina,16,0,16,0
1708249464721,HUM 2,B06,422842,Markman; Kristina,16,0,16,0
1708249464721,HUM 2,B07,422843,Markman; Kristina,15,0,16,1
1708249464721,HUM 2,B08,422848,Markman; Kristina,16,0,16,0
1708249464721,HUM 2,B09,422850,Markman; Kristina,15,0,16,1
1708249464721,HUM 2,B10,422851,Markman; Kristina,12,0,16,4
1708249464721,HUM 2,B11,422852,Markman; Kristina,15,0,16,1
1708249464721,HUM 2,B12,422853,Markman; Kristina,16,0,16,0
1708249464721,HUM 2,C01,422855,Rodriguez; Bretton Sigfred,15,0,16,1
1708249464721,HUM 2,C02,422856,Rodriguez; Bretton Sigfred,16,0,16,0
1708249464721,HUM 2,C03,422859,Rodriguez; Bretton Sigfred,15,0,16,1
1708249464721,HUM 2,C04,423106,Rodriguez; Bretton Sigfred,12,0,16,4
1708249464721,HUM 2,C05,423107,Rodriguez; Bretton Sigfred,15,0,16,1
1708249464721,HUM 2,C06,423108,Rodriguez; Bretton Sigfred,14,0,16,2
1708249464721,HUM 2,C07,423109,Rodriguez; Bretton Sigfred,15,0,16,1
1708249464721,HUM 2,C08,423110,Rodriguez; Bretton Sigfred,15,0,16,1
1708249464721,HUM 2,C09,423133,Rodriguez; Bretton Sigfred,14,0,16,2
1708249464721,HUM 2,C10,423134,Rodriguez; Bretton Sigfred,14,0,16,2
1708249464721,HUM 2,C11,423135,Rodriguez; Bretton Sigfred,16,0,16,0
1708249464721,HUM 2,C12,423136,Rodriguez; Bretton Sigfred,15,0,16,1
1708249464721,HUM 2,C13,423137,Rodriguez; Bretton Sigfred,16,0,16,0
1708249464721,HUM 2,C14,423138,Rodriguez; Bretton Sigfred,16,0,16,0
1708249464721,HUM 2,D01,423140,West; Geoffrey Scott,13,0,16,3
1708249464721,HUM 2,D02,423141,West; Geoffrey Scott,15,0,16,1
1708249464721,HUM 2,D03,423142,West; Geoffrey Scott,15,0,16,1
1708249464721,HUM 2,D04,423143,West; Geoffrey Scott,14,0,16,2
1708249464721,HUM 2,D05,423144,West; Geoffrey Scott,16,0,16,0
1708249464721,HUM 2,D06,423145,West; Geoffrey Scott,16,0,16,0
1708249464721,HUM 2,D07,423146,West; Geoffrey Scott,16,0,16,0
1708249464721,HUM 2,D08,423158,West; Geoffrey Scott,16,0,16,0
1708249464721,HUM 2,D09,423169,West; Geoffrey Scott,16,0,16,0
1708249464721,HUM 2,D10,423174,West; Geoffrey Scott,16,0,16,0
1708249464721,HUM 2,D11,423175,West; Geoffrey Scott,16,0,16,0
1708249464721,HUM 2,D12,423179,West; Geoffrey Scott,15,0,16,1
1708249464721,HUM 2,D13,423188,West; Geoffrey Scott,15,0,16,1
1708249464721,HUM 2,D14,423204,West; Geoffrey Scott,16,0,16,0
1708249465259,HUM 5,A01,423221,Lyon; Antony J.,26,0,30,4
1708249465259,HUM 5,A02,423232,Lyon; Antony J.,24,0,30,6
1708249465259,HUM 5,A03,423237,Lyon; Antony J.,18,0,30,12
1708249465259,HUM 5,A04,423240,Lyon; Antony J.,25,0,30,5
1708249465259,HUM 5,A05,423242,Lyon; Antony J.,28,0,30,2
1708249465259,HUM 5,A06,423244,Lyon; Antony J.,23,0,30,7
1708249465259,HUM 5,A07,423247,Lyon; Antony J.,27,0,30,3
1708249465259,HUM 5,A08,423254,Lyon; Antony J.,27,0,30,3
1708249465259,HUM 5,B01,423286,Patterson; Patrick H.,28,0,30,2
1708249465259,HUM 5,B02,423291,Patterson; Patrick H.,29,0,30,1
1708249465259,HUM 5,B03,423294,Patterson; Patrick H.,28,0,30,2
1708249465259,HUM 5,B04,423297,Patterson; Patrick H.,29,0,30,1
1708249465259,HUM 5,B05,423313,Patterson; Patrick H.,30,0,30,0
1708249465259,HUM 5,B06,423318,Patterson; Patrick H.,30,0,30,0
1708249465259,HUM 5,B07,423362,Patterson; Patrick H.,29,0,30,1
1708249465259,HUM 5,B08,423363,Patterson; Patrick H.,29,0,30,1
1708249465259,HUM 5,C01,423365,Caldwell; Michael Alan,23,0,30,7
1708249465259,HUM 5,C02,423474,Caldwell; Michael Alan,24,0,30,6
1708249465259,HUM 5,C03,423528,Caldwell; Michael Alan,30,0,30,0
1708249465259,HUM 5,C04,423529,Caldwell; Michael Alan,27,0,30,3
1708249465259,HUM 5,C05,423545,Caldwell; Michael Alan,30,0,30,0
1708249465259,HUM 5,C06,423546,Caldwell; Michael Alan,30,0,30,0
1708249465259,HUM 5,C07,423547,Caldwell; Michael Alan,29,0,30,1
1708249465259,HUM 5,C08,423548,Caldwell; Michael Alan,28,0,30,2
1708249465785,INTL 101,A01,404350,Day; Joel Keith,23,0,25,2
1708249465785,INTL 101,A02,404356,Day; Joel Keith,25,0,25,0
1708249465785,INTL 101,A03,404357,Day; Joel Keith,24,0,25,1
1708249465785,INTL 101,A04,404360,Day; Joel Keith,25,0,25,0
1708249466312,INTL 102,A01,404375,Fisk; David Lee,25,0,25,0
1708249466312,INTL 102,A02,404376,Fisk; David Lee,22,0,25,3
1708249466312,INTL 102,A03,404377,Fisk; David Lee,20,0,25,5
1708249466312,INTL 102,A04,404381,Fisk; David Lee,25,0,25,0
1708249466844,INTL 190,A00,404396,Samphantharak; Krislert,24,0,25,1
1708249466844,INTL 190,B00,404402,McIntosh; Justin Daniel,24,0,25,1
1708249466844,INTL 190,C00,404403,Vos; Stacie N.,24,0,25,1
1708249466844,INTL 190,D00,404404,Nadkarni; Vidya,24,0,25,1
1708249466844,INTL 190,E00,404407,Scott; Jeffrey F,25,0,25,0
1708249466844,INTL 190,F00,404409,Auerbach; Bradford C,25,0,25,0
1708249466844,INTL 190,G00,404442,Auerbach; Bradford C,25,0,25,0
1708249466844,INTL 190,H00,404465,Segui; Alan S,25,0,25,0
1708249466844,INTL 190,I00,404481,Segui; Alan S,25,0,25,0
1708249467375,JAPN 10C,A01,403881,Iwamoto; Naoki,15,0,15,0
1708249467375,JAPN 10C,B01,403884,McKee; Mayumi Mochizuki,15,0,15,0
1708249467375,JAPN 10C,C01,403887,Sato; Kyoko,10,0,10,0
1708249467375,JAPN 10C,C02,403888,Sato; Kyoko,10,0,10,0
1708249467375,JAPN 10C,D01,403890,Inada; Minori,8,0,10,2
1708249467375,JAPN 10C,D02,403891,Inada; Minori,10,0,10,0
1708249467375,JAPN 10C,E01,403893,Sato; Kyoko,10,0,10,0
1708249467375,JAPN 10C,E02,403894,Sato; Kyoko,10,0,10,0
1708249467375,JAPN 10C,F01,403896,McKee; Mayumi Mochizuki,10,0,10,0
1708249467375,JAPN 10C,F02,403897,McKee; Mayumi Mochizuki,10,0,10,0
1708249467375,JAPN 10C,G01,403899,Homma; Kunihiko,10,0,10,0
1708249467375,JAPN 10C,G02,403900,Homma; Kunihiko,10,0,10,0
1708249467375,JAPN 10C,H01,403902,Maruyama; Rie,10,0,10,0
1708249467375,JAPN 10C,H02,403903,Maruyama; Rie,9,0,10,1
1708249467375,JAPN 10C,I01,403905,Inada; Minori,10,0,10,0
1708249467375,JAPN 10C,I02,403906,Inada; Minori,9,0,10,1
1708249467375,JAPN 10C,J01,403915,Iwamoto; Naoki,10,0,10,0
1708249467375,JAPN 10C,J02,403916,Iwamoto; Naoki,9,0,10,1
1708249467375,JAPN 10C,K01,403918,Ross; Kayoko F,10,0,10,0
1708249467375,JAPN 10C,K02,403928,Ross; Kayoko F,10,0,10,0
1708249467375,JAPN 10C,L01,403935,Homma; Kunihiko,9,0,10,1
1708249467375,JAPN 10C,L02,403936,Homma; Kunihiko,10,0,10,0
1708249467375,JAPN 10C,M02,403939,Kamioka; Sachiko,13,0,15,2
1708249467375,JAPN 10C,N01,479041,Iwamoto; Naoki,15,0,15,0
1708249467901,JAPN 10CR,A01,403982,Inada; Minori,12,0,12,0
1708249467901,JAPN 10CR,A02,403983,Inada; Minori,12,0,12,0
1708249468436,JAPN 20C,A01,403988,Homma; Kunihiko,10,0,12,2
1708249468436,JAPN 20C,B02,404029,Kamioka; Sachiko,10,0,12,2
1708249468436,JAPN 20C,C01,404033,Takeda; Izumi,8,0,12,4
1708249468436,JAPN 20C,D02,404114,Kamioka; Sachiko,11,0,12,1
1708249468436,JAPN 20C,E01,404135,Simpson; Junko Tokuda,12,0,12,0
1708249468962,JAPN 130C,A01,404144,Maruyama; Rie,9,0,9,0
1708249468962,JAPN 130C,A02,404145,Maruyama; Rie,9,0,9,0
1708249468962,JAPN 130C,B01,404147,Simpson; Junko Tokuda,8,0,9,1
1708249468962,JAPN 130C,B02,404148,Simpson; Junko Tokuda,9,0,9,0
1708249469487,JAPN 135C,A00,404176,Ross; Kayoko F,16,0,16,0
1708249469487,JAPN 135C,B00,404253,Takeda; Izumi,14,0,16,2
1708249470012,JAPN 140C,A00,404255,Sato; Kyoko,18,0,20,2
1708249470539,JAPN 150C,A00,404258,McKee; Mayumi Mochizuki,14,0,14,0
1708249471064,JAPN 190,A00,404260,Miyao; Daisuke,17,0,20,3
1708249471589,JAPN 196B,001,487237,Turner; Christena L.,9999,0,9999,0
1708249472114,JWSP 3,A01,404485,Shuster; Alana,20,0,20,0
1708249472639,LATI 10,A01,405201,Kennemore; Amy Michelle,27,0,30,3
1708249472639,LATI 10,A02,405202,Kennemore; Amy Michelle,27,0,30,3
1708249472639,LATI 10,A03,405208,Kennemore; Amy Michelle,28,0,30,2
1708249473172,LATI 50,A01,405214,Kokinis; Troy Andreas,34,0,35,1
1708249473172,LATI 50,A02,405215,Kokinis; Troy Andreas,34,0,35,1
1708249473703,LATI 130,A01,482880,Alvarez; Camila Huerta,29,0,30,1
1708249474231,LATI 160,A01,477482,Kokinis; Troy Andreas,30,0,30,0
1708249474762,LATI 180,A00,405221,Kennemore; Amy Michelle,28,0,30,2
1708249474762,LATI 180,B00,405222,Mostajo; Lorena,30,0,30,0
1708249475289,LIAB 1C,A00,405278,Saab; Dima,13,0,14,1
1708249475289,LIAB 1C,B00,405279,Saab; Dima,11,0,14,3
1708249475822,LIAB 1CX,A00,405281,Akjeje; Abdelhak,19,0,20,1
1708249475822,LIAB 1CX,B00,405291,Akjeje; Abdelhak,20,0,20,0
1708249476349,LIAB 1F,A00,482814,El Cheddadi; Youniss,14,0,14,0
1708249476949,LIDS 19,001,492979,Goodall; Grant Todd,9999,0,9999,0
1708249476949,LIDS 19,002,492980,Goodall; Grant Todd,9999,0,9999,0
1708249476949,LIDS 19,003,492981,Goodall; Grant Todd,9999,0,9999,0
1708249476949,LIDS 19,004,492982,Goodall; Grant Todd,9999,0,9999,0
1708249476949,LIDS 19,005,492983,Goodall; Grant Todd,9999,0,9999,0
1708249476949,LIDS 19,006,492984,Goodall; Grant Todd,9999,0,9999,0
1708249476949,LIDS 19,007,492985,Goodall; Grant Todd,9999,0,9999,0
1708249476949,LIDS 19,008,492986,Goodall; Grant Todd,9999,0,9999,0
1708249476949,LIDS 19,009,492987,Goodall; Grant Todd,9999,0,9999,0
1708249476949,LIDS 19,010,492988,Goodall; Grant Todd,9999,0,9999,0
1708249476949,LIDS 19,011,492989,Goodall; Grant Todd,9999,0,9999,0
1708249476949,LIDS 19,012,492990,Goodall; Grant Todd,9999,0,9999,0
1708249477480,LIFR 1A,A00,405299,Van Moer; Vinciane G,13,0,14,1
1708249477480,LIFR 1A,B00,405300,Van Moer; Vinciane G,13,0,14,1
1708249477480,LIFR 1A,C00,405301,Van Moer; Vinciane G,13,0,14,1
1708249477480,LIFR 1A,D00,405307,Van Moer; Vinciane G,14,0,14,0
1708249478006,LIFR 1AX,A00,405308,Van Moer; Vinciane G,27,0,28,1
1708249478006,LIFR 1AX,B00,405309,Van Moer; Vinciane G,27,0,28,1
1708249478535,LIFR 1C,A00,405310,Van Moer; Vinciane G,14,0,14,0
1708249478535,LIFR 1C,B00,405311,Van Moer; Vinciane G,12,0,14,2
1708249478535,LIFR 1C,C00,405325,Van Moer; Vinciane G,13,0,14,1
1708249478535,LIFR 1C,D00,405326,Van Moer; Vinciane G,11,0,14,3
1708249479061,LIFR 1CX,A00,405332,Van Moer; Vinciane G,25,0,28,3
1708249479061,LIFR 1CX,B00,405333,Van Moer; Vinciane G,27,0,28,1
1708249479589,LIFR 1D,A00,405334,Van Moer; Vinciane G,13,0,14,1
1708249479589,LIFR 1D,B00,405335,Van Moer; Vinciane G,13,0,14,1
1708249479589,LIFR 1D,C00,405336,Van Moer; Vinciane G,13,0,14,1
1708249479589,LIFR 1D,D00,405337,Van Moer; Vinciane G,13,0,14,1
1708249480134,LIFR 1DX,A00,405338,Van Moer; Vinciane G,25,0,28,3
1708249480134,LIFR 1DX,B00,405394,Van Moer; Vinciane G,27,0,28,1
1708249480662,LIFR 11,001,405395,Goodall; Grant Todd,999,0,999,0
1708249481204,LIGM 1C,A00,405398,Fischer-Grunski; Eva K,12,0,14,2
1708249481204,LIGM 1C,B00,405400,Fischer-Grunski; Eva K,13,0,14,1
1708249481204,LIGM 1C,C00,405403,Fischer-Grunski; Eva K,13,0,14,1
1708249481204,LIGM 1C,D00,405404,Fischer-Grunski; Eva K,13,0,14,1
1708249481745,LIGM 1CX,A00,405407,Fischer-Grunski; Eva K,27,0,28,1
1708249481745,LIGM 1CX,B00,405408,Fischer-Grunski; Eva K,26,0,28,2
1708249482273,LIGM 11,001,405464,Goodall; Grant Todd,999,0,999,0
1708249482799,LIGN 8,A00,411133,McIntosh; Justin Daniel,232,0,240,8
1708249483325,LIGN 17,A00,411141,Kehler; Andrew Scott,287,0,300,13
1708249483850,LIGN 101,A01,411144,Staff,28,0,30,2
1708249483850,LIGN 101,A02,411147,Staff,29,0,30,1
1708249483850,LIGN 101,A03,411154,Staff,27,0,30,3
1708249483850,LIGN 101,A04,411163,Staff,29,0,30,1
1708249484374,LIGN 120,A01,411165,Ackerman; Farrell,28,0,30,2
1708249484374,LIGN 120,A02,411177,Ackerman; Farrell,23,0,27,4
1708249484899,LIGN 130,A01,411223,Staff,29,0,30,1
1708249484899,LIGN 130,A02,411231,Staff,30,0,30,0
1708249484899,LIGN 130,A03,411232,Staff,29,0,30,1
1708249486439,LIGN 141,A00,411276,Rose; Sharon,37,0,40,3
1708249486965,LIGN 144,A00,411277,Lott; Margaret S.,22,0,24,2
1708249487490,LIGN 148,A00,411278,Mayberry; Rachel,71,0,75,4
1708249488020,LIGN 165,A00,411279,Bergen; Leon,41,0,70,29
1708249488547,LIGN 168,A01,411281,Styler; William Francis,65,0,70,5
1708249489077,LIGN 175,A00,482816,Rodriguez Aispuro; Alejandro,35,0,40,5
1708249489608,LIGN 230,A00,411293,Caponigro; Ivano,19,0,20,1
1708249490138,LIGN 238,A00,411308,Bergen; Benjamin,20,0,20,0
1708249490664,LIGN 252,A00,411309,Bergen; Leon,28,0,30,2
1708249491193,LIGN 256,A00,411310,Nakashole; Ndapandula,0,0,5,5
1708249491723,LIGN 272,A00,482887,Kluender; Robert,10,0,10,0
1708249492248,LIHL 112P,A00,405228,Pagkalinawan; Leticia Cant,27,0,28,1
1708249492790,LIHL 114P,A00,405229,Nguyen; Hoan Thi,26,0,28,2
1708249493317,LIHL 117P,A00,405256,Sadegholvad; Elham,27,0,28,1
1708249493843,LIHL 118,A00,405257,Chen; Areana Yen,28,0,28,0
1708249494368,LIHL 124P,A00,405262,Nguyen; Hoan Thi,28,0,28,0
1708249494897,LIHL 132P,A00,405263,Pagkalinawan; Leticia Cant,28,0,28,0
1708249495426,LIHL 134P,A00,405269,Nguyen; Hoan Thi,28,0,28,0
1708249495952,LIHL 138,A00,405270,Chen; Areana Yen,27,0,28,1
1708249496479,LIIT 1C,A00,405465,Carnelos; Chiara,12,0,14,2
1708249496479,LIIT 1C,B00,405466,Carnelos; Chiara,14,0,14,0
1708249497007,LIIT 1CX,A00,405594,Carnelos; Chiara,28,0,28,0
1708249497537,LIPO 1C,A00,405595,Paladini; Denise,13,0,14,1
1708249497537,LIPO 1C,B00,405596,Paladini; Denise,14,0,14,0
1708249498068,LIPO 1CX,A00,405597,De Abreu; Cassia,28,0,28,0
1708249498594,LISL 1A,C00,405600,Lott; Margaret S.,13,0,14,1
1708249498594,LISL 1A,D00,405601,Lott; Margaret S.,10,0,14,4
1708249498594,LISL 1A,E00,405602,Lott; Margaret S.,13,0,14,1
1708249498594,LISL 1A,F00,405603,Lott; Margaret S.,13,0,14,1
1708249499122,LISL 1AR,A00,480605,Lott; Margaret S.,13,0,15,2
1708249499122,LISL 1AR,B00,480606,Lott; Margaret S.,14,0,15,1
1708249499649,LISL 1AX,A00,405754,Lott; Margaret S.,26,0,28,2
1708249499649,LISL 1AX,B00,405755,Lott; Margaret S.,23,0,28,5
1708249500179,LISL 1C,A00,405776,Lott; Margaret S.,13,0,14,1
1708249500179,LISL 1C,B00,405779,Lott; Margaret S.,14,0,14,0
1708249500179,LISL 1C,C00,405785,Lott; Margaret S.,14,0,14,0
1708249500179,LISL 1C,D00,405787,Lott; Margaret S.,9,0,14,5
1708249500179,LISL 1C,E00,405827,Lott; Margaret S.,12,0,14,2
1708249500179,LISL 1C,F00,405830,Lott; Margaret S.,13,0,14,1
1708249500706,LISL 1CX,A00,405844,Lott; Margaret S.,25,0,28,3
1708249500706,LISL 1CX,B00,405848,Lott; Margaret S.,25,0,28,3
1708249500706,LISL 1CX,C00,405849,Lott; Margaret S.,28,0,28,0
1708249501232,LISL 1D,A00,405850,Lott; Margaret S.,8,0,14,6
1708249501232,LISL 1D,B00,405851,Lott; Margaret S.,13,0,14,1
1708249501232,LISL 1D,C00,405852,Lott; Margaret S.,10,0,14,4
1708249501776,LISL 1DX,A00,405854,Lott; Margaret S.,17,0,22,5
1708249501776,LISL 1DX,B00,405855,Lott; Margaret S.,18,0,22,4
1708249502308,LISP 1A,001,405856,Munoz Sanchez; Alicia,11,0,14,3
1708249502308,LISP 1A,002,405857,Munoz Sanchez; Alicia,13,0,14,1
1708249502308,LISP 1A,003,405858,Munoz Sanchez; Alicia,14,0,14,0
1708249502308,LISP 1A,004,405861,Munoz Sanchez; Alicia,14,0,14,0
1708249502833,LISP 1AX,001,405862,Munoz Sanchez; Alicia,28,0,28,0
1708249502833,LISP 1AX,002,405863,Munoz Sanchez; Alicia,25,0,28,3
1708249503374,LISP 1C,001,405864,Munoz Sanchez; Alicia,13,0,14,1
1708249503374,LISP 1C,002,405865,Munoz Sanchez; Alicia,12,0,14,2
1708249503374,LISP 1C,003,405879,Munoz Sanchez; Alicia,12,0,14,2
1708249503374,LISP 1C,004,405880,Munoz Sanchez; Alicia,13,0,14,1
1708249503374,LISP 1C,005,405881,Munoz Sanchez; Alicia,12,0,14,2
1708249503374,LISP 1C,006,405882,Munoz Sanchez; Alicia,12,0,14,2
1708249503374,LISP 1C,007,405904,Munoz Sanchez; Alicia,14,0,14,0
1708249503374,LISP 1C,008,405905,Munoz Sanchez; Alicia,14,0,14,0
1708249503374,LISP 1C,009,405908,Munoz Sanchez; Alicia,14,0,14,0
1708249503374,LISP 1C,010,405917,Munoz Sanchez; Alicia,13,0,14,1
1708249503909,LISP 1CX,001,405922,Munoz Sanchez; Alicia,24,0,28,4
1708249503909,LISP 1CX,002,405990,Munoz Sanchez; Alicia,26,0,28,2
1708249503909,LISP 1CX,003,406007,Munoz Sanchez; Alicia,27,0,28,1
1708249503909,LISP 1CX,004,406008,Munoz Sanchez; Alicia,25,0,28,3
1708249503909,LISP 1CX,005,406015,Munoz Sanchez; Alicia,26,0,28,2
1708249504454,LISP 1D,001,406016,Munoz Sanchez; Alicia,12,0,14,2
1708249504454,LISP 1D,002,406017,Munoz Sanchez; Alicia,13,0,14,1
1708249504454,LISP 1D,003,406018,Munoz Sanchez; Alicia,14,0,14,0
1708249504454,LISP 1D,004,406019,Munoz Sanchez; Alicia,11,0,14,3
1708249504454,LISP 1D,005,406020,Munoz Sanchez; Alicia,13,0,14,1
1708249504454,LISP 1D,006,406021,Munoz Sanchez; Alicia,10,0,14,4
1708249504454,LISP 1D,007,406022,Munoz Sanchez; Alicia,13,0,14,1
1708249504454,LISP 1D,008,406023,Munoz Sanchez; Alicia,13,0,14,1
1708249504454,LISP 1D,009,406024,Munoz Sanchez; Alicia,11,0,14,3
1708249504454,LISP 1D,010,406025,Munoz Sanchez; Alicia,12,0,14,2
1708249504454,LISP 1D,011,406026,Munoz Sanchez; Alicia,13,0,14,1
1708249504454,LISP 1D,012,406027,Munoz Sanchez; Alicia,13,0,14,1
1708249504454,LISP 1D,013,406028,Munoz Sanchez; Alicia,12,0,14,2
1708249504454,LISP 1D,014,406029,Munoz Sanchez; Alicia,12,0,14,2
1708249504454,LISP 1D,015,406030,Munoz Sanchez; Alicia,10,0,14,4
1708249504454,LISP 1D,016,406031,Munoz Sanchez; Alicia,14,0,14,0
1708249504454,LISP 1D,017,406032,Munoz Sanchez; Alicia,14,0,14,0
1708249504454,LISP 1D,018,406033,Munoz Sanchez; Alicia,12,0,14,2
1708249504454,LISP 1D,019,406034,Munoz Sanchez; Alicia,13,0,14,1
1708249504454,LISP 1D,020,406035,Munoz Sanchez; Alicia,14,0,14,0
1708249504454,LISP 1D,021,406036,Munoz Sanchez; Alicia,13,0,14,1
1708249504454,LISP 1D,022,406037,Munoz Sanchez; Alicia,14,0,14,0
1708249504454,LISP 1D,023,406038,Munoz Sanchez; Alicia,14,0,14,0
1708249504454,LISP 1D,024,406039,Munoz Sanchez; Alicia,13,0,14,1
1708249505011,LISP 1DX,001,406040,Munoz Sanchez; Alicia,28,0,28,0
1708249505011,LISP 1DX,002,406041,Munoz Sanchez; Alicia,27,0,28,1
1708249505011,LISP 1DX,003,406127,Munoz Sanchez; Alicia,24,0,28,4
1708249505011,LISP 1DX,004,406128,Munoz Sanchez; Alicia,17,0,28,11
1708249505011,LISP 1DX,005,406418,Munoz Sanchez; Alicia,24,0,28,4
1708249505011,LISP 1DX,006,406536,Munoz Sanchez; Alicia,27,0,28,1
1708249505011,LISP 1DX,007,406561,Munoz Sanchez; Alicia,24,0,28,4
1708249505011,LISP 1DX,008,406576,Munoz Sanchez; Alicia,25,0,28,3
1708249505011,LISP 1DX,009,406679,Munoz Sanchez; Alicia,28,0,28,0
1708249505011,LISP 1DX,010,406691,Munoz Sanchez; Alicia,26,0,28,2
1708249505011,LISP 1DX,011,406692,Munoz Sanchez; Alicia,28,0,28,0
1708249505011,LISP 1DX,012,406693,Munoz Sanchez; Alicia,28,0,28,0
1708249505536,LISP 17,001,406694,Munoz Sanchez; Alicia,18,0,20,2
1708249506060,LISP 18,001,406695,Munoz Sanchez; Alicia,20,0,20,0
1708249506587,LTAM 105,A00,412520,Ruiz; Ariana,28,0,40,12
1708249507115,LTCH 101,A00,479214,Zhu; Ping,39,0,40,1
1708249507643,LTCS 87,A00,492906,Nguyen; Hoang Tan,20,0,20,0
1708249507643,LTCS 87,B00,492907,Nguyen; Hoang Tan,20,0,20,0
1708249508175,LTCS 150,A00,412543,Liao; Ping H,39,0,40,1
1708249508705,LTCS 225,A00,412819,Mendoza; Andrea,14,0,15,1
1708249509230,LTCS 250,A00,412821,Lee; Jin-Kyung,15,0,15,0
1708249509760,LTEA 110B,A00,412548,Liao; Ping H,60,0,60,0
1708249510287,LTEA 120A,A00,479216,Zhu; Ping,36,0,40,4
1708249510814,LTEA 120C,A00,412552,Fiss; Geraldine Anna,295,0,300,5
1708249511345,LTEA 132,A00,412561,Mendoza; Andrea,51,0,60,9
1708249511876,LTEA 141,A00,412565,Lee; Jin-Kyung,37,0,40,3
1708249512402,LTEN 23,A01,411317,Vijay; Ameeth Varma,24,0,25,1
1708249512402,LTEN 23,A02,411318,Vijay; Ameeth Varma,24,0,25,1
1708249512402,LTEN 23,A03,411371,Vijay; Ameeth Varma,25,0,25,0
1708249512402,LTEN 23,A04,411375,Vijay; Ameeth Varma,24,0,25,1
1708249512934,LTEN 28,A01,411632,Blanco; John D,25,0,25,0
1708249512934,LTEN 28,A02,411697,Blanco; John D,25,0,25,0
1708249512934,LTEN 28,A03,411698,Blanco; John D,25,0,25,0
1708249512934,LTEN 28,A04,411709,Blanco; John D,25,0,25,0
1708249512934,LTEN 28,A05,411719,Blanco; John D,25,0,25,0
1708249512934,LTEN 28,A06,411744,Blanco; John D,25,0,25,0
1708249512934,LTEN 28,A07,411780,Blanco; John D,25,0,25,0
1708249512934,LTEN 28,A08,411820,Blanco; John D,25,0,25,0
1708249513464,LTEN 110,A00,486891,Vitkus; Daniel J.,38,0,40,2
1708249513991,LTEN 144,A00,412570,Vijay; Ameeth Varma,39,0,40,1
1708249514518,LTEN 180,A00,412581,Perreira; Christopher Michael,18,0,25,7
1708249515044,LTEN 181,A00,412582,Mukherjee; Silpa,55,0,60,5
1708249515570,LTEN 245,A00,412824,Johnson; Sara E.,13,0,15,2
1708249516099,LTEN 259,A00,412825,Streeby; Shelley,13,0,15,2
1708249516626,LTEU 111,A00,412588,Kontje; Todd Curtis,38,0,40,2
1708249517159,LTEU 140,A00,480172,De Marchi Gherini; Adriana,36,0,37,1
1708249517685,LTEU 141,A00,412592,Cohen; Alain J. J.,40,0,40,0
1708249518212,LTFR 2A,A01,411996,Ploye; Catherine,25,0,25,0
1708249518754,LTFR 2C,A00,411997,Ploye; Catherine,24,0,25,1
1708249519300,LTFR 142,A00,412597,Zhiri; Oumelbanine,20,0,20,0
1708249519832,LTGK 3,A00,412001,Murray; Kourtney Kristine,30,0,30,0
1708249520358,LTGM 2C,A00,412002,Fischer-Grunski; Eva K,25,0,25,0
1708249520902,LTKO 1C,A01,412029,Cho; Hye Jin,24,0,25,1
1708249520902,LTKO 1C,B01,412164,Cho; Hye Jin,23,0,25,2
1708249520902,LTKO 1C,C01,412168,Cho; Hye Jin,25,0,25,0
1708249520902,LTKO 1C,D01,412353,Yim; Nancy,24,0,25,1
1708249520902,LTKO 1C,E01,412372,Yim; Nancy,25,0,25,0
1708249521432,LTKO 2C,A01,412374,Yim; Nancy,21,0,25,4
1708249521961,LTKO 130P,A00,412601,Lee; Jeyseon,25,0,25,0
1708249522485,LTKO 135,A00,412606,Lee; Jeyseon,25,0,25,0
1708249523016,LTLA 3,A00,412375,Murray; Kourtney Kristine,36,0,40,4
1708249523546,LTRU 1C,A01,412491,Wells; Patricia Rebecca,24,0,25,1
1708249524074,LTRU 104A,A01,412614,Wells; Patricia Rebecca,20,0,20,0
1708249524605,LTSP 2A,A01,412493,Lampell; Toni,24,0,25,1
1708249525139,LTSP 2B,A01,412497,Lampell; Toni,22,0,25,3
1708249525139,LTSP 2B,B01,479218,Lampell; Toni,24,0,25,1
1708249525665,LTSP 2C,A01,412499,Mastromartino; Alexandra L,23,0,25,2
1708249526206,LTSP 2D,A00,412500,Dominguez; Noelia,24,0,25,1
1708249526733,LTSP 2E,A00,412501,Mastromartino; Alexandra L,24,0,25,1
1708249526733,LTSP 2E,B00,412502,Mastromartino; Alexandra L,25,0,25,0
1708249527261,LTSP 87,A00,479212,Bessett; Ryan Matthew,20,0,20,0
1708249527792,LTSP 100B,A00,412619,Dominguez; Noelia,25,0,25,0
1708249527792,LTSP 100B,B00,412623,Dominguez; Noelia,24,0,25,1
1708249528321,LTSP 116,A00,412628,Blanco; John D,28,0,30,2
1708249528846,LTSP 135A,A00,412631,Parra; Max,27,0,30,3
1708249529374,LTSP 174,A00,479213,Staff,28,0,30,2
1708249529903,LTTH 115,A00,412632,Kontje; Todd Curtis,35,0,40,5
1708249530429,LTTH 210C,A00,412826,Batarseh; Amanda Alicia,14,0,15,1
1708249530956,LTTH 255,A00,412827,Ali; Mohammad Kazim,13,0,15,2
1708249531541,LTTH 260,A00,412828,Kim; Joo Ok,30,0,30,0
1708249532071,LTWL 19C,A00,412503,Kelting; Edward William,40,0,40,0
1708249532597,LTWL 101,A00,412633,Kelting; Edward William,39,0,40,1
1708249533122,LTWL 114,A00,412656,Fiss; Geraldine Anna,60,0,60,0
1708249533648,LTWL 123,A00,412674,Lampert-Weissig; Lisa,31,0,40,9
1708249534173,LTWL 172,A00,412729,De Marchi Gherini; Adriana,37,0,40,3
1708249534698,LTWL 183,A00,412731,Cohen; Alain J. J.,38,0,40,2
1708249535222,LTWL 184,A00,479219,Mukherjee; Silpa,38,0,40,2
1708249535751,LTWL 194A,A00,489635,Vijay; Ameeth Varma,27,0,31,4
1708249536282,LTWR 8A,A01,412505,Springer; Anna Joy,24,0,25,1
1708249536282,LTWR 8A,A02,412506,Springer; Anna Joy,24,0,25,1
1708249536282,LTWR 8A,A03,412507,Springer; Anna Joy,25,0,25,0
1708249536282,LTWR 8A,A04,412508,Springer; Anna Joy,23,0,25,2
1708249536812,LTWR 8C,A01,412511,Forbes; Camille,23,0,25,2
1708249536812,LTWR 8C,A02,412512,Forbes; Camille,25,0,25,0
1708249536812,LTWR 8C,A03,412514,Forbes; Camille,25,0,25,0
1708249536812,LTWR 8C,A04,412519,Forbes; Camille,24,0,25,1
1708249537341,LTWR 100,A00,412734,Forbes; Camille,7,0,15,8
1708249537867,LTWR 113,A00,412816,Carroll; Amy Sara,28,0,30,2
1708249538391,LTWR 114,A00,412817,Springer; Anna Joy,23,0,30,7
1708249538918,LTWR 126,A00,412818,Hoang; Lily Kim,25,0,30,5
1708249539442,LTWR 215,A00,412880,Carroll; Amy Sara,19,0,20,1
1708249539976,MAE 3,A01,435606,Qi; Huihui,16,0,20,4
1708249539976,MAE 3,A02,435607,Qi; Huihui,15,0,20,5
1708249539976,MAE 3,A03,435608,Qi; Huihui,19,0,20,1
1708249539976,MAE 3,B01,435618,Delson; Nathan Joseph & Mullin; Jennifer S,20,0,20,0
1708249539976,MAE 3,B02,435626,Delson; Nathan Joseph & Mullin; Jennifer S,20,0,20,0
1708249539976,MAE 3,B03,435666,Delson; Nathan Joseph & Mullin; Jennifer S,20,0,20,0
1708249539976,MAE 3,B04,435679,Delson; Nathan Joseph & Mullin; Jennifer S,20,0,20,0
1708249539976,MAE 3,B05,494545,Delson; Nathan Joseph & Mullin; Jennifer S,20,0,20,0
1708249540502,MAE 8,A01,435688,Pham; Hieu Tan,197,0,200,3
1708249541029,MAE 30B,A00,435689,Lubarda; Marko,128,0,130,2
1708249541029,MAE 30B,B00,435701,Ghazinejad; Maziar,117,0,130,13
1708249541556,MAE 101B,A00,435702,Saintillan; David,146,0,150,4
1708249541556,MAE 101B,B00,435703,Nomura; Keiko K.,138,0,146,8
1708249542083,MAE 101C,A00,435704,Sadeghizadeh; Zahra,53,0,65,12
1708249542611,MAE 101D,A00,435705,Chen; Renkun,14,0,20,6
1708249543135,MAE 105,A00,435706,Becker; Janet Maria,115,0,120,5
1708249543661,MAE 107,A00,435707,Lindsey; Stephanie,48,0,50,2
1708249543661,MAE 107,B00,435708,Davidson; Michael R,55,0,60,5
1708249544187,MAE 119,A00,435710,Hidalgo-Gonzalez; Patricia,100,0,120,20
1708249544712,MAE 120,A00,435722,Arefiev; Alexey,49,0,65,16
1708249545236,MAE 125,A00,435723,Kleissl; Jan,60,0,65,5
1708249545765,MAE 131A,A00,435724,Qi; Huihui,119,0,125,6
1708249545765,MAE 131A,B00,435725,Meyers; Marc,123,0,125,2
1708249546293,MAE 143B,A00,435726,Morimoto; Tania,114,0,120,6
1708249546293,MAE 143B,B00,435727,Herbert; Sylvia Lee,117,0,120,3
1708249546293,MAE 143B,C00,435728,Diagne; Mamadou Lamine,108,0,120,12
1708249546818,MAE 145,A00,435729,Martinez; Sonia,41,0,60,19
1708249547348,MAE 148,A01,492802,Silberman; Jack,14,0,24,10
1708249547875,MAE 150,A00,435730,Pham; Hieu Tan,52,0,60,8
1708249548405,MAE 152,A00,435731,Llewellyn Smith; Stefan G.,14,0,14,0
1708249548405,MAE 152,B00,435747,Llewellyn Smith; Stefan G.,12,0,14,2
1708249548405,MAE 152,C00,435748,Llewellyn Smith; Stefan G.,12,0,14,2
1708249548405,MAE 152,D00,435749,Llewellyn Smith; Stefan G.,8,0,14,6
1708249548405,MAE 152,E00,435750,Llewellyn Smith; Stefan G.,13,0,14,1
1708249548930,MAE 155B,A01,435752,Hwang; John T,36,0,50,14
1708249548930,MAE 155B,B01,435768,Anderson; Mark Ronald,27,0,50,23
1708249548930,MAE 155B,C01,494006,Saha; Abhishek,0,0,0,0
1708249549459,MAE 156B,A01,435770,Tustaniwskyj; Jerry I,33,0,40,7
1708249549459,MAE 156B,B01,435772,Ghazinejad; Maziar,35,0,40,5
1708249549459,MAE 156B,C01,435774,Delson; Nathan Joseph,38,0,40,2
1708249549459,MAE 156B,D01,435776,Saha; Abhishek,31,0,40,9
1708249549986,MAE 166,A00,435777,Fullerton; Eric E,44,0,50,6
1708249550513,MAE 170,A01,435779,Lubarda; Marko,30,0,32,2
1708249550513,MAE 170,A02,435780,Lubarda; Marko,27,0,32,5
1708249550513,MAE 170,A03,435781,Lubarda; Marko,32,0,32,0
1708249550513,MAE 170,A04,435782,Lubarda; Marko,31,0,32,1
1708249550513,MAE 170,A05,435783,Lubarda; Marko,29,0,32,3
1708249550513,MAE 170,A06,435784,Lubarda; Marko,30,0,32,2
1708249550513,MAE 170,B01,435786,Evdokimenko; Ekaterina,23,0,24,1
1708249550513,MAE 170,B02,435787,Evdokimenko; Ekaterina,20,0,24,4
1708249550513,MAE 170,B03,435788,Evdokimenko; Ekaterina,23,0,24,1
1708249550513,MAE 170,B04,435789,Evdokimenko; Ekaterina,23,0,24,1
1708249550513,MAE 170,B05,435790,Evdokimenko; Ekaterina,19,0,24,5
1708249550513,MAE 170,B06,435791,Evdokimenko; Ekaterina,23,0,24,1
1708249551043,MAE 180,A00,479477,Sadeghizadeh; Zahra,56,0,60,4
1708249551573,MAE 184,A00,435792,Anderson; Mark Ronald,7,0,50,43
1708249552100,MAE 190,A00,435793,Beg; Farhat N.,17,0,20,3
1708249552100,MAE 190,B00,479209,Gerardo; Hortense Flotilde,12,0,15,3
1708249552632,MAE 202,A00,435794,Bandaru; Prabhakar,32,0,70,38
1708249553163,MAE 205,A00,435804,Hwang; John T & Tynan; George Robert & Seshadri; Kalyanasundaram & Rangamani; Padmini & Bandaru; Prabhakar,9990,0,9999,9
1708249553689,MAE 207,A00,435805,Beg; Farhat N.,9,0,10,1
1708249553689,MAE 207,B00,435815,Campbell; Edward Michael,6,0,10,4
1708249553689,MAE 207,C00,477499,Gerardo; Hortense Flotilde,6,0,30,24
1708249554216,MAE 209,A00,435816,Scholtes Acevedo; Claire,25,0,30,5
1708249554741,MAE 210C,A00,435817,Becker; Janet Maria,22,0,30,8
1708249555267,MAE 211,A00,435818,Seshadri; Kalyanasundaram,20,0,30,10
1708249555794,MAE 214A,A00,435819,Sarkar; Sutanu,27,0,35,8
1708249556322,MAE 217C,A00,435820,Marinoni; Alessandro,10,0,10,0
1708249556851,MAE 221C,A00,435821,Seshadri; Kalyanasundaram,9,0,15,6
1708249557379,MAE 221D,A00,435822,Poulikakos; Lisa Voula,23,0,30,7
1708249557906,MAE 224A,A00,435823,Pawlak; Geno Ronald,5,0,10,5
1708249558432,MAE 227,A00,435824,Hidalgo-Gonzalez; Patricia,21,0,35,14
1708249558958,MAE 231A,A00,435825,Boechler; Nicholas Sebastia,14,0,30,16
1708249559484,MAE 240,A00,435826,Rosengren; Aaron,19,0,30,11
1708249560012,MAE 242,A00,435827,Martinez; Sonia,0,0,45,45
1708249560538,MAE 249,A00,435842,Tolley; Michael Thomas,0,0,35,35
1708249561066,MAE 253,A00,435891,Staff,24,0,25,1
1708249561594,MAE 256,A00,435949,Coimbra; Carlos F.,6,0,10,4
1708249562119,MAE 263,A00,435987,Rangamani; Padmini,10,0,10,0
1708249562648,MAE 266,A00,435988,Evdokimenko; Ekaterina,7,0,30,23
1708249563178,MAE 271C,A00,435990,Arzt; Eduard,10,0,10,0
1708249563704,MAE 281B,A00,435991,Cortes; Jorge,9,0,25,16
1708249564230,MAE 288A,A00,435998,McEneaney; William Michael,6,0,40,34
1708249564757,MAE 288B,A00,435999,Bitmead; Robert R.,41,0,45,4
1708249565286,MAE 290C,A00,436008,Schmidt; Oliver,26,0,30,4
1708249565812,MAE 294C,A01,436010,Young; William Roy,19,0,20,1
1708249566341,MATH 2,A01,431271,Staff,31,0,35,4
1708249566341,MATH 2,B01,431273,Staff,29,0,35,6
1708249566341,MATH 2,C01,431275,Staff,31,0,35,4
1708249566868,MATH 3C,A01,431277,Safii; Soheil,12,0,15,3
1708249566868,MATH 3C,A02,431278,Safii; Soheil,12,0,15,3
1708249566868,MATH 3C,A03,431279,Safii; Soheil,12,0,15,3
1708249566868,MATH 3C,A04,431280,Safii; Soheil,15,0,15,0
1708249566868,MATH 3C,A05,431281,Safii; Soheil,14,0,15,1
1708249566868,MATH 3C,A06,431282,Safii; Soheil,15,0,15,0
1708249567395,MATH 10A,A01,431284,Bowers; Adam R.,20,0,30,10
1708249567395,MATH 10A,A02,431285,Bowers; Adam R.,18,0,30,12
1708249567395,MATH 10A,A03,431369,Bowers; Adam R.,28,0,30,2
1708249567395,MATH 10A,A04,431395,Bowers; Adam R.,27,0,30,3
1708249567395,MATH 10A,A05,431450,Bowers; Adam R.,28,0,30,2
1708249567395,MATH 10A,A06,431508,Bowers; Adam R.,30,0,30,0
1708249567395,MATH 10A,B01,431572,Kowalenko; Ethan J,24,0,30,6
1708249567395,MATH 10A,B02,431573,Kowalenko; Ethan J,29,0,30,1
1708249567395,MATH 10A,B03,431574,Kowalenko; Ethan J,30,0,30,0
1708249567395,MATH 10A,B04,431576,Kowalenko; Ethan J,30,0,30,0
1708249567395,MATH 10A,B05,431577,Kowalenko; Ethan J,30,0,30,0
1708249567395,MATH 10A,B06,431583,Kowalenko; Ethan J,30,0,30,0
1708249567924,MATH 10B,A01,431595,Habib; Yousaf,29,0,36,7
1708249567924,MATH 10B,A02,431597,Habib; Yousaf,35,0,36,1
1708249567924,MATH 10B,A03,431669,Habib; Yousaf,37,0,37,0
1708249567924,MATH 10B,A04,431670,Habib; Yousaf,36,0,37,1
1708249567924,MATH 10B,A05,431671,Habib; Yousaf,70,0,70,0
1708249567924,MATH 10B,B01,431673,Habib; Yousaf,25,0,33,8
1708249567924,MATH 10B,B02,431712,Habib; Yousaf,33,0,33,0
1708249567924,MATH 10B,B03,431713,Habib; Yousaf,33,0,33,0
1708249567924,MATH 10B,B04,431714,Habib; Yousaf,33,0,33,0
1708249567924,MATH 10B,B05,431715,Habib; Yousaf,60,0,60,0
1708249567924,MATH 10B,C01,431717,Bach; Quang Tran,57,0,60,3
1708249567924,MATH 10B,C02,431718,Bach; Quang Tran,18,0,34,16
1708249567924,MATH 10B,C03,431719,Bach; Quang Tran,34,0,34,0
1708249567924,MATH 10B,C04,431720,Bach; Quang Tran,33,0,34,1
1708249567924,MATH 10B,C05,431721,Bach; Quang Tran,32,0,34,2
1708249567924,MATH 10B,D01,431723,Staff,28,0,34,6
1708249567924,MATH 10B,D02,431724,Staff,34,0,34,0
1708249567924,MATH 10B,D03,431725,Staff,34,0,34,0
1708249567924,MATH 10B,D04,431726,Staff,34,0,34,0
1708249567924,MATH 10B,D05,431727,Staff,57,0,60,3
1708249568454,MATH 10C,A01,431741,Staff,94,0,96,2
1708249568454,MATH 10C,A02,431742,Staff,39,0,40,1
1708249568454,MATH 10C,B01,431744,Staff,95,0,96,1
1708249568454,MATH 10C,B02,431746,Staff,27,0,40,13
1708249568454,MATH 10C,C01,431748,Pardo Guerra; Sebastian,30,0,40,10
1708249568454,MATH 10C,C02,431885,Pardo Guerra; Sebastian,40,0,40,0
1708249568454,MATH 10C,C03,431895,Pardo Guerra; Sebastian,32,0,33,1
1708249568454,MATH 10C,C04,431896,Pardo Guerra; Sebastian,32,0,32,0
1708249568989,MATH 11,A01,431933,Rava; Denise,82,0,100,18
1708249568989,MATH 11,A02,431960,Rava; Denise,66,0,70,4
1708249568989,MATH 11,A03,431971,Rava; Denise,39,0,40,1
1708249568989,MATH 11,B01,432053,Staff,99,0,100,1
1708249568989,MATH 11,B02,432064,Staff,37,0,45,8
1708249568989,MATH 11,B03,432073,Staff,44,0,45,1
1708249569520,MATH 18,A01,432082,Mackall; Eoin Travis,65,0,70,5
1708249569520,MATH 18,A02,432086,Mackall; Eoin Travis,68,0,70,2
1708249569520,MATH 18,B01,432089,Suk; Andrew Hoon,39,0,40,1
1708249569520,MATH 18,B02,432090,Suk; Andrew Hoon,35,0,40,5
1708249569520,MATH 18,B03,432091,Suk; Andrew Hoon,33,0,40,7
1708249569520,MATH 18,B04,432092,Suk; Andrew Hoon,30,0,40,10
1708249569520,MATH 18,B05,432093,Suk; Andrew Hoon,34,0,35,1
1708249569520,MATH 18,B06,432094,Suk; Andrew Hoon,33,0,35,2
1708249569520,MATH 18,B07,432095,Suk; Andrew Hoon,98,0,100,2
1708249569520,MATH 18,B08,432096,Suk; Andrew Hoon,100,0,100,0
1708249569520,MATH 18,B09,432097,Suk; Andrew Hoon,98,0,100,2
1708249569520,MATH 18,B10,432098,Suk; Andrew Hoon,69,0,70,1
1708249570050,MATH 20A,A01,432101,Briones; Jor-el Thomas Caparas,30,0,40,10
1708249570050,MATH 20A,A02,432102,Briones; Jor-el Thomas Caparas,98,0,100,2
1708249570050,MATH 20A,B01,432104,Briones; Jor-el Thomas Caparas,99,0,100,1
1708249570050,MATH 20A,B02,432105,Briones; Jor-el Thomas Caparas,40,0,40,0
1708249570579,MATH 20B,A01,432107,Quarfoot; David James,33,0,35,2
1708249570579,MATH 20B,A02,432108,Quarfoot; David James,18,0,35,17
1708249570579,MATH 20B,A03,432109,Quarfoot; David James,32,0,35,3
1708249570579,MATH 20B,A04,432110,Quarfoot; David James,34,0,35,1
1708249570579,MATH 20B,A05,432331,Quarfoot; David James,26,0,32,6
1708249570579,MATH 20B,A06,432411,Quarfoot; David James,31,0,32,1
1708249570579,MATH 20B,B01,432413,Mackall; Eoin Travis,62,0,65,3
1708249570579,MATH 20B,B02,432443,Mackall; Eoin Travis,65,0,65,0
1708249570579,MATH 20B,B03,432444,Mackall; Eoin Travis,60,0,60,0
1708249570579,MATH 20B,B04,432471,Mackall; Eoin Travis,60,0,60,0
1708249571114,MATH 20C,A01,432473,Ohm; Ko Woon,26,0,38,12
1708249571114,MATH 20C,A02,432474,Ohm; Ko Woon,36,0,38,2
1708249571114,MATH 20C,A03,432475,Ohm; Ko Woon,34,0,37,3
1708249571114,MATH 20C,A04,432546,Ohm; Ko Woon,36,0,37,1
1708249571114,MATH 20C,A05,432550,Ohm; Ko Woon,88,0,90,2
1708249571114,MATH 20C,B01,432568,Ohm; Ko Woon,43,0,45,2
1708249571114,MATH 20C,B02,432594,Ohm; Ko Woon,40,0,45,5
1708249571114,MATH 20C,B03,432609,Ohm; Ko Woon,85,0,90,5
1708249571114,MATH 20C,C01,432613,Cheng; Hsiao-Bing,67,0,70,3
1708249571114,MATH 20C,C02,432614,Cheng; Hsiao-Bing,68,0,70,2
1708249571114,MATH 20C,C03,432615,Cheng; Hsiao-Bing,70,0,70,0
1708249571114,MATH 20C,D01,432617,Cheng; Hsiao-Bing,69,0,70,1
1708249571114,MATH 20C,D02,432618,Cheng; Hsiao-Bing,68,0,70,2
1708249571114,MATH 20C,D03,432619,Cheng; Hsiao-Bing,70,0,70,0
1708249571644,MATH 20D,A01,432622,Hammock; Frances H,58,0,60,2
1708249571644,MATH 20D,A02,432623,Hammock; Frances H,58,0,60,2
1708249571644,MATH 20D,A03,432658,Hammock; Frances H,35,0,35,0
1708249571644,MATH 20D,A04,432660,Hammock; Frances H,35,0,35,0
1708249571644,MATH 20D,B01,432702,Hammock; Frances H,66,0,70,4
1708249571644,MATH 20D,B02,432703,Hammock; Frances H,70,0,70,0
1708249571644,MATH 20D,B03,432766,Hammock; Frances H,30,0,30,0
1708249571644,MATH 20D,B04,432782,Hammock; Frances H,20,0,30,10
1708249571644,MATH 20D,C01,432811,Sheng; Hongyi,60,0,60,0
1708249571644,MATH 20D,C02,432931,Sheng; Hongyi,60,0,60,0
1708249571644,MATH 20D,C03,432945,Sheng; Hongyi,28,0,30,2
1708249571644,MATH 20D,C04,432949,Sheng; Hongyi,30,0,30,0
1708249572169,MATH 20E,A01,433007,Eggers; John Dietrich,70,0,80,10
1708249572169,MATH 20E,A02,433070,Eggers; John Dietrich,77,0,80,3
1708249572169,MATH 20E,A03,433079,Eggers; John Dietrich,32,0,35,3
1708249572169,MATH 20E,B01,433092,Staff,86,0,90,4
1708249572169,MATH 20E,B02,433093,Staff,90,0,90,0
1708249572169,MATH 20E,C01,433237,Bach; Quang Tran,52,0,60,8
1708249572169,MATH 20E,C02,433238,Bach; Quang Tran,69,0,70,1
1708249572169,MATH 20E,C03,433239,Bach; Quang Tran,70,0,70,0
1708249572699,MATH 31CH,A01,433241,Rabin; Jeffrey Mark,35,0,35,0
1708249573226,MATH 95,A00,433242,Stevens; Laura Jeanne,30,0,30,0
1708249573753,MATH 100C,A01,433244,Pollack; Aaron,31,0,35,4
1708249573753,MATH 100C,A02,433245,Pollack; Aaron,35,0,35,0
1708249574280,MATH 102,A01,433298,Ophir; Amit,29,0,30,1
1708249574280,MATH 102,A02,433369,Ophir; Amit,30,0,30,0
1708249574280,MATH 102,A03,433373,Ophir; Amit,30,0,30,0
1708249574280,MATH 102,A04,433374,Ophir; Amit,29,0,30,1
1708249574280,MATH 102,B01,433572,Zhang; Ming,28,0,30,2
1708249574280,MATH 102,B02,433732,Zhang; Ming,30,0,30,0
1708249574280,MATH 102,B03,433733,Zhang; Ming,30,0,30,0
1708249574280,MATH 102,B04,433734,Zhang; Ming,29,0,30,1
1708249574812,MATH 103B,A01,433793,Lu; Yunze,23,0,30,7
1708249574812,MATH 103B,A02,433795,Lu; Yunze,30,0,30,0
1708249574812,MATH 103B,A03,433830,Lu; Yunze,28,0,30,2
1708249574812,MATH 103B,B01,433845,Lahiri; Aranya,24,0,30,6
1708249574812,MATH 103B,B02,433846,Lahiri; Aranya,28,0,30,2
1708249574812,MATH 103B,B03,433847,Lahiri; Aranya,27,0,30,3
1708249575347,MATH 109,A01,433849,Aycock; Jon Merrill,6,0,10,4
1708249575347,MATH 109,A02,433850,Aycock; Jon Merrill,9,0,10,1
1708249575347,MATH 109,B01,433852,Klevdal; Christian Sleek,10,0,10,0
1708249575347,MATH 109,B02,433859,Klevdal; Christian Sleek,10,0,10,0
1708249575347,MATH 109,C01,433861,Treuer; John N,5,0,10,5
1708249575347,MATH 109,C02,433862,Treuer; John N,10,0,10,0
1708249575347,MATH 109,D01,433864,Treuer; John N,8,0,10,2
1708249575347,MATH 109,D02,433865,Treuer; John N,8,0,10,2
1708249575347,MATH 109,E01,433868,Sheng; Hongyi,10,0,10,0
1708249575347,MATH 109,E02,433869,Sheng; Hongyi,19,0,20,1
1708249575873,MATH 110,A01,433871,Pillai; Mohandas K,24,0,35,11
1708249575873,MATH 110,A02,433872,Pillai; Mohandas K,33,0,35,2
1708249576399,MATH 112B,A01,480683,Komarova; Natalia,27,0,27,0
1708249576929,MATH 120B,A01,433885,Xiao; Ming,32,0,35,3
1708249576929,MATH 120B,A02,433886,Xiao; Ming,34,0,35,1
1708249577460,MATH 121B,A01,433888,Stevens; Laura Jeanne,29,0,30,1
1708249577989,MATH 140B,A01,433890,Seward; Brandon M.,31,0,35,4
1708249577989,MATH 140B,A02,433891,Seward; Brandon M.,35,0,35,0
1708249578515,MATH 140C,A01,433895,Spolaor; Luca,32,0,35,3
1708249578515,MATH 140C,A02,433896,Spolaor; Luca,35,0,35,0
1708249579042,MATH 142B,A01,433966,Eggers; John Dietrich,25,0,35,10
1708249579042,MATH 142B,A02,434063,Eggers; John Dietrich,32,0,35,3
1708249579042,MATH 142B,B01,434071,Sanchez; Anthony,32,0,35,3
1708249579042,MATH 142B,B02,434083,Sanchez; Anthony,34,0,35,1
1708249579042,MATH 142B,C01,434094,Kunnawalkam Elayavalli; Sr,31,0,35,4
1708249579042,MATH 142B,C02,434095,Kunnawalkam Elayavalli; Sr,34,0,35,1
1708249579570,MATH 144,A01,434097,Cloninger; Alexander,30,0,30,0
1708249580096,MATH 150B,A01,434104,Parise; Davide,33,0,35,2
1708249580620,MATH 152,A01,434107,Grier; Daniel T,20,0,40,20
1708249581150,MATH 154,A01,434109,Wesley; William J,31,0,35,4
1708249581150,MATH 154,A02,434119,Wesley; William J,35,0,35,0
1708249581150,MATH 154,A03,434120,Wesley; William J,35,0,35,0
1708249581150,MATH 154,A04,434121,Wesley; William J,34,0,35,1
1708249581150,MATH 154,B01,434126,Aliabadi Sr.; Mohsen,26,0,35,9
1708249581150,MATH 154,B02,434127,Aliabadi Sr.; Mohsen,34,0,35,1
1708249581150,MATH 154,B03,434138,Aliabadi Sr.; Mohsen,35,0,35,0
1708249581150,MATH 154,B04,434139,Aliabadi Sr.; Mohsen,35,0,35,0
1708249581676,MATH 163,A01,434144,Bowers; Adam R.,0,0,5,5
1708249582205,MATH 170A,A01,434148,Nag; Panchali,36,0,36,0
1708249582205,MATH 170A,A02,434149,Nag; Panchali,36,0,36,0
1708249582205,MATH 170A,A03,434150,Nag; Panchali,36,0,37,1
1708249582205,MATH 170A,A04,434151,Nag; Panchali,36,0,36,0
1708249582732,MATH 170B,A01,434155,Huang; Lei,31,0,35,4
1708249582732,MATH 170B,A02,434160,Huang; Lei,35,0,35,0
1708249582732,MATH 170B,A03,434161,Huang; Lei,35,0,35,0
1708249582732,MATH 170B,A04,434162,Huang; Lei,35,0,35,0
1708249583259,MATH 170C,A01,434176,Leok; Melvin,30,0,35,5
1708249583259,MATH 170C,A02,434300,Leok; Melvin,34,0,35,1
1708249583788,MATH 171B,A01,434576,Nie; Jiawang,25,0,35,10
1708249583788,MATH 171B,A02,434583,Nie; Jiawang,35,0,35,0
1708249583788,MATH 171B,A03,434584,Nie; Jiawang,35,0,35,0
1708249583788,MATH 171B,A04,434609,Nie; Jiawang,35,0,35,0
1708249584314,MATH 180A,A01,434638,Gartland; Christopher John,29,0,30,1
1708249584314,MATH 180A,A02,434821,Gartland; Christopher John,28,0,30,2
1708249584314,MATH 180A,A03,434833,Gartland; Christopher John,24,0,30,6
1708249584314,MATH 180A,A04,434839,Gartland; Christopher John,30,0,30,0
1708249584314,MATH 180A,A05,434843,Gartland; Christopher John,30,0,30,0
1708249584314,MATH 180A,A06,434895,Gartland; Christopher John,30,0,30,0
1708249584898,MATH 180B,A01,435085,Gartland; Christopher John,30,0,35,5
1708249584898,MATH 180B,A02,435086,Gartland; Christopher John,35,0,35,0
1708249584898,MATH 180B,A03,435087,Gartland; Christopher John,34,0,35,1
1708249584898,MATH 180B,A04,435088,Gartland; Christopher John,35,0,35,0
1708249585430,MATH 180C,A01,435090,Carfagnini; Marco,29,0,35,6
1708249585430,MATH 180C,A02,435091,Carfagnini; Marco,35,0,35,0
1708249585430,MATH 180C,A03,435092,Carfagnini; Marco,32,0,35,3
1708249585430,MATH 180C,A04,435113,Carfagnini; Marco,35,0,35,0
1708249585956,MATH 181A,A01,435279,Zhang; Danna,30,0,35,5
1708249585956,MATH 181A,A02,435300,Zhang; Danna,35,0,35,0
1708249585956,MATH 181A,A03,435301,Zhang; Danna,21,0,35,14
1708249585956,MATH 181A,A04,435302,Zhang; Danna,31,0,35,4
1708249586482,MATH 181B,A01,435315,Rava; Denise,33,0,35,2
1708249586482,MATH 181B,A02,435316,Rava; Denise,32,0,35,3
1708249586482,MATH 181B,A03,435317,Rava; Denise,33,0,35,2
1708249586482,MATH 181B,A04,435318,Rava; Denise,35,0,35,0
1708249587012,MATH 183,A01,435320,Quarfoot; David James,26,0,35,9
1708249587012,MATH 183,A02,435321,Quarfoot; David James,35,0,35,0
1708249587012,MATH 183,A03,435322,Quarfoot; David James,32,0,35,3
1708249587012,MATH 183,A04,435323,Quarfoot; David James,34,0,35,1
1708249587012,MATH 183,A05,435327,Quarfoot; David James,34,0,35,1
1708249587012,MATH 183,A06,435329,Quarfoot; David James,33,0,35,2
1708249587541,MATH 184,A01,435337,Verstraete; Jacques Allan,32,0,35,3
1708249587541,MATH 184,A02,435338,Verstraete; Jacques Allan,35,0,35,0
1708249587541,MATH 184,A03,435339,Verstraete; Jacques Allan,34,0,35,1
1708249587541,MATH 184,A04,435347,Verstraete; Jacques Allan,30,0,35,5
1708249588070,MATH 185,A01,435432,Arias-Castro; Ery,15,0,30,15
1708249588070,MATH 185,A02,435436,Arias-Castro; Ery,30,0,30,0
1708249588070,MATH 185,A03,435437,Arias-Castro; Ery,30,0,30,0
1708249588070,MATH 185,A04,435438,Arias-Castro; Ery,30,0,30,0
1708249588598,MATH 187A,A01,435443,Agrawal; Shishir,15,0,30,15
1708249588598,MATH 187A,A02,435444,Agrawal; Shishir,30,0,30,0
1708249588598,MATH 187A,A03,435503,Agrawal; Shishir,28,0,30,2
1708249588598,MATH 187A,A04,435507,Agrawal; Shishir,30,0,30,0
1708249588598,MATH 187A,A05,435554,Agrawal; Shishir,22,0,30,8
1708249588598,MATH 187A,A06,435558,Agrawal; Shishir,28,0,30,2
1708249589129,MATH 187B,A01,435570,Bucur; Alina Ioana,24,0,35,11
1708249589129,MATH 187B,A02,435571,Bucur; Alina Ioana,35,0,35,0
1708249589657,MATH 188,A01,435573,Kunnawalkam Elayavalli; Sr,35,0,35,0
1708249590182,MATH 189,A01,435577,Vishwanath; Siddharth,0,0,10,10
1708249590182,MATH 189,A02,435594,Vishwanath; Siddharth,0,0,10,10
1708249590182,MATH 189,A03,435595,Vishwanath; Siddharth,0,0,10,10
1708249590182,MATH 189,A04,435596,Vishwanath; Siddharth,0,0,10,10
1708249590182,MATH 189,A05,480706,Vishwanath; Siddharth,2,0,10,8
1708249590182,MATH 189,A06,481362,Vishwanath; Siddharth,6,0,10,4
1708249590708,MATH 200C,A00,430388,Bucur; Alina Ioana,15,0,15,0
1708249591237,MATH 202C,A00,430389,Rhoades; Brendon Patrick,15,0,15,0
1708249591767,MATH 203C,A00,430390,Izadi; Elham,15,0,15,0
1708249592291,MATH 204C,A00,430391,Sorensen; Claus M,15,0,15,0
1708249592815,MATH 208,A00,430392,Izadi; Elham,8,0,10,2
1708249593343,MATH 209,A00,430393,Pollack; Aaron,10,0,10,0
1708249593869,MATH 211A,A00,430394,Salehi Golsefidy; Alireza,10,0,10,0
1708249594394,MATH 211B,A00,430395,Seward; Brandon M.,10,0,10,0
1708249594923,MATH 212B,A01,480692,Komarova; Natalia,5,0,5,0
1708249595450,MATH 216C,A00,430429,Saab; Rayan,13,0,15,2
1708249595976,MATH 217,A00,430430,Li; Bo,13,0,15,2
1708249596504,MATH 218,A00,430431,Li; Bo,8,0,10,2
1708249597031,MATH 220C,A00,430432,Xiao; Ming,15,0,15,0
1708249597557,MATH 240C,A00,430433,Ebenfelt; Peter F,14,0,15,1
1708249598083,MATH 241B,A00,430434,Ioana; Adrian,14,0,15,1
1708249598607,MATH 243,A00,430435,Kunnawalkam Elayavalli; Sr,9,0,10,1
1708249599136,MATH 248,A00,430436,Bejenaru; Ioan,9,0,10,1
1708249599665,MATH 251C,A00,430437,Wenzl; Hans G,15,0,15,0
1708249600194,MATH 258,A00,430438,Spolaor; Luca,10,0,10,0
1708249600719,MATH 261C,A00,430439,Manners; Frederick,14,0,15,1
1708249601249,MATH 262A,A00,430440,Warnke; Lutz Peter,14,0,15,1
1708249601777,MATH 268,A00,430441,Buss; Samuel R,10,0,10,0
1708249602303,MATH 269,A00,430442,Rhoades; Brendon Patrick & Warnke; Lutz Peter,10,0,10,0
1708249602828,MATH 270C,A00,430445,Cheng; Li-Tien,15,0,15,0
1708249603353,MATH 273B,A00,430452,Zhu; Yuhua,15,0,15,0
1708249603879,MATH 276,A00,430458,Mc Culloch; Andrew Douglas & Amaro; Rommie E,0,0,0,0
1708249604410,MATH 277A,A00,430464,Dumitriu; Ioana,14,0,15,1
1708249604938,MATH 278A,A00,430470,Cheng; Li-Tien,9,0,10,1
1708249605463,MATH 278B,A00,430471,Cloninger; Alexander,10,0,10,0
1708249605988,MATH 278C,A00,430472,Nie; Jiawang,9,0,10,1
1708249606514,MATH 280C,A00,430485,Schweinsberg; Jason,13,0,15,2
1708249607042,MATH 281C,A00,430496,Arias-Castro; Ery,8,0,15,7
1708249607566,MATH 284,A00,430503,Xu; Ronghui,11,0,15,4
1708249608092,MATH 287C,A00,430520,Zhang; Danna,14,0,15,1
1708249608620,MATH 288,A00,430527,Carfagnini; Marco,9,0,10,1
1708249609150,MATH 289A,A00,430541,Novak; Jonathan I,14,0,15,1
1708249609680,MATH 290C,A00,430548,Roberts; Justin Deritter,13,0,15,2
1708249610207,MATH 292,A00,430660,Lu; Yunze,10,0,10,0
1708249610736,MATH 294,A00,430678,Fitzsimmons; Patrick J,11,0,15,4
1708249611265,MATH 295,A00,430692,Bejenaru; Ioan,15,0,15,0
1708249611792,MATH 297,001,430721,Gamst; Anthony Collins,0,0,0,0
1708249612318,MATS 200,A00,414457,Graeve; Olivia A,9995,0,9999,4
1708249612847,MATS 201C,A00,414465,Arzt; Eduard,38,0,50,12
1708249613374,MATS 236,A00,414466,Staff,17,0,20,3
1708249613900,MATS 252,A00,414467,Evdokimenko; Ekaterina,42,0,45,3
1708249614431,MATS 261B,A00,414468,Qiao; Yu,17,0,25,8
1708249614958,MATS 295,A00,414469,Graeve; Olivia A,9999,0,9999,0
1708249614958,MATS 295,B00,478858,Kummel; Andrew C,9999,0,9999,0
1708249615486,MCWP 40,001,414476,Montejo; Carolina,19,0,20,1
1708249615486,MCWP 40,004,414480,Wastal; Carrie King,13,0,15,2
1708249615486,MCWP 40,005,414481,Wastal; Carrie King,10,0,15,5
1708249615486,MCWP 40,006,414482,Wastal; Carrie King,12,0,15,3
1708249615486,MCWP 40,007,414483,Wastal; Carrie King,13,0,15,2
1708249615486,MCWP 40,008,414484,Wastal; Carrie King,15,0,15,0
1708249615486,MCWP 40,009,414487,Wastal; Carrie King,12,0,15,3
1708249615486,MCWP 40,014,414505,Staff,20,0,20,0
1708249615486,MCWP 40,015,494362,Wastal; Carrie King,14,0,15,1
1708249616018,MCWP 50,002,414534,Bartulis; Jason Michael,20,0,20,0
1708249616018,MCWP 50,003,414536,Bartulis; Jason Michael,20,0,20,0
1708249616018,MCWP 50,004,414538,Krone; Jarret,16,0,20,4
1708249616018,MCWP 50,005,414539,Krone; Jarret,19,0,20,1
1708249616018,MCWP 50,006,414540,Smith; Haydee Marie,16,0,20,4
1708249616018,MCWP 50,007,414544,Compas; Sean Matthew,14,0,20,6
1708249616018,MCWP 50,008,414549,Redela; Pamela Morgan,20,0,20,0
1708249616018,MCWP 50,011,414557,Carter; Andrea L,16,0,20,4
1708249616018,MCWP 50,012,414592,Silva; Kelly B,20,0,20,0
1708249616018,MCWP 50,013,414593,Silva; Kelly B,19,0,20,1
1708249616018,MCWP 50,014,414594,Carter; Andrea L,20,0,20,0
1708249616018,MCWP 50,016,414596,Morshed; Michael James,14,0,20,6
1708249616018,MCWP 50,017,414598,Morshed; Michael James,17,0,20,3
1708249616018,MCWP 50,019,414601,Redela; Pamela Morgan,17,0,20,3
1708249616018,MCWP 50,020,414606,Carter; Jennifer A,20,0,20,0
1708249616018,MCWP 50,021,414607,Carter; Jennifer A,19,0,20,1
1708249616018,MCWP 50,022,414649,Compas; Sean Matthew,11,0,20,9
1708249616018,MCWP 50,023,414650,Smith; Haydee Marie,20,0,20,0
1708249616018,MCWP 50,024,414651,Nies; Laurie Elizabeth,19,0,20,1
1708249616018,MCWP 50,025,414655,Nies; Laurie Elizabeth,18,0,20,2
1708249616018,MCWP 50,026,414656,Pham; Vincent Minhduc,19,0,20,1
1708249616018,MCWP 50,027,414657,Pham; Vincent Minhduc,20,0,20,0
1708249616018,MCWP 50,028,414668,Morshed; Michael James,16,0,20,4
1708249616018,MCWP 50,029,414669,Morshed; Michael James,19,0,20,1
1708249616547,MCWP 50R,A00,486838,Miller; Elizabeth Deen,19,0,20,1
1708249616547,MCWP 50R,B00,486843,Miller; Elizabeth Deen,16,0,20,4
1708249616547,MCWP 50R,C00,486844,Miller; Elizabeth Deen,19,0,20,1
1708249617076,MCWP 125,A00,414670,Wilson; Marion E.,20,0,20,0
1708249617076,MCWP 125,B00,414674,Guillen; Melinda,20,0,20,0
1708249617076,MCWP 125,C00,414678,Guillen; Melinda,20,0,20,0
1708249617076,MCWP 125,D00,414682,Guillen; Melinda,20,0,20,0
1708249617602,MED 231,A00,476440,Hurst; Samantha,7,0,7,0
1708249618134,MED 246,A00,492785,Gordts; Philip & Varki; Ajit P & Lewis; Amanda Lark & Godula; Kamil & Gagneux; Pascal & Esko; Jeffrey D. & Bode; Lars,10,0,10,0
1708249618662,MED 262,A00,492942,Koola; Jejo David,28,0,30,2
1708249619188,MED 267,A01,492789,Hogarth; Michael Andrew,25,0,30,5
1708249619714,MED 275,A00,464684,Liu; George Yenhsi,10,0,10,0
1708249620241,MED 276,A00,492786,Sitapati; Amy,23,0,25,2
1708249620774,MED 278,A00,492787,Carter; Hannah Kathryn & Mesirov; Jill P. & Curtius; Kathleen Mary,20,0,20,0
1708249621298,MED 296,001,464685,Chi; Neil C.,48,0,50,2
1708249621298,MED 296,002,464686,Hong; Kimberly N,49,0,50,1
1708249621298,MED 296,003,464687,Staff,50,0,50,0
1708249621824,MGT 3,A00,442429,Wagner; Timothy Ryan,95,0,98,3
1708249622350,MGT 4,A01,442443,Levkoff; Steven B.,0,0,5,5
1708249622350,MGT 4,A02,442444,Levkoff; Steven B.,4,0,5,1
1708249622875,MGT 5,A00,442446,Molloie Jr.; William H,184,0,196,12
1708249623405,MGT 12,A00,442447,Lindenberger; Wade Douglas,83,0,100,17
1708249623405,MGT 12,B00,442448,Lindenberger; Wade Douglas,72,0,100,28
1708249623405,MGT 12,C00,442449,Pecore; Joseph P.,88,0,100,12
1708249623932,MGT 16,A00,442452,Buchanan; Harold G,97,0,100,3
1708249623932,MGT 16,B00,442459,Buchanan; Harold G,92,0,100,8
1708249623932,MGT 16,C00,442461,Campbell; Robert Harold,113,0,120,7
1708249623932,MGT 16,D00,442475,Campbell; Robert Harold,118,0,120,2
1708249624466,MGT 18,A00,442477,McKay; Michael J,98,0,98,0
1708249624466,MGT 18,B00,442491,McKay; Michael J,96,0,98,2
1708249624466,MGT 18,C00,442493,McKay; Michael J,98,0,98,0
1708249624466,MGT 18,D00,442503,Chamberlain; Travis Dean,98,0,98,0
1708249624994,MGT 45,A00,442508,Pecore; Joseph P.,147,0,150,3
1708249624994,MGT 45,B00,442510,Pecore; Joseph P.,142,0,150,8
1708249625521,MGT 71,A00,442524,Lee; Hyun Seok,77,0,98,21
1708249626052,MGT 71R,A00,442526,Phiroz; Zal Navroze,77,0,98,21
1708249626579,MGT 100,A00,442541,Wilbur; Kenneth C,82,0,98,16
1708249626579,MGT 100,B00,442542,Wilbur; Kenneth C,89,0,98,9
1708249627107,MGT 103,A00,442543,Eberhard; Craig A,98,0,98,0
1708249627107,MGT 103,B00,442544,Eberhard; Craig A,95,0,98,3
1708249627107,MGT 103,C00,442545,Ehrich; Kristine R,90,0,98,8
1708249627107,MGT 103,D00,442547,Ehrich; Kristine R,96,0,98,2
1708249627107,MGT 103,E00,442548,Ehrich; Kristine R,97,0,98,1
1708249627107,MGT 103,F00,442549,Demill; Burritt,92,0,98,6
1708249627107,MGT 103,G00,442550,Bates; Kenneth Walter,97,0,98,1
1708249627635,MGT 105,A00,442558,Bates; Kenneth Walter,86,0,98,12
1708249628165,MGT 106,A00,442560,Eberhard; Craig A,95,0,98,3
1708249628695,MGT 109,A00,442574,Campbell; Colin Leslie,90,0,98,8
1708249629224,MGT 112,A00,442576,Somasundaram; Tyagarajan,96,0,98,2
1708249629224,MGT 112,B00,442590,Somasundaram; Tyagarajan,94,0,98,4
1708249629224,MGT 112,C00,442592,Zimmermann; Carsten,87,0,98,11
1708249629752,MGT 119,A00,442602,Staff,97,0,98,1
1708249629752,MGT 119,B00,442603,Anderson; Jon Marcus,96,0,98,2
1708249630279,MGT 121B,A00,442606,Klaas; Jeffrey David,94,0,98,4
1708249630808,MGT 128R,A00,442607,Krishnan; Viswanathan,84,0,98,14
1708249631333,MGT 131A,A00,442608,Houskeeper; Robert,148,0,150,2
1708249631862,MGT 131B,A00,442609,Houskeeper; Robert,100,0,100,0
1708249632392,MGT 132,A00,442610,Blakley; Bruce,97,0,98,1
1708249632918,MGT 137,A00,442611,Lindenberger; Wade Douglas,86,0,98,12
1708249633444,MGT 147,A00,442612,Anderson; John Charles,32,0,40,8
1708249633969,MGT 151R,A00,442613,Phiroz; Zal Navroze,92,0,98,6
1708249634495,MGT 153,A00,442650,Perols; Johan Lars,55,0,80,25
1708249635021,MGT 162,A00,442652,Demill; Burritt,81,0,98,17
1708249635021,MGT 162,B00,442654,Demill; Burritt,88,0,98,10
1708249635021,MGT 162,C00,442776,Staff,95,0,98,3
1708249635021,MGT 162,D00,442778,Staff,96,0,98,2
1708249635548,MGT 164,A00,442780,McKay; Mary A,97,0,98,1
1708249635548,MGT 164,B00,442849,McKay; Mary A,96,0,98,2
1708249635548,MGT 164,C00,442917,McKay; Mary A,97,0,98,1
1708249635548,MGT 164,D00,442949,Meyer; Alison Bloomfield,90,0,98,8
1708249636073,MGT 166,A00,443017,Moran; Cathleen L.,95,0,98,3
1708249636073,MGT 166,B00,443045,Moran; Cathleen L.,97,0,98,1
1708249636073,MGT 166,C00,443046,Moran; Cathleen L.,98,0,98,0
1708249636599,MGT 167,A00,443047,Klaas; Jeffrey David,93,0,98,5
1708249637128,MGT 171R,A00,443048,Phiroz; Zal Navroze,86,0,98,12
1708249637653,MGT 172,A00,443049,Hedges; Kathleen & Royal; Rebecca,116,0,120,4
1708249637653,MGT 172,B00,443050,Hedges; Kathleen,95,0,98,3
1708249637653,MGT 172,C00,443051,Zimmermann; Carsten,96,0,98,2
1708249638235,MGT 173,A00,443052,Hayes; Sherry Lorine,92,0,100,8
1708249638760,MGT 175,A00,443053,Gopal; Christopher S.,98,0,98,0
1708249640306,MGT 180,A00,443055,Bliss; Barbara Ann,139,0,150,11
1708249640306,MGT 180,B00,443069,Bliss; Barbara Ann,145,0,150,5
1708249640832,MGT 181,A00,443120,Buchanan; Harold G,147,0,150,3
1708249641361,MGT 183,A00,443121,Banerjee; Snehal,88,0,98,10
1708249641888,MGT 185,A00,443122,Dunn; Louis Jean,90,0,98,8
1708249642417,MGT 187,A00,443133,Dunn; Louis Jean,95,0,100,5
1708249642943,MGT 189,A00,443134,Avenancio-Leon; Carlos,98,0,98,0
1708249643470,MGT 227,A00,479242,Serra Garcia; Marta,19,0,20,1
1708249643995,MGT 259,A00,443135,Oveis; Christopher S,19,0,20,1
1708249644538,MGT 296,001,481416,Gneezy; Ayelet,3,0,3,0
1708249644538,MGT 296,002,481420,Amir; On,3,0,3,0
1708249644538,MGT 296,003,481466,Amir; On & Karmarkar; Uma R,3,0,3,0
1708249644538,MGT 296,004,481468,Liu; Jun,3,0,3,0
1708249644538,MGT 296,005,481469,Misra; Kanishka,3,0,3,0
1708249644538,MGT 296,006,481470,Erat; Sanjiv,3,0,3,0
1708249644538,MGT 296,007,481473,Timmermann; Allan,3,0,3,0
1708249644538,MGT 296,008,481474,Smith; Pamela Karen,3,0,3,0
1708249644538,MGT 296,009,481477,Zhang; Zhe,3,0,3,0
1708249644538,MGT 296,010,481478,Oveis; Christopher S,3,0,3,0
1708249644538,MGT 296,011,481479,Amir; On & Gneezy; Ayelet,3,0,3,0
1708249644538,MGT 296,012,481481,Wilbur; Kenneth C,3,0,3,0
1708249645212,MMW 13,A01,412918,Chang; Edmond Yi-Teh,15,0,16,1
1708249645212,MMW 13,A02,412928,Chang; Edmond Yi-Teh,16,0,16,0
1708249645212,MMW 13,A03,413017,Chang; Edmond Yi-Teh,16,0,16,0
1708249645212,MMW 13,A04,413018,Chang; Edmond Yi-Teh,16,0,16,0
1708249645212,MMW 13,A05,413019,Chang; Edmond Yi-Teh,15,0,16,1
1708249645212,MMW 13,A06,413020,Chang; Edmond Yi-Teh,16,0,16,0
1708249645212,MMW 13,A07,413021,Chang; Edmond Yi-Teh,15,0,16,1
1708249645212,MMW 13,A08,413023,Chang; Edmond Yi-Teh,16,0,16,0
1708249645212,MMW 13,A09,413024,Chang; Edmond Yi-Teh,16,0,16,0
1708249645212,MMW 13,A10,413025,Chang; Edmond Yi-Teh,16,0,16,0
1708249645212,MMW 13,A11,413026,Chang; Edmond Yi-Teh,16,0,16,0
1708249645212,MMW 13,A12,413027,Chang; Edmond Yi-Teh,16,0,16,0
1708249645212,MMW 13,A13,413028,Chang; Edmond Yi-Teh,0,0,0,0
1708249645212,MMW 13,A14,413029,Chang; Edmond Yi-Teh,0,0,0,0
1708249645212,MMW 13,A15,413030,Chang; Edmond Yi-Teh,14,0,16,2
1708249645212,MMW 13,A16,413031,Chang; Edmond Yi-Teh,15,0,16,1
1708249645212,MMW 13,A17,413032,Chang; Edmond Yi-Teh,16,0,16,0
1708249645212,MMW 13,A18,413034,Chang; Edmond Yi-Teh,14,0,16,2
1708249645212,MMW 13,A19,413035,Chang; Edmond Yi-Teh,16,0,16,0
1708249645212,MMW 13,A20,413036,Chang; Edmond Yi-Teh,16,0,16,0
1708249645212,MMW 13,A21,413037,Chang; Edmond Yi-Teh,0,0,0,0
1708249645212,MMW 13,A22,413038,Chang; Edmond Yi-Teh,0,0,0,0
1708249645212,MMW 13,B01,413290,Zhiri; Oumelbanine,15,0,16,1
1708249645212,MMW 13,B02,413291,Zhiri; Oumelbanine,15,0,16,1
1708249645212,MMW 13,B03,413308,Zhiri; Oumelbanine,14,0,16,2
1708249645212,MMW 13,B04,413322,Zhiri; Oumelbanine,14,0,16,2
1708249645212,MMW 13,B05,413343,Zhiri; Oumelbanine,12,0,16,4
1708249645212,MMW 13,B06,413344,Zhiri; Oumelbanine,14,0,16,2
1708249645212,MMW 13,B07,413524,Zhiri; Oumelbanine,16,0,16,0
1708249645212,MMW 13,B08,413584,Zhiri; Oumelbanine,16,0,16,0
1708249645212,MMW 13,B09,413588,Zhiri; Oumelbanine,15,0,16,1
1708249645212,MMW 13,B10,413590,Zhiri; Oumelbanine,16,0,16,0
1708249645212,MMW 13,B11,413779,Zhiri; Oumelbanine,12,0,16,4
1708249645212,MMW 13,B12,413780,Zhiri; Oumelbanine,9,0,16,7
1708249645212,MMW 13,B13,413781,Zhiri; Oumelbanine,0,0,0,0
1708249645212,MMW 13,B14,413782,Zhiri; Oumelbanine,0,0,0,0
1708249645212,MMW 13,B15,413808,Zhiri; Oumelbanine,16,0,16,0
1708249645212,MMW 13,B16,413815,Zhiri; Oumelbanine,15,0,16,1
1708249645212,MMW 13,B17,413816,Zhiri; Oumelbanine,15,0,16,1
1708249645212,MMW 13,B18,413817,Zhiri; Oumelbanine,12,0,16,4
1708249645212,MMW 13,B19,413822,Zhiri; Oumelbanine,16,0,16,0
1708249645212,MMW 13,B20,413823,Zhiri; Oumelbanine,14,0,16,2
1708249645212,MMW 13,B21,413825,Zhiri; Oumelbanine,0,0,0,0
1708249645212,MMW 13,B22,413826,Zhiri; Oumelbanine,0,0,0,0
1708249645212,MMW 13,B23,413827,Zhiri; Oumelbanine,16,0,16,0
1708249645212,MMW 13,B24,413834,Zhiri; Oumelbanine,15,0,16,1
1708249645212,MMW 13,C01,413859,Vitkus; Daniel J.,16,0,16,0
1708249645212,MMW 13,C02,413860,Vitkus; Daniel J.,16,0,16,0
1708249645212,MMW 13,C04,413868,Vitkus; Daniel J.,0,0,0,0
1708249645212,MMW 13,C05,413869,Vitkus; Daniel J.,16,0,16,0
1708249645212,MMW 13,C06,413871,Vitkus; Daniel J.,16,0,16,0
1708249645212,MMW 13,C07,413886,Vitkus; Daniel J.,16,0,16,0
1708249645212,MMW 13,C08,413908,Vitkus; Daniel J.,16,0,16,0
1708249645212,MMW 13,C09,413930,Vitkus; Daniel J.,16,0,16,0
1708249645212,MMW 13,C10,413952,Vitkus; Daniel J.,15,0,16,1
1708249645212,MMW 13,C11,413972,Vitkus; Daniel J.,16,0,16,0
1708249645212,MMW 13,C12,413991,Vitkus; Daniel J.,16,0,16,0
1708249645212,MMW 13,C13,414007,Vitkus; Daniel J.,0,0,0,0
1708249645212,MMW 13,C14,414017,Vitkus; Daniel J.,0,0,0,0
1708249645212,MMW 13,C15,414030,Vitkus; Daniel J.,16,0,16,0
1708249645212,MMW 13,C16,414032,Vitkus; Daniel J.,16,0,16,0
1708249645212,MMW 13,C17,414033,Vitkus; Daniel J.,15,0,16,1
1708249645212,MMW 13,C18,414034,Vitkus; Daniel J.,16,0,16,0
1708249645212,MMW 13,C19,414041,Vitkus; Daniel J.,16,0,16,0
1708249645212,MMW 13,C20,414056,Vitkus; Daniel J.,16,0,16,0
1708249645212,MMW 13,C21,414057,Vitkus; Daniel J.,15,0,16,1
1708249645212,MMW 13,C22,414059,Vitkus; Daniel J.,16,0,16,0
1708249645804,MMW 15,A01,414065,Chang; Edmond Yi-Teh,28,0,28,0
1708249645804,MMW 15,A02,414067,Chang; Edmond Yi-Teh,27,0,28,1
1708249645804,MMW 15,A03,414092,Chang; Edmond Yi-Teh,26,0,28,2
1708249645804,MMW 15,A04,414104,Chang; Edmond Yi-Teh,28,0,28,0
1708249645804,MMW 15,A05,414121,Chang; Edmond Yi-Teh,0,0,0,0
1708249645804,MMW 15,A06,414122,Chang; Edmond Yi-Teh,0,0,0,0
1708249645804,MMW 15,A07,414123,Chang; Edmond Yi-Teh,28,0,28,0
1708249645804,MMW 15,A08,414124,Chang; Edmond Yi-Teh,28,0,28,0
1708249645804,MMW 15,A09,414125,Chang; Edmond Yi-Teh,0,0,0,0
1708249645804,MMW 15,A10,414130,Chang; Edmond Yi-Teh,0,0,0,0
1708249645804,MMW 15,B01,414132,Radcliff; Pamela B.,27,0,28,1
1708249645804,MMW 15,B02,414134,Radcliff; Pamela B.,27,0,28,1
1708249645804,MMW 15,B03,414135,Radcliff; Pamela B.,26,0,28,2
1708249645804,MMW 15,B04,414136,Radcliff; Pamela B.,27,0,28,1
1708249645804,MMW 15,B05,414137,Radcliff; Pamela B.,28,0,28,0
1708249645804,MMW 15,B06,414138,Radcliff; Pamela B.,27,0,28,1
1708249645804,MMW 15,B07,414140,Radcliff; Pamela B.,26,0,28,2
1708249645804,MMW 15,B08,414141,Radcliff; Pamela B.,28,0,28,0
1708249645804,MMW 15,C01,414143,Prestholdt; Jeremy,0,0,0,0
1708249645804,MMW 15,C02,414144,Prestholdt; Jeremy,0,0,0,0
1708249645804,MMW 15,C03,414145,Prestholdt; Jeremy,24,0,28,4
1708249645804,MMW 15,C04,414147,Prestholdt; Jeremy,17,0,28,11
1708249645804,MMW 15,C05,414148,Prestholdt; Jeremy,28,0,28,0
1708249645804,MMW 15,C06,414149,Prestholdt; Jeremy,26,0,28,2
1708249645804,MMW 15,C07,414152,Prestholdt; Jeremy,25,0,28,3
1708249645804,MMW 15,C08,414153,Prestholdt; Jeremy,23,0,28,5
1708249646331,MSED 295,A00,477850,Rabin; Jeffrey Mark,5,0,5,0
1708249646331,MSED 295,B00,477852,Lo; Stanley M.,5,0,5,0
1708249646858,MSED 296C,A00,477853,Staff,14,0,15,1
1708249647402,MUS 1C,A01,416488,Ishov; Alexander Alexandrovich,24,0,25,1
1708249647402,MUS 1C,A02,416502,Ishov; Alexander Alexandrovich,25,0,25,0
1708249647402,MUS 1C,A03,416519,Ishov; Alexander Alexandrovich,25,0,25,0
1708249647402,MUS 1C,A04,416520,Ishov; Alexander Alexandrovich,25,0,25,0
1708249647402,MUS 1C,A05,416521,Ishov; Alexander Alexandrovich,25,0,25,0
1708249647929,MUS 2C,A01,416523,Richards; Stephanie F,30,0,30,0
1708249648472,MUS 2CK,A00,416524,Ohnishi; Takae,15,0,15,0
1708249648472,MUS 2CK,B00,416547,Ohnishi; Takae,15,0,15,0
1708249649002,MUS 2JK,A00,416548,Kenyatta; Kamau,15,0,15,0
1708249649550,MUS 4,A01,416562,Staff,25,0,25,0
1708249649550,MUS 4,A02,416634,Staff,24,0,25,1
1708249649550,MUS 4,A03,416644,Staff,25,0,25,0
1708249649550,MUS 4,A04,416659,Staff,24,0,25,1
1708249649550,MUS 4,A05,416667,Staff,25,0,25,0
1708249649550,MUS 4,A06,416757,Staff,25,0,25,0
1708249649550,MUS 4,A07,416830,Staff,25,0,25,0
1708249649550,MUS 4,A08,416953,Staff,23,0,25,2
1708249649550,MUS 4,A09,417005,Staff,25,0,25,0
1708249649550,MUS 4,A10,417007,Staff,24,0,25,1
1708249650081,MUS 7,A01,417048,Staff,23,0,24,1
1708249650081,MUS 7,A02,417102,Staff,23,0,24,1
1708249650081,MUS 7,A03,417103,Staff,23,0,24,1
1708249650081,MUS 7,A04,417114,Staff,22,0,24,2
1708249650611,MUS 8,A01,417119,Staff,14,0,20,6
1708249650611,MUS 8,A02,417163,Staff,16,0,20,4
1708249650611,MUS 8,A03,417164,Staff,16,0,20,4
1708249650611,MUS 8,A04,417165,Staff,17,0,20,3
1708249650611,MUS 8,A05,417194,Staff,18,0,20,2
1708249650611,MUS 8,A06,417198,Staff,20,0,20,0
1708249651139,MUS 11,A01,417201,Terrazas Perez; Wilfrido D,21,0,25,4
1708249651139,MUS 11,A02,417219,Terrazas Perez; Wilfrido D,23,0,25,2
1708249651139,MUS 11,A03,417220,Terrazas Perez; Wilfrido D,25,0,25,0
1708249651139,MUS 11,A04,417222,Terrazas Perez; Wilfrido D,25,0,25,0
1708249651139,MUS 11,A05,417223,Terrazas Perez; Wilfrido D,24,0,25,1
1708249651139,MUS 11,A06,417295,Terrazas Perez; Wilfrido D,23,0,25,2
1708249651139,MUS 11,A07,417297,Terrazas Perez; Wilfrido D,24,0,25,1
1708249651139,MUS 11,A08,417298,Terrazas Perez; Wilfrido D,25,0,25,0
1708249651670,MUS 12,A01,417300,Guy; Nancy,25,0,25,0
1708249651670,MUS 12,A02,417301,Guy; Nancy,25,0,25,0
1708249651670,MUS 12,A03,417302,Guy; Nancy,25,0,25,0
1708249651670,MUS 12,A04,417303,Guy; Nancy,25,0,25,0
1708249652440,MUS 13,A01,417305,Leslie Santana; Myrta,25,0,25,0
1708249652440,MUS 13,A02,417306,Leslie Santana; Myrta,25,0,25,0
1708249652440,MUS 13,A03,417307,Leslie Santana; Myrta,25,0,25,0
1708249652440,MUS 13,A04,417308,Leslie Santana; Myrta,25,0,25,0
1708249652985,MUS 15,A01,417327,Schaffer; Max Benjamin,18,0,20,2
1708249652985,MUS 15,A02,417331,Schaffer; Max Benjamin,19,0,20,1
1708249652985,MUS 15,A03,417358,Schaffer; Max Benjamin,19,0,20,1
1708249652985,MUS 15,A04,417359,Schaffer; Max Benjamin,17,0,20,3
1708249652985,MUS 15,A05,417360,Schaffer; Max Benjamin,20,0,20,0
1708249652985,MUS 15,A06,417370,Schaffer; Max Benjamin,20,0,20,0
1708249652985,MUS 15,A07,417371,Schaffer; Max Benjamin,17,0,20,3
1708249652985,MUS 15,A08,417372,Schaffer; Max Benjamin,18,0,20,2
1708249652985,MUS 15,A09,417378,Schaffer; Max Benjamin,19,0,20,1
1708249652985,MUS 15,A10,417379,Schaffer; Max Benjamin,19,0,20,1
1708249653528,MUS 17,A01,417381,Staff,22,0,25,3
1708249653528,MUS 17,A02,417406,Staff,24,0,25,1
1708249653528,MUS 17,A03,417420,Staff,24,0,25,1
1708249653528,MUS 17,A04,417594,Staff,24,0,25,1
1708249653528,MUS 17,A05,417595,Staff,25,0,25,0
1708249653528,MUS 17,A06,417605,Staff,21,0,25,4
1708249653528,MUS 17,A07,417606,Staff,25,0,25,0
1708249653528,MUS 17,A08,417627,Staff,25,0,25,0
1708249653528,MUS 17,A09,417628,Staff,21,0,25,4
1708249653528,MUS 17,A10,417629,Staff,24,0,25,1
1708249653528,MUS 17,A11,417630,Staff,25,0,25,0
1708249653528,MUS 17,A12,417631,Staff,24,0,25,1
1708249653528,MUS 17,A13,417632,Staff,25,0,25,0
1708249653528,MUS 17,A14,417633,Staff,25,0,25,0
1708249654056,MUS 32,001,418855,Dresser; Mark Stuart,10,0,10,0
1708249654056,MUS 32,002,418856,Kenyatta; Kamau,9,0,10,1
1708249654056,MUS 32,003,418864,Curtis; Charles Rector,10,0,10,0
1708249654056,MUS 32,004,418865,Carlstrom; Mitchell Kraig,9,0,10,1
1708249654056,MUS 32,005,418868,Terrazas Perez; Wilfrido D,10,0,10,0
1708249654056,MUS 32,006,418869,Ohnishi; Takae,10,0,10,0
1708249654056,MUS 32,007,418872,Burr; Anthony I,10,0,10,0
1708249654056,MUS 32,008,418873,Carlson; Erik Norman,10,0,10,0
1708249654056,MUS 32,009,418874,Blair; Kyle Adam,10,0,10,0
1708249654056,MUS 32,010,418875,Richards; Stephanie F,10,0,10,0
1708249654583,MUS 32V,A00,417634,Narucki; Susan M,10,0,10,0
1708249654583,MUS 32V,B00,417635,Staff,10,0,10,0
1708249655108,MUS 32VM,A00,417636,Staff,15,0,15,0
1708249655637,MUS 33C,A00,417637,Taylor; Alexander Lawther,20,0,20,0
1708249656161,MUS 43,A00,417647,Burr; Anthony I,83,0,90,7
1708249656690,MUS 95D,A00,417919,Staff,40,0,40,0
1708249657216,MUS 95E,A00,417933,Henson; Matthew Alexander,55,0,55,0
1708249657746,MUS 95G,A00,417935,Anderson; Kenneth,387,0,395,8
1708249657746,MUS 95G,B00,417937,Anderson; Kenneth,394,0,395,1
1708249658272,MUS 95JC,A00,417939,Kenyatta; Kamau,30,0,30,0
1708249658801,MUS 95L,A00,417940,Jones; Michael David,50,0,50,0
1708249659326,MUS 95W,A00,417946,Seshadri; Kartik,29,0,30,1
1708249659326,MUS 95W,B00,417948,Seshadri; Kartik,30,0,30,0
1708249659852,MUS 101C,A01,417951,Burr; Anthony I,33,0,35,2
1708249660377,MUS 103C,A00,417952,Davis; Anthony Curtis,14,0,15,1
1708249660902,MUS 103F,A00,417959,Obermueller; Karola,1,0,1,0
1708249661432,MUS 113,A00,418015,Narucki; Susan M,14,0,15,1
1708249661957,MUS 120C,A01,418032,Leslie Santana; Myrta,25,0,25,0
1708249662487,MUS 127,A00,418037,Richards; Stephanie F,92,0,100,8
1708249663012,MUS 130,A00,418047,Ohnishi; Takae,30,0,30,0
1708249663537,MUS 131,A00,418065,Roberts; Matana,30,0,30,0
1708249664063,MUS 132,001,418883,Dresser; Mark Stuart,10,0,10,0
1708249664063,MUS 132,002,418885,Kenyatta; Kamau,10,0,10,0
1708249664063,MUS 132,003,418886,Curtis; Charles Rector,10,0,10,0
1708249664063,MUS 132,004,418887,Carlstrom; Mitchell Kraig,10,0,10,0
1708249664063,MUS 132,005,418888,Jones; Michael David,10,0,10,0
1708249664063,MUS 132,006,418889,Terrazas Perez; Wilfrido D,10,0,10,0
1708249664063,MUS 132,007,418893,Ohnishi; Takae,10,0,10,0
1708249664063,MUS 132,008,418894,Burr; Anthony I,10,0,10,0
1708249664063,MUS 132,009,418896,Carlson; Erik Norman,10,0,10,0
1708249664063,MUS 132,010,418900,Blair; Kyle Adam,10,0,10,0
1708249664063,MUS 132,011,418932,Richards; Stephanie F,10,0,10,0
1708249664063,MUS 132,012,418933,Nourai; Keyarash,10,0,10,0
1708249664590,MUS 132R,A00,418067,Burr; Anthony I,5,0,5,0
1708249664590,MUS 132R,B00,418078,Jones; Michael David,5,0,5,0
1708249665115,MUS 132V,A00,418092,Narucki; Susan M,15,0,15,0
1708249665115,MUS 132V,B00,418096,Staff,15,0,15,0
1708249665643,MUS 134,A00,418098,Staff,40,0,40,0
1708249666169,MUS 137C,A00,418109,Kenyatta; Kamau,25,0,25,0
1708249666694,MUS 143,A00,418123,Burr; Anthony I,33,0,40,7
1708249667219,MUS 150,A00,418127,Davis; Anthony Curtis,28,0,30,2
1708249667748,MUS 151,A00,418129,Hankins; Sarah E.,21,0,30,9
1708249668276,MUS 160B,A00,418172,Staff,11,0,15,4
1708249668276,MUS 160B,B00,418175,Dubnov; Shlomo,14,0,15,1
1708249668805,MUS 172,A01,418178,Staff,36,0,40,4
1708249669332,MUS 174C,A00,418179,Erbe; Tom,24,0,27,3
1708249669860,MUS 175,A00,418247,Smyth; Tamara R.,28,0,30,2
1708249670386,MUS 177,A00,418265,Erbe; Tom,11,0,15,4
1708249670912,MUS 201A,A00,418267,Narucki; Susan M,15,0,15,0
1708249670912,MUS 201A,B00,418268,Dresser; Mark Stuart,13,0,15,2
1708249671436,MUS 203C,A00,418269,Lou; Michelle Siulai,15,0,15,0
1708249671961,MUS 203D,A00,418272,Davis; Anthony Curtis,4,0,5,1
1708249671961,MUS 203D,B00,418275,Obermueller; Karola,5,0,5,0
1708249671961,MUS 203D,C00,418277,Liang; Lei,5,0,5,0
1708249671961,MUS 203D,D00,418323,Lou; Michelle Siulai,5,0,5,0
1708249672489,MUS 204,A00,418324,Obermueller; Karola,24,0,25,1
1708249673015,MUS 205,A00,418325,Cimini; Amy Marie,22,0,25,3
1708249673544,MUS 206,A00,418326,Liang; Lei,13,0,15,2
1708249673544,MUS 206,B00,418327,Roberts; Matana,13,0,15,2
1708249674073,MUS 215C,A00,418328,Cimini; Amy Marie,14,0,15,1
1708249674599,MUS 232,001,418937,Dresser; Mark Stuart,9,0,10,1
1708249674599,MUS 232,002,418969,Kenyatta; Kamau,10,0,10,0
1708249674599,MUS 232,003,418971,Curtis; Charles Rector,10,0,10,0
1708249674599,MUS 232,004,418974,Terrazas Perez; Wilfrido D,10,0,10,0
1708249674599,MUS 232,005,418979,Ohnishi; Takae,10,0,10,0
1708249674599,MUS 232,006,418980,Burr; Anthony I,10,0,10,0
1708249674599,MUS 232,007,418981,Carlson; Erik Norman,10,0,10,0
1708249674599,MUS 232,008,418982,Richards; Stephanie F,10,0,10,0
1708249674599,MUS 232,009,418985,Narucki; Susan M,10,0,10,0
1708249675128,MUS 234,A00,418329,Staff,15,0,15,0
1708249675654,MUS 245,A00,418330,Carlson; Erik Norman,14,0,15,1
1708249676183,MUS 267,A00,418331,Erbe; Tom,15,0,15,0
1708249676709,MUS 270B,A00,418332,Staff,15,0,15,0
1708249677236,MUS 270D,A00,479231,Smyth; Tamara R.,15,0,15,0
1708249677764,NANO 103,A00,414714,Jahed Motlagh; Zeinab,40,0,40,0
1708249678295,NANO 108,A00,414740,Lubarda; Vlado,70,0,70,0
1708249678824,NANO 112,A01,414825,Vazquez Mena; Oscar,70,0,70,0
1708249679350,NANO 115L,A01,414830,Yang; Kesong,37,0,38,1
1708249679350,NANO 115L,B01,414832,Xu; Sheng,35,0,38,3
1708249679880,NANO 120B,A01,414835,Vecchio; Kenneth S,33,0,35,2
1708249679880,NANO 120B,B01,414841,Fenning; David,30,0,35,5
1708249680405,NANO 156,A00,414843,Fullerton; Eric E,24,0,30,6
1708249680944,NANO 158,A00,414844,Luo; Jian,29,0,30,1
1708249681469,NANO 175,A00,414850,Steinmetz; Nicole F,30,0,35,5
1708249681993,NANO 200,A00,414852,Jahed Motlagh; Zeinab,118,0,120,2
1708249682521,NANO 241,A00,414854,Pokorski; Jonathan Kyle,18,0,25,7
1708249683046,NANO 262,A00,414858,Wang; Joseph,50,0,50,0
1708249683572,NANO 271,A00,414862,Cubukcu; Ertugrul,22,0,25,3
1708249684098,NANO 272,A00,414877,Xu; Sheng,42,0,50,8
1708249684624,NANO 279,A00,414878,Liu; Ping,32,0,40,8
1708249685156,NANO 282,A00,414879,Steinmetz; Nicole F,30,0,30,0
1708249685681,NEU 200C,A00,455013,Staff,0,0,0,1
1708249686209,NEU 276,A01,479489,Staff,35,0,36,1
1708249686739,NEU 277,A00,479492,Risbrough; Victoria Blythe,0,0,0,0
1708249687265,NEU 296,001,464921,Evans; Sean Jeffrey,48,0,50,2
1708249687265,NEU 296,002,464922,Staff,50,0,50,0
1708249687265,NEU 296,003,464925,Staff,50,0,50,0
1708249687792,NEUG 221,A00,479490,Zheng; Binhai,15,0,15,0
1708249688318,NEUG 280,A00,479491,Chen; Xu,0,0,0,0
1708249688843,NEUG 296,A00,479493,Bloodgood; Brenda Laurie,9998,0,9999,1
1708249689369,OPTH 296,001,465054,Baxter; Sally Liu,49,0,50,1
1708249689369,OPTH 296,002,465068,Afshari; Natalie,49,0,50,1
1708249689369,OPTH 296,003,465074,Staff,50,0,50,0
1708249690910,ORTH 296,A00,465104,Staff,50,0,50,0
1708249690910,ORTH 296,001,465111,Staff,50,0,50,0
1708249690910,ORTH 296,002,465120,Staff,50,0,50,0
1708249691436,PATH 224,A01,494386,Ross; Camille,11,0,12,1
1708249691965,PATH 296,001,465373,Calcutt; Nigel A,49,0,50,1
1708249691965,PATH 296,002,465374,Staff,50,0,50,0
1708249691965,PATH 296,003,465375,Staff,50,0,50,0
1708249692495,PEDS 296,001,465527,Weiss; Katherine Jean,49,0,50,1
1708249692495,PEDS 296,002,465528,Staff,50,0,50,0
1708249692495,PEDS 296,003,465529,Staff,50,0,50,0
1708249693023,PH 196BH,A01,405158,Binkin; Nancy Jeanne,20,0,20,0
1708249693550,PHAR 219,A00,415016,Ross; Camille,1,0,1,0
1708249694132,PHAR 231,A00,415017,Furnari; Frank,20,0,20,0
1708249694132,PHAR 231,B00,415018,Lopez Ramirez; Miguel Alej,20,0,20,0
1708249695674,PHAR 276,A00,415020,Mc Culloch; Andrew Douglas & Amaro; Rommie E,1,0,1,0
1708249696199,PHAR 295,A00,415022,Brown; Joan Heller,15,0,15,0
1708249696730,PHIL 1,A00,415023,Harrell; Maralee Mae,58,0,60,2
1708249697273,PHIL 10,A01,415026,Grush; Rick Scott,40,0,44,4
1708249697273,PHIL 10,A02,415028,Grush; Rick Scott,42,0,44,2
1708249697273,PHIL 10,A03,415029,Grush; Rick Scott,0,0,0,0
1708249697273,PHIL 10,A04,415031,Grush; Rick Scott,0,0,0,0
1708249697273,PHIL 10,A05,415113,Grush; Rick Scott,43,0,44,1
1708249697273,PHIL 10,A06,415114,Grush; Rick Scott,43,0,44,1
1708249697273,PHIL 10,A07,415116,Grush; Rick Scott,44,0,44,0
1708249697273,PHIL 10,A08,415118,Grush; Rick Scott,43,0,44,1
1708249697801,PHIL 12,A01,415120,McKenzie; Kerry V.,28,0,30,2
1708249697801,PHIL 12,A02,415136,McKenzie; Kerry V.,30,0,30,0
1708249697801,PHIL 12,A03,415137,McKenzie; Kerry V.,27,0,30,3
1708249697801,PHIL 12,A04,415142,McKenzie; Kerry V.,30,0,30,0
1708249698347,PHIL 13,A01,415165,Brink; David O.,25,0,25,0
1708249698347,PHIL 13,A02,415179,Brink; David O.,22,0,25,3
1708249698347,PHIL 13,A03,415185,Brink; David O.,24,0,25,1
1708249698347,PHIL 13,A04,415201,Brink; David O.,25,0,25,0
1708249698347,PHIL 13,A05,415204,Brink; David O.,25,0,25,0
1708249698347,PHIL 13,A06,415220,Brink; David O.,25,0,25,0
1708249698873,PHIL 15,A01,415250,Fulkerson; Matthew Todd,26,0,30,4
1708249698873,PHIL 15,A02,415281,Fulkerson; Matthew Todd,29,0,30,1
1708249699407,PHIL 27,A01,415293,Brandt; Reuven A,20,0,25,5
1708249699407,PHIL 27,A02,415296,Brandt; Reuven A,0,0,0,0
1708249699407,PHIL 27,A03,415332,Brandt; Reuven A,22,0,25,3
1708249699407,PHIL 27,A04,415333,Brandt; Reuven A,22,0,25,3
1708249699407,PHIL 27,A05,415342,Brandt; Reuven A,20,0,25,5
1708249699407,PHIL 27,A06,415384,Brandt; Reuven A,24,0,25,1
1708249699407,PHIL 27,A07,415385,Brandt; Reuven A,25,0,25,0
1708249699407,PHIL 27,A08,415391,Brandt; Reuven A,0,0,0,0
1708249699407,PHIL 27,A09,415406,Brandt; Reuven A,0,0,0,0
1708249699407,PHIL 27,A10,415407,Brandt; Reuven A,0,0,0,0
1708249699933,PHIL 28,A01,415412,Lamey; Andy M.,24,0,25,1
1708249699933,PHIL 28,A02,415470,Lamey; Andy M.,20,0,25,5
1708249699933,PHIL 28,A03,415474,Lamey; Andy M.,0,0,0,0
1708249699933,PHIL 28,A04,415475,Lamey; Andy M.,22,0,25,3
1708249699933,PHIL 28,A05,415487,Lamey; Andy M.,24,0,25,1
1708249699933,PHIL 28,A06,415506,Lamey; Andy M.,21,0,25,4
1708249699933,PHIL 28,A07,415507,Lamey; Andy M.,25,0,25,0
1708249699933,PHIL 28,A08,415508,Lamey; Andy M.,24,0,25,1
1708249699933,PHIL 28,A09,415509,Lamey; Andy M.,25,0,25,0
1708249699933,PHIL 28,A10,415510,Lamey; Andy M.,0,0,0,0
1708249700460,PHIL 33,A01,415521,Hardimon; Michael O.,35,0,35,0
1708249700460,PHIL 33,A02,415522,Hardimon; Michael O.,35,0,35,0
1708249700987,PHIL 60,A00,415523,Marechal; Patricia,55,0,60,5
1708249701514,PHIL 102,A00,415524,Johnson; Monte,37,0,40,3
1708249702041,PHIL 106,A00,415544,Watkins; Eric,40,0,40,0
1708249702572,PHIL 112,A00,415545,Watkins; Eric,34,0,40,6
1708249703097,PHIL 115,A00,415548,Nelkin; Dana Kay,20,0,20,0
1708249703622,PHIL 120,A00,415549,Carr; Jennifer Rose,64,0,65,1
1708249704150,PHIL 134,A00,415552,Carr; Jennifer Rose,40,0,40,0
1708249704676,PHIL 150,A00,415553,Cohen; Jonathan David,38,0,40,2
1708249705205,PHIL 171,A00,415561,Brink; David O.,39,0,40,1
1708249705730,PHIL 172,A00,415563,Lamey; Andy M.,40,0,40,0
1708249706262,PHIL 174,A01,415576,Danks; David J,21,0,25,4
1708249706262,PHIL 174,A02,415582,Danks; David J,22,0,25,3
1708249706262,PHIL 174,A03,415583,Danks; David J,24,0,25,1
1708249706262,PHIL 174,A04,415584,Danks; David J,25,0,25,0
1708249706788,PHIL 175,A00,415585,Shields; Christopher John,40,0,40,0
1708249707320,PHIL 181,A00,415601,Tolley; Clinton,34,0,40,6
1708249707850,PHIL 209B,A00,415655,Serlin; David,4,0,5,1
1708249708374,PHIL 209C,A00,415658,Gates; Kelly,5,0,5,0
1708249708903,PHIL 210,A00,415659,Marechal; Patricia,20,0,20,0
1708249709429,PHIL 230,A00,415661,Grush; Rick Scott,20,0,20,0
1708249709956,PHIL 232,A00,415662,Sher; Gila,20,0,20,0
1708249710481,PHIL 260,A00,415675,Bazargan-Forward; Saba,20,0,20,0
1708249711007,PHIL 277,A00,479176,Tolley; Clinton,9,0,10,1
1708249711533,PHIL 285,A00,415685,Kovaka; Karenc,20,0,20,0
1708249712059,PHIL 287,A00,415697,Marechal; Patricia,5,0,5,0
1708249712612,PHIL 290,001,415701,Nelkin; Dana Kay,9999,0,9999,0
1708249712612,PHIL 290,002,415721,Bazargan-Forward; Saba,9999,0,9999,0
1708249712612,PHIL 290,003,415731,Brandt; Reuven A,9999,0,9999,0
1708249712612,PHIL 290,004,415743,Brink; David O.,9999,0,9999,0
1708249712612,PHIL 290,005,415747,Callender; Craig Adam,9999,0,9999,0
1708249712612,PHIL 290,006,415779,Carr; Jennifer Rose,9999,0,9999,0
1708249712612,PHIL 290,007,415780,Cartwright; Nancy D.,9999,0,9999,0
1708249712612,PHIL 290,008,415781,Cohen; Jonathan David,9999,0,9999,0
1708249712612,PHIL 290,009,415782,Danks; David J,9999,0,9999,0
1708249712612,PHIL 290,010,415783,Fulkerson; Matthew Todd,9999,0,9999,0
1708249712612,PHIL 290,011,415784,Grush; Rick Scott,9999,0,9999,0
1708249712612,PHIL 290,012,415785,Hardimon; Michael O.,9999,0,9999,0
1708249712612,PHIL 290,013,415786,Harrell; Maralee Mae,9999,0,9999,0
1708249712612,PHIL 290,014,415787,Johnson; Monte,9999,0,9999,0
1708249712612,PHIL 290,015,415788,Kovaka; Karenc,9999,0,9999,0
1708249712612,PHIL 290,016,415789,Lamey; Andy M.,9999,0,9999,0
1708249712612,PHIL 290,017,415790,Marechal; Patricia,9999,0,9999,0
1708249712612,PHIL 290,018,415791,McKenzie; Kerry V.,9999,0,9999,0
1708249712612,PHIL 290,019,415792,Rickless; Samuel Charles,9999,0,9999,0
1708249712612,PHIL 290,020,415793,Sher; Gila,9999,0,9999,0
1708249712612,PHIL 290,021,415794,Shields; Christopher John,9999,0,9999,0
1708249712612,PHIL 290,022,415805,Tolley; Clinton,9999,0,9999,0
1708249712612,PHIL 290,023,415806,Vargas; Manuel Rogelio,9999,0,9999,0
1708249712612,PHIL 290,024,415807,Watkins; Eric,9999,0,9999,0
1708249712612,PHIL 290,025,415815,Chen; Keming,9999,0,9999,0
1708249713169,PHIL 295,001,415816,Bazargan-Forward; Saba,9999,0,9999,0
1708249713169,PHIL 295,002,415857,Brandt; Reuven A,9999,0,9999,0
1708249713169,PHIL 295,003,415858,Brink; David O.,9999,0,9999,0
1708249713169,PHIL 295,004,415877,Callender; Craig Adam,9999,0,9999,0
1708249713169,PHIL 295,005,415878,Carr; Jennifer Rose,9999,0,9999,0
1708249713169,PHIL 295,006,415884,Cartwright; Nancy D.,9999,0,9999,0
1708249713169,PHIL 295,007,415885,Chen; Keming,9999,0,9999,0
1708249713169,PHIL 295,008,415891,Cohen; Jonathan David,9999,0,9999,0
1708249713169,PHIL 295,009,415892,Danks; David J,9999,0,9999,0
1708249713169,PHIL 295,010,415937,Fulkerson; Matthew Todd,9999,0,9999,0
1708249713169,PHIL 295,011,415940,Grush; Rick Scott,9999,0,9999,0
1708249713169,PHIL 295,012,415945,Hardimon; Michael O.,9999,0,9999,0
1708249713169,PHIL 295,013,415946,Harrell; Maralee Mae,9999,0,9999,0
1708249713169,PHIL 295,014,415953,Johnson; Monte,9999,0,9999,0
1708249713169,PHIL 295,015,415954,Kovaka; Karenc,9999,0,9999,0
1708249713169,PHIL 295,016,415957,Lamey; Andy M.,9999,0,9999,0
1708249713169,PHIL 295,017,415958,Marechal; Patricia,9999,0,9999,0
1708249713169,PHIL 295,018,415959,McKenzie; Kerry V.,9999,0,9999,0
1708249713169,PHIL 295,019,415960,Nelkin; Dana Kay,9999,0,9999,0
1708249713169,PHIL 295,020,415961,Rickless; Samuel Charles,9999,0,9999,0
1708249713169,PHIL 295,021,415987,Sher; Gila,9999,0,9999,0
1708249713169,PHIL 295,022,416027,Shields; Christopher John,9999,0,9999,0
1708249713169,PHIL 295,023,416030,Tolley; Clinton,9999,0,9999,0
1708249713169,PHIL 295,024,416033,Vargas; Manuel Rogelio,9999,0,9999,0
1708249713169,PHIL 295,025,416034,Watkins; Eric,9999,0,9999,0
1708249713697,PHYA 224,A00,442106,Sandstrom; Karin Marie,30,0,30,0
1708249714225,PHYS 1A,A00,441607,Gilbert; Dylan Paul,346,0,362,16
1708249714773,PHYS 1AL,001,441608,Arlett; Jessica Lynn & Yagil; Avi,30,0,30,0
1708249714773,PHYS 1AL,002,441609,Arlett; Jessica Lynn & Yagil; Avi,28,0,30,2
1708249714773,PHYS 1AL,003,441610,Arlett; Jessica Lynn & Yagil; Avi,26,0,30,4
1708249714773,PHYS 1AL,004,441611,Arlett; Jessica Lynn & Yagil; Avi,29,0,30,1
1708249714773,PHYS 1AL,005,441612,Arlett; Jessica Lynn & Yagil; Avi,28,0,30,2
1708249714773,PHYS 1AL,006,441616,Arlett; Jessica Lynn & Yagil; Avi,28,0,30,2
1708249714773,PHYS 1AL,007,441618,Arlett; Jessica Lynn & Yagil; Avi,26,0,30,4
1708249714773,PHYS 1AL,008,441620,Arlett; Jessica Lynn & Yagil; Avi,29,0,30,1
1708249714773,PHYS 1AL,009,441623,Arlett; Jessica Lynn & Yagil; Avi,29,0,30,1
1708249714773,PHYS 1AL,010,441625,Arlett; Jessica Lynn & Yagil; Avi,29,0,30,1
1708249714773,PHYS 1AL,011,441626,Arlett; Jessica Lynn & Yagil; Avi,29,0,30,1
1708249714773,PHYS 1AL,012,441627,Arlett; Jessica Lynn & Yagil; Avi,29,0,30,1
1708249715299,PHYS 1B,A00,441630,Groisman; Alexander,351,0,362,11
1708249715825,PHYS 1BL,001,441632,Arlett; Jessica Lynn & Yagil; Avi,28,0,30,2
1708249715825,PHYS 1BL,002,441634,Arlett; Jessica Lynn & Yagil; Avi,29,0,30,1
1708249715825,PHYS 1BL,003,441636,Arlett; Jessica Lynn & Yagil; Avi,29,0,30,1
1708249715825,PHYS 1BL,004,441637,Arlett; Jessica Lynn & Yagil; Avi,29,0,30,1
1708249715825,PHYS 1BL,005,441639,Arlett; Jessica Lynn & Yagil; Avi,29,0,30,1
1708249715825,PHYS 1BL,006,441641,Arlett; Jessica Lynn & Yagil; Avi,26,0,30,4
1708249715825,PHYS 1BL,007,441642,Arlett; Jessica Lynn & Yagil; Avi,23,0,30,7
1708249715825,PHYS 1BL,008,441643,Arlett; Jessica Lynn & Yagil; Avi,30,0,30,0
1708249715825,PHYS 1BL,009,441646,Arlett; Jessica Lynn & Yagil; Avi,29,0,30,1
1708249715825,PHYS 1BL,010,441648,Arlett; Jessica Lynn & Yagil; Avi,29,0,30,1
1708249715825,PHYS 1BL,011,441652,Arlett; Jessica Lynn & Yagil; Avi,29,0,30,1
1708249715825,PHYS 1BL,012,441654,Arlett; Jessica Lynn & Yagil; Avi,30,0,30,0
1708249716351,PHYS 1C,A00,441658,Popmintchev; Tenio,587,0,600,13
1708249716351,PHYS 1C,B00,441662,Popmintchev; Tenio,558,0,600,42
1708249716928,PHYS 1CL,001,441664,Arlett; Jessica Lynn & Yagil; Avi,29,0,30,1
1708249716928,PHYS 1CL,002,441665,Arlett; Jessica Lynn & Yagil; Avi,27,0,30,3
1708249716928,PHYS 1CL,003,441666,Arlett; Jessica Lynn & Yagil; Avi,25,0,30,5
1708249716928,PHYS 1CL,004,441667,Arlett; Jessica Lynn & Yagil; Avi,30,0,30,0
1708249716928,PHYS 1CL,005,441668,Arlett; Jessica Lynn & Yagil; Avi,28,0,30,2
1708249716928,PHYS 1CL,006,441669,Arlett; Jessica Lynn & Yagil; Avi,25,0,30,5
1708249716928,PHYS 1CL,007,441671,Arlett; Jessica Lynn & Yagil; Avi,27,0,30,3
1708249716928,PHYS 1CL,008,441673,Arlett; Jessica Lynn & Yagil; Avi,30,0,30,0
1708249716928,PHYS 1CL,009,441674,Arlett; Jessica Lynn & Yagil; Avi,26,0,30,4
1708249716928,PHYS 1CL,010,441676,Arlett; Jessica Lynn & Yagil; Avi,30,0,30,0
1708249716928,PHYS 1CL,011,441677,Arlett; Jessica Lynn & Yagil; Avi,30,0,30,0
1708249716928,PHYS 1CL,012,441683,Arlett; Jessica Lynn & Yagil; Avi,30,0,30,0
1708249716928,PHYS 1CL,013,441685,Arlett; Jessica Lynn & Yagil; Avi,28,0,30,2
1708249716928,PHYS 1CL,014,441687,Arlett; Jessica Lynn & Yagil; Avi,30,0,30,0
1708249716928,PHYS 1CL,015,441689,Arlett; Jessica Lynn & Yagil; Avi,17,0,30,13
1708249716928,PHYS 1CL,016,441692,Arlett; Jessica Lynn & Yagil; Avi,29,0,30,1
1708249716928,PHYS 1CL,017,441696,Arlett; Jessica Lynn & Yagil; Avi,24,0,30,6
1708249716928,PHYS 1CL,018,441698,Arlett; Jessica Lynn & Yagil; Avi,25,0,30,5
1708249716928,PHYS 1CL,019,441702,Arlett; Jessica Lynn & Yagil; Avi,25,0,30,5
1708249716928,PHYS 1CL,020,441705,Arlett; Jessica Lynn & Yagil; Avi,29,0,30,1
1708249716928,PHYS 1CL,021,441706,Arlett; Jessica Lynn & Yagil; Avi,30,0,30,0
1708249716928,PHYS 1CL,022,441707,Arlett; Jessica Lynn & Yagil; Avi,30,0,30,0
1708249716928,PHYS 1CL,023,441708,Arlett; Jessica Lynn & Yagil; Avi,27,0,30,3
1708249716928,PHYS 1CL,024,441710,Arlett; Jessica Lynn & Yagil; Avi,29,0,30,1
1708249716928,PHYS 1CL,025,441711,Arlett; Jessica Lynn & Yagil; Avi,28,0,30,2
1708249716928,PHYS 1CL,026,441712,Arlett; Jessica Lynn & Yagil; Avi,29,0,30,1
1708249716928,PHYS 1CL,027,441713,Arlett; Jessica Lynn & Yagil; Avi,26,0,30,4
1708249716928,PHYS 1CL,028,441714,Arlett; Jessica Lynn & Yagil; Avi,29,0,30,1
1708249716928,PHYS 1CL,029,441715,Arlett; Jessica Lynn & Yagil; Avi,25,0,30,5
1708249716928,PHYS 1CL,030,441717,Arlett; Jessica Lynn & Yagil; Avi,29,0,30,1
1708249716928,PHYS 1CL,031,441718,Arlett; Jessica Lynn & Yagil; Avi,27,0,30,3
1708249716928,PHYS 1CL,032,441721,Arlett; Jessica Lynn & Yagil; Avi,30,0,30,0
1708249716928,PHYS 1CL,033,441724,Arlett; Jessica Lynn & Yagil; Avi,28,0,30,2
1708249716928,PHYS 1CL,034,441726,Arlett; Jessica Lynn & Yagil; Avi,29,0,30,1
1708249716928,PHYS 1CL,035,441728,Arlett; Jessica Lynn & Yagil; Avi,29,0,30,1
1708249716928,PHYS 1CL,036,441729,Arlett; Jessica Lynn & Yagil; Avi,30,0,30,0
1708249716928,PHYS 1CL,037,441730,Arlett; Jessica Lynn & Yagil; Avi,27,0,30,3
1708249716928,PHYS 1CL,038,441732,Arlett; Jessica Lynn & Yagil; Avi,29,0,30,1
1708249716928,PHYS 1CL,039,441733,Arlett; Jessica Lynn & Yagil; Avi,27,0,30,3
1708249716928,PHYS 1CL,040,441734,Arlett; Jessica Lynn & Yagil; Avi,30,0,30,0
1708249716928,PHYS 1CL,041,441735,Arlett; Jessica Lynn & Yagil; Avi,29,0,30,1
1708249716928,PHYS 1CL,042,441766,Arlett; Jessica Lynn & Yagil; Avi,30,0,30,0
1708249716928,PHYS 1CL,043,441768,Arlett; Jessica Lynn & Yagil; Avi,29,0,30,1
1708249716928,PHYS 1CL,044,441770,Arlett; Jessica Lynn & Yagil; Avi,30,0,30,0
1708249717489,PHYS 2A,A01,460308,Bal; Gurleen K,28,0,30,2
1708249717489,PHYS 2A,A02,460320,Bal; Gurleen K,30,0,30,0
1708249717489,PHYS 2A,A03,460321,Bal; Gurleen K,29,0,30,1
1708249717489,PHYS 2A,A04,460325,Bal; Gurleen K,28,0,30,2
1708249717489,PHYS 2A,A05,460326,Bal; Gurleen K,29,0,30,1
1708249717489,PHYS 2A,A06,460327,Bal; Gurleen K,30,0,30,0
1708249717489,PHYS 2A,A07,460495,Bal; Gurleen K,28,0,30,2
1708249717489,PHYS 2A,A08,460535,Bal; Gurleen K,27,0,30,3
1708249717489,PHYS 2A,A09,460536,Bal; Gurleen K,30,0,30,0
1708249717489,PHYS 2A,A10,460537,Bal; Gurleen K,30,0,30,0
1708249717489,PHYS 2A,A11,460538,Bal; Gurleen K,30,0,30,0
1708249717489,PHYS 2A,A12,460539,Bal; Gurleen K,30,0,30,0
1708249718076,PHYS 2B,A01,460620,Barreiro Guerrero; Julio,30,0,30,0
1708249718076,PHYS 2B,A02,460625,Barreiro Guerrero; Julio,30,0,30,0
1708249718076,PHYS 2B,A03,460626,Barreiro Guerrero; Julio,29,0,30,1
1708249718076,PHYS 2B,A04,460716,Barreiro Guerrero; Julio,26,0,30,4
1708249718076,PHYS 2B,A05,460756,Barreiro Guerrero; Julio,29,0,30,1
1708249718076,PHYS 2B,A06,460837,Barreiro Guerrero; Julio,30,0,30,0
1708249718076,PHYS 2B,A07,460865,Barreiro Guerrero; Julio,30,0,30,0
1708249718076,PHYS 2B,A08,460866,Barreiro Guerrero; Julio,30,0,30,0
1708249718076,PHYS 2B,A09,460867,Barreiro Guerrero; Julio,29,0,30,1
1708249718076,PHYS 2B,A10,460868,Barreiro Guerrero; Julio,30,0,30,0
1708249718076,PHYS 2B,A11,460869,Barreiro Guerrero; Julio,30,0,30,0
1708249718076,PHYS 2B,A12,460874,Barreiro Guerrero; Julio,30,0,30,0
1708249718076,PHYS 2B,B01,469381,Barreiro Guerrero; Julio,30,0,30,0
1708249718076,PHYS 2B,B02,469382,Barreiro Guerrero; Julio,29,0,30,1
1708249718076,PHYS 2B,B03,469402,Barreiro Guerrero; Julio,27,0,30,3
1708249718076,PHYS 2B,B04,469403,Barreiro Guerrero; Julio,28,0,30,2
1708249718076,PHYS 2B,B05,469442,Barreiro Guerrero; Julio,30,0,30,0
1708249718076,PHYS 2B,B06,469449,Barreiro Guerrero; Julio,30,0,30,0
1708249718076,PHYS 2B,B07,469450,Barreiro Guerrero; Julio,29,0,30,1
1708249718076,PHYS 2B,B08,469451,Barreiro Guerrero; Julio,30,0,30,0
1708249718076,PHYS 2B,B09,469457,Barreiro Guerrero; Julio,29,0,30,1
1708249718076,PHYS 2B,B10,469460,Barreiro Guerrero; Julio,30,0,30,0
1708249718076,PHYS 2B,B11,469468,Barreiro Guerrero; Julio,30,0,30,0
1708249718076,PHYS 2B,B12,469475,Barreiro Guerrero; Julio,30,0,30,0
1708249718621,PHYS 2BL,A01,441779,Meyertholen; Andrew D.,21,0,24,3
1708249718621,PHYS 2BL,A02,441780,Meyertholen; Andrew D.,17,0,24,7
1708249718621,PHYS 2BL,A03,441781,Meyertholen; Andrew D.,21,0,24,3
1708249718621,PHYS 2BL,A04,441782,Meyertholen; Andrew D.,21,0,24,3
1708249718621,PHYS 2BL,A05,441784,Meyertholen; Andrew D.,23,0,24,1
1708249718621,PHYS 2BL,A06,441786,Meyertholen; Andrew D.,23,0,24,1
1708249718621,PHYS 2BL,A07,441788,Meyertholen; Andrew D.,23,0,24,1
1708249718621,PHYS 2BL,A08,441790,Meyertholen; Andrew D.,24,0,24,0
1708249718621,PHYS 2BL,A09,441792,Meyertholen; Andrew D.,24,0,24,0
1708249718621,PHYS 2BL,A10,441794,Meyertholen; Andrew D.,23,0,24,1
1708249718621,PHYS 2BL,A11,441796,Meyertholen; Andrew D.,22,0,24,2
1708249718621,PHYS 2BL,A12,441798,Meyertholen; Andrew D.,24,0,24,0
1708249718621,PHYS 2BL,A13,441800,Meyertholen; Andrew D.,24,0,24,0
1708249718621,PHYS 2BL,A14,441802,Meyertholen; Andrew D.,24,0,24,0
1708249718621,PHYS 2BL,A15,441804,Meyertholen; Andrew D.,23,0,24,1
1708249719155,PHYS 2C,A01,460540,Tan; Tzer Han,30,0,30,0
1708249719155,PHYS 2C,A02,460541,Tan; Tzer Han,28,0,30,2
1708249719155,PHYS 2C,A03,460542,Tan; Tzer Han,28,0,30,2
1708249719155,PHYS 2C,A04,460543,Tan; Tzer Han,28,0,30,2
1708249719155,PHYS 2C,A05,460544,Tan; Tzer Han,28,0,30,2
1708249719155,PHYS 2C,A06,460545,Tan; Tzer Han,29,0,30,1
1708249719155,PHYS 2C,A07,460553,Tan; Tzer Han,30,0,30,0
1708249719155,PHYS 2C,A08,460561,Tan; Tzer Han,30,0,30,0
1708249719155,PHYS 2C,A09,460562,Tan; Tzer Han,28,0,30,2
1708249719155,PHYS 2C,A10,460563,Tan; Tzer Han,29,0,30,1
1708249719155,PHYS 2C,A11,460567,Tan; Tzer Han,30,0,30,0
1708249719155,PHYS 2C,A12,460568,Tan; Tzer Han,28,0,30,2
1708249719682,PHYS 2CL,A01,441809,Ni; Kaixuan,25,0,28,3
1708249719682,PHYS 2CL,A02,441811,Ni; Kaixuan,27,0,28,1
1708249719682,PHYS 2CL,A03,441814,Ni; Kaixuan,23,0,28,5
1708249719682,PHYS 2CL,A04,441817,Ni; Kaixuan,28,0,28,0
1708249719682,PHYS 2CL,A05,441819,Ni; Kaixuan,26,0,28,2
1708249719682,PHYS 2CL,A06,441820,Ni; Kaixuan,27,0,28,1
1708249720211,PHYS 2D,A01,460569,Sharma; Vivek A.,24,0,25,1
1708249720211,PHYS 2D,A02,460574,Sharma; Vivek A.,24,0,25,1
1708249720211,PHYS 2D,A03,460575,Sharma; Vivek A.,25,0,25,0
1708249720757,PHYS 4B,A01,441829,Grinstein; Benjamin,34,0,38,4
1708249720757,PHYS 4B,A02,441831,Grinstein; Benjamin,30,0,32,2
1708249720757,PHYS 4B,A03,441832,Grinstein; Benjamin,30,0,30,0
1708249720757,PHYS 4B,A04,441833,Grinstein; Benjamin,30,0,30,0
1708249721288,PHYS 4E,A01,441907,Frano Pereira; Alex M,33,0,34,1
1708249721288,PHYS 4E,A02,441958,Frano Pereira; Alex M,34,0,34,0
1708249721816,PHYS 10,A01,441971,Burgasser; Adam Jonathan,118,0,120,2
1708249722344,PHYS 13,A01,441974,Wright; Shelley Adams,61,0,65,4
1708249722873,PHYS 87,A00,486898,Grinstein; Benjamin,19,0,20,1
1708249723400,PHYS 100C,A01,441978,Averitt; Richard Douglas,58,0,60,2
1708249723931,PHYS 105B,A01,441985,Green; Daniel Richard,37,0,40,3
1708249724457,PHYS 120,A01,441995,Arnold; Kam S,40,0,44,4
1708249724457,PHYS 120,A02,442011,Arnold; Kam S,41,0,44,3
1708249724984,PHYS 130A,A01,442032,Parker; Daniel E,74,0,75,1
1708249725510,PHYS 130B,A01,442056,Branson; James G,47,0,50,3
1708249726037,PHYS 139,A00,442057,Jun; Suckjoon,30,0,30,0
1708249726037,PHYS 139,B00,442059,Duarte; Javier Mauricio & Li; Aobo,42,0,50,8
1708249726565,PHYS 140A,A01,442065,Shotwell; Brian,49,0,50,1
1708249727091,PHYS 152B,A01,442067,Hirsch; Jorge Eduardo,17,0,20,3
1708249727618,PHYS 154,A01,442069,Jenkins; Elizabeth,29,0,30,1
1708249728148,PHYS 162,A01,442096,Keating; Brian,64,0,65,1
1708249728675,PHYS 170,A01,486870,Oh; Seungeun,39,0,40,1
1708249729201,PHYS 177,A00,442103,Dudko; Olga,20,0,20,0
1708249729727,PHYS 203B,A01,442132,Fogler; Michael M.,20,0,20,0
1708249730256,PHYS 210A,A01,442143,Hwa; Terence T.,20,0,20,0
1708249730783,PHYS 212C,A01,442200,Chivukula; Raja S,18,0,20,2
1708249731312,PHYS 215C,A00,442201,Intriligator; Kenneth Arthur,19,0,20,1
1708249731843,PHYS 225C,A01,442203,Flauger; Raphael M,19,0,20,1
1708249732373,PHYS 227,A00,442204,Tytler; David Robert,29,0,30,1
1708249732904,PHYS 230,A01,442206,McGreevy; John A.,20,0,20,0
1708249733432,PHYS 239,A00,442207,Goldenfeld; Nigel,20,0,20,0
1708249733432,PHYS 239,B00,442208,Duarte; Javier Mauricio & Li; Aobo,5,0,5,0
1708249733958,PHYS 244,A01,442280,Norman; Michael L,12,0,20,8
1708249734484,PHYS 250,A00,442300,Fogler; Michael M.,50,0,50,0
1708249735010,PHYS 251,A00,442307,Grinstein; Benjamin,20,0,20,0
1708249735539,PHYS 252,A00,442348,Diamond; Patrick H,10,0,10,0
1708249736065,PHYS 253,A00,442349,Theissen; Christopher Alexander,30,0,30,0
1708249736595,PHYS 254,A00,442352,Hwa; Terence T.,30,0,30,0
1708249737123,PHYS 255,A00,442423,Hwa; Terence T.,30,0,30,0
1708249737649,PHYS 258,A00,442426,Theissen; Christopher Alexander,30,0,30,0
1708249738178,PHYS 260,A00,442427,Frano Pereira; Alex M,50,0,50,0
1708249738704,PHYS 277,A00,442428,Dudko; Olga,20,0,20,0
1708249739253,POLI 5D,A01,419010,Dai; Yinlin,5,0,7,2
1708249739253,POLI 5D,A02,419020,Dai; Yinlin,7,0,7,0
1708249739253,POLI 5D,A03,419022,Dai; Yinlin,4,0,6,2
1708249739253,POLI 5D,A04,419040,Dai; Yinlin,5,0,5,0
1708249739253,POLI 5D,B01,419065,Dai; Yinlin,7,0,7,0
1708249739253,POLI 5D,B02,419068,Dai; Yinlin,7,0,7,0
1708249739253,POLI 5D,B03,419069,Dai; Yinlin,6,0,6,0
1708249739253,POLI 5D,B04,419070,Dai; Yinlin,5,0,5,0
1708249739253,POLI 5D,C01,487211,Staff,3,0,5,2
1708249739781,POLI 11D,A01,419072,Desposato; Scott,32,0,34,2
1708249739781,POLI 11D,A02,419073,Desposato; Scott,33,0,34,1
1708249739781,POLI 11D,A03,419082,Desposato; Scott,32,0,34,2
1708249739781,POLI 11D,A04,419123,Desposato; Scott,34,0,34,0
1708249739781,POLI 11D,A05,419124,Desposato; Scott,34,0,34,0
1708249739781,POLI 11D,A06,419125,Desposato; Scott,34,0,34,0
1708249740312,POLI 12D,A01,419127,Gartzke; Erik,29,0,34,5
1708249740312,POLI 12D,A02,419128,Gartzke; Erik,34,0,34,0
1708249740312,POLI 12D,A03,419129,Gartzke; Erik,34,0,34,0
1708249740312,POLI 12D,A04,419130,Gartzke; Erik,34,0,34,0
1708249740312,POLI 12D,A05,419131,Gartzke; Erik,32,0,34,2
1708249740312,POLI 12D,A06,419168,Gartzke; Erik,34,0,34,0
1708249740839,POLI 13DR,A01,477733,Draper; Matthew William,28,0,34,6
1708249740839,POLI 13DR,A02,477734,Draper; Matthew William,32,0,34,2
1708249740839,POLI 13DR,A03,477736,Draper; Matthew William,33,0,34,1
1708249740839,POLI 13DR,A04,477737,Draper; Matthew William,32,0,34,2
1708249740839,POLI 13DR,A05,477739,Draper; Matthew William,31,0,34,3
1708249740839,POLI 13DR,A06,477740,Draper; Matthew William,34,0,34,0
1708249741386,POLI 30D,A01,419179,Desposato; Scott,19,0,28,9
1708249741386,POLI 30D,A02,419180,Desposato; Scott,25,0,28,3
1708249741386,POLI 30D,A03,419181,Desposato; Scott,27,0,28,1
1708249741386,POLI 30D,A04,419182,Desposato; Scott,28,0,28,0
1708249741386,POLI 30D,A05,419187,Desposato; Scott,24,0,28,4
1708249741386,POLI 30D,A06,419189,Desposato; Scott,28,0,28,0
1708249741911,POLI 100E,A00,419191,Pitcher; Kennedy Anell,105,0,115,10
1708249742440,POLI 104P,A00,419192,Orfield; Michael Bennett,183,0,196,13
1708249742967,POLI 104U,A00,419193,Nichter; Maysa,89,0,115,26
1708249743510,POLI 108,A00,419194,Adida; Claire,293,0,295,2
1708249744036,POLI 110C,A00,419195,Soon; Valerie,47,0,50,3
1708249744566,POLI 120D,A00,419207,Hansen; Jan Eric,48,0,50,2
1708249745100,POLI 124A,A00,419209,Fortunato; David,48,0,50,2
1708249745627,POLI 131CR,A00,419211,Hoston; Germaine,41,0,50,9
1708249745627,POLI 131CR,B00,481592,Hoston; Germaine,10,0,10,0
1708249746154,POLI 136A,A00,419212,Roeder; Philip G,111,0,115,4
1708249746685,POLI 140D,A00,419213,Wong; Tak Kei,183,0,192,9
1708249747213,POLI 142D,A00,419214,Gartzke; Erik,227,0,230,3
1708249747739,POLI 145C,A00,419222,Fisk; David Lee,101,0,115,14
1708249748270,POLI 150A,A00,419225,Wong; Tak Kei,217,0,230,13
1708249748850,POLI 170A,A00,419226,Skillman; Rachel Diane,115,0,115,0
1708249749377,POLI 179,A00,419238,Staff,95,0,104,9
1708249749903,POLI 194,A00,455332,Hill; Seth J,0,0,0,0
1708249750428,POLI 194SD,A00,419248,Nichter; Maysa,999,0,999,0
1708249750952,POLI 197SD,001,419258,Nichter; Maysa,999,0,999,0
1708249751479,POLI 203B,A00,419265,Slantchev; Branislav,21,0,25,4
1708249752005,POLI 214R,A00,419275,Hoston; Germaine,23,0,25,2
1708249752530,POLI 219,A00,419289,Soon; Valerie,24,0,25,1
1708249753056,POLI 220A,A00,419299,Ferree; Karen E,21,0,25,4
1708249753584,POLI 233,A00,419333,Adida; Claire,23,0,25,2
1708249754111,POLI 243,A00,479118,Joseph; Michael F,23,0,25,2
1708249754637,POLI 251,A00,419334,Ban; Pamela M,23,0,25,2
1708249755162,POLI 257,A00,419335,Hill; Seth J,25,0,25,0
1708249755689,POLI 273,A00,419336,Mignozzetti; Umberto,16,0,25,9
1708249756215,POLI 280,A00,419337,Hafner-Burton; Emilie,18,0,25,7
1708249756744,POLI 281,A00,419338,Ban; Pamela M,21,0,25,4
1708249757272,POLI 282,A00,419339,Ferree; Karen E,19,0,25,6
1708249757800,POLI 283,A00,419340,Naoi; Megumi,23,0,25,2
1708249758329,POLI 285,A00,419341,Ingham; Sean,25,0,25,0
1708249758856,POLI 286,A00,419342,Mignozzetti; Umberto,23,0,25,2
1708249759385,POLI 288,A00,479174,Fowler; James,13,0,15,2
1708249759912,PSY 296,001,465760,Besterman; Aaron David,49,0,50,1
1708249759912,PSY 296,002,465765,Eyler; Lisa T.,49,0,50,1
1708249759912,PSY 296,003,465767,Patel; Ekta Himanshu,49,0,50,1
1708249760441,PSYC 3R,A00,419378,Pilegard; Celeste Cristine,314,0,325,11
1708249760968,PSYC 7,A00,419384,Powell; Lindsey Jane,288,0,295,7
1708249761498,PSYC 60,A01,460208,Lowe; Angela Beth,31,0,35,4
1708249761498,PSYC 60,A02,460209,Lowe; Angela Beth,28,0,35,7
1708249761498,PSYC 60,A03,460210,Lowe; Angela Beth,35,0,35,0
1708249761498,PSYC 60,A04,460211,Lowe; Angela Beth,33,0,35,2
1708249761498,PSYC 60,A05,460212,Lowe; Angela Beth,34,0,35,1
1708249761498,PSYC 60,A06,460213,Lowe; Angela Beth,35,0,35,0
1708249761498,PSYC 60,A07,460214,Lowe; Angela Beth,33,0,35,2
1708249761498,PSYC 60,B01,460215,Rose; Fred E.,35,0,35,0
1708249761498,PSYC 60,B02,460216,Rose; Fred E.,35,0,35,0
1708249761498,PSYC 60,B03,460218,Rose; Fred E.,35,0,35,0
1708249761498,PSYC 60,B04,460219,Rose; Fred E.,35,0,35,0
1708249761498,PSYC 60,B05,460220,Rose; Fred E.,32,0,35,3
1708249761498,PSYC 60,B06,460221,Rose; Fred E.,35,0,35,0
1708249761498,PSYC 60,B07,460222,Rose; Fred E.,35,0,35,0
1708249762025,PSYC 70,A01,460223,Pilegard; Celeste Cristine,29,0,35,6
1708249762025,PSYC 70,A02,460224,Pilegard; Celeste Cristine,32,0,35,3
1708249762025,PSYC 70,A03,460225,Pilegard; Celeste Cristine,34,0,35,1
1708249762025,PSYC 70,A04,460266,Pilegard; Celeste Cristine,33,0,35,2
1708249762025,PSYC 70,A05,460267,Pilegard; Celeste Cristine,35,0,35,0
1708249762025,PSYC 70,A06,460277,Pilegard; Celeste Cristine,34,0,35,1
1708249762558,PSYC 71,A01,419620,Staff,19,0,21,2
1708249762558,PSYC 71,A02,419662,Staff,20,0,21,1
1708249762558,PSYC 71,B01,419682,Geller; Emma Harlan,24,0,25,1
1708249762558,PSYC 71,B02,419732,Geller; Emma Harlan,26,0,26,0
1708249763088,PSYC 88,A00,419733,Dobkins; Karen R.,47,0,65,18
1708249763617,PSYC 100,A00,419734,Chapman; Eddie Nathaniel,388,0,410,22
1708249764150,PSYC 101,A00,419735,Walker; Caren Michelle,272,0,295,23
1708249764680,PSYC 102,A00,419779,Moranton; Nirelia Melbina-,292,0,295,3
1708249765209,PSYC 104,A00,419880,Fine; Rachel,267,0,295,28
1708249765737,PSYC 105,A00,419946,Lowe; Angela Beth,276,0,295,19
1708249766264,PSYC 111B,A01,419948,Geller; Emma Harlan,35,0,35,0
1708249766790,PSYC 116C,A01,420046,Lang; Ariel,25,0,25,0
1708249767318,PSYC 117,A01,420092,Bajic; Daniel Andrew,25,0,25,0
1708249767845,PSYC 118,A01,420095,Miller; Cory T.,37,0,45,8
1708249768373,PSYC 124,A00,420096,Chapman; Eddie Nathaniel,381,0,410,29
1708249768901,PSYC 127,A00,420097,Dickenson; Janna Alene,14,0,20,6
1708249769427,PSYC 132,A00,420121,Staff,114,0,120,6
1708249769954,PSYC 133R,A01,420172,Golden; Susan S. & Gorman; Michael R.,10,0,16,6
1708249769954,PSYC 133R,A02,420173,Golden; Susan S. & Gorman; Michael R.,16,0,16,0
1708249769954,PSYC 133R,A03,420175,Golden; Susan S. & Gorman; Michael R.,16,0,16,0
1708249769954,PSYC 133R,A04,420249,Golden; Susan S. & Gorman; Michael R.,13,0,16,3
1708249770479,PSYC 134,A00,420311,Kaye; Walter H.,296,0,300,4
1708249771005,PSYC 137,A00,420312,Lin; Chujun,292,0,295,3
1708249771535,PSYC 144,A00,420313,Wixted; John T,287,0,295,8
1708249772062,PSYC 147,A00,420315,Wong; Lauren Hitomi,120,0,146,26
1708249772591,PSYC 164,A00,420328,Kaplan; Paul,259,0,295,36
1708249773119,PSYC 172,A00,420336,Dickenson; Janna Alene,294,0,300,6
1708249773648,PSYC 178,A00,420337,Glaser; Dale,131,0,146,15
1708249774176,PSYC 179,A00,420338,Lacefield; Katharine I,257,0,328,71
1708249774706,PSYC 181,A00,420339,Anagnostaras; Stephan,333,0,350,17
1708249775235,PSYC 184,A00,420367,Wilson; Brent M,275,0,295,20
1708249775762,PSYC 188,A00,420368,Lacefield; Katharine I,234,0,300,66
1708249776287,PSYC 190,A00,420378,Barner; David A.,374,0,395,21
1708249776814,PSYC 193,B00,420626,Brashier; Nadia Marie,215,0,216,1
1708249776814,PSYC 193,C00,420643,Gremel; Christina M,33,0,35,2
1708249777348,PSYC 193L,A01,420817,Brown; Sandra A,65,0,65,0
1708249777348,PSYC 193L,B01,420830,Staff,26,0,30,4
1708249777348,PSYC 193L,C01,420832,Staff,49,0,49,0
1708249777348,PSYC 193L,D01,420834,Staff,27,0,30,3
1708249777348,PSYC 193L,E01,493996,Aron; Adam,24,0,24,0
1708249777875,PSYC 194C,A01,420905,Heyman; Gail D.,1,0,1,0
1708249778401,PSYC 205,A00,420906,Harris; Christine Renee,17,0,20,3
1708249778927,PSYC 218,A00,420907,Brady; Timothy Francis,11,0,20,9
1708249779458,PSYC 224,A00,420908,Gremel; Christina M,30,0,30,0
1708249779984,PSYC 242,A00,421469,Walker; Caren Michelle,27,0,30,3
1708249780510,PSYC 247,A00,421473,Walker; Caren Michelle,14,0,20,6
1708249781035,PSYC 270C,A00,421554,Dobkins; Karen R.,13,0,20,7
1708249781566,PSYC 272,A00,421561,Gentner; Tim,20,0,20,0
1708249782092,PSYC 274,A00,421564,McCullough; Michael E,29,0,30,1
1708249782620,PSYC 275,A00,421620,Staff,23,0,30,7
1708249783147,PSYC 276,A00,421622,McCullough; Michael E,14,0,20,6
1708249783674,PSYC 280,A00,421623,Serences; John Thomas,76,0,85,9
1708249784206,PSYC 296,001,421667,Anagnostaras; Stephan,9999,0,9999,0
1708249784206,PSYC 296,002,421773,Aron; Adam,9999,0,9999,0
1708249784206,PSYC 296,003,421794,Mukku; Dhananjaya,9999,0,9999,0
1708249784206,PSYC 296,004,421795,Barner; David A.,9998,0,9999,1
1708249784206,PSYC 296,005,421796,Schachner; Adena,9999,0,9999,0
1708249784206,PSYC 296,006,421797,Brown; Sandra A,9999,0,9999,0
1708249784206,PSYC 296,007,421798,Chapman; Eddie Nathaniel,9999,0,9999,0
1708249784206,PSYC 296,008,421799,Dickenson; Janna Alene,9999,0,9999,0
1708249784206,PSYC 296,009,421800,Dobkins; Karen R.,9998,0,9999,1
1708249784206,PSYC 296,010,421801,Fan; Judith Ellen,9999,0,9999,0
1708249784206,PSYC 296,011,421803,Ferreira; Victor,9999,0,9999,0
1708249784206,PSYC 296,012,421814,Geller; Emma Harlan,9998,0,9999,1
1708249784206,PSYC 296,013,422102,Gentner; Tim,9999,0,9999,0
1708249784206,PSYC 296,014,422103,Gorman; Michael R.,9999,0,9999,0
1708249784206,PSYC 296,015,422104,Gremel; Christina M,9999,0,9999,0
1708249784206,PSYC 296,016,422106,Harris; Christine Renee,9999,0,9999,0
1708249784206,PSYC 296,017,422107,Heyman; Gail D.,9999,0,9999,0
1708249784206,PSYC 296,018,422108,McCullough; Michael E,9999,0,9999,0
1708249784206,PSYC 296,019,422109,Mc Kenzie; Craig R.M.,9999,0,9999,0
1708249784206,PSYC 296,020,422122,Miller; Cory T.,9999,0,9999,0
1708249784206,PSYC 296,021,422123,Pashler; Harold E,9999,0,9999,0
1708249784206,PSYC 296,022,422124,Pilegard; Celeste Cristine,9999,0,9999,0
1708249784206,PSYC 296,023,422125,Powell; Lindsey Jane,9999,0,9999,0
1708249784206,PSYC 296,025,422127,Rickard; Timothy C.,9998,0,9999,1
1708249784206,PSYC 296,026,422128,Serences; John Thomas,9998,0,9999,1
1708249784206,PSYC 296,027,422130,Walker; Caren Michelle,9998,0,9999,1
1708249784206,PSYC 296,028,422132,Winkielman; Piotr,9999,0,9999,0
1708249784206,PSYC 296,029,422134,Wixted; John T,9996,0,9999,3
1708249784206,PSYC 296,030,422146,Brady; Timothy Francis,9998,0,9999,1
1708249784206,PSYC 296,031,422154,Carver; Leslie J.,9999,0,9999,0
1708249784206,PSYC 296,032,422161,Lin; Chujun,9999,0,9999,0
1708249784206,PSYC 296,033,422169,Brashier; Nadia Marie,9998,0,9999,1
1708249784206,PSYC 296,034,422177,Oesch; Nicholas W,9999,0,9999,0
1708249784731,RAD 296,001,465795,Staff,50,0,50,0
1708249784731,RAD 296,002,465796,Staff,50,0,50,0
1708249784731,RAD 296,003,465797,Staff,50,0,50,0
1708249785256,RELI 150,A00,419353,Rahimi; Babak,37,0,40,3
1708249785784,REV 87,A00,422721,Lyon; Antony J.,19,0,20,1
1708249786312,RMAS 296,001,465827,Murphy; James D,49,0,50,1
1708249786312,RMAS 296,002,465828,Staff,50,0,50,0
1708249786312,RMAS 296,003,465831,Staff,50,0,50,0
1708249786841,RMED 296,001,466791,Staff,50,0,50,0
1708249786841,RMED 296,002,466792,Staff,50,0,50,0
1708249786841,RMED 296,003,466793,Staff,50,0,50,0
1708249787374,SE 3,A01,446938,Van Den Einde; Yael Dahlia,50,0,52,2
1708249787374,SE 3,A02,446942,Van Den Einde; Yael Dahlia,49,0,52,3
1708249787374,SE 3,A03,446948,Van Den Einde; Yael Dahlia,52,0,53,1
1708249787374,SE 3,A04,446965,Van Den Einde; Yael Dahlia,53,0,53,0
1708249787901,SE 9,A01,447015,Kuester; Falko,30,0,34,4
1708249787901,SE 9,A02,447017,Kuester; Falko,33,0,33,0
1708249787901,SE 9,A03,447022,Kuester; Falko,31,0,33,2
1708249788428,SE 101B,A01,447040,Kosmatka; John B,55,0,56,1
1708249788954,SE 105,A01,447042,Qiao; Yu,118,0,120,2
1708249789485,SE 110A,A01,467467,Asaro; Robert J,56,0,56,0
1708249790012,SE 110B,A00,447045,Zhu; Qiang,122,0,125,3
1708249790540,SE 130B,A01,447049,Chadha; Mayank,92,0,100,8
1708249791071,SE 131A,A01,447059,Krysl; Petr,102,0,110,8
1708249791598,SE 132,A01,447078,Chen; Jiun-Shyan,48,0,50,2
1708249792128,SE 140B,A01,447086,Restrepo; Jose,29,0,34,5
1708249792128,SE 140B,A02,447123,Restrepo; Jose,21,0,33,12
1708249792128,SE 140B,A03,447124,Restrepo; Jose,30,0,33,3
1708249792655,SE 143B,A01,447133,Tehrani; Mehran,11,0,15,4
1708249792655,SE 143B,A02,447134,Tehrani; Mehran,13,0,15,2
1708249793181,SE 150A,A01,447136,Uang; Chia-Ming,94,0,100,6
1708249793708,SE 150B,A01,447214,Morrison; Machel Leigh,49,0,50,1
1708249794236,SE 151B,A00,447215,Shing; P. Benson,71,0,75,4
1708249794762,SE 160B,A01,467468,Kim; Hyunsun Alicia,91,0,100,9
1708249795294,SE 165,A00,447238,Farrar; Charles R.,9,0,10,1
1708249795824,SE 184,A00,447253,Hutchinson; Tara,20,0,20,0
1708249796354,SE 202,A00,447392,Kosmatka; John B,25,0,30,5
1708249796881,SE 204,A00,447482,Todd; Michael,12,0,20,8
1708249797410,SE 206,A00,447483,Conte; Joel P,30,0,30,0
1708249797936,SE 213,A00,447499,Palermo; Alessandro,17,0,30,13
1708249798467,SE 215,A00,447500,Zhu; Qiang,34,0,45,11
1708249798997,SE 222,A00,447507,Elgamal; Ahmed,30,0,30,0
1708249799523,SE 227,A00,447576,Hutchinson; Tara,20,0,25,5
1708249800048,SE 244,A00,447577,Elgamal; Ahmed,29,0,30,1
1708249800574,SE 247,A00,447580,Hutchinson; Tara,0,0,5,5
1708249801106,SE 251B,A00,447612,Qiao; Yu,15,0,25,10
1708249801631,SE 253B,A00,447613,Kim; Hyonny,28,0,30,2
1708249802213,SE 260B,A00,447614,Kim; Hyunsun Alicia,10,0,10,0
1708249802739,SE 265,A00,447615,Farrar; Charles R.,20,0,25,5
1708249803267,SE 266,A00,447616,Loh; Chin Hsiung,23,0,25,2
1708249804322,SE 280,A00,447650,Krysl; Petr,22,0,25,3
1708249804854,SE 281,A01,447658,Kuester; Falko,12,0,30,18
1708249805382,SE 290,A00,447659,Qiao; Yu,78,0,100,22
1708249805913,SE 296,001,447666,Asaro; Robert J,9999,0,9999,0
1708249805913,SE 296,002,447669,Chen; Jiun-Shyan,9999,0,9999,0
1708249805913,SE 296,003,447689,Conte; Joel P,9999,0,9999,0
1708249805913,SE 296,004,447690,Elgamal; Ahmed,9999,0,9999,0
1708249805913,SE 296,005,447728,Hutchinson; Tara,9999,0,9999,0
1708249805913,SE 296,006,447733,Jandaghi Semnani; Shabnam,9999,0,9999,0
1708249805913,SE 296,007,447734,Kim; Hyonny,9999,0,9999,0
1708249805913,SE 296,008,447737,Kim; Hyunsun Alicia,9999,0,9999,0
1708249805913,SE 296,009,447738,Kosmatka; John B,9999,0,9999,0
1708249805913,SE 296,010,447739,Krysl; Petr,9999,0,9999,0
1708249805913,SE 296,011,447740,Kuester; Falko,9999,0,9999,0
1708249805913,SE 296,012,447741,Lanza Di Scalea; Francesco,9999,0,9999,0
1708249805913,SE 296,013,447742,Loh; Kenneth J. H.,9999,0,9999,0
1708249805913,SE 296,014,447745,McCartney; John Scott,9999,0,9999,0
1708249805913,SE 296,015,447747,Morrison; Machel Leigh,9999,0,9999,0
1708249805913,SE 296,016,447749,Mosqueda; Gilberto,9999,0,9999,0
1708249805913,SE 296,017,447874,Qiao; Yu,9999,0,9999,0
1708249805913,SE 296,018,447875,Restrepo; Jose,9999,0,9999,0
1708249805913,SE 296,019,447886,Shing; P. Benson,9999,0,9999,0
1708249805913,SE 296,020,447887,Todd; Michael,9999,0,9999,0
1708249805913,SE 296,021,447888,Tomac; Ingrid,9999,0,9999,0
1708249805913,SE 296,022,447889,Tsampras; Georgios,9999,0,9999,0
1708249805913,SE 296,023,447890,Uang; Chia-Ming,9999,0,9999,0
1708249805913,SE 296,024,447931,Van Den Einde; Yael Dahlia,9999,0,9999,0
1708249805913,SE 296,025,447932,Zhu; Qiang,9999,0,9999,0
1708249805913,SE 296,026,448007,Tehrani; Mehran,9999,0,9999,0
1708249805913,SE 296,027,448008,Palermo; Alessandro,9999,0,9999,0
1708249805913,SE 296,028,492941,Farrar; Charles R.,9998,0,9999,1
1708249806438,SIO 10,A00,446025,Borsa; Adrian Antal,573,0,590,17
1708249806969,SIO 16,A00,446031,Gee; Jeffrey S,119,0,120,1
1708249807502,SIO 50,A01,446057,Cook; Geoffrey W,19,0,22,3
1708249807502,SIO 50,A02,446058,Cook; Geoffrey W,21,0,22,1
1708249808027,SIO 75,A00,446060,Norris; Richard D.,32,0,35,3
1708249808560,SIO 87,A00,479215,Feddersen; Falk & Morzfeld; Matthias,20,0,20,0
1708249808560,SIO 87,B00,489613,Cook; Geoffrey W,19,0,20,1
1708249808560,SIO 87,C00,489620,Cook; Geoffrey W,20,0,20,0
1708249809085,SIO 90,A00,446061,Staff,61,0,70,9
1708249809616,SIO 113,A01,446064,May; David Alexander,27,0,30,3
1708249810674,SIO 128,A00,446115,Bartlett; Douglas H,110,0,120,10
1708249811206,SIO 135,A01,446153,Fricker; Helen A.,16,0,17,1
1708249811206,SIO 135,A02,446156,Fricker; Helen A.,14,0,18,4
1708249811733,SIO 136,A01,446159,Kacev; David & Wegner; Nicholas Craig & Bartlett; Douglas H,31,0,33,2
1708249811733,SIO 136,A02,446160,Kacev; David & Wegner; Nicholas Craig & Bartlett; Douglas H,33,0,33,0
1708249812261,SIO 139,A00,446164,Kacev; David,66,0,70,4
1708249812791,SIO 141,A01,446173,Pomeroy; Robert S.,11,0,12,1
1708249813338,SIO 143,A01,446175,Andersson; Andreas Jerry,20,0,30,10
1708249813867,SIO 145,A01,446181,Choy; Carolyn Anela,6,0,18,12
1708249814407,SIO 152,A01,446184,Van Allen; Emily Joyce,8,0,10,2
1708249814407,SIO 152,A02,479204,Van Allen; Emily Joyce,10,0,10,0
1708249814953,SIO 153,A01,446188,Capaldi; Tomas,24,0,26,2
1708249815479,SIO 160,A00,446189,Stegman; David,21,0,25,4
1708249816008,SIO 164,A00,446193,Staff,27,0,35,8
1708249816554,SIO 173,A00,446194,Lutsko; Nicholas J.,28,0,30,2
1708249817081,SIO 174,A00,446197,Aluwihare; Lihini & Russell; Lynn M.,26,0,30,4
1708249817607,SIO 181,A01,446200,Tresguerres; Martin,18,0,25,7
1708249817607,SIO 181,A02,446201,Tresguerres; Martin,23,0,25,2
1708249817607,SIO 181,A03,446209,Tresguerres; Martin,24,0,25,1
1708249817607,SIO 181,A04,446211,Tresguerres; Martin,24,0,25,1
1708249817607,SIO 181,A05,446223,Tresguerres; Martin,24,0,25,1
1708249817607,SIO 181,A06,446236,Tresguerres; Martin,24,0,25,1
1708249818131,SIO 192,A00,479211,Gerwick; William Henry,20,0,20,0
1708249818659,SIO 194,A00,455340,Hill; Seth J,0,0,0,0
1708249819187,SIOB 262,A00,446243,Gerwick; William Henry,23,0,25,2
1708249819713,SIOB 269,A00,446244,Staff,19,0,20,1
1708249820245,SIOB 270,A01,446261,Allen; Andrew Ellis & Petrik; Colleen Mary,18,0,20,2
1708249820771,SIOB 278,A00,446273,Arcila; Dahiana K,13,0,15,2
1708249820771,SIOB 278,B00,481742,Aburto Oropeza; Marco Octavio,18,0,20,2
1708249821301,SIOB 279,A00,446286,Franks; Peter,31,0,35,4
1708249821830,SIOB 291,A00,446292,Hechinger; Ryan F.,20,0,20,0
1708249822361,SIOB 296,A00,446293,Mongiardino Koch; Nicolas,16,0,20,4
1708249822887,SIOB 297,A00,446294,Allen; Eric,66,0,70,4
1708249823415,SIOC 202B,A00,446312,Stramski; Dariusz & Gabriel; Anne Alice-Agnes,17,0,20,3
1708249823942,SIOC 203C,A01,446314,Young; William Roy,5,0,5,0
1708249824470,SIOC 207C,A00,492798,Vasconcelos; Manuela,5,0,5,0
1708249824998,SIOC 208,A00,446315,Merrifield; Mark A,16,0,20,4
1708249825526,SIOC 209,A00,478924,Werner; Bradley T.,11,0,15,4
1708249825526,SIOC 209,B00,479224,Watson-Parris; Duncan,15,0,25,10
1708249825526,SIOC 209,C00,480739,Ricke; Katharine L,24,0,24,0
1708249826066,SIOC 212B,A01,446324,Cessi; Paola,40,0,40,0
1708249826596,SIOC 217C,A00,446325,Lutsko; Nicholas J.,25,0,25,0
1708249827126,SIOC 220,A00,446326,Rudnick; Daniel Lars,13,0,15,2
1708249827657,SIOC 224,A00,446327,Eisenman; Ian,20,0,25,5
1708249828184,SIOC 228,A00,446328,Shi; Yuanyuan,1,0,10,9
1708249828713,SIOC 235,A00,446342,Xie; Shang-Ping,14,0,15,1
1708249829239,SIOC 251,A00,446343,Evan; Amato Tomas,19,0,20,1
1708249829766,SIOG 200B,A00,446344,Gabriel; Anne Alice-Agnes,9,0,10,1
1708249830293,SIOG 221,A00,446354,Parnell-Turner; Ross Ernes,29,0,30,1
1708249830821,SIOG 227B,A00,446355,Laske; Gabi & Shearer; Peter M,19,0,20,1
1708249831346,SIOG 228,A00,446356,Van Allen; Emily Joyce,7,0,20,13
1708249831873,SIOG 230,A00,446359,Constable; Catherine G,25,0,25,0
1708249832403,SIOG 232,A00,446360,Constable; Catherine G & Constable; Steven C,37,0,40,3
1708249832933,SIOG 234,A00,446361,Sandwell; David T,15,0,15,0
1708249833466,SIOG 236,A01,477658,Fricker; Helen A.,5,0,5,0
1708249833466,SIOG 236,A02,477685,Fricker; Helen A.,3,0,5,2
1708249833996,SIOG 239,A00,446362,Gabriel; Anne Alice-Agnes,19,0,20,1
1708249833996,SIOG 239,B00,481507,May; David Alexander,6,0,6,0
1708249833996,SIOG 239,C00,486863,Fialko; Yuri A.,15,0,15,0
1708249834521,SIOG 268,A00,446364,Barbeau; Katherine,12,0,15,3
1708249835048,SOCE 194,A00,455341,Hill; Seth J,0,0,0,0
1708249835588,SOCG 204,A00,446551,Ng; Kwai,0,0,8,8
1708249836118,SOCG 206,A00,446552,Alvarez; Camila Huerta,4,0,8,4
1708249836649,SOCG 214,A00,446553,Raudenbush; Danielle,3,0,8,5
1708249837174,SOCG 255B,A00,446602,Serlin; David,2,0,5,3
1708249837941,SOCG 255C,A00,446813,Gates; Kelly,3,0,5,2
1708249838485,SOCG 290,A00,446910,Thorpe; Charles Robert,0,0,10,10
1708249838485,SOCG 290,B00,446911,Goldman; Harvey Stern,1,0,10,9
1708249838485,SOCG 290,C00,446914,Lampland; Martha,5,0,10,5
1708249839013,SOCI 2,A01,446373,Rogers; Julia Ellen,28,0,30,2
1708249839013,SOCI 2,A02,446374,Rogers; Julia Ellen,29,0,30,1
1708249839013,SOCI 2,A03,446382,Rogers; Julia Ellen,29,0,30,1
1708249839013,SOCI 2,A04,446384,Rogers; Julia Ellen,30,0,30,0
1708249839013,SOCI 2,A05,446389,Rogers; Julia Ellen,30,0,30,0
1708249839013,SOCI 2,A06,446393,Rogers; Julia Ellen,29,0,30,1
1708249839539,SOCI 20,A01,446396,Calderon-Zaks; Michael Aar,33,0,34,1
1708249839539,SOCI 20,A02,446409,Calderon-Zaks; Michael Aar,34,0,34,0
1708249840064,SOCI 40,A01,446417,Raudenbush; Danielle,30,0,32,2
1708249840064,SOCI 40,A02,446419,Raudenbush; Danielle,31,0,32,1
1708249840064,SOCI 40,A03,446434,Raudenbush; Danielle,31,0,32,1
1708249840064,SOCI 40,A04,446436,Raudenbush; Danielle,28,0,32,4
1708249840064,SOCI 40,A05,446441,Raudenbush; Danielle,29,0,32,3
1708249840064,SOCI 40,A06,446445,Raudenbush; Danielle,32,0,32,0
1708249840590,SOCI 60,A01,446461,Sutton; April Marie,30,0,32,2
1708249840590,SOCI 60,A02,446468,Sutton; April Marie,30,0,32,2
1708249840590,SOCI 60,A03,446469,Sutton; April Marie,26,0,32,6
1708249840590,SOCI 60,A04,446471,Sutton; April Marie,31,0,32,1
1708249841119,SOCI 100,A01,446480,Payne; Christine Anna,28,0,30,2
1708249841119,SOCI 100,A02,446491,Payne; Christine Anna,29,0,30,1
1708249841119,SOCI 100,A03,446492,Payne; Christine Anna,28,0,30,2
1708249841119,SOCI 100,A04,446493,Payne; Christine Anna,27,0,30,3
1708249841646,SOCI 103M,A00,481672,Kilpatrick; Kevin,27,0,28,1
1708249842174,SOCI 104,A00,446494,Turner; Christena L.,28,0,30,2
1708249842698,SOCI 104Q,A00,446495,Rogers; Julia Ellen,27,0,30,3
1708249843224,SOCI 106,A00,446496,Payne; Christine Anna,25,0,30,5
1708249843753,SOCI 107,A00,446497,Staff,30,0,30,0
1708249844279,SOCI 109,A00,446498,Rona-Tas; Akos,20,0,25,5
1708249844809,SOCI 111,A00,446499,Ribas Norris; Janet Vanesa,54,0,56,2
1708249845335,SOCI 114,A00,446500,Lampland; Martha,73,0,75,2
1708249845860,SOCI 117,A01,446502,Jones; Gabrielle Anastasia,14,0,17,3
1708249845860,SOCI 117,A02,446516,Jones; Gabrielle Anastasia,17,0,17,0
1708249845860,SOCI 117,A03,458787,Jones; Gabrielle Anastasia,17,0,17,0
1708249845860,SOCI 117,A04,458835,Jones; Gabrielle Anastasia,19,0,19,0
1708249846387,SOCI 120T,A00,446518,Staff,56,0,56,0
1708249846914,SOCI 123,A00,446519,Staff,79,0,80,1
1708249847445,SOCI 125,A00,487186,Calderon-Zaks; Michael Aar,55,0,56,1
1708249847972,SOCI 126,A01,446532,Jones; Makeba,15,0,15,0
1708249847972,SOCI 126,A02,446533,Jones; Makeba,15,0,15,0
1708249847972,SOCI 126,A03,458839,Jones; Makeba,15,0,15,0
1708249847972,SOCI 126,A04,458840,Jones; Makeba,15,0,15,0
1708249848497,SOCI 133,A00,446534,Calderon-Zaks; Michael Aar,53,0,56,3
1708249849023,SOCI 135,A00,486886,Ruiz; Jonathan Joseph,55,0,56,1
1708249849552,SOCI 136,A00,486887,Ruiz; Jonathan Joseph,56,0,56,0
1708249850096,SOCI 139,A00,446535,Ribas Norris; Janet Vanesa,78,0,80,2
1708249850624,SOCI 140J,A00,446537,Estefan; Michel,75,0,100,25
1708249851151,SOCI 142,A00,477639,Crofts; Christine,43,0,50,7
1708249851682,SOCI 146,A00,446538,Summers; Valerie R.,113,0,120,7
1708249852209,SOCI 151,A00,446540,Goldman; Harvey Stern,56,0,56,0
1708249852735,SOCI 156,A00,446541,Ostovany; Khashayar,55,0,56,1
1708249853282,SOCI 157,A00,446542,Jules-Rosette; Bennetta W.,28,0,28,0
1708249853812,SOCI 159,A00,494493,Estefan; Michel,93,0,96,3
1708249854338,SOCI 161,A00,477638,Staff,45,0,45,0
1708249854866,SOCI 162,A00,477642,Staff,54,0,55,1
1708249855396,SOCI 165,A00,446543,Rona-Tas; Akos,49,0,56,7
1708249856014,SOCI 171,A00,446544,Thorpe; Charles Robert,56,0,56,0
1708249856541,SOCI 173,A00,482888,Crofts; Christine,92,0,100,8
1708249857104,SOCI 180,A00,446545,Ostovany; Khashayar,55,0,56,1
1708249857633,SOCI 183,A00,446546,Sutton; April Marie,43,0,45,2
1708249858160,SOCI 185,A00,494495,Staff,30,0,30,0
1708249858687,SOCI 188D,A00,446549,Kokinis; Troy Andreas,24,0,25,1
1708249859213,SOCI 198RA,001,446550,Ng; Kwai,30,0,30,0
1708249859739,SOMC 224C,A00,466928,Bhakta; Savita Ganapathi,160,0,160,0
1708249860269,SOMC 229,A00,466925,Hoang; Mai Phuong,160,0,160,0
1708249860796,SOMC 240,A00,466937,Coyne; Christopher John,150,0,150,0
1708249861325,SOMC 242,A00,466931,Kline; Ahnika Sarah,160,0,160,0
1708249861856,SOMC 244,A00,466939,Mandel; Jess,150,0,150,0
1708249862382,SOMC 245C,A01,466935,Noel; Geoffroy Pierre Jean,160,0,160,0
1708249862908,SOMC 246C,A00,487163,Eyler; Lisa T.,160,0,160,0
1708249863440,SOMC 247C,A50,466950,Calcutt; Nigel A,160,0,160,0
1708249863970,SOMC 248C,A00,466936,Joshi; Weena Erin,160,0,160,0
1708249864496,SOMC 255C,A00,466951,Allison; Matthew,160,0,160,0
1708249865027,SPPH 161R,A01,476600,Chambers; Christina D,99,0,100,1
1708249865557,SPPH 263B,A01,460901,Hook; Vivian Yuan-Ho,25,0,25,0
1708249866083,SPPS 200A,A00,460907,Luli; Alex J,99,0,99,0
1708249866609,SPPS 200B,A00,460928,Luli; Alex J,99,0,99,0
1708249867137,SPPS 200C,A00,460934,Luli; Alex J,95,0,99,4
1708249867664,SPPS 203,A00,460955,Painter; Nathan A.,83,0,99,16
1708249868192,SPPS 205,A01,460978,Bandeira; Nuno Filipe Cabrita,64,0,80,16
1708249868722,SPPS 209,A00,460979,Bounthavong; Mark,94,0,99,5
1708249869247,SPPS 210,001,460980,Gustafsson; Asa Birgitta,99,0,99,0
1708249869774,SPPS 211A,A00,460987,Ferguson; Fleur,85,0,99,14
1708249870317,SPPS 211B,A00,460991,Ferguson; Fleur,96,0,99,3
1708249870843,SPPS 211C,A00,460992,Ferguson; Fleur,95,0,99,4
1708249871368,SPPS 211D,A00,460993,Tsunoda; Shirley M.,99,0,99,0
1708249871895,SPPS 212C,A01,460995,Saunders; Ila Maewal,95,0,99,4
1708249872421,SPPS 213C,A00,460996,Awdishu; Linda,95,0,99,4
1708249872966,SPPS 218B,A00,460997,Mandyam; Chitra,95,0,99,4
1708249873491,SPPS 225,A01,460999,Reed; Chantal,83,0,99,16
1708249874019,SPPS 236,A00,461000,Reid; Erin G.,96,0,99,3
1708249874549,SPPS 237,A00,461002,Mimoto; Mizuho Stacy,96,0,99,3
1708249875076,SPPS 238,A00,461041,Beyhan; Sinem,96,0,99,3
1708249875606,SPPS 241,A01,461122,Tsunoda; Shirley M.,83,0,99,16
1708249876133,SPPS 249,A00,461123,Brandl; Katharina,96,0,99,3
1708249876662,SPPS 250,A00,461126,Tsunoda; Shirley M.,45,0,50,5
1708249877188,SPPS 251,A00,461127,Chen; Timothy,99,0,99,0
1708249877715,SPPS 252,A00,461128,Abdul-Mutakabbir; Jacinda,74,0,80,6
1708249878252,SPPS 254,A00,481670,Shapiro; Desiree Nicolette,77,0,80,3
1708249878779,SPPS 261,A00,461129,Chambers; Christina D,93,0,99,6
1708249879324,SPPS 278,A00,459983,Fricovsky; Eduardo Santiago,98,0,99,1
1708249879856,SPPS 280,A00,461259,Fricovsky; Eduardo Santiago,19,0,20,1
1708249880382,SPPS 283,A00,461283,Tsunoda; Shirley M.,96,0,99,3
1708249880910,SURG 261,A00,466973,Staff,50,0,50,0
1708249881437,SURG 296,001,467004,Agha Hosseini; Ava,49,0,50,1
1708249881437,SURG 296,002,467005,Hinchcliff; Katharine Moss,49,0,50,1
1708249881437,SURG 296,003,467006,Eliceiri; Brian,49,0,50,1
1708249882004,SYN 1,001,448577,Bishop; Graham,19,0,20,1
1708249882004,SYN 1,002,448578,Iatarola; Briana Marie,19,0,20,1
1708249882004,SYN 1,003,448579,Browne; Emily,20,0,20,0
1708249882004,SYN 1,004,448580,Vega; Adrian,20,0,20,0
1708249882004,SYN 1,005,448581,Browne; Emily,20,0,20,0
1708249882004,SYN 1,006,448582,Rock; Martin,20,0,20,0
1708249882004,SYN 1,007,448583,Rock; Martin,20,0,20,0
1708249882004,SYN 1,008,448584,Iatarola; Briana Marie,19,0,20,1
1708249882004,SYN 1,009,448585,Bishop; Graham,20,0,20,0
1708249882004,SYN 1,010,448586,Bishop; Graham,20,0,20,0
1708249882004,SYN 1,011,448587,Gladstein; Jill M,15,0,15,0
1708249882004,SYN 1,012,448588,Meyer; Leslie Rose,20,0,20,0
1708249882004,SYN 1,013,448589,Rosenberg; Ryan Glenn,20,0,20,0
1708249882004,SYN 1,014,448627,Rosenberg; Ryan Glenn,19,0,20,1
1708249882004,SYN 1,015,448630,Atkinson; Arthur Laird,20,0,20,0
1708249882004,SYN 1,016,448651,Hom; Kirstyn Courtney,20,0,20,0
1708249882004,SYN 1,017,448652,Difruscio; Mark,20,0,20,0
1708249882004,SYN 1,018,448669,Hom; Kirstyn Courtney,20,0,20,0
1708249882004,SYN 1,019,448674,Hom; Kirstyn Courtney,18,0,20,2
1708249882004,SYN 1,020,448675,Atkinson; Arthur Laird,20,0,20,0
1708249882004,SYN 1,021,448678,Gladstein; Jill M,15,0,15,0
1708249882004,SYN 1,022,448682,Iatarola; Briana Marie,20,0,20,0
1708249882004,SYN 1,023,448691,Birberick; Brittany Celest,20,0,20,0
1708249882004,SYN 1,024,448751,Birberick; Brittany Celest,20,0,20,0
1708249882004,SYN 1,027,448766,Deavenport; James Cary,19,0,20,1
1708249882004,SYN 1,028,448767,Meyer; Leslie Rose,20,0,20,0
1708249882004,SYN 1,029,448775,Tawater; Hanna Jean,20,0,20,0
1708249882004,SYN 1,030,448777,Tawater; Hanna Jean,20,0,20,0
1708249882004,SYN 1,031,448792,Deavenport; James Cary,20,0,20,0
1708249882004,SYN 1,032,480169,Tawater; Hanna Jean,18,0,20,2
1708249882533,SYN 1R,001,448793,Difruscio; Mark,20,0,20,0
1708249882533,SYN 1R,004,449146,Difruscio; Mark,20,0,20,0
1708249883078,SYN 100,A01,449148,Staff,11,0,15,4
1708249883078,SYN 100,A02,449149,Staff,15,0,15,0
1708249883078,SYN 100,B01,449164,Gladstein; Jill M,0,0,0,0
1708249883078,SYN 100,B02,449166,Gladstein; Jill M,0,0,0,1
1708249883078,SYN 100,C01,449244,Staff,7,0,15,8
1708249883078,SYN 100,C02,449274,Staff,13,0,15,2
1708249883078,SYN 100,D01,449278,Staff,20,0,20,0
1708249883078,SYN 100,D02,449279,Staff,20,0,20,0
1708249883078,SYN 100,E01,449281,Rock; Martin,9,0,15,6
1708249883078,SYN 100,E02,449282,Rock; Martin,14,0,15,1
1708249883078,SYN 100,F01,449304,Browne; Emily,12,0,15,3
1708249883078,SYN 100,F02,449306,Browne; Emily,14,0,15,1
1708249883078,SYN 100,I01,449390,Gormally; Brenna,0,0,0,0
1708249883078,SYN 100,I02,449391,Gormally; Brenna,0,0,0,0
1708249883078,SYN 100,J01,449401,Atkinson; Arthur Laird,11,0,15,4
1708249883078,SYN 100,J02,449402,Atkinson; Arthur Laird,14,0,15,1
1708249883078,SYN 100,K01,449404,Deavenport; James Cary,11,0,15,4
1708249883078,SYN 100,K02,449405,Deavenport; James Cary,14,0,15,1
1708249883078,SYN 100,L01,449408,Rosenberg; Ryan Glenn,10,0,15,5
1708249883078,SYN 100,L02,449420,Rosenberg; Ryan Glenn,15,0,15,0
1708249883620,SYN 150,001,450016,Vega; Adrian,19,0,19,0
1708249883620,SYN 150,003,450031,Birberick; Brittany Celest,20,0,20,0
1708249884145,SYN 150R,001,494950,Vega; Adrian,20,0,20,0
1708249884673,SYN 198,001,494388,Staff,9999,0,9999,0
1708249885222,TDAC 1,A00,450042,Walsh; Kim C.,14,0,20,6
1708249885222,TDAC 1,B00,450043,Walsh; Kim C.,11,0,20,9
1708249885222,TDAC 1,C00,450044,Walsh; Kim C.,15,0,20,5
1708249885222,TDAC 1,D00,486830,Basso; Beatrice,20,0,20,0
1708249885222,TDAC 1,E00,492912,Walsh; Kim C.,15,0,20,5
1708249885222,TDAC 1,F00,492936,Walsh; Kim C.,18,0,20,2
1708249885749,TDAC 101,A00,450895,Celik; Aysan Karagasli,18,0,20,2
1708249886278,TDAC 102,A00,450904,Walsh; Kim C.,20,0,20,0
1708249886278,TDAC 102,B00,450916,Harting; Carla Kelso,20,0,20,0
1708249886807,TDAC 108,A00,450917,Buescher; Stephen W.,18,0,20,2
1708249887336,TDAC 109,A00,450924,Blair; Kyle Adam,20,0,20,0
1708249887866,TDAC 122,A00,451025,Perry; Lamar,30,0,30,0
1708249887866,TDAC 122,B00,480845,Perry; Lamar,30,0,30,0
1708249888397,TDAC 123,A00,451026,Buescher; Stephen W.,30,0,30,0
1708249888397,TDAC 123,B00,451028,Celik; Aysan Karagasli,30,0,30,0
1708249888397,TDAC 123,C00,480851,Perry; Lamar,30,0,30,0
1708249888926,TDDE 101,A00,451030,Guirguis; Mark C,18,0,20,2
1708249889452,TDDE 112,A00,451032,Staff,20,0,20,0
1708249889984,TDDE 130,A00,451033,Guirguis; Mark C,19,0,20,1
1708249890511,TDDE 132,A00,451034,Guirguis; Mark C,20,0,20,0
1708249891036,TDDE 169A,A00,481304,Petrovich; Victoria A.,19,0,20,1
1708249891565,TDDM 1,A00,450045,Weinberg; Sadie,27,0,30,3
1708249892092,TDDM 101,A00,451067,Staff,29,0,30,1
1708249892620,TDDR 101,A00,451068,Powell; Lora,29,0,34,5
1708249893145,TDDR 102,A00,451069,Powell; Lora,19,0,20,1
1708249893674,TDDR 111,A00,451070,Castro; Robert Jess,15,0,16,1
1708249893674,TDDR 111,B00,451071,Castro; Robert Jess,15,0,16,1
1708249894199,TDDR 190,A00,451073,Perry; Lamar,1,0,1,0
1708249894730,TDGE 1,A01,450047,Salovey; Todd,20,0,20,0
1708249894730,TDGE 1,A02,450048,Salovey; Todd,20,0,20,0
1708249894730,TDGE 1,A03,450085,Salovey; Todd,18,0,20,2
1708249894730,TDGE 1,A04,450093,Salovey; Todd,20,0,20,0
1708249894730,TDGE 1,A05,450096,Salovey; Todd,19,0,20,1
1708249894730,TDGE 1,A06,450132,Salovey; Todd,16,0,20,4
1708249895261,TDGE 25,A00,450236,Harting; Carla Kelso,12,0,20,8
1708249895261,TDGE 25,B00,450240,Harting; Carla Kelso,16,0,20,4
1708249895261,TDGE 25,C00,450243,Harting; Carla Kelso,14,0,20,6
1708249895261,TDGE 25,D00,450388,Harting; Carla Kelso,16,0,20,4
1708249895791,TDGE 100,A01,451098,Salovey; Todd,24,0,25,1
1708249895791,TDGE 100,A02,451099,Salovey; Todd,24,0,25,1
1708249896318,TDGE 124,A00,451122,Fulton; Julia,168,0,200,32
1708249896845,TDGE 125,A00,480853,Havis; Allan,197,0,200,3
1708249896845,TDGE 125,B00,480886,Staff,216,0,220,4
1708249897375,TDGE 133,A00,481097,Brill; Robert L.,20,0,20,0
1708249897901,TDGE 196B,A00,493144,Barricelli; Marc Alexander,1,0,1,0
1708249897901,TDGE 196B,B00,493148,Buescher; Stephen W.,2,0,2,0
1708249897901,TDGE 196B,C00,493151,Burelle; Julie Sara Veronique,1,0,1,0
1708249897901,TDGE 196B,D00,493189,Castro; Robert Jess,2,0,2,0
1708249897901,TDGE 196B,E00,493190,Guirguis; Mark C,1,0,1,0
1708249897901,TDGE 196B,F00,493240,Iizuka; Naomi Hisako,1,0,1,0
1708249897901,TDGE 196B,G00,493241,Perry; Lamar,1,0,1,0
1708249897901,TDGE 196B,H00,493249,Powell; Lora,1,0,1,0
1708249897901,TDGE 196B,I00,493296,Stein; Deborah Isobel,6,0,6,0
1708249898427,TDGR 213C,A00,451385,Buescher; Stephen W.,10,0,10,0
1708249898957,TDGR 220A,A00,451386,Barricelli; Marc Alexander,10,0,10,0
1708249899481,TDGR 239,A00,451387,Blair; Kyle Adam,10,0,10,0
1708249900006,TDGR 240,A00,481306,Portes; Elizabeth Marie,5,0,5,0
1708249900531,TDGR 245,A00,451388,Perry; Lamar,7,0,7,0
1708249901060,TDGR 250,A00,451395,Iizuka; Naomi Hisako,8,0,10,2
1708249901585,TDGR 251,A00,451397,Iizuka; Naomi Hisako,9,0,10,1
1708249901585,TDGR 251,B00,451398,Stein; Deborah Isobel,9,0,10,1
1708249902111,TDGR 257B,A00,451399,Finch; Michael S,8,0,10,2
1708249902636,TDGR 278,A00,481307,Petrovich; Victoria A.,4,0,5,1
1708249903162,TDGR 279,A00,451400,Bokovikova; Alina V,9,0,10,1
1708249903162,TDGR 279,B00,451401,Brill; Robert L.,10,0,10,0
1708249903162,TDGR 279,C00,451402,Petrovich; Victoria A.,10,0,10,0
1708249903162,TDGR 279,D00,451403,McElver; Robert Harrison,10,0,10,0
1708249903162,TDGR 279,E00,451404,Kuhl; Christopher August,10,0,10,0
1708249903688,TDGR 286,A00,451405,Knox; Leila Elizabeth,9,0,10,1
1708249904215,TDGR 288,A00,451406,Powell; Lora,6,0,7,1
1708249904751,TDGR 292,A00,451407,Power; Jade Yukana,10,0,10,0
1708249904751,TDGR 292,B00,451408,Mehrishi; Rishika,10,0,10,0
1708249905296,TDGR 293,001,451417,Power; Jade Yukana,7,0,7,0
1708249905296,TDGR 293,002,451418,Burelle; Julie Sara Veronique,7,0,7,0
1708249905296,TDGR 293,003,451419,Yapp; Hentyle T,7,0,7,0
1708249905296,TDGR 293,005,451421,Anderson; Mysia Anyse,7,0,7,0
1708249905826,TDGR 294,001,451429,Burelle; Julie Sara Veronique,7,0,7,0
1708249905826,TDGR 294,002,451431,Power; Jade Yukana,7,0,7,0
1708249905826,TDGR 294,003,451432,Yapp; Hentyle T,7,0,7,0
1708249906352,TDGR 295,A00,451433,Barricelli; Marc Alexander,10,0,10,0
1708249906881,TDGR 296,A00,451489,Powell; Lora,6,0,7,1
1708249906881,TDGR 296,B00,451497,Porter; Lisa,6,0,7,1
1708249907407,TDHD 175,A00,451123,Jun; Grace Shin Hae,40,0,40,0
1708249907952,TDHD 176,A00,451124,Caligagan; Maria T.,40,0,40,0
1708249908480,TDHT 10,A00,450409,Power; Jade Yukana,20,0,20,0
1708249908480,TDHT 10,B00,450450,Power; Jade Yukana,19,0,20,1
1708249909011,TDHT 23,A01,450546,Salimi; Rana,24,0,24,0
1708249909011,TDHT 23,A02,450549,Salimi; Rana,22,0,24,2
1708249909011,TDHT 23,A03,450553,Salimi; Rana,24,0,24,0
1708249909593,TDHT 101,A00,451125,Anderson; Mysia Anyse,25,0,25,0
1708249909593,TDHT 101,B00,451126,Mehrishi; Rishika,23,0,25,2
1708249910120,TDHT 104,A00,451225,Basso; Beatrice,22,0,25,3
1708249910650,TDHT 109,A01,451227,Anderson; Mysia Anyse,25,0,25,0
1708249911174,TDHT 122,A00,451228,Power; Jade Yukana,21,0,25,4
1708249911702,TDMV 1,A00,450558,Caligagan; Maria T.,15,0,30,15
1708249912230,TDMV 2,A00,450627,Anabo; Cherry,24,0,30,6
1708249912755,TDMV 3,A00,450630,Arcidiacono; Kristin,37,0,40,3
1708249913285,TDMV 11,A00,481244,Fyall; DauntÉ Edward,30,0,30,0
1708249913813,TDMV 20,A00,450789,Smith; Alison D,38,0,40,2
1708249914342,TDMV 110,A00,451229,Caligagan; Maria T.,28,0,30,2
1708249914866,TDMV 111,A00,451234,Smith; Alison D,28,0,30,2
1708249915396,TDMV 120,A00,451260,Weinberg; Sadie,30,0,30,0
1708249915396,TDMV 120,B00,451261,Sammartano; Tonnie,30,0,30,0
1708249915921,TDMV 122,A00,451262,Staff,28,0,30,2
1708249916447,TDMV 123,A00,451263,Duran; Marcos Antonio,28,0,30,2
1708249916973,TDMV 130,A00,451272,Mack; Kara Shanai',30,0,30,0
1708249917500,TDMV 138,A00,451275,Jun; Grace Shin Hae,4,0,30,26
1708249918031,TDMV 140,A00,451276,Lima; Paulo Henrique,40,0,40,0
1708249918031,TDMV 140,B00,451308,Power; Jade Yukana,39,0,40,1
1708249918031,TDMV 140,C00,451371,Caligagan; Tony,40,0,40,0
1708249918031,TDMV 140,D00,451373,Corrales; Joseph Bernales,28,0,30,2
1708249918556,TDMV 141,A00,451374,Caligagan; Tony,26,0,30,4
1708249919081,TDMV 142,A00,451375,Blanco; Juan Carlos,26,0,40,14
1708249919611,TDMV 143,A00,451376,Fyall; DauntÉ Edward,39,0,40,1
1708249920138,TDMV 144,A00,451377,Anabo; Cherry,39,0,40,1
1708249920666,TDMV 149,A00,451378,Jun; Grace Shin Hae,36,0,40,4
1708249921192,TDPF 162,A00,451379,Alvarez; Ana Maria,40,0,40,0
1708249921719,TDPR 6,A01,450799,Guirguis; Mark C,50,0,50,0
1708249921719,TDPR 6,A02,450801,Guirguis; Mark C,50,0,50,0
1708249922247,TDPR 102,A00,451380,Guirguis; Mark C,20,0,20,0
1708249922773,TDPR 104,A00,451381,Powell; Lora,15,0,15,0
1708249923300,TDPW 1,A00,450808,Stein; Deborah Isobel,14,0,15,1
1708249923300,TDPW 1,B00,450864,Stein; Deborah Isobel,13,0,15,2
1708249923300,TDPW 1,C00,450865,Stein; Deborah Isobel,15,0,15,0
1708249923300,TDPW 1,D00,450868,Stein; Deborah Isobel,13,0,15,2
1708249923300,TDPW 1,E00,450874,Stein; Deborah Isobel,14,0,15,1
1708249923829,TDPW 102,A00,451382,Staff,18,0,20,2
1708249924355,TDPW 104,A00,481182,Staff,17,0,20,3
1708249924881,TDTR 10,A00,450881,Wilson; Terry A.,28,0,30,2
1708249925410,TDTR 15,A00,450882,Smith; Alison D,30,0,30,0
1708249925934,TMC 15,A00,479039,Hemans; Patricia Ann Benitez,25,0,25,0
1708249926463,TMC 87,A00,479049,Solomon; Amanda Lee Albaniel,20,0,20,0
1708249926989,UROL 296,001,467060,Anger; Jennifer Tash,49,0,50,1
1708249926989,UROL 296,002,467061,Staff,50,0,50,0
1708249927521,USP 3,A01,458852,Martin; Isaac,34,0,35,1
1708249927521,USP 3,A02,458853,Martin; Isaac,35,0,35,0
1708249927521,USP 3,A03,458861,Martin; Isaac,34,0,35,1
1708249927521,USP 3,A04,458862,Martin; Isaac,32,0,35,3
1708249928050,USP 4,A00,451772,Schwaller; Nora Louise,19,0,25,6
1708249928578,USP 5,A01,458863,Shenkman; Michael Thomas,33,0,35,2
1708249928578,USP 5,A02,458864,Shenkman; Michael Thomas,31,0,35,4
1708249929108,USP 15,A01,458931,Staff,33,0,35,2
1708249929108,USP 15,A02,459024,Staff,31,0,35,4
1708249929634,USP 25,A00,451786,Sun; Feiyang,57,0,60,3
1708249930159,USP 100,A00,451787,Moses; Kelema Lee,55,0,60,5
1708249930685,USP 108,A00,477594,Martin; Isaac,25,0,25,0
1708249931214,USP 119,A00,477595,Schwaller; Nora Louise,23,0,25,2
1708249931738,USP 124,A00,451790,Hinds; Juli Beth,62,0,70,8
1708249932268,USP 128B,A01,451910,Lewis; Leslie R,12,0,13,1
1708249932799,USP 142B,A01,451954,Lewis; Leslie R,24,0,25,1
1708249933325,USP 142C,A00,451977,Lerner; Amy M,0,0,0,0
1708249933854,USP 145,A00,451999,Yaghmaee; Saman,140,0,146,6
1708249934381,USP 150,A00,452165,Staff,44,0,50,6
1708249934912,USP 151,A00,452166,Staff,49,0,50,1
1708249935439,USP 152A,A01,459025,Weaver; Todd D,25,0,25,0
1708249935439,USP 152A,A02,459074,Weaver; Todd D,24,0,25,1
1708249935966,USP 152B,A00,452224,Moeder; Nathan L,21,0,25,4
1708249936494,USP 153,A00,452339,Shenkman; Michael Thomas,50,0,50,0
1708249937020,USP 158A,A00,452410,Sun; Feiyang,25,0,25,0
1708249937546,USP 159B,A00,452411,Gherini; Paul Pier-Carlo,6,0,8,2
1708249938088,USP 160,A00,452412,Wartell; Julie Dara,25,0,25,0
1708249938616,USP 164,A00,452413,Moses; Kelema Lee,22,0,25,3
1708249939141,USP 165C,A00,452442,Frank; Lawrence Douglas,20,0,20,0
1708249939667,USP 169,A00,452598,Bajaj; Ravi Siddharth,32,0,35,3
1708249940199,USP 170,A00,477593,Entezam; Maryam,60,0,60,0
1708249940727,USP 172,A00,452676,Peerson; Susan,19,0,25,6
1708249941252,USP 175,A00,452848,Velasco; Diego,18,0,20,2
1708249941793,USP 177A,A00,453084,Velasco; Diego,21,0,25,4
1708249942323,USP 177B,A00,453127,Peerson; Susan,22,0,25,3
1708249942851,USP 183,A00,453128,Sutton; April Marie,19,0,20,1
1708249943379,USP 188B,A00,453187,Pezzoli; Keith,30,0,30,0
1708249943907,USP 190,A00,453234,Pezzoli; Keith,0,0,0,1
1708249944433,USP 191B,A00,453240,Polat; Soydan Alihan,18,0,20,2
1708249944962,USP 193,A00,453251,Bussell; Mirle Rabinowitz,24,0,25,1
1708249945494,USP 194,A00,455342,Hill; Seth J,0,0,0,0
1708249946023,USP 265C,A00,453264,Frank; Lawrence Douglas,10,0,10,0
1708249946792,VIS 3,A01,453427,Staff,25,0,25,0
1708249946792,VIS 3,A02,453428,Staff,15,0,25,10
1708249946792,VIS 3,A03,453429,Staff,25,0,25,0
1708249946792,VIS 3,A04,453430,Staff,21,0,25,4
1708249946792,VIS 3,A05,453431,Staff,25,0,25,0
1708249946792,VIS 3,A06,453432,Staff,23,0,25,2
1708249946792,VIS 3,A07,453433,Staff,17,0,25,8
1708249946792,VIS 3,A08,453434,Staff,23,0,25,2
1708249946792,VIS 3,A09,453435,Staff,21,0,25,4
1708249946792,VIS 3,A10,453436,Staff,23,0,25,2
1708249947319,VIS 9,A00,453437,Camargo; William,116,0,146,30
1708249947849,VIS 10,A00,453438,Kiratli; Solen,189,0,200,11
1708249948377,VIS 21B,A01,453440,Shen; Kuiyi,31,0,32,1
1708249948377,VIS 21B,A02,453441,Shen; Kuiyi,31,0,32,1
1708249948377,VIS 21B,A03,453442,Shen; Kuiyi,31,0,32,1
1708249948377,VIS 21B,A04,453443,Shen; Kuiyi,32,0,32,0
1708249948377,VIS 21B,A05,453444,Shen; Kuiyi,32,0,32,0
1708249948377,VIS 21B,A06,453452,Shen; Kuiyi,32,0,32,0
1708249948377,VIS 21B,A07,453468,Shen; Kuiyi,30,0,32,2
1708249948377,VIS 21B,A08,453587,Shen; Kuiyi,32,0,32,0
1708249948905,VIS 22,A01,453589,Rose; Jordan M,32,0,32,0
1708249948905,VIS 22,A02,453590,Rose; Jordan M,32,0,32,0
1708249948905,VIS 22,A03,453615,Rose; Jordan M,31,0,32,1
1708249948905,VIS 22,A04,453616,Rose; Jordan M,32,0,32,0
1708249948905,VIS 22,A05,453617,Rose; Jordan M,30,0,32,2
1708249948905,VIS 22,A06,453618,Rose; Jordan M,30,0,32,2
1708249948905,VIS 22,A07,453620,Rose; Jordan M,32,0,32,0
1708249948905,VIS 22,A08,453621,Rose; Jordan M,32,0,32,0
1708249948905,VIS 22,A09,453635,Rose; Jordan M,32,0,32,0
1708249948905,VIS 22,A10,453636,Rose; Jordan M,32,0,32,0
1708249949435,VIS 31,A00,453637,Dominguez; Ricardo,133,0,146,13
1708249949964,VIS 41,A01,453644,D'Elena-Tweed; Jessica Erin,23,0,25,2
1708249949964,VIS 41,A02,453645,D'Elena-Tweed; Jessica Erin,22,0,25,3
1708249949964,VIS 41,A03,453646,D'Elena-Tweed; Jessica Erin,25,0,25,0
1708249949964,VIS 41,A04,453647,D'Elena-Tweed; Jessica Erin,18,0,25,7
1708249949964,VIS 41,A05,453648,D'Elena-Tweed; Jessica Erin,25,0,25,0
1708249949964,VIS 41,A06,453650,D'Elena-Tweed; Jessica Erin,24,0,25,1
1708249950491,VIS 70N,A01,453652,Garnett; Mariah J,21,0,22,1
1708249950491,VIS 70N,A02,453653,Garnett; Mariah J,21,0,22,1
1708249950491,VIS 70N,A03,453654,Garnett; Mariah J,22,0,22,0
1708249950491,VIS 70N,A04,453657,Garnett; Mariah J,22,0,22,0
1708249950491,VIS 70N,A05,453662,Garnett; Mariah J,20,0,22,2
1708249950491,VIS 70N,A06,453663,Garnett; Mariah J,22,0,22,0
1708249951019,VIS 83,A00,453664,Kester; Grant,137,0,146,9
1708249951545,VIS 101A,A00,453666,Cruz; Edwin Teddy,10,0,15,5
1708249952073,VIS 102,A00,453668,Cruz; Edwin Teddy,81,0,85,4
1708249952603,VIS 105A,A00,453669,Adler; Amy,29,0,30,1
1708249953130,VIS 105B,A00,453738,Herc-Balaszek; Malgorzata,25,0,30,5
1708249953130,VIS 105B,B00,453739,Staff,27,0,30,3
1708249953656,VIS 106A,A00,453740,Staff,22,0,25,3
1708249954186,VIS 106B,A00,453741,De Luca; Mara Julia,20,0,25,5
1708249954717,VIS 106C,A00,453746,Vangenderen; Monique Luise,11,0,15,4
1708249955245,VIS 107A,A00,453747,Gregoire; Mathieu,19,0,25,6
1708249955771,VIS 107B,A00,453748,Dean; Danielle Adobi,23,0,25,2
1708249956297,VIS 110A,A00,453749,Adler; Amy,13,0,15,2
1708249956823,VIS 110E,A00,453798,Gregoire; Mathieu,14,0,15,1
1708249957349,VIS 110F,A00,453799,Staff,15,0,15,0
1708249957875,VIS 110N,A00,453803,Dean; Danielle Adobi,15,0,15,0
1708249958405,VIS 123B,A00,453804,Gaines; Malik Julian,75,0,75,0
1708249958934,VIS 125BN,A00,453813,Welchman; John C.,75,0,75,0
1708249959481,VIS 126P,A00,453814,Wardwell; Mariana Razo,74,0,75,1
1708249960007,VIS 128E,A00,453815,Staff,75,0,75,0
1708249960537,VIS 129E,A00,453855,Shen; Kuiyi,12,0,15,3
1708249961063,VIS 131,A00,453859,Trigilio; Michael,12,0,15,3
1708249961063,VIS 131,B00,479342,Mangolte; Babette,15,0,15,0
1708249961589,VIS 133A,A00,454231,Barbosa; Erika Katrina,13,0,15,2
1708249962116,VIS 134,A00,454232,Yoldas; Pinar,59,0,75,16
1708249962645,VIS 141B,A00,454233,Stalbaum; Brett,12,0,15,3
1708249963226,VIS 145B,A00,454234,Alexander; Amy J,14,0,15,1
1708249963226,VIS 145B,B00,454235,Kiratli; Solen,8,0,15,7
1708249963751,VIS 147A,A01,454237,Stalbaum; Brett,20,0,22,2
1708249963751,VIS 147A,A02,454238,Stalbaum; Brett,18,0,22,4
1708249964281,VIS 157,A01,454240,Cartwright; Lisa,32,0,34,2
1708249964281,VIS 157,A02,454241,Cartwright; Lisa,32,0,34,2
1708249964809,VIS 159,A01,454243,Akten; Mehmet,34,0,34,0
1708249964809,VIS 159,A02,454244,Akten; Mehmet,32,0,34,2
1708249964809,VIS 159,A03,454300,Akten; Mehmet,30,0,34,4
1708249964809,VIS 159,A04,454301,Akten; Mehmet,33,0,34,1
1708249964809,VIS 159,A05,454302,Akten; Mehmet,30,0,34,4
1708249964809,VIS 159,A06,454307,Akten; Mehmet,33,0,34,1
1708249964809,VIS 159,A07,454308,Akten; Mehmet,34,0,34,0
1708249964809,VIS 159,A08,454309,Akten; Mehmet,33,0,34,1
1708249965341,VIS 160B,A00,454310,Alexander; Amy J,13,0,15,2
1708249965341,VIS 160B,B00,454311,Akten; Mehmet,14,0,15,1
1708249965341,VIS 160B,C00,454312,Stone; Patricia,12,0,15,3
1708249965868,VIS 164,A00,454313,Cross; Brian R,19,0,22,3
1708249965868,VIS 164,B00,454314,Camargo; William,22,0,22,0
1708249966398,VIS 165,A00,454315,Erdmann; Dean,22,0,22,0
1708249966925,VIS 167,A00,454316,Staff,18,0,22,4
1708249967452,VIS 169A,A00,454317,Mostajo; Lorena,21,0,22,1
1708249967978,VIS 171,A00,454318,Nakayama; Yue,21,0,22,1
1708249968508,VIS 174,A00,454319,Staff,19,0,22,3
1708249969034,VIS 177,A00,454320,Cho; Erica,21,0,22,1
1708249969563,VIS 178,A00,454321,Staff,0,0,0,0
1708249970088,VIS 179,A00,454322,Erdmann; Dean,22,0,22,0
1708249970618,VIS 180A,A00,454323,Nakayama; Yue,21,0,22,1
1708249971148,VIS 180B,A00,454341,Cross; Brian R,20,0,22,2
1708249971674,VIS 183A,A00,454342,Cho; Erica,17,0,22,5
1708249972200,VIS 185,A00,454343,Miller; Nicole L,18,0,22,4
1708249972726,VIS 190,A00,454360,Crandall; Jordan,15,0,15,0
1708249972726,VIS 190,B00,454361,D'Elena-Tweed; Jessica Erin,10,0,15,5
1708249973254,VIS 202,A00,454369,Miller; Nicole L,12,0,15,3
1708249973784,VIS 203,A00,454370,Garnett; Mariah J,8,0,15,7
1708249974310,VIS 206,A00,454376,Kester; Grant,10,0,15,5
1708249974836,VIS 208,A00,454377,Moss; Ceci,15,0,15,0
1708249975360,VIS 211,A00,454413,Segade; Alexandro Abraham,0,0,0,2
1708249975885,VIS 243,A00,454429,Rose; Jordan M,5,0,15,10
1708249976414,VIS 255,A00,454430,Welchman; John C.,8,0,15,7
1708249976940,VIS 262,A00,454431,Yoldas; Pinar,11,0,15,4
1708249977473,WCWP 10A,001,454442,Uriarte; Emma,17,0,20,3
1708249977473,WCWP 10A,002,454443,Uriarte; Emma,14,0,20,6
1708249977473,WCWP 10A,003,454479,Uriarte; Emma,19,0,20,1
1708249977473,WCWP 10A,004,454480,Staff,0,0,0,0
1708249977473,WCWP 10A,005,454484,Staff,0,0,0,0
1708249977473,WCWP 10A,006,454485,Staff,0,0,0,0
1708249977473,WCWP 10A,007,454487,Staff,0,0,0,0
1708249977473,WCWP 10A,008,454488,Susi; Natalie,14,0,20,6
1708249977473,WCWP 10A,009,454489,Staff,0,0,0,0
1708249977473,WCWP 10A,010,454490,Staff,0,0,0,0
1708249978013,WCWP 10B,001,454492,Ornelas; Tricia,20,0,20,0
1708249978013,WCWP 10B,002,454501,Ornelas; Tricia,20,0,20,0
1708249978013,WCWP 10B,003,454565,Gagnon; Jeffrey C,2,0,20,18
1708249978013,WCWP 10B,004,454604,Ornelas; Tricia,16,0,20,4
1708249978013,WCWP 10B,005,454668,Staff,16,0,16,0
1708249978013,WCWP 10B,006,454724,Staff,16,0,16,0
1708249978013,WCWP 10B,007,454725,Staff,14,0,16,2
1708249978013,WCWP 10B,008,454768,Staff,0,0,0,0
1708249978013,WCWP 10B,009,454769,Staff,0,0,0,0
1708249978013,WCWP 10B,010,454770,Staff,0,0,0,0
1708249978013,WCWP 10B,011,454771,Dhir; Simrita,16,0,20,4
1708249978013,WCWP 10B,012,454772,Dhir; Simrita,16,0,20,4
1708249978013,WCWP 10B,013,454773,Merryman; Walter,17,0,20,3
1708249978013,WCWP 10B,014,454774,Dhir; Simrita,18,0,20,2
1708249978013,WCWP 10B,015,454775,Merryman; Walter,17,0,20,3
1708249978013,WCWP 10B,016,454776,Merryman; Walter,18,0,20,2
1708249978013,WCWP 10B,017,454777,Welji; Haleema Nazir,14,0,16,2
1708249978013,WCWP 10B,018,478868,Staff,16,0,16,0
1708249978013,WCWP 10B,019,478869,Staff,0,0,0,0
1708249978013,WCWP 10B,020,478876,Staff,0,0,0,0
1708249978013,WCWP 10B,021,478877,Staff,0,0,0,0
1708249978013,WCWP 10B,022,478887,Staff,0,0,0,0
1708249978013,WCWP 10B,023,478889,Staff,16,0,16,0
1708249978013,WCWP 10B,024,478892,Staff,0,0,0,0
1708249978013,WCWP 10B,025,478907,Staff,0,0,0,0
1708249978544,WCWP 100,A00,454800,McCleary; Keith Long,20,0,20,0
1708249978544,WCWP 100,B00,454804,McCleary; Keith Long,20,0,20,0
1708249978544,WCWP 100,C00,454822,Twohig; Niall Ivan,19,0,20,1
1708249978544,WCWP 100,D00,454855,Young; Mark T,20,0,20,0
1708249978544,WCWP 100,E00,454860,Twohig; Niall Ivan,20,0,20,0
1708249978544,WCWP 100,F00,454932,Young; Mark T,20,0,20,0
1708249978544,WCWP 100,G00,454933,Young; Mark T,20,0,20,0
1708249979074,WES 207,A00,454941,Kastner; Ryan Charles,20,0,20,0
1708249979599,WES 265,A00,454942,Staff,19,0,20,1
1708249981310,AAS 10,A01,392963,Butler; Elizabeth Annette,34,0,34,0
1708249981310,AAS 10,A02,392965,Butler; Elizabeth Annette,33,0,34,1
1708249981835,AAS 170,A00,392977,Butler; Elizabeth Annette,31,0,32,1
1708249982365,AAS 198,001,479182,Childs; Dennis R.,20,0,20,0
1708249982898,AESE 261,A00,387945,Staff,33,0,33,0
1708249983428,AESE 278D,A00,387953,Staff,33,0,33,0
1708249983958,AESE 278E,A00,387954,Staff,33,0,33,0
1708249984484,AESE 279A,A00,387956,Staff,33,0,33,0
1708249985015,AIP 197P,001,494494,Goldfarb; Brian,9999,0,9999,0
1708249985543,ANAR 100,A00,387884,Shtienberg; Gilad,15,0,16,1
1708249986070,ANAR 104,A01,387886,Tamberino; Anthony Thomas,21,0,25,4
1708249986601,ANAR 111,A00,387888,Staff,36,0,36,0
1708249987131,ANAR 115,A00,387889,Shtienberg; Gilad,36,0,36,0
1708249987657,ANAR 120,A00,387890,Staff,36,0,36,0
1708249988187,ANAR 155,A00,387891,Braswell; Geoffrey E.,15,0,25,10
1708249988713,ANAR 164,A00,387892,Staff,32,0,35,3
1708249989238,ANBI 100,A00,489626,Fox; Patrick Keolu Ozer,39,0,40,1
1708249989771,ANBI 111,A00,387893,Hrvoj Mihic; Branka,37,0,40,3
1708249990832,ANBI 144,A00,387896,Wilder; Linnea Lorene,72,0,75,3
1708249991357,ANBI 149,A00,489628,Non; Amy L,0,0,0,0
1708249991883,ANBI 173,A00,387897,Wilder; Linnea Lorene,74,0,75,1
1708249992409,ANBI 174,A00,489627,Strum; Shirley C.,13,0,15,2
1708249992937,ANES 296,001,463968,Gabriel; Rodney A,49,0,50,1
1708249992937,ANES 296,002,463969,Staff,50,0,50,0
1708249992937,ANES 296,003,463970,Staff,50,0,50,0
1708249993468,ANSC 100,A00,387898,Bialecki; Jon Anthony,40,0,40,0
1708249993996,ANSC 101,A00,387900,Sloane; Julia Kathryn,34,0,40,6
1708249994526,ANSC 117,A00,387901,Martin Sandino; Amanda Maria Yoland,13,0,15,2
1708249995054,ANSC 134,A00,387902,Staff,38,0,40,2
1708249995580,ANSC 137,A00,387903,Stewart; Alexander B,80,0,80,0
1708249996110,ANSC 138,A00,387904,Parish; Steven Martin,14,0,15,1
1708249996636,ANSC 142,A00,387905,Stone; Annika Britt,34,0,40,6
1708249997165,ANSC 147,A00,387906,Stewart; Alexander B,40,0,40,0
1708249997696,ANSC 148,A00,387907,Olivas Hernandez; Olga Lid,92,0,92,0
1708249998221,ANSC 186,A00,387910,Hankins; Joseph D.,28,0,30,2
1708249998753,ANTH 2,A01,387863,Marchetto; Maria Carolina,37,0,40,3
1708249998753,ANTH 2,A02,387864,Marchetto; Maria Carolina,40,0,40,0
1708249998753,ANTH 2,A03,387865,Marchetto; Maria Carolina,36,0,40,4
1708249998753,ANTH 2,A04,387866,Marchetto; Maria Carolina,39,0,40,1
1708249999282,ANTH 3,A01,387868,Stroth; Luke Reyneri,28,0,30,2
1708249999282,ANTH 3,A02,387869,Stroth; Luke Reyneri,29,0,30,1
1708249999282,ANTH 3,A03,387870,Stroth; Luke Reyneri,30,0,30,0
1708249999282,ANTH 3,A04,387871,Stroth; Luke Reyneri,29,0,30,1
1708249999807,ANTH 10,A00,387872,Stewart; Alexander B,80,0,80,0
1708250000334,ANTH 21,A01,387874,Stone; Annika Britt,40,0,40,0
1708250000334,ANTH 21,A02,387875,Stone; Annika Britt,40,0,40,0
1708250000334,ANTH 21,A03,387876,Stone; Annika Britt,40,0,40,0
1708250000334,ANTH 21,A04,387877,Stone; Annika Britt,39,0,40,1
1708250000866,ANTH 23,A01,387879,Staff,40,0,40,0
1708250000866,ANTH 23,A02,387880,Staff,40,0,40,0
1708250000866,ANTH 23,A03,387881,Staff,40,0,40,0
1708250000866,ANTH 23,A04,387882,Staff,40,0,40,0
1708250001393,ANTH 24,A00,387883,Pedersen; David,40,0,40,0
1708250001918,ANTH 103,A00,387911,Staff,343,0,350,7
1708250002443,ANTH 105,A00,387912,Staff,73,0,75,2
1708250002972,ANTH 112,A00,387913,Staff,23,0,25,2
1708250003499,ANTH 120,A00,479486,Parish; Steven Martin,28,0,30,2
1708250004029,ANTH 128B,A01,387923,Lewis; Leslie R,12,0,12,0
1708250004555,ANTH 192,A00,387925,Varma; Saiba,20,0,20,0
1708250005084,ANTH 196C,A00,387927,Varma; Saiba,15,0,15,0
1708250005612,ANTH 212,A00,387931,Marchetto; Maria Carolina,25,0,25,0
1708250005612,ANTH 212,B00,479487,Semendeferi; Ekaterini,25,0,25,0
1708250006138,ANTH 220,A00,387932,Csordas; Thomas J.,9,0,12,3
1708250006711,ANTH 230,001,493297,Goldstein; Paul S,18,0,20,2
1708250007240,ANTH 260,A00,479223,Jenkins; Janis A.,25,0,25,0
1708250007766,ANTH 272,A00,387936,Serlin; David,5,0,5,0
1708250008292,ANTH 273,A00,387938,Gates; Kelly,5,0,5,0
1708250008819,ANTH 288,A00,387940,Braswell; Geoffrey E.,25,0,25,0
1708250009350,ANTH 295,001,493298,Algaze; Guillermo,3,0,3,0
1708250009350,ANTH 295,002,493299,Brenner; Suzanne A,3,0,3,0
1708250009350,ANTH 295,003,493300,Csordas; Thomas J.,3,0,3,0
1708250009350,ANTH 295,004,493422,Fox; Patrick Keolu Ozer,3,0,3,0
1708250009350,ANTH 295,005,493472,Gagneux; Pascal,3,0,3,0
1708250009350,ANTH 295,006,493515,Goldstein; Paul S,3,0,3,0
1708250009350,ANTH 295,007,493592,Hankins; Joseph D.,3,0,3,0
1708250009350,ANTH 295,008,493631,Jassal; Aftab,3,0,3,0
1708250009350,ANTH 295,009,493639,Jenkins; Janis A.,3,0,3,0
1708250009350,ANTH 295,010,493657,Kaiser; Bronwyn Nicole,3,0,3,0
1708250009350,ANTH 295,011,493692,Kang; Byung Chu,3,0,3,0
1708250009350,ANTH 295,012,493758,Marchetto; Maria Carolina,3,0,3,0
1708250009350,ANTH 295,013,493761,Non; Amy L,3,0,3,0
1708250009350,ANTH 295,014,493762,Pedersen; David,3,0,3,0
1708250009350,ANTH 295,015,493825,Rivera-Collazo; Isabel C,3,0,3,0
1708250009350,ANTH 295,016,493826,Varma; Saiba,3,0,3,0
1708250009350,ANTH 295,017,493828,Yeh; Rihan Wen Xin,3,0,3,0
1708250009878,ANTH 296,001,493830,Braswell; Geoffrey E.,3,0,3,0
1708250009878,ANTH 296,002,493836,Marchetto; Maria Carolina,3,0,3,0
1708250009878,ANTH 296,003,493838,Rivera-Collazo; Isabel C,3,0,3,0
1708250009878,ANTH 296,004,493840,Varma; Saiba,3,0,3,0
1708250009878,ANTH 296,005,493842,Algaze; Guillermo,3,0,3,0
1708250009878,ANTH 296,006,493845,Brenner; Suzanne A,3,0,3,0
1708250009878,ANTH 296,007,493846,Csordas; Thomas J.,3,0,3,0
1708250009878,ANTH 296,008,493907,Fox; Patrick Keolu Ozer,3,0,3,0
1708250009878,ANTH 296,009,493949,Gagneux; Pascal,3,0,3,0
1708250009878,ANTH 296,010,493960,Goldstein; Paul S,3,0,3,0
1708250009878,ANTH 296,011,493961,Hankins; Joseph D.,3,0,3,0
1708250009878,ANTH 296,012,493962,Jassal; Aftab,3,0,3,0
1708250009878,ANTH 296,013,493963,Jenkins; Janis A.,3,0,3,0
1708250009878,ANTH 296,014,493964,Kaiser; Bronwyn Nicole,3,0,3,0
1708250009878,ANTH 296,015,493965,Kang; Byung Chu,3,0,3,0
1708250009878,ANTH 296,016,493966,Levy; Thomas E,3,0,3,0
1708250009878,ANTH 296,017,493967,Non; Amy L,3,0,3,0
1708250009878,ANTH 296,018,493968,Pedersen; David,3,0,3,0
1708250009878,ANTH 296,019,493969,Postero; Nancy Grey,3,0,3,0
1708250009878,ANTH 296,020,493970,Semendeferi; Ekaterini,3,0,3,0
1708250009878,ANTH 296,021,493971,Yeh; Rihan Wen Xin,3,0,3,0
1708250010409,AUD 236,A00,480192,Harris; Jeffrey Paul,12,0,12,0
1708250010938,AUD 260,A00,480227,Spriggs; Meghan K,12,0,12,0
1708250011471,AUD 272,A00,480367,Zettner; Erika,12,0,12,0
1708250011997,AUD 275,A00,480369,Zettner; Erika,12,0,12,0
1708250012528,AUD 284,A00,480370,Zettner; Erika,12,0,12,0
1708250012528,AUD 284,B00,480372,Spriggs; Meghan K,12,0,12,0
1708250013054,AUD 291,A00,480374,Zettner; Erika,12,0,12,0
1708250013581,AUD 296,A00,480375,Zettner; Erika,12,0,12,0
1708250013581,AUD 296,B00,480376,Harris; Jeffrey Paul,12,0,12,0
1708250013581,AUD 296,C00,480377,Ryan; Allen F.,12,0,12,0
1708250014111,AWP 3,002,387672,Given; William Allan,9,0,9,0
1708250014111,AWP 3,003,387678,Staff,5,0,5,0
1708250014111,AWP 3,004,387681,Staff,0,0,0,0
1708250014111,AWP 3,007,387784,West; Geoffrey Scott,4,0,5,1
1708250014111,AWP 3,009,387786,Kolodezh; Samuel,5,0,5,0
1708250014111,AWP 3,010,387787,Gilbert; Peter W,5,0,5,0
1708250014637,AWP 4A,001,387791,Staff,12,0,12,0
1708250014637,AWP 4A,002,387792,Staff,0,0,0,0
1708250015218,AWP 4B,001,387793,Bolin; Jillian,0,0,0,0
1708250015218,AWP 4B,002,387794,Bolin; Jillian,0,0,0,0
1708250015218,AWP 4B,003,387795,Bauer; Holly Jean,0,0,0,0
1708250015218,AWP 4B,004,387796,Vaughn; Kelsey Sara,0,0,0,0
1708250015218,AWP 4B,005,387797,Vaughn; Kelsey Sara,0,0,0,0
1708250015218,AWP 4B,007,387799,Ajo; Frances Margaret,0,0,0,0
1708250015218,AWP 4B,008,387800,Ajo; Frances Margaret,0,0,0,0
1708250015218,AWP 4B,009,387801,Hall; Graham T,0,0,0,0
1708250015218,AWP 4B,010,387802,Hall; Graham T,0,0,0,0
1708250015218,AWP 4B,011,387803,Heiser; Jerrod A,0,0,0,0
1708250015218,AWP 4B,012,387804,Heiser; Jerrod A,0,0,0,0
1708250015218,AWP 4B,013,387805,Jones; William Jadie,0,0,0,0
1708250015218,AWP 4B,014,387806,Jones; William Jadie,0,0,0,0
1708250015218,AWP 4B,015,387807,Christie; Veronica Ann,0,0,0,0
1708250015218,AWP 4B,016,387808,Christie; Veronica Ann,0,0,0,0
1708250015218,AWP 4B,019,387820,Falcon; Jennifer A,0,0,0,0
1708250015218,AWP 4B,020,387821,Falcon; Jennifer A,0,0,0,0
1708250015218,AWP 4B,021,387822,Eastin; Schuyler E.,0,0,0,0
1708250015218,AWP 4B,023,387824,Coulter; Jane Elisabeth,0,0,0,0
1708250015218,AWP 4B,025,387826,O'Neil; Courtney L,0,0,0,0
1708250015218,AWP 4B,026,387827,O'Neil; Courtney L,0,0,0,0
1708250015218,AWP 4B,027,387828,Tsurska Svetina; Olena,0,0,0,0
1708250015218,AWP 4B,028,387829,Tsurska Svetina; Olena,0,0,0,0
1708250015218,AWP 4B,029,387830,Spicer; Jacqueline,0,0,0,0
1708250015218,AWP 4B,030,387831,Spicer; Jacqueline,0,0,0,0
1708250015218,AWP 4B,031,387832,Steinberg; Stacy A,0,0,0,0
1708250015218,AWP 4B,032,387833,Steinberg; Stacy A,0,0,0,0
1708250015218,AWP 4B,033,387834,Chandler; Bailee Daniele,0,0,0,0
1708250015218,AWP 4B,034,387835,Chandler; Bailee Daniele,0,0,0,0
1708250015218,AWP 4B,035,387836,Tiernan; Christa Michelle,0,0,0,0
1708250015218,AWP 4B,036,387837,Tiernan; Christa Michelle,0,0,0,0
1708250015218,AWP 4B,037,387840,Gardella; Alexander Drew,0,0,0,0
1708250015218,AWP 4B,038,387841,Gardella; Alexander Drew,0,0,0,0
1708250015218,AWP 4B,039,387857,Zimmerman; Guy,0,0,0,0
1708250015218,AWP 4B,040,387858,Zimmerman; Guy,0,0,0,0
1708250015218,AWP 4B,041,387859,Zroka; Amy Liane,0,0,0,0
1708250015218,AWP 4B,042,387860,Zroka; Amy Liane,0,0,0,0
1708250015747,BENG 87,A00,489656,Sah; Robert Lie-Yuan,20,0,20,0
1708250015747,BENG 87,B00,489657,Sah; Robert Lie-Yuan,20,0,20,0
1708250015747,BENG 87,C00,494754,Omens; Jeffrey Howard,20,0,20,0
1708250016274,BENG 100,A01,387959,Alexandrov; Ludmil B,26,0,28,2
1708250016274,BENG 100,A02,387960,Alexandrov; Ludmil B,26,0,28,2
1708250016274,BENG 100,A03,387984,Alexandrov; Ludmil B,26,0,28,2
1708250016274,BENG 100,A04,387985,Alexandrov; Ludmil B,25,0,28,3
1708250016274,BENG 100,A05,387986,Alexandrov; Ludmil B,27,0,28,1
1708250016801,BENG 102,A00,387987,Chapelin; Fanny,55,0,56,1
1708250017622,BENG 103B,A00,387993,Fraley; Stephanie I.,116,0,120,4
1708250018150,BENG 112B,A01,388053,Shi; Lingyan,26,0,30,4
1708250018150,BENG 112B,A02,388054,Shi; Lingyan,29,0,30,1
1708250018678,BENG 125,A00,388055,Hasty; Jeff M,120,0,160,40
1708250019221,BENG 133,A01,388866,Mali; Prashant Gulab Ram,36,0,40,4
1708250019754,BENG 140B,A01,388884,Cabrales; Pedro,28,0,30,2
1708250019754,BENG 140B,A02,388885,Cabrales; Pedro,30,0,30,0
1708250019754,BENG 140B,A03,388886,Cabrales; Pedro,26,0,30,4
1708250020282,BENG 160,A50,388889,Aguado; Brian Alberto,23,0,25,2
1708250020282,BENG 160,A51,388919,Aguado; Brian Alberto,25,0,25,0
1708250020282,BENG 160,A52,388920,Aguado; Brian Alberto,25,0,25,0
1708250020814,BENG 168,A01,388961,Khojah; Reem I,30,0,30,0
1708250021340,BENG 172,A50,389087,Omens; Jeffrey Howard & Cabrales; Pedro,15,0,20,5
1708250021340,BENG 172,A51,389088,Omens; Jeffrey Howard & Cabrales; Pedro,14,0,20,6
1708250021868,BENG 182,A01,389128,Bafna; Vineet,28,0,30,2
1708250022396,BENG 186A,A00,389130,Kwon; Ester Jihae,105,0,120,15
1708250022927,BENG 187A,A00,389289,Taylor Amos; Alyssa C,157,0,170,13
1708250023457,BENG 187D,A00,389290,Taylor Amos; Alyssa C,33,0,60,27
1708250023457,BENG 187D,B00,389300,Taylor Amos; Alyssa C,51,0,60,9
1708250023457,BENG 187D,C00,389302,Taylor Amos; Alyssa C,35,0,60,25
1708250023984,BENG 189,A00,389303,Contijoch; Francisco,26,0,30,4
1708250024512,BENG 193,A00,389328,Engler; Adam J.,0,0,0,0
1708250025041,BENG 196,A00,436038,Engler; Adam J.,9999,0,9999,0
1708250025567,BENG 197,A00,436081,Engler; Adam J.,9999,0,9999,0
1708250026117,BENG 203,A00,389385,Bafna; Vineet & Zhong; Sheng,20,0,20,0
1708250026643,BENG 207,A00,389386,Kwon; Ester Jihae,10,0,40,30
1708250026643,BENG 207,B00,389400,Taylor Amos; Alyssa C,8,0,30,22
1708250026643,BENG 207,C00,389432,Khojah; Reem I,20,0,40,20
1708250027174,BENG 209,A00,389456,Scholtes Acevedo; Claire,30,0,30,0
1708250027701,BENG 213,A00,389496,Palsson; Bernhard O.,16,0,20,4
1708250028771,BENG 224,A00,389515,Staff,0,0,0,0
1708250029314,BENG 226,A01,479043,Schmid-Schoenbein; Geert W,7,0,30,23
1708250029840,BENG 227,A00,389591,Fraley; Stephanie I.,56,0,120,64
1708250030367,BENG 230C,A00,389810,Mc Culloch; Andrew Douglas,43,0,90,47
1708250030898,BENG 232,A01,390161,Sah; Robert Lie-Yuan,6,0,50,44
1708250031430,BENG 233,A00,390290,Shah; Sameer B,33,0,50,17
1708250031965,BENG 234,A00,390291,Silva; Gabriel,21,0,56,35
1708250032492,BENG 235,A00,390318,Bintu; Bogdan,16,0,40,24
1708250033019,BENG 276,A00,390357,Mc Culloch; Andrew Douglas & Amaro; Rommie E,0,0,0,0
1708250033549,BENG 280C,A01,390443,McVeigh; Elliot R.,45,0,56,11
1708250034074,BENG 281,A00,390444,Kravets; Vira V.,50,0,110,60
1708250034600,BENG 283,A00,390445,Komives; Elizabeth A,4,0,4,0
1708250035125,BENG 292,A01,390623,Ross; Camille,20,0,20,0
1708250035650,BENG 294C,A00,390709,Engler; Adam J.,17,0,20,3
1708250036176,BENG 295,A00,436300,Watson; John Thomas,9999,0,9999,0
1708250036710,BGGN 205,A00,423656,Daugherty; Matthew Dorton,47,0,60,13
1708250037236,BGGN 207,A01,423703,Ross; Camille,0,0,0,0
1708250037766,BGGN 215,A00,423704,Petrie; Katherine Lynn,22,0,30,8
1708250038296,BGGN 216,A01,423855,Mueller; Liam O'Connor,37,0,50,13
1708250038822,BGGN 218,A00,423861,David; Michael,19,0,30,11
1708250039348,BGGN 223,A00,423862,Bier; Ethan,17,0,35,18
1708250039875,BGGN 230,A00,423863,Taylor; Susan S.,8,0,15,7
1708250040416,BGGN 232,A00,423864,Briggs; Steven & Troemel; Emily Ruth,25,0,30,5
1708250040946,BGGN 239,A01,424014,Kronenberg; Mitchell E.,30,0,30,0
1708250041477,BGGN 240,A01,424016,Juavinett; Ashley Lauren,0,0,6,6
1708250042004,BGGN 248,A00,424017,Halpain; Shelley,26,0,30,4
1708250042532,BGGN 249C,A00,424052,Staff,33,0,33,0
1708250043059,BGGN 250,A01,424091,Zou; Yimin,7,0,8,1
1708250043831,BGGN 252,A01,424093,Sejnowski; Terrence J,5,0,6,1
1708250044380,BGGN 255,A00,424094,Root; Cory Matthew,29,0,30,1
1708250044906,BGGN 262,A01,424096,Villa Rodriguez; Elizabeth,30,0,30,0
1708250045442,BGGN 267,A01,424099,Benna; Marcus K & Aljadeff; Johnatan,5,0,6,1
1708250045976,BGGN 270,A00,477483,Juavinett; Ashley Lauren,67,0,75,8
1708250046764,BGGN 271,001,481745,Ackerman; Susan,9998,0,9999,1
1708250046764,BGGN 271,002,481746,Akbari; Omar Sultan,9999,0,9999,0
1708250046764,BGGN 271,003,481747,Allen; Nicola J,9999,0,9999,0
1708250046764,BGGN 271,004,481748,Banegas; Matthew Patrick,9999,0,9999,0
1708250046764,BGGN 271,005,481749,Breen; Ellen C.,9998,0,9999,1
1708250046764,BGGN 271,006,481750,Briggs; Steven,9998,0,9999,1
1708250046764,BGGN 271,007,481751,Bui; Jack D,9999,0,9999,0
1708250046764,BGGN 271,008,481762,Busch; Wolfgang,9999,0,9999,0
1708250046764,BGGN 271,009,481763,Castle; Michael James,9999,0,9999,0
1708250046764,BGGN 271,010,481764,Chang; John Tzu-yu,9999,0,9999,0
1708250046764,BGGN 271,011,481765,Chen; Ju,9998,0,9999,1
1708250046764,BGGN 271,012,481766,Chen; Xu,9999,0,9999,0
1708250046764,BGGN 271,013,481767,Cheng; Christine Shiang-Ling,9999,0,9999,0
1708250046764,BGGN 271,014,481768,Cherqui; Stephanie,9999,0,9999,0
1708250046764,BGGN 271,015,481769,Cho; Yoshitake,9999,0,9999,0
1708250046764,BGGN 271,016,481770,Church; Kellie Breen,9998,0,9999,1
1708250046764,BGGN 271,017,481771,Cleland; Elsa Eleanor,9999,0,9999,0
1708250046764,BGGN 271,018,481779,Cohen; Shiran,9998,0,9999,1
1708250046764,BGGN 271,019,481814,Cook-Andersen; Heidi Leigh,9999,0,9999,0
1708250046764,BGGN 271,020,481815,Cooke; James Edward,9999,0,9999,0
1708250046764,BGGN 271,021,481816,Coufal; Nicole Gabriele,9998,0,9999,1
1708250046764,BGGN 271,022,481818,Crotty Alexander; Laura E,9999,0,9999,0
1708250046764,BGGN 271,023,481819,Daugherty; Matthew Dorton,9998,0,9999,1
1708250046764,BGGN 271,024,481820,De Guglielmo; Giordano,9998,0,9999,1
1708250046764,BGGN 271,025,481821,Doherty; Taylor Alan,9998,0,9999,1
1708250046764,BGGN 271,026,481822,Dulawa; Stephanie Carole,9999,0,9999,0
1708250046764,BGGN 271,027,481823,Esko; Jeffrey D.,9998,0,9999,1
1708250046764,BGGN 271,028,481824,Feldstein; Ariel E,9998,0,9999,1
1708250046764,BGGN 271,029,481825,Friedman; Rick Adam,9999,0,9999,0
1708250046764,BGGN 271,030,481826,Furnari; Frank,9999,0,9999,0
1708250046764,BGGN 271,031,481829,Ghosh; Pradipta,9998,0,9999,1
1708250046764,BGGN 271,032,481830,Gleeson; Joseph Gerard,9999,0,9999,0
1708250046764,BGGN 271,033,481831,Golden; Susan S.,9998,0,9999,1
1708250046764,BGGN 271,034,481832,Goren; Alon M,9998,0,9999,1
1708250046764,BGGN 271,035,481834,Gustafsson; Asa Birgitta,9999,0,9999,0
1708250046764,BGGN 271,036,481836,Hamdoun; Amr,9999,0,9999,0
1708250046764,BGGN 271,037,481837,Hao; Nan,9999,0,9999,0
1708250046764,BGGN 271,038,481840,Holway; David A.,9998,0,9999,1
1708250046764,BGGN 271,039,481841,Huffaker; Alisa,9998,0,9999,1
1708250046764,BGGN 271,040,481843,Sebat; Lilia Mikhailovna,9998,0,9999,1
1708250046764,BGGN 271,041,481889,Ideker; Trey,9999,0,9999,0
1708250046764,BGGN 271,042,481890,Jiang; Qingfei,9998,0,9999,1
1708250046764,BGGN 271,043,482311,Jin; Yishi,9999,0,9999,0
1708250046764,BGGN 271,044,482334,Joiner; William J.,9999,0,9999,0
1708250046764,BGGN 271,045,482353,Kaech; Susan Michelle,9998,0,9999,1
1708250046764,BGGN 271,046,482378,Karin; Michael,9999,0,9999,0
1708250046764,BGGN 271,047,482379,Kleinfeld; David,9999,0,9999,0
1708250046764,BGGN 271,048,482413,Koffler; Yacov,9999,0,9999,0
1708250046764,BGGN 271,049,482414,Komiyama; Takaki,9999,0,9999,0
1708250046764,BGGN 271,050,482415,Kryazhimskiy; Sergey A,9999,0,9999,0
1708250046764,BGGN 271,051,482416,Lawson; Mark Andrew,9999,0,9999,0
1708250046764,BGGN 271,052,482417,Lee; Yun Sok,9999,0,9999,0
1708250046764,BGGN 271,053,482451,Leutgeb; Stefan,9998,0,9999,1
1708250046764,BGGN 271,054,482452,Lo; Stanley M.,9999,0,9999,0
1708250046764,BGGN 271,055,482453,Lu; Pengzhe,9998,0,9999,1
1708250046764,BGGN 271,056,482454,Lykke-Andersen; Jens,9998,0,9999,1
1708250046764,BGGN 271,057,482456,McDonnell; Lisa Marie,9999,0,9999,0
1708250046764,BGGN 271,058,482461,McHugh; Colleen A,9998,0,9999,1
1708250046764,BGGN 271,059,482478,Meharena; Hiruy Sibhatu,9999,0,9999,0
1708250046764,BGGN 271,060,482497,Morris; Gerald P,9999,0,9999,0
1708250046764,BGGN 271,061,482499,Mukamel; Eran A,9998,0,9999,1
1708250046764,BGGN 271,062,482535,Muotri; Alysson,9999,0,9999,0
1708250046764,BGGN 271,063,482551,Muroyama; Andrew David,9999,0,9999,0
1708250046764,BGGN 271,064,482552,Neal; Sonya E,9999,0,9999,0
1708250046764,BGGN 271,065,482618,Nieh; James Charles,9999,0,9999,0
1708250046764,BGGN 271,066,482619,O'Donoghue; Anthony John,9999,0,9999,0
1708250046764,BGGN 271,067,482626,Pantham; Priyadarshini,9999,0,9999,0
1708250046764,BGGN 271,068,482633,Parast; Mana,9999,0,9999,0
1708250046764,BGGN 271,069,482634,Perry; Michael William,9999,0,9999,0
1708250046764,BGGN 271,070,482639,Pride; David Tevis,9999,0,9999,0
1708250046764,BGGN 271,071,482645,Pruneda-Paz; Jose L.,9999,0,9999,0
1708250046764,BGGN 271,072,482648,Rana; Tariq,9999,0,9999,0
1708250046764,BGGN 271,073,482650,Risbrough; Victoria Blythe,9999,0,9999,0
1708250046764,BGGN 271,074,482655,Rissman; Robert Andrew,9999,0,9999,0
1708250046764,BGGN 271,075,482656,Rosenfeld; Michael G,9999,0,9999,0
1708250046764,BGGN 271,076,482657,Saier; Milton H.,9999,0,9999,0
1708250046764,BGGN 271,077,482663,Sander; Maike,9999,0,9999,0
1708250046764,BGGN 271,078,482664,Schenk; Simon,9999,0,9999,0
1708250046764,BGGN 271,079,482665,Schoeneberg; Johannes,9998,0,9999,1
1708250046764,BGGN 271,080,482666,Schroeder; Julian I,9998,0,9999,1
1708250046764,BGGN 271,081,482667,Shaner; Nathan C.,9999,0,9999,0
1708250046764,BGGN 271,082,482668,Sheikh; Farah,9999,0,9999,0
1708250046764,BGGN 271,083,482669,Shurin; Jonathan,9999,0,9999,0
1708250046764,BGGN 271,084,482675,Sigurdson; Christina,9999,0,9999,0
1708250046764,BGGN 271,085,482676,Smith; David M.,9999,0,9999,0
1708250046764,BGGN 271,086,482677,Steinmetz; Nicole F,9999,0,9999,0
1708250046764,BGGN 271,087,482692,Su; Chih-Ying,9999,0,9999,0
1708250046764,BGGN 271,088,482694,Suel; Gurol Mehmet,9999,0,9999,0
1708250046764,BGGN 271,089,482695,Telese; Francesca,9999,0,9999,0
1708250046764,BGGN 271,090,482745,Thackray; Varykina G.,9999,0,9999,0
1708250046764,BGGN 271,091,482746,Towers; Christina Garlingt,9999,0,9999,0
1708250046764,BGGN 271,092,482747,Troemel; Emily Ruth,9997,0,9999,2
1708250046764,BGGN 271,093,482748,Tye; Kay M,9999,0,9999,0
1708250046764,BGGN 271,094,482749,Valdez-Jasso; Daniela,9998,0,9999,1
1708250046764,BGGN 271,095,482750,Wahlin; Karl Jonas,9997,0,9999,2
1708250046764,BGGN 271,096,482751,Welsbie; Derek,9999,0,9999,0
1708250046764,BGGN 271,097,482752,Wilkinson; Miles Frome,9999,0,9999,0
1708250046764,BGGN 271,098,482754,Yaksh; Tony L.,9999,0,9999,0
1708250046764,BGGN 271,099,482760,Yang; Jing,9999,0,9999,0
1708250046764,BGGN 271,100,482761,Yeo; Eugene Wei-Ming,9998,0,9999,1
1708250046764,BGGN 271,101,482763,Ying; Wei,9999,0,9999,0
1708250046764,BGGN 271,102,482764,Zarrinpar; Amir,9999,0,9999,0
1708250046764,BGGN 271,103,482765,Zengler; Karsten B,9999,0,9999,0
1708250046764,BGGN 271,104,482766,Zhang; Dong-Er,9999,0,9999,0
1708250046764,BGGN 271,105,482768,Zhao; Yunde,9999,0,9999,0
1708250046764,BGGN 271,106,482776,Zheng; Binhai,9999,0,9999,0
1708250046764,BGGN 271,107,482777,Zheng; Ye,9998,0,9999,1
1708250046764,BGGN 271,108,482806,Zuniga; Elina I,9999,0,9999,0
1708250047298,BGGN 273,A01,424101,Mueller; Liam O'Connor,43,0,50,7
1708250047825,BGGN 280,A00,424102,Ernst; Andreas,3,0,5,2
1708250047825,BGGN 280,C00,481361,Amaro; Rommie E,2,0,5,3
1708250048351,BGGN 281,A00,424103,Desai; Arshad & Oegema; Karen,0,0,5,5
1708250048878,BGGN 283,A00,424104,Rivera; Fabian Chavez,0,0,5,5
1708250048878,BGGN 283,B00,424105,Russell; Alistair B,4,0,5,1
1708250048878,BGGN 283,D00,424107,Wildonger; Jill Cathleen,1,0,5,4
1708250049405,BGGN 284,A00,424108,Glasgow; Stacey Marie,2,0,5,3
1708250049938,BGGN 285,A00,424109,Chisholm; Andrew D.,1,0,5,4
1708250049938,BGGN 285,B00,424110,Farley; Emma Kristen,2,0,5,3
1708250050465,BGGN 295,A00,424120,Tour; Ella,9,0,30,21
1708250050997,BGJC 204,A00,424138,Lu; Li-Fan & Chang; John Tzu-yu,9998,0,9999,1
1708250051523,BGJC 215,A00,424139,Cooke; James Edward & Lo; Stanley M.,10,0,10,0
1708250052532,BGRD 200,001,485528,Ackerman; Susan,9998,0,9999,1
1708250052532,BGRD 200,002,485529,Akbari; Omar Sultan,9999,0,9999,0
1708250052532,BGRD 200,003,485530,Allen; Eric,9999,0,9999,0
1708250052532,BGRD 200,004,485531,Allen; Nicola J,9999,0,9999,0
1708250052532,BGRD 200,005,485533,Amaro; Rommie E,9999,0,9999,0
1708250052532,BGRD 200,006,485535,Augustine; Vineet,9999,0,9999,0
1708250052532,BGRD 200,007,485536,Ayres; Janelle Samantha,9999,0,9999,0
1708250052532,BGRD 200,008,485538,Banegas; Matthew Patrick,9999,0,9999,0
1708250052532,BGRD 200,009,485539,Banghart; Matthew Ryan,9999,0,9999,0
1708250052532,BGRD 200,010,485542,Benna; Marcus K,9999,0,9999,0
1708250052532,BGRD 200,011,485543,Bennett; Eric J,9999,0,9999,0
1708250052532,BGRD 200,012,485545,Bloodgood; Brenda Laurie,9999,0,9999,0
1708250052532,BGRD 200,013,485546,Breen; Ellen C.,9998,0,9999,1
1708250052532,BGRD 200,014,485548,Briggs; Steven,9998,0,9999,1
1708250052532,BGRD 200,015,485549,Bui; Jack D,9999,0,9999,0
1708250052532,BGRD 200,016,485552,Busch; Wolfgang,9999,0,9999,0
1708250052532,BGRD 200,017,485621,Callaway; Edward M,9999,0,9999,0
1708250052532,BGRD 200,018,485622,Castle; Michael James,9999,0,9999,0
1708250052532,BGRD 200,019,485623,Chaim; Isaac,9999,0,9999,0
1708250052532,BGRD 200,020,485624,Chang; John Tzu-yu,9999,0,9999,0
1708250052532,BGRD 200,021,485625,Chen; Ju,9999,0,9999,0
1708250052532,BGRD 200,022,485626,Chen; Xu,9999,0,9999,0
1708250052532,BGRD 200,023,485627,Cheng; Christine Shiang-Ling,9999,0,9999,0
1708250052532,BGRD 200,024,485632,Cherqui; Stephanie,9999,0,9999,0
1708250052532,BGRD 200,025,485633,Cho; Yoshitake,9999,0,9999,0
1708250052532,BGRD 200,026,485634,Church; Kellie Breen,9999,0,9999,0
1708250052532,BGRD 200,027,485635,Cleland; Elsa Eleanor,9999,0,9999,0
1708250052532,BGRD 200,028,485636,Cohen; Shiran,9998,0,9999,1
1708250052532,BGRD 200,029,485639,Cook-Andersen; Heidi Leigh,9999,0,9999,0
1708250052532,BGRD 200,030,485686,Cooke; James Edward,9999,0,9999,0
1708250052532,BGRD 200,031,485688,Cooper; Kimberly Lynn,9999,0,9999,0
1708250052532,BGRD 200,032,485689,Coufal; Nicole Gabriele,9998,0,9999,1
1708250052532,BGRD 200,033,485690,Crotty Alexander; Laura E,9999,0,9999,0
1708250052532,BGRD 200,034,485691,Staff,9999,0,9999,0
1708250052532,BGRD 200,035,485692,De Guglielmo; Giordano,9999,0,9999,0
1708250052532,BGRD 200,036,485693,De Silva; Shermin,9999,0,9999,0
1708250052532,BGRD 200,037,485694,Desai; Arshad,9999,0,9999,0
1708250052532,BGRD 200,038,485695,Dickinson; Alexandra Jazz,9999,0,9999,0
1708250052532,BGRD 200,039,485717,Doherty; Taylor Alan,9998,0,9999,1
1708250052532,BGRD 200,040,485720,Dulawa; Stephanie Carole,9999,0,9999,0
1708250052532,BGRD 200,041,485721,Ecker; Joseph R,9999,0,9999,0
1708250052532,BGRD 200,042,485760,Engle; Dannielle D,9999,0,9999,0
1708250052532,BGRD 200,043,485761,Ernst; Andreas,9998,0,9999,1
1708250052532,BGRD 200,044,485766,Esko; Jeffrey D.,9998,0,9999,1
1708250052532,BGRD 200,045,485905,Evans; Ronald M,9999,0,9999,0
1708250052532,BGRD 200,046,485907,Staff,9999,0,9999,0
1708250052532,BGRD 200,047,485918,Feldstein; Ariel E,9998,0,9999,1
1708250052532,BGRD 200,048,485938,Friedman; Rick Adam,9999,0,9999,0
1708250052532,BGRD 200,049,485986,Furnari; Frank,9999,0,9999,0
1708250052532,BGRD 200,050,486018,Gage; Fred H,9999,0,9999,0
1708250052532,BGRD 200,051,486139,George; Monique Leana,9999,0,9999,0
1708250052532,BGRD 200,052,486140,Ghosh; Pradipta,9998,0,9999,1
1708250052532,BGRD 200,053,486141,Glass; Christopher,9998,0,9999,1
1708250052532,BGRD 200,054,486142,Gleeson; Joseph Gerard,9999,0,9999,0
1708250052532,BGRD 200,055,486143,Golden; Susan S.,9999,0,9999,0
1708250052532,BGRD 200,056,486144,Goldrath; Ananda,9999,0,9999,0
1708250052532,BGRD 200,057,486145,Goren; Alon M,9998,0,9999,1
1708250052532,BGRD 200,058,486146,Gustafsson; Asa Birgitta,9999,0,9999,0
1708250052532,BGRD 200,059,486164,Gutkind; Jorge Silvio,9999,0,9999,0
1708250052532,BGRD 200,060,486203,Hamdoun; Amr,9999,0,9999,0
1708250052532,BGRD 200,061,486204,Hampton; Randolph Y.,9999,0,9999,0
1708250052532,BGRD 200,062,486205,Hao; Nan,9999,0,9999,0
1708250052532,BGRD 200,063,486206,Staff,9999,0,9999,0
1708250052532,BGRD 200,064,486207,Hasty; Jeff M,9999,0,9999,0
1708250052532,BGRD 200,065,486208,Hollern; Daniel Patrick,9999,0,9999,0
1708250052532,BGRD 200,066,486209,Holway; David A.,9997,0,9999,2
1708250052532,BGRD 200,067,486214,Huffaker; Alisa,9998,0,9999,1
1708250052532,BGRD 200,068,486215,Hui; Enfu,9999,0,9999,0
1708250052532,BGRD 200,069,486216,Hwa; Terence T.,9999,0,9999,0
1708250052532,BGRD 200,070,486217,Sebat; Lilia Mikhailovna,9998,0,9999,1
1708250052532,BGRD 200,071,486218,Ideker; Trey,9999,0,9999,0
1708250052532,BGRD 200,072,486219,Jackrel; Sara,9998,0,9999,1
1708250052532,BGRD 200,073,486224,Jiang; Qingfei,9998,0,9999,1
1708250052532,BGRD 200,074,486225,Jin; Yishi,9999,0,9999,0
1708250052532,BGRD 200,075,486226,Joiner; William J.,9999,0,9999,0
1708250052532,BGRD 200,076,486227,Jun; Suckjoon,9999,0,9999,0
1708250052532,BGRD 200,077,486228,Kadonaga; James T,9998,0,9999,1
1708250052532,BGRD 200,078,486229,Kaech; Susan Michelle,9997,0,9999,2
1708250052532,BGRD 200,079,486237,Karin; Michael,9999,0,9999,0
1708250052532,BGRD 200,080,486238,Kleinfeld; David,9999,0,9999,0
1708250052532,BGRD 200,081,486239,Knight; Robin,9999,0,9999,0
1708250052532,BGRD 200,082,486335,Koffler; Yacov,9999,0,9999,0
1708250052532,BGRD 200,083,486336,Komiyama; Takaki,9999,0,9999,0
1708250052532,BGRD 200,084,486337,Kosuri; Pallav,9999,0,9999,0
1708250052532,BGRD 200,085,486353,Kryazhimskiy; Sergey A,9999,0,9999,0
1708250052532,BGRD 200,086,486354,Kurle; Carolyn M.,9999,0,9999,0
1708250052532,BGRD 200,087,486355,Law; Julie A,9999,0,9999,0
1708250052532,BGRD 200,088,486356,Lawson; Mark Andrew,9999,0,9999,0
1708250052532,BGRD 200,089,486357,Lee; Kuo Fen,9999,0,9999,0
1708250052532,BGRD 200,090,486376,Lee; Yun Sok,9999,0,9999,0
1708250052532,BGRD 200,091,486413,Leutgeb; Jill K.,9999,0,9999,0
1708250052532,BGRD 200,092,486414,Leutgeb; Stefan,9998,0,9999,1
1708250052532,BGRD 200,093,486415,Lim; Byungkook,9999,0,9999,0
1708250052532,BGRD 200,094,486419,Lo; Stanley M.,9999,0,9999,0
1708250052532,BGRD 200,095,486420,Looger; Loren Lee,9999,0,9999,0
1708250052532,BGRD 200,096,486422,Lovett-Barron; Matthew Rod,9999,0,9999,0
1708250052532,BGRD 200,097,486423,Lu; Li-Fan,9998,0,9999,1
1708250052532,BGRD 200,098,486424,Lu; Pengzhe,9998,0,9999,1
1708250052532,BGRD 200,099,486425,Lykke-Andersen; Jens,9998,0,9999,1
1708250052532,BGRD 200,100,486426,Lyumkis; Dmitry Evgenievich,9999,0,9999,0
1708250052532,BGRD 200,101,486427,Madigan; Cressida Ariana,9999,0,9999,0
1708250052532,BGRD 200,102,486428,Staff,9999,0,9999,0
1708250052532,BGRD 200,103,486429,Mayfield; Stephen P.,9998,0,9999,1
1708250052532,BGRD 200,104,486430,McDonnell; Lisa Marie,9999,0,9999,0
1708250052532,BGRD 200,105,486620,McHugh; Colleen A,9998,0,9999,1
1708250052532,BGRD 200,106,486621,Meharena; Hiruy Sibhatu,9999,0,9999,0
1708250052532,BGRD 200,107,486622,Staff,9999,0,9999,0
1708250052532,BGRD 200,108,486681,Morris; Gerald P,9999,0,9999,0
1708250052532,BGRD 200,109,486682,Mukamel; Eran A,9998,0,9999,1
1708250052532,BGRD 200,110,486683,Muotri; Alysson,9999,0,9999,0
1708250052532,BGRD 200,111,486684,Muroyama; Andrew David,9999,0,9999,0
1708250052532,BGRD 200,112,486687,Murre; Cornelis,9999,0,9999,0
1708250052532,BGRD 200,113,486691,Neal; Sonya E,9999,0,9999,0
1708250052532,BGRD 200,114,486692,Nieh; James Charles,9998,0,9999,1
1708250052532,BGRD 200,115,486693,Nimmerjahn; Axel,9999,0,9999,0
1708250052532,BGRD 200,116,486694,Nizet; Victor F.,9999,0,9999,0
1708250052532,BGRD 200,117,486695,O'Donoghue; Anthony John,9999,0,9999,0
1708250052532,BGRD 200,118,486706,Oegema; Karen,9999,0,9999,0
1708250052532,BGRD 200,119,486708,O'Shea; Clodagh,9999,0,9999,0
1708250052532,BGRD 200,120,486709,Pantham; Priyadarshini,9999,0,9999,0
1708250052532,BGRD 200,121,486715,Parast; Mana,9999,0,9999,0
1708250052532,BGRD 200,122,486716,Pasquinelli; Amy,9998,0,9999,1
1708250052532,BGRD 200,123,486718,Pekkurnaz Banghart; Gulcin,9999,0,9999,0
1708250052532,BGRD 200,124,486720,Perry; Michael William,9999,0,9999,0
1708250052532,BGRD 200,125,486721,Pfaff; Samuel,9999,0,9999,0
1708250052532,BGRD 200,126,486723,Pogliano; Joseph,9999,0,9999,0
1708250052532,BGRD 200,127,486724,Pogliano; Kit J.,9999,0,9999,0
1708250052532,BGRD 200,128,486727,Pride; David Tevis,9999,0,9999,0
1708250052532,BGRD 200,129,486728,Pruneda-Paz; Jose L.,9999,0,9999,0
1708250052532,BGRD 200,130,486733,Staff,9999,0,9999,0
1708250052532,BGRD 200,131,486734,Rana; Tariq,9999,0,9999,0
1708250052532,BGRD 200,132,486736,Reck-Peterson; Samara L,9999,0,9999,0
1708250052532,BGRD 200,133,486738,Rennison; Diana,9999,0,9999,0
1708250052532,BGRD 200,134,486741,Rifkin; Scott,9999,0,9999,0
1708250052532,BGRD 200,135,486743,Risbrough; Victoria Blythe,9999,0,9999,0
1708250052532,BGRD 200,136,486749,Rissman; Robert Andrew,9999,0,9999,0
1708250052532,BGRD 200,137,486750,Rivera; Fabian Chavez,9999,0,9999,0
1708250052532,BGRD 200,138,486753,Root; Cory Matthew,9999,0,9999,0
1708250052532,BGRD 200,139,486760,Rosenfeld; Michael G,9998,0,9999,1
1708250052532,BGRD 200,140,486763,Russell; Alistair B,9999,0,9999,0
1708250052532,BGRD 200,141,486766,Saier; Milton H.,9999,0,9999,0
1708250052532,BGRD 200,142,486768,Sander; Maike,9999,0,9999,0
1708250052532,BGRD 200,143,486770,Saphire; Erica Ollmann,9999,0,9999,0
1708250052532,BGRD 200,144,486771,Schenk; Simon,9999,0,9999,0
1708250052532,BGRD 200,145,486774,Schoeneberg; Johannes,9999,0,9999,0
1708250052532,BGRD 200,146,486777,Schroeder; Julian I,9998,0,9999,1
1708250052532,BGRD 200,147,486783,Shah; Sameer B,9999,0,9999,0
1708250052532,BGRD 200,148,486784,Shaner; Nathan C.,9999,0,9999,0
1708250052532,BGRD 200,149,486785,Shaw; Reuben,9999,0,9999,0
1708250052532,BGRD 200,150,486786,Sheikh; Farah,9999,0,9999,0
1708250052532,BGRD 200,151,486787,Staff,9999,0,9999,0
1708250052532,BGRD 200,152,486788,Signer; Robert,9999,0,9999,0
1708250052532,BGRD 200,153,486789,Sigurdson; Christina,9999,0,9999,0
1708250052532,BGRD 200,154,486790,Smith; David M.,9999,0,9999,0
1708250052532,BGRD 200,155,486791,Soncin; Francesca,9999,0,9999,0
1708250052532,BGRD 200,156,486792,Steinmetz; Nicole F,9999,0,9999,0
1708250052532,BGRD 200,157,486793,Su; Chih-Ying,9999,0,9999,0
1708250052532,BGRD 200,158,486794,Suel; Gurol Mehmet,9999,0,9999,0
1708250052532,BGRD 200,159,486795,Sun; Xin,9999,0,9999,0
1708250052532,BGRD 200,160,486796,Telese; Francesca,9999,0,9999,0
1708250052532,BGRD 200,161,486797,Thackray; Varykina G.,9999,0,9999,0
1708250052532,BGRD 200,162,486798,Towers; Christina Garlingt,9999,0,9999,0
1708250052532,BGRD 200,163,486799,Traver; David,9999,0,9999,0
1708250052532,BGRD 200,164,486800,Troemel; Emily Ruth,9998,0,9999,1
1708250052532,BGRD 200,165,486801,Tye; Kay M,9999,0,9999,0
1708250052532,BGRD 200,166,486802,Valdez-Jasso; Daniela,9998,0,9999,1
1708250052532,BGRD 200,167,486803,Vijayanand; Pandurangan,9999,0,9999,0
1708250052532,BGRD 200,168,486804,Villa Rodriguez; Elizabeth,9999,0,9999,0
1708250052532,BGRD 200,169,486805,Wahlin; Karl Jonas,9997,0,9999,2
1708250052532,BGRD 200,170,486806,Wang; Jean Yin Jen,9999,0,9999,0
1708250052532,BGRD 200,171,486807,Welsbie; Derek,9999,0,9999,0
1708250052532,BGRD 200,172,486808,Wildonger; Jill Cathleen,9998,0,9999,1
1708250052532,BGRD 200,173,486809,Wilkinson; Miles Frome,9999,0,9999,0
1708250052532,BGRD 200,174,486810,Winzeler; Elizabeth A,9999,0,9999,0
1708250052532,BGRD 200,175,486811,Yaksh; Tony L.,9999,0,9999,0
1708250052532,BGRD 200,176,486812,Yang; Jing,9999,0,9999,0
1708250052532,BGRD 200,177,486813,Staff,9999,0,9999,0
1708250052532,BGRD 200,178,486814,Yeo; Eugene Wei-Ming,9998,0,9999,1
1708250052532,BGRD 200,179,486815,Ying; Wei,9999,0,9999,0
1708250052532,BGRD 200,180,486816,Zarrinpar; Amir,9999,0,9999,0
1708250052532,BGRD 200,181,486817,Zengler; Karsten B,9999,0,9999,0
1708250052532,BGRD 200,182,486818,Zhang; Dong-Er,9999,0,9999,0
1708250052532,BGRD 200,183,486819,Zhao; Yunde,9999,0,9999,0
1708250052532,BGRD 200,184,486820,Zheng; Binhai,9999,0,9999,0
1708250052532,BGRD 200,185,486821,Zheng; Ye,9998,0,9999,1
1708250052532,BGRD 200,186,486822,Zuniga; Elina I,9999,0,9999,0
1708250053059,BGSE 200,A00,424140,Tour; Ella & Petrie; Katherine Lynn,9995,0,9999,4
1708250053590,BGSE 205,A00,424177,Bennett; Eric J,49,0,50,1
1708250053590,BGSE 205,B00,424179,Bennett; Eric J,48,0,50,2
1708250053590,BGSE 205,C00,424182,Bennett; Eric J,47,0,50,3
1708250053590,BGSE 205,D00,424184,Bennett; Eric J,46,0,50,4
1708250053590,BGSE 205,E00,424185,Bennett; Eric J,50,0,50,0
1708250054135,BIBC 100,A01,425401,Corbett; Kevin Daniel,150,0,158,8
1708250054135,BIBC 100,B01,477769,Amaro; Rommie E,156,0,158,2
1708250055680,BIBC 102,A01,425425,Bozinovic; Goran,255,0,256,1
1708250055680,BIBC 102,B01,425440,Hampton; Randolph Y.,250,0,256,6
1708250055680,BIBC 102,C01,486849,Flagg; Matthew Paul,62,0,120,58
1708250056248,BIBC 103,A01,425476,Grossman; Emily N,17,0,24,7
1708250056248,BIBC 103,A02,425509,Grossman; Emily N,21,0,24,3
1708250056248,BIBC 103,A03,425530,Grossman; Emily N,18,0,24,6
1708250056248,BIBC 103,A04,425536,Grossman; Emily N,22,0,24,2
1708250056248,BIBC 103,B01,425538,Boumechache; Miyyada,20,0,24,4
1708250056248,BIBC 103,B02,425539,Boumechache; Miyyada,24,0,24,0
1708250056248,BIBC 103,B03,425548,Boumechache; Miyyada,24,0,24,0
1708250056248,BIBC 103,B04,425549,Boumechache; Miyyada,24,0,24,0
1708250056777,BIBC 120,A01,425592,Coleman; Aaron B.,242,0,256,14
1708250057309,BIBC 194,A00,425609,Ernst; Andreas,21,0,27,6
1708250057309,BIBC 194,B00,477632,Saier; Milton H.,26,0,27,1
1708250057309,BIBC 194,C00,481360,Amaro; Rommie E,23,0,27,4
1708250057309,BIBC 194,D00,486852,Flagg; Matthew Paul,21,0,32,11
1708250058123,BICD 100,A01,470377,Troemel; Emily Ruth,127,0,128,1
1708250058123,BICD 100,A02,470378,Troemel; Emily Ruth,126,0,128,2
1708250058123,BICD 100,B01,470409,Reinagel; Pam,59,0,64,5
1708250058123,BICD 100,B02,470413,Reinagel; Pam,62,0,64,2
1708250058123,BICD 100,B03,470464,Reinagel; Pam,64,0,64,0
1708250058123,BICD 100,B04,470468,Reinagel; Pam,63,0,64,1
1708250058123,BICD 100,C01,470469,Beyhan; Sinem,51,0,64,13
1708250058123,BICD 100,C02,470605,Beyhan; Sinem,58,0,64,6
1708250058123,BICD 100,C03,470606,Beyhan; Sinem,60,0,64,4
1708250058123,BICD 100,C04,470607,Beyhan; Sinem,63,0,64,1
1708250058123,BICD 100,D01,477465,Nguyen; Vu Quang,158,0,160,2
1708250058659,BICD 100R,A01,425674,Smith; Laurie,29,0,34,5
1708250058659,BICD 100R,A02,425675,Smith; Laurie,30,0,34,4
1708250058659,BICD 100R,A03,425676,Smith; Laurie,30,0,34,4
1708250059202,BICD 104,A01,425696,Greenspan; Ralph J.,60,0,64,4
1708250059751,BICD 110,A01,470608,Muroyama; Andrew David,264,0,275,11
1708250059751,BICD 110,B01,425721,Ernst; Andreas,245,0,275,30
1708250060280,BICD 112,A01,458177,Cooper; Kimberly Lynn & Traver; David,10,0,32,22
1708250060280,BICD 112,A02,458180,Cooper; Kimberly Lynn & Traver; David,28,0,32,4
1708250060810,BICD 123,A01,425725,Zhao; Yunde,24,0,32,8
1708250061338,BICD 140,A01,425728,Lu; Li-Fan,227,0,240,13
1708250061866,BICD 158,A01,425730,Bier; Ethan,136,0,145,9
1708250062399,BICD 194,A00,425731,Desai; Arshad & Oegema; Karen,18,0,27,9
1708250062399,BICD 194,B00,481735,Wilhelm; James E.,29,0,32,3
1708250062925,BIEB 121,A00,425732,Butler; Shannon Rhey,21,0,32,11
1708250062925,BIEB 121,B00,425733,Butler; Shannon Rhey,24,0,32,8
1708250063458,BIEB 130,A01,425735,Kurle; Carolyn M.,243,0,295,52
1708250063984,BIEB 146,A01,425737,Petrie; Katherine Lynn,366,0,395,29
1708250064516,BIEB 148,A01,470637,Rose; Noah Hartmann,59,0,63,4
1708250064516,BIEB 148,A02,470638,Rose; Noah Hartmann,61,0,63,2
1708250065045,BIEB 154,A01,458184,Stockwell; Sarah R,29,0,30,1
1708250065045,BIEB 154,A02,458186,Stockwell; Sarah R,29,0,30,1
1708250065577,BIEB 176,A01,425741,De Silva; Shermin,56,0,64,8
1708250066106,BIEB 182,A01,458194,Roy; Kaustuv,25,0,32,7
1708250066106,BIEB 182,A02,458215,Roy; Kaustuv,31,0,32,1
1708250066638,BILD 1,A01,424267,Patrick; Gentry,249,0,250,1
1708250066638,BILD 1,B01,424272,Burg; Michael,231,0,250,19
1708250066638,BILD 1,C01,424293,Pickett; Brooke Elizabeth,245,0,250,5
1708250066638,BILD 1,D01,458292,Gonzalez Gamboa; Ivonne,48,0,50,2
1708250066638,BILD 1,D02,458295,Gonzalez Gamboa; Ivonne,50,0,50,0
1708250066638,BILD 1,D03,458296,Gonzalez Gamboa; Ivonne,50,0,50,0
1708250066638,BILD 1,D04,458297,Gonzalez Gamboa; Ivonne,49,0,50,1
1708250066638,BILD 1,D05,458303,Gonzalez Gamboa; Ivonne,50,0,50,0
1708250067168,BILD 2,A01,458304,Reyes Gonzalez; Catalina,53,0,56,3
1708250067168,BILD 2,A02,458307,Reyes Gonzalez; Catalina,55,0,56,1
1708250067168,BILD 2,A03,458313,Reyes Gonzalez; Catalina,55,0,56,1
1708250067168,BILD 2,A04,458320,Reyes Gonzalez; Catalina,56,0,56,0
1708250067168,BILD 2,B01,458324,Reyes Gonzalez; Catalina,47,0,56,9
1708250067168,BILD 2,B02,458327,Reyes Gonzalez; Catalina,54,0,56,2
1708250067168,BILD 2,B03,458339,Reyes Gonzalez; Catalina,56,0,56,0
1708250067168,BILD 2,B04,458340,Reyes Gonzalez; Catalina,56,0,56,0
1708250067168,BILD 2,C01,458387,Park; Ji Young,44,0,49,5
1708250067168,BILD 2,C02,458544,Park; Ji Young,46,0,49,3
1708250067168,BILD 2,C03,458557,Park; Ji Young,47,0,49,2
1708250067168,BILD 2,C04,458563,Park; Ji Young,46,0,49,3
1708250067712,BILD 3,A01,424312,Hammond; LaTisha Marie,331,0,350,19
1708250067712,BILD 3,B01,470107,Stockwell; Sarah R,66,0,70,4
1708250067712,BILD 3,B02,470110,Stockwell; Sarah R,70,0,70,0
1708250067712,BILD 3,B03,470116,Stockwell; Sarah R,70,0,70,0
1708250067712,BILD 3,B04,470123,Stockwell; Sarah R,67,0,70,3
1708250067712,BILD 3,B05,470150,Stockwell; Sarah R,70,0,70,0
1708250067712,BILD 3,C01,470159,Cooper; Kimberly Lynn,67,0,70,3
1708250067712,BILD 3,C02,470160,Cooper; Kimberly Lynn,69,0,70,1
1708250067712,BILD 3,C03,470164,Cooper; Kimberly Lynn,70,0,70,0
1708250067712,BILD 3,C04,470165,Cooper; Kimberly Lynn,69,0,70,1
1708250067712,BILD 3,C05,470374,Cooper; Kimberly Lynn,68,0,70,2
1708250068269,BILD 4,A01,424318,Staff,22,0,24,2
1708250068269,BILD 4,A02,424324,Staff,24,0,24,0
1708250068269,BILD 4,A03,424325,Staff,24,0,24,0
1708250068269,BILD 4,A04,424326,Staff,22,0,24,2
1708250068269,BILD 4,A05,424327,Staff,24,0,24,0
1708250068269,BILD 4,A06,424330,Staff,24,0,24,0
1708250068269,BILD 4,A07,424331,Staff,24,0,24,0
1708250068269,BILD 4,A08,424342,Staff,24,0,24,0
1708250068269,BILD 4,B01,424462,Pickett; Brooke Elizabeth,23,0,24,1
1708250068269,BILD 4,B02,424466,Pickett; Brooke Elizabeth,24,0,24,0
1708250068269,BILD 4,B03,424469,Pickett; Brooke Elizabeth,23,0,24,1
1708250068269,BILD 4,B04,424470,Pickett; Brooke Elizabeth,22,0,24,2
1708250068269,BILD 4,B05,424700,Pickett; Brooke Elizabeth,23,0,24,1
1708250068269,BILD 4,B06,424723,Pickett; Brooke Elizabeth,24,0,24,0
1708250068269,BILD 4,B07,424730,Pickett; Brooke Elizabeth,24,0,24,0
1708250068269,BILD 4,B08,424929,Pickett; Brooke Elizabeth,22,0,24,2
1708250068269,BILD 4,C01,424947,Gonzalez Gamboa; Ivonne,22,0,24,2
1708250068269,BILD 4,C02,424951,Gonzalez Gamboa; Ivonne,23,0,24,1
1708250068269,BILD 4,C03,424991,Gonzalez Gamboa; Ivonne,23,0,24,1
1708250068269,BILD 4,C04,424993,Gonzalez Gamboa; Ivonne,24,0,24,0
1708250068269,BILD 4,C05,424994,Gonzalez Gamboa; Ivonne,24,0,24,0
1708250068269,BILD 4,C06,425209,Gonzalez Gamboa; Ivonne,24,0,24,0
1708250068269,BILD 4,C07,425233,Gonzalez Gamboa; Ivonne,24,0,24,0
1708250068269,BILD 4,C08,425247,Gonzalez Gamboa; Ivonne,24,0,24,0
1708250068800,BILD 60,A01,425326,Hammond; LaTisha Marie,62,0,64,2
1708250069326,BILD 83,A00,425347,Pogliano; Joseph,25,0,30,5
1708250069854,BILD 87,A00,425368,Saier; Milton H.,20,0,20,0
1708250070387,BIMM 100,A01,425744,Cooper; Andrew Michael,303,0,320,17
1708250070387,BIMM 100,B01,425746,Cooper; Andrew Michael,315,0,320,5
1708250070957,BIMM 101,A01,425748,McDonnell; Lisa Marie,8,0,24,16
1708250070957,BIMM 101,A02,425749,McDonnell; Lisa Marie,23,0,24,1
1708250070957,BIMM 101,B01,425751,Day; Christopher D,22,0,24,2
1708250070957,BIMM 101,B02,425752,Day; Christopher D,24,0,24,0
1708250070957,BIMM 101,B03,425753,Day; Christopher D,22,0,24,2
1708250070957,BIMM 101,B04,425754,Day; Christopher D,24,0,24,0
1708250070957,BIMM 101,C01,425756,Rusert; Jessica Marie,16,0,24,8
1708250070957,BIMM 101,C02,425757,Rusert; Jessica Marie,23,0,24,1
1708250070957,BIMM 101,C03,425758,Rusert; Jessica Marie,23,0,24,1
1708250070957,BIMM 101,C04,425759,Rusert; Jessica Marie,23,0,24,1
1708250071484,BIMM 110,A01,425764,Niwa; Maho,55,0,56,1
1708250071484,BIMM 110,A02,425765,Niwa; Maho,56,0,56,0
1708250071484,BIMM 110,A03,425766,Niwa; Maho,56,0,56,0
1708250071484,BIMM 110,A04,425767,Niwa; Maho,55,0,56,1
1708250072012,BIMM 116R,A01,425771,Golden; Susan S. & Gorman; Michael R.,55,0,72,17
1708250072012,BIMM 116R,A02,425772,Golden; Susan S. & Gorman; Michael R.,53,0,72,19
1708250072012,BIMM 116R,A03,425773,Golden; Susan S. & Gorman; Michael R.,66,0,72,6
1708250072012,BIMM 116R,A04,425774,Golden; Susan S. & Gorman; Michael R.,70,0,72,2
1708250072538,BIMM 118,A01,425779,David; Michael,83,0,96,13
1708250073073,BIMM 120,A01,425792,Pirino; Giorgia,203,0,216,13
1708250073073,BIMM 120,B01,470639,Saier; Milton H.,201,0,216,15
1708250073682,BIMM 121,A01,425830,Gustafson-Brown; Cindy,18,0,24,6
1708250073682,BIMM 121,A02,425831,Gustafson-Brown; Cindy,21,0,24,3
1708250073682,BIMM 121,A03,425832,Gustafson-Brown; Cindy,24,0,24,0
1708250073682,BIMM 121,A04,425833,Gustafson-Brown; Cindy,23,0,24,1
1708250073682,BIMM 121,B01,425835,Pirino; Giorgia,18,0,24,6
1708250073682,BIMM 121,B02,425836,Pirino; Giorgia,24,0,24,0
1708250073682,BIMM 121,C01,425838,Park; Ji Young,6,0,24,18
1708250073682,BIMM 121,C02,425839,Park; Ji Young,20,0,24,4
1708250074208,BIMM 134,A01,425841,Burg; Michael,393,0,416,23
1708250074736,BIMM 143,A01,425843,Grant; Barry J,17,0,40,23
1708250074736,BIMM 143,B01,425845,Bozinovic; Goran,33,0,40,7
1708250075270,BIMM 182,A01,455012,Bafna; Vineet,28,0,50,22
1708250075806,BIMM 194,A00,425847,Rivera; Fabian Chavez,24,0,27,3
1708250075806,BIMM 194,B00,425868,Russell; Alistair B,16,0,27,11
1708250075806,BIMM 194,D00,425870,Wildonger; Jill Cathleen,14,0,27,13
1708250076338,BIOM 202,A00,390710,Corbett; Kevin Daniel,93,0,100,7
1708250076866,BIOM 219,A00,390713,Ross; Camille,0,0,0,7
1708250077393,BIOM 231,A00,455099,Furnari; Frank,0,0,0,0
1708250077393,BIOM 231,B00,455100,Lopez Ramirez; Miguel Alej,0,0,0,0
1708250077923,BIOM 242,A00,390714,Hamilton; Bruce Alan,20,0,20,0
1708250078454,BIOM 246,A00,492784,Gordts; Philip & Varki; Ajit P & Lewis; Amanda Lark & Godula; Kamil & Gagneux; Pascal & Esko; Jeffrey D. & Bode; Lars,0,0,0,0
1708250078986,BIOM 252,A00,390715,Ayyagari; Radha,27,0,28,1
1708250079515,BIOM 254,A00,390718,Corbett; Kevin Daniel,14,0,20,6
1708250080042,BIOM 272,A00,390722,Hangauer; Matthew John,16,0,20,4
1708250080569,BIOM 274,A00,390725,Sun; Bryan Kee-Hong,7,0,15,8
1708250081100,BIOM 283,A00,390728,Komives; Elizabeth A,2,0,2,0
1708250081631,BIOM 285,A00,390730,Gaulton; Kyle J,10,0,20,10
1708250082156,BIOM 295,A00,455083,Brown; Joan Heller,0,0,0,0
1708250082687,BIPN 100,A01,425872,Augustine; Vineet,240,0,245,5
1708250082687,BIPN 100,B01,425874,George; Monique Leana,240,0,245,5
1708250082687,BIPN 100,C01,458640,Maita; Isabella Vincenza,44,0,49,5
1708250082687,BIPN 100,C02,458646,Maita; Isabella Vincenza,48,0,49,1
1708250082687,BIPN 100,C03,458714,Maita; Isabella Vincenza,48,0,49,1
1708250082687,BIPN 100,C04,458716,Maita; Isabella Vincenza,48,0,49,1
1708250082687,BIPN 100,C05,458717,Maita; Isabella Vincenza,46,0,49,3
1708250083215,BIPN 105,A01,425877,Armour; Jon Christopher,12,0,21,9
1708250083215,BIPN 105,A02,425878,Armour; Jon Christopher,21,0,21,0
1708250083215,BIPN 105,A03,425879,Armour; Jon Christopher,10,0,21,11
1708250083215,BIPN 105,A04,425880,Armour; Jon Christopher,20,0,21,1
1708250083746,BIPN 120,A01,425882,Cooke; James Edward,371,0,395,24
1708250084276,BIPN 140,A01,425884,Hibbs; Ryan E.,183,0,192,9
1708250084806,BIPN 144,A01,425886,Zou; Yimin,153,0,158,5
1708250085341,BIPN 145,A01,425888,Maita; Isabella Vincenza,41,0,42,1
1708250085341,BIPN 145,B01,425918,Marino; Marc J,37,0,42,5
1708250085341,BIPN 145,B02,425954,Marino; Marc J,40,0,42,2
1708250085869,BIPN 147,A01,426086,Sejnowski; Terrence J,53,0,64,11
1708250086396,BIPN 152,A01,426112,Halpain; Shelley,97,0,128,31
1708250086923,BIPN 162,A01,426120,Juavinett; Ashley Lauren,17,0,30,13
1708250087457,BIPN 164,A01,455010,Benna; Marcus K & Aljadeff; Johnatan,120,0,120,0
1708250087985,BIPN 194,A00,426122,Glasgow; Stacey Marie,20,0,27,7
1708250088517,BISP 170,A00,426158,French; Kathleen Ann,26,0,30,4
1708250089045,BISP 182,A00,426168,Pogliano; Joseph,9999,0,9999,0
1708250089573,BISP 194,A00,426240,Chisholm; Andrew D.,11,0,27,16
1708250089573,BISP 194,B00,426241,Farley; Emma Kristen,25,0,27,2
1708250090107,BNFO 281,A00,427175,Gaasterland; Theresa,85,0,100,15
1708250090639,BNFO 283,A00,427211,Carter; Hannah Kathryn & Chavez; Alejandro,39,0,50,11
1708250090639,BNFO 283,B00,480483,Amariuta-Bartell; Tiffany & Dorrestein; Pieter,21,0,30,9
1708250091165,BNFO 294,B01,427269,Ross; Camille,47,0,50,3
1708250091707,CAT 3,A01,396994,Glaser; Amelia,15,0,15,0
1708250091707,CAT 3,A02,396995,Glaser; Amelia,15,0,15,0
1708250091707,CAT 3,A03,396996,Glaser; Amelia,7,0,15,8
1708250091707,CAT 3,A04,396997,Glaser; Amelia,12,0,15,3
1708250091707,CAT 3,A05,397004,Glaser; Amelia,15,0,15,0
1708250091707,CAT 3,A06,397039,Glaser; Amelia,11,0,15,4
1708250091707,CAT 3,A07,397040,Glaser; Amelia,13,0,15,2
1708250091707,CAT 3,A08,397084,Glaser; Amelia,15,0,15,0
1708250091707,CAT 3,A09,397269,Glaser; Amelia,13,0,15,2
1708250091707,CAT 3,A10,397270,Glaser; Amelia,0,0,15,15
1708250091707,CAT 3,A11,397271,Glaser; Amelia,9,0,15,6
1708250091707,CAT 3,A12,397272,Glaser; Amelia,12,0,15,3
1708250091707,CAT 3,A13,397273,Glaser; Amelia,15,0,15,0
1708250091707,CAT 3,A14,397274,Glaser; Amelia,14,0,15,1
1708250091707,CAT 3,B01,397276,Porter; Lisa,15,0,15,0
1708250091707,CAT 3,B02,397277,Porter; Lisa,15,0,15,0
1708250091707,CAT 3,B03,397278,Porter; Lisa,14,0,15,1
1708250091707,CAT 3,B04,397279,Porter; Lisa,15,0,15,0
1708250091707,CAT 3,B06,397281,Porter; Lisa,15,0,15,0
1708250091707,CAT 3,B07,397291,Porter; Lisa,15,0,15,0
1708250091707,CAT 3,B09,397293,Porter; Lisa,15,0,15,0
1708250091707,CAT 3,B10,397294,Porter; Lisa,15,0,15,0
1708250091707,CAT 3,B11,397295,Porter; Lisa,12,0,15,3
1708250091707,CAT 3,B12,397296,Porter; Lisa,14,0,15,1
1708250091707,CAT 3,B13,397297,Porter; Lisa,11,0,15,4
1708250091707,CAT 3,B14,397298,Porter; Lisa,15,0,15,0
1708250091707,CAT 3,B15,397299,Porter; Lisa,15,0,15,0
1708250091707,CAT 3,B16,397300,Porter; Lisa,15,0,15,0
1708250091707,CAT 3,C01,397302,Marchisotto; Jennifer Anne,13,0,15,2
1708250091707,CAT 3,C02,397308,Marchisotto; Jennifer Anne,9,0,15,6
1708250091707,CAT 3,C03,397309,Marchisotto; Jennifer Anne,9,0,15,6
1708250091707,CAT 3,C04,397315,Marchisotto; Jennifer Anne,11,0,15,4
1708250091707,CAT 3,C05,397316,Marchisotto; Jennifer Anne,14,0,15,1
1708250091707,CAT 3,C06,397322,Marchisotto; Jennifer Anne,15,0,15,0
1708250091707,CAT 3,C07,397323,Marchisotto; Jennifer Anne,15,0,15,0
1708250091707,CAT 3,C08,397329,Marchisotto; Jennifer Anne,15,0,15,0
1708250091707,CAT 3,C09,397333,Marchisotto; Jennifer Anne,15,0,15,0
1708250091707,CAT 3,C10,397336,Marchisotto; Jennifer Anne,15,0,15,0
1708250091707,CAT 3,C11,397354,Marchisotto; Jennifer Anne,13,0,15,2
1708250091707,CAT 3,C12,397357,Marchisotto; Jennifer Anne,15,0,15,0
1708250091707,CAT 3,C13,397364,Marchisotto; Jennifer Anne,14,0,15,1
1708250091707,CAT 3,C14,397367,Marchisotto; Jennifer Anne,14,0,15,1
1708250091707,CAT 3,C15,397369,Marchisotto; Jennifer Anne,15,0,15,0
1708250091707,CAT 3,C16,397373,Marchisotto; Jennifer Anne,15,0,15,0
1708250091707,CAT 3,C17,397374,Marchisotto; Jennifer Anne,15,0,15,0
1708250091707,CAT 3,C18,397380,Marchisotto; Jennifer Anne,14,0,15,1
1708250091707,CAT 3,D02,397405,Rahimi; Babak,13,0,15,2
1708250091707,CAT 3,D03,397408,Rahimi; Babak,14,0,15,1
1708250091707,CAT 3,D04,397415,Rahimi; Babak,15,0,15,0
1708250091707,CAT 3,D05,397416,Rahimi; Babak,15,0,15,0
1708250091707,CAT 3,D06,397422,Rahimi; Babak,15,0,15,0
1708250091707,CAT 3,D07,397426,Rahimi; Babak,14,0,15,1
1708250091707,CAT 3,D09,397447,Rahimi; Babak,11,0,15,4
1708250091707,CAT 3,D10,397450,Rahimi; Babak,13,0,15,2
1708250091707,CAT 3,D11,397625,Rahimi; Babak,13,0,15,2
1708250091707,CAT 3,D12,397630,Rahimi; Babak,15,0,15,0
1708250091707,CAT 3,D13,397631,Rahimi; Babak,14,0,15,1
1708250091707,CAT 3,D14,397635,Rahimi; Babak,14,0,15,1
1708250092238,CAT 3CE,A01,397642,Bronstein; Phoebe Malan,25,0,25,0
1708250092768,CAT 87,A00,397645,Bronstein; Phoebe Malan,19,0,20,1
1708250093294,CAT 90,A00,480731,Bronstein; Phoebe Malan,20,0,20,0
1708250093826,CAT 124,A01,397662,Knight; Amy,5,0,5,0
1708250093826,CAT 124,A02,397722,Knight; Amy,5,0,5,0
1708250093826,CAT 124,A03,397726,Knight; Amy,5,0,5,0
1708250093826,CAT 124,A04,397829,Knight; Amy,4,0,5,1
1708250094380,CAT 125,001,397832,Popko; Elizabeth Ashley,20,0,20,0
1708250094380,CAT 125,002,397833,Delaville; Romain,20,0,20,0
1708250094380,CAT 125,003,397834,Marchisotto; Jennifer Anne,18,0,20,2
1708250094380,CAT 125,004,397835,Bigham; David Joseph,20,0,20,0
1708250094380,CAT 125,005,397836,Bigham; David Joseph,19,0,20,1
1708250094380,CAT 125,006,397837,Bigham; David Joseph,16,0,20,4
1708250094380,CAT 125,007,397838,Vanderschuit; Maya Alysia,20,0,20,0
1708250094380,CAT 125,008,397839,Vanderschuit; Maya Alysia,20,0,20,0
1708250094380,CAT 125,009,397840,Vanderschuit; Maya Alysia,20,0,20,0
1708250094380,CAT 125,010,397841,Morales; Celeste Georgianna,15,0,16,1
1708250094380,CAT 125,011,397842,Morales; Celeste Georgianna,16,0,16,0
1708250094380,CAT 125,012,397881,Morales; Celeste Georgianna,19,0,20,1
1708250094380,CAT 125,013,397954,Rose; Becca Rae,18,0,20,2
1708250094380,CAT 125,014,397956,Rose; Becca Rae,20,0,20,0
1708250094380,CAT 125,015,397998,Rose; Becca Rae,19,0,20,1
1708250094380,CAT 125,016,397999,Tosun; Adriana,20,0,20,0
1708250094380,CAT 125,017,398001,Tosun; Adriana,20,0,20,0
1708250094380,CAT 125,018,398009,Irwin; Matthew Joseph,19,0,20,1
1708250094380,CAT 125,019,398010,Irwin; Matthew Joseph,18,0,20,2
1708250094380,CAT 125,020,398014,Irwin; Matthew Joseph,20,0,20,0
1708250094920,CAT 125R,A00,398015,Smith; Lauryn Alissa,19,0,20,1
1708250094920,CAT 125R,B00,398016,Smith; Lauryn Alissa,17,0,20,3
1708250094920,CAT 125R,C00,398017,Smith; Lauryn Alissa,19,0,20,1
1708250094920,CAT 125R,D00,398019,Tosun; Adriana,19,0,20,1
1708250094920,CAT 125R,E00,398020,Hyland; Tina Mae,12,0,20,8
1708250094920,CAT 125R,F00,398027,Hyland; Tina Mae,18,0,20,2
1708250094920,CAT 125R,G00,398028,Hyland; Tina Mae,18,0,20,2
1708250095454,CCE 1,A01,396087,Kenley Grounds; Nicole,40,0,40,0
1708250095454,CCE 1,B01,396142,Quijada; David,39,0,40,1
1708250095454,CCE 1,C01,396159,Bigley; Michele Heather,39,0,40,1
1708250095454,CCE 1,D01,396164,Bigley; Michele Heather,40,0,40,0
1708250095454,CCE 1,E01,396166,Lee; Kassandra,40,0,40,0
1708250095454,CCE 1,F01,396168,Lee; Kassandra,40,0,40,0
1708250095454,CCE 1,G01,396170,Staff,40,0,40,0
1708250095454,CCE 1,H01,396172,Staff,40,0,40,0
1708250095988,CENG 101B,A00,392993,Chen; Shaochen,44,0,45,1
1708250096520,CENG 101C,A00,392997,Li; Yanran,148,0,150,2
1708250097049,CENG 113,A00,393000,Chen; Zheng,69,0,70,1
1708250097049,CENG 113,B00,393001,Li; Wan-Lu,69,0,70,1
1708250097577,CENG 124B,A00,393036,Powell; Alyssa & Russ; Benjamin Edward,113,0,120,7
1708250098108,CENG 157,A00,393220,Opatkiewicz; Justin Paul,50,0,57,7
1708250098636,CENG 160,A00,393231,Powell; Alyssa,70,0,80,10
1708250099168,CENG 170,A01,393238,Drews; Aaron,27,0,30,3
1708250099699,CENG 175,A00,393239,Steinmetz; Nicole F,34,0,35,1
1708250100227,CENG 176B,A01,393285,Opatkiewicz; Justin Paul,46,0,52,6
1708250100227,CENG 176B,B01,393629,Zhang; Liangfang,40,0,49,9
1708250100758,CENG 205,A00,393681,Jahed Motlagh; Zeinab,53,0,60,7
1708250101286,CENG 257,A00,393682,Opatkiewicz; Justin Paul,10,0,13,3
1708250101819,CGS 87,A00,489609,Wesling; Megan E.,20,0,20,0
1708250102346,CGS 100B,A00,396181,Whitley; Leila Marie,28,0,30,2
1708250102874,CGS 109,A00,396194,Whitley; Leila Marie,19,0,20,1
1708250103401,CGS 112,A00,396220,Martin Sandino; Amanda Maria Yoland,22,0,25,3
1708250103928,CGS 114,A00,396223,Steelman; Katherine Wallis,14,0,16,2
1708250104457,CGS 116,A00,396295,Staff,19,0,20,1
1708250104983,CGS 117,A00,396306,Martin Sandino; Amanda Maria Yoland,14,0,15,1
1708250105516,CGS 118,A00,396314,Hankins; Joseph D.,28,0,29,1
1708250106042,CGS 128,A00,396366,Whitley; Leila Marie,14,0,15,1
1708250106570,CGS 137,A00,396865,Martin Sandino; Amanda Maria Yoland,16,0,19,3
1708250107100,CGS 150,A00,396901,Taylor-Garcia; Daphne,18,0,18,0
1708250107628,CGS 196B,A00,396904,Lo; Stanley M.,7,0,7,0
1708250107628,CGS 196B,B00,396973,Brenner; Suzanne A,7,0,7,0
1708250107628,CGS 196B,C00,396985,Jones; Makeba,7,0,7,0
1708250108157,CGS 198,001,396987,Anderson; Patrick W.,0,0,0,0
1708250108157,CGS 198,002,396988,Anderson; Patrick W.,0,0,0,0
1708250108157,CGS 198,003,396989,Anderson; Patrick W.,0,0,0,0
1708250108157,CGS 198,004,396990,Anderson; Patrick W.,0,0,0,0
1708250108689,CGS 200,A00,396991,Perez; Roy,0,0,0,3
1708250109224,CHEM 6A,A01,459563,Deshmukh; Lalit,40,0,40,0
1708250109224,CHEM 6A,A02,459564,Deshmukh; Lalit,35,0,40,5
1708250109224,CHEM 6A,A03,459565,Deshmukh; Lalit,31,0,40,9
1708250109224,CHEM 6A,A04,459566,Deshmukh; Lalit,30,0,38,8
1708250109224,CHEM 6A,A05,459567,Deshmukh; Lalit,40,0,40,0
1708250109224,CHEM 6A,A06,459568,Deshmukh; Lalit,37,0,40,3
1708250109224,CHEM 6A,A07,459569,Deshmukh; Lalit,37,0,40,3
1708250109224,CHEM 6A,A08,459570,Deshmukh; Lalit,0,0,0,0
1708250109753,CHEM 6B,A01,467314,Ortony; Julia Helen,39,0,40,1
1708250109753,CHEM 6B,A02,467322,Ortony; Julia Helen,32,0,40,8
1708250109753,CHEM 6B,A03,467323,Ortony; Julia Helen,40,0,40,0
1708250109753,CHEM 6B,A04,467325,Ortony; Julia Helen,31,0,40,9
1708250109753,CHEM 6B,A05,467326,Ortony; Julia Helen,39,0,40,1
1708250109753,CHEM 6B,A06,467346,Ortony; Julia Helen,40,0,40,0
1708250109753,CHEM 6B,B01,467360,Hopkins; Patrycja Anna,35,0,40,5
1708250109753,CHEM 6B,B02,467363,Hopkins; Patrycja Anna,38,0,40,2
1708250109753,CHEM 6B,B03,467364,Hopkins; Patrycja Anna,35,0,40,5
1708250109753,CHEM 6B,B04,467380,Hopkins; Patrycja Anna,40,0,40,0
1708250109753,CHEM 6B,B05,467381,Hopkins; Patrycja Anna,40,0,40,0
1708250109753,CHEM 6B,B06,467382,Hopkins; Patrycja Anna,39,0,40,1
1708250110292,CHEM 6C,A01,468994,Ternansky; Robert J.,39,0,40,1
1708250110292,CHEM 6C,A02,469054,Ternansky; Robert J.,38,0,40,2
1708250110292,CHEM 6C,A03,469065,Ternansky; Robert J.,39,0,40,1
1708250110292,CHEM 6C,A04,469069,Ternansky; Robert J.,40,0,40,0
1708250110292,CHEM 6C,A05,469080,Ternansky; Robert J.,40,0,40,0
1708250110292,CHEM 6C,B01,469318,Ternansky; Robert J.,39,0,40,1
1708250110292,CHEM 6C,B02,469319,Ternansky; Robert J.,40,0,40,0
1708250110292,CHEM 6C,B03,469320,Ternansky; Robert J.,39,0,40,1
1708250110292,CHEM 6C,B04,469321,Ternansky; Robert J.,40,0,40,0
1708250110292,CHEM 6C,B05,469322,Ternansky; Robert J.,40,0,40,0
1708250110292,CHEM 6C,C01,469323,Schurmeier; Kimberly,38,0,40,2
1708250110292,CHEM 6C,C02,469324,Schurmeier; Kimberly,36,0,40,4
1708250110292,CHEM 6C,C03,469325,Schurmeier; Kimberly,38,0,40,2
1708250110292,CHEM 6C,C04,469326,Schurmeier; Kimberly,36,0,40,4
1708250110292,CHEM 6C,C05,469327,Schurmeier; Kimberly,40,0,40,0
1708250110292,CHEM 6C,D01,460183,Schurmeier; Kimberly,39,0,40,1
1708250110292,CHEM 6C,D02,460184,Schurmeier; Kimberly,32,0,40,8
1708250110292,CHEM 6C,D03,460185,Schurmeier; Kimberly,26,0,40,14
1708250110292,CHEM 6C,D04,460186,Schurmeier; Kimberly,38,0,40,2
1708250110292,CHEM 6C,D05,460187,Schurmeier; Kimberly,40,0,40,0
1708250110292,CHEM 6C,E01,460188,Stallings; Dontarie M,24,0,40,16
1708250110292,CHEM 6C,E02,460190,Stallings; Dontarie M,25,0,40,15
1708250110292,CHEM 6C,E03,460191,Stallings; Dontarie M,3,0,20,17
1708250110292,CHEM 6C,E04,460192,Stallings; Dontarie M,36,0,40,4
1708250110292,CHEM 6C,E05,460193,Stallings; Dontarie M,37,0,40,3
1708250110821,CHEM 6CH,A01,459630,Tezcan; Faik,40,0,40,0
1708250111367,CHEM 7L,A01,393998,Jazzar; Rodolphe,0,0,0,3
1708250111367,CHEM 7L,A02,393999,Jazzar; Rodolphe,10,0,24,14
1708250111367,CHEM 7L,A03,394000,Jazzar; Rodolphe,21,0,24,3
1708250111367,CHEM 7L,A04,394001,Jazzar; Rodolphe,22,0,24,2
1708250111367,CHEM 7L,A05,394002,Jazzar; Rodolphe,18,0,24,6
1708250111367,CHEM 7L,A06,394003,Jazzar; Rodolphe,22,0,24,2
1708250111367,CHEM 7L,A07,394004,Jazzar; Rodolphe,18,0,21,3
1708250111367,CHEM 7L,A08,394005,Jazzar; Rodolphe,0,0,0,0
1708250111367,CHEM 7L,A09,394006,Jazzar; Rodolphe,20,0,24,4
1708250111367,CHEM 7L,A10,394007,Jazzar; Rodolphe,24,0,24,0
1708250111367,CHEM 7L,B01,394009,Jazzar; Rodolphe,0,0,0,1
1708250111367,CHEM 7L,B02,394010,Jazzar; Rodolphe,1,0,6,5
1708250111367,CHEM 7L,B03,394011,Jazzar; Rodolphe,15,0,24,9
1708250111367,CHEM 7L,B04,394012,Jazzar; Rodolphe,18,0,21,3
1708250111367,CHEM 7L,B05,394013,Jazzar; Rodolphe,0,0,0,0
1708250111367,CHEM 7L,B06,394014,Jazzar; Rodolphe,15,0,24,9
1708250111367,CHEM 7L,B07,394015,Jazzar; Rodolphe,18,0,24,6
1708250111367,CHEM 7L,B08,394016,Jazzar; Rodolphe,23,0,24,1
1708250111367,CHEM 7L,B09,394017,Jazzar; Rodolphe,24,0,24,0
1708250111367,CHEM 7L,B10,394018,Jazzar; Rodolphe,24,0,24,0
1708250111367,CHEM 7L,C01,394020,Staff,0,0,0,0
1708250111367,CHEM 7L,C02,394021,Staff,21,0,24,3
1708250111367,CHEM 7L,C03,394022,Staff,23,0,24,1
1708250111367,CHEM 7L,C04,394023,Staff,24,0,24,0
1708250111367,CHEM 7L,C05,394024,Staff,0,0,0,0
1708250111367,CHEM 7L,C06,394025,Staff,20,0,24,4
1708250111367,CHEM 7L,C07,394026,Staff,22,0,24,2
1708250111367,CHEM 7L,C08,394027,Staff,23,0,24,1
1708250111367,CHEM 7L,C09,394028,Staff,24,0,24,0
1708250111367,CHEM 7L,C10,394029,Staff,23,0,24,1
1708250111898,CHEM 11,A01,459661,Staff,42,0,44,2
1708250111898,CHEM 11,A02,459664,Staff,44,0,44,0
1708250111898,CHEM 11,A03,459702,Staff,42,0,44,2
1708250111898,CHEM 11,A04,459707,Staff,44,0,44,0
1708250111898,CHEM 11,A05,459708,Staff,43,0,44,1
1708250111898,CHEM 11,A06,459711,Staff,41,0,44,3
1708250112428,CHEM 40A,A01,459576,Albizati; Kim F.,36,0,40,4
1708250112428,CHEM 40A,A02,459577,Albizati; Kim F.,33,0,40,7
1708250112428,CHEM 40A,A03,459578,Albizati; Kim F.,37,0,40,3
1708250112428,CHEM 40A,A04,459579,Albizati; Kim F.,38,0,40,2
1708250112428,CHEM 40A,A05,459580,Albizati; Kim F.,40,0,40,0
1708250112428,CHEM 40A,A06,459581,Albizati; Kim F.,37,0,40,3
1708250112428,CHEM 40A,A07,459582,Albizati; Kim F.,38,0,40,2
1708250112428,CHEM 40A,A08,459588,Albizati; Kim F.,39,0,40,1
1708250112957,CHEM 40B,A01,467442,Weizman; Haim,29,0,40,11
1708250112957,CHEM 40B,A02,467443,Weizman; Haim,33,0,40,7
1708250112957,CHEM 40B,A03,467444,Weizman; Haim,39,0,40,1
1708250112957,CHEM 40B,A04,467445,Weizman; Haim,38,0,40,2
1708250112957,CHEM 40B,A05,467446,Weizman; Haim,39,0,40,1
1708250112957,CHEM 40B,A06,467447,Weizman; Haim,37,0,40,3
1708250112957,CHEM 40B,A07,467448,Weizman; Haim,31,0,40,9
1708250112957,CHEM 40B,A08,467449,Weizman; Haim,40,0,40,0
1708250112957,CHEM 40B,B01,467383,Molinski; Tadeusz,40,0,40,0
1708250112957,CHEM 40B,B02,467384,Molinski; Tadeusz,40,0,40,0
1708250112957,CHEM 40B,B03,467385,Molinski; Tadeusz,40,0,40,0
1708250112957,CHEM 40B,B04,467399,Molinski; Tadeusz,40,0,40,0
1708250112957,CHEM 40B,B05,467400,Molinski; Tadeusz,40,0,40,0
1708250112957,CHEM 40B,B06,467401,Molinski; Tadeusz,40,0,40,0
1708250112957,CHEM 40B,B07,467402,Molinski; Tadeusz,40,0,40,0
1708250112957,CHEM 40B,B08,467404,Molinski; Tadeusz,39,0,40,1
1708250113486,CHEM 41B,A01,459571,Klosterman; Jeremy K,40,0,40,0
1708250113486,CHEM 41B,A02,459572,Klosterman; Jeremy K,36,0,37,1
1708250113486,CHEM 41B,A03,459573,Klosterman; Jeremy K,40,0,40,0
1708250114019,CHEM 41C,A01,459589,Tor; Yitzhak,40,0,40,0
1708250114019,CHEM 41C,A02,459624,Tor; Yitzhak,38,0,40,2
1708250114019,CHEM 41C,A03,459625,Tor; Yitzhak,40,0,40,0
1708250114019,CHEM 41C,A04,459626,Tor; Yitzhak,40,0,40,0
1708250114019,CHEM 41C,A05,459627,Tor; Yitzhak,29,0,29,0
1708250114019,CHEM 41C,A06,459628,Tor; Yitzhak,38,0,40,2
1708250114019,CHEM 41C,A07,459629,Tor; Yitzhak,40,0,40,0
1708250114555,CHEM 43A,A01,394068,Lam; Tin Yiu,12,0,24,12
1708250114555,CHEM 43A,A02,394088,Lam; Tin Yiu,23,0,24,1
1708250114555,CHEM 43A,A03,394092,Lam; Tin Yiu,23,0,24,1
1708250114555,CHEM 43A,A04,394093,Lam; Tin Yiu,21,0,24,3
1708250114555,CHEM 43A,A05,394094,Lam; Tin Yiu,23,0,24,1
1708250114555,CHEM 43A,A06,394096,Lam; Tin Yiu,15,0,24,9
1708250114555,CHEM 43A,A07,394115,Lam; Tin Yiu,20,0,24,4
1708250114555,CHEM 43A,A08,394116,Lam; Tin Yiu,22,0,24,2
1708250114555,CHEM 43A,A09,394117,Lam; Tin Yiu,22,0,24,2
1708250114555,CHEM 43A,A10,394118,Lam; Tin Yiu,20,0,24,4
1708250114555,CHEM 43A,A11,394119,Lam; Tin Yiu,8,0,13,5
1708250114555,CHEM 43A,A12,394120,Lam; Tin Yiu,24,0,24,0
1708250114555,CHEM 43A,A13,394132,Lam; Tin Yiu,24,0,24,0
1708250114555,CHEM 43A,B01,394134,Lam; Tin Yiu,24,0,24,0
1708250114555,CHEM 43A,B02,394135,Lam; Tin Yiu,16,0,24,8
1708250114555,CHEM 43A,B03,394136,Lam; Tin Yiu,13,0,24,11
1708250114555,CHEM 43A,B04,394137,Lam; Tin Yiu,17,0,24,7
1708250114555,CHEM 43A,B05,394138,Lam; Tin Yiu,20,0,24,4
1708250114555,CHEM 43A,B06,394139,Lam; Tin Yiu,19,0,24,5
1708250114555,CHEM 43A,B07,394140,Lam; Tin Yiu,20,0,24,4
1708250114555,CHEM 43A,B08,394141,Lam; Tin Yiu,24,0,24,0
1708250114555,CHEM 43A,B09,394142,Lam; Tin Yiu,20,0,24,4
1708250114555,CHEM 43A,B10,394143,Lam; Tin Yiu,24,0,24,0
1708250114555,CHEM 43A,B11,394145,Lam; Tin Yiu,22,0,24,2
1708250114555,CHEM 43A,B12,394146,Lam; Tin Yiu,23,0,24,1
1708250115087,CHEM 96,A00,394159,Bussey; Thomas J,24,0,25,1
1708250115617,CHEM 100A,A01,394161,Li; Shaowei,16,0,22,6
1708250115617,CHEM 100A,A02,394162,Li; Shaowei,20,0,24,4
1708250115617,CHEM 100A,A03,394163,Li; Shaowei,22,0,24,2
1708250115617,CHEM 100A,A04,394164,Li; Shaowei,24,0,24,0
1708250115617,CHEM 100A,A05,394165,Li; Shaowei,24,0,24,0
1708250115617,CHEM 100A,A06,394166,Li; Shaowei,20,0,22,2
1708250116149,CHEM 100B,A01,394175,Pomeroy; Robert S.,19,0,25,6
1708250116677,CHEM 105A,A01,394177,Young; Mark,31,0,39,8
1708250116677,CHEM 105A,B01,394179,Young; Mark,0,0,0,0
1708250117204,CHEM 108,A01,394181,Staff,14,0,20,6
1708250117204,CHEM 108,A02,394182,Staff,23,0,24,1
1708250117204,CHEM 108,B01,394184,Staff,4,0,20,16
1708250117204,CHEM 108,B02,394185,Staff,23,0,24,1
1708250117732,CHEM 109,A01,394187,Piercy; Marc Anthony,17,0,20,3
1708250117732,CHEM 109,A02,394188,Piercy; Marc Anthony,22,0,24,2
1708250117732,CHEM 109,B01,394193,Piercy; Marc Anthony,12,0,20,8
1708250117732,CHEM 109,B02,394194,Piercy; Marc Anthony,23,0,24,1
1708250118262,CHEM 111,A00,394195,Thiemens; Mark H,97,0,100,3
1708250118788,CHEM 114B,A01,459574,Piercy; Marc Anthony,39,0,45,6
1708250118788,CHEM 114B,A02,459575,Piercy; Marc Anthony,40,0,45,5
1708250119320,CHEM 114C,A01,467286,Komives; Elizabeth A,32,0,44,12
1708250119320,CHEM 114C,A02,467287,Komives; Elizabeth A,42,0,44,2
1708250119320,CHEM 114C,A03,467290,Komives; Elizabeth A,42,0,44,2
1708250119320,CHEM 114C,A04,467295,Komives; Elizabeth A,43,0,44,1
1708250119848,CHEM 114D,A00,394198,Ghosh; Gourisankar,29,0,30,1
1708250120381,CHEM 118,A01,459788,Donoghue; Daniel J.,37,0,40,3
1708250120381,CHEM 118,A02,459800,Donoghue; Daniel J.,37,0,40,3
1708250120381,CHEM 118,A03,459807,Donoghue; Daniel J.,36,0,40,4
1708250120381,CHEM 118,A04,459809,Donoghue; Daniel J.,38,0,40,2
1708250120381,CHEM 118,A05,459811,Donoghue; Daniel J.,37,0,40,3
1708250120381,CHEM 118,A06,459826,Donoghue; Daniel J.,39,0,40,1
1708250120908,CHEM 119,A01,467427,Joseph; Simpson,35,0,40,5
1708250120908,CHEM 119,A02,467441,Joseph; Simpson,0,0,0,0
1708250121442,CHEM 120B,A01,467450,Griffith; Kent,37,0,40,3
1708250121442,CHEM 120B,A02,467451,Griffith; Kent,34,0,40,6
1708250121442,CHEM 120B,A03,467452,Griffith; Kent,35,0,40,5
1708250121973,CHEM 123,A00,394211,Schimpf; Alina M,0,0,0,1
1708250122500,CHEM 125,A00,394217,Tezcan; Faik,18,0,20,2
1708250123027,CHEM 126A,A01,459715,Yong; Haiwang,39,0,40,1
1708250123027,CHEM 126A,A02,459725,Yong; Haiwang,36,0,40,4
1708250123555,CHEM 126B,A01,467405,Tauber; Michael,36,0,40,4
1708250123555,CHEM 126B,A02,467406,Tauber; Michael,39,0,40,1
1708250123555,CHEM 126B,A03,467426,Tauber; Michael,39,0,40,1
1708250124085,CHEM 132,A01,460181,Galperin; Michael,42,0,45,3
1708250124085,CHEM 132,A02,460182,Galperin; Michael,37,0,45,8
1708250124612,CHEM 135,A01,394222,Tauber; Michael,15,0,15,0
1708250125139,CHEM 143B,A01,394229,Klosterman; Jeremy K,16,0,24,8
1708250125139,CHEM 143B,A02,394230,Klosterman; Jeremy K,21,0,24,3
1708250125667,CHEM 156,A00,394231,Romero; Erik Anthony,30,0,30,0
1708250126195,CHEM 157,A00,394232,Tor; Yitzhak,74,0,80,6
1708250126727,CHEM 165,A01,460194,Herzik; Mark Anthony,21,0,25,4
1708250127309,CHEM 167,A01,467296,Deshmukh; Lalit,39,0,40,1
1708250127309,CHEM 167,A02,467297,Deshmukh; Lalit,33,0,40,7
1708250127309,CHEM 167,A03,467298,Deshmukh; Lalit,37,0,40,3
1708250127309,CHEM 167,A04,467312,Deshmukh; Lalit,37,0,40,3
1708250127840,CHEM 173,A00,394284,Young; Mark,48,0,50,2
1708250128367,CHEM 174,A01,455015,Pomeroy; Robert S.,45,0,50,5
1708250128901,CHEM 186,A00,477716,Paesani; Francesco & Gilson; Michael K.,6,0,12,6
1708250129426,CHEM 188,A00,394294,Bussey; Thomas J,19,0,20,1
1708250129952,CHEM 214,A00,394336,Ghosh; Gourisankar,12,0,20,8
1708250130478,CHEM 217,A00,394341,Joseph; Simpson,25,0,30,5
1708250131004,CHEM 221,A00,394425,Taylor; Susan S.,10,0,20,10
1708250131529,CHEM 225,A00,394429,Tezcan; Faik,4,0,10,6
1708250132059,CHEM 227,A00,394430,Schimpf; Alina M,26,0,30,4
1708250132588,CHEM 229,A00,394431,Stauber; Julia Megan,13,0,20,7
1708250133114,CHEM 235,A01,394433,Tauber; Michael,20,0,20,0
1708250133647,CHEM 236,A00,394434,Kummel; Andrew C,14,0,15,1
1708250134179,CHEM 241,A00,394435,Pokorski; Jonathan Kyle,14,0,15,1
1708250134711,CHEM 250,A00,394436,Weizman; Haim,0,0,0,16
1708250135242,CHEM 256,A00,394437,Romero; Erik Anthony,15,0,20,5
1708250135789,CHEM 257,A00,394438,Tor; Yitzhak,23,0,30,7
1708250136318,CHEM 265,A01,460195,Herzik; Mark Anthony,13,0,20,7
1708250136849,CHEM 273,A00,394440,Young; Mark,13,0,20,7
1708250137378,CHEM 276,A00,394441,Mc Culloch; Andrew Douglas & Amaro; Rommie E,0,0,0,0
1708250137908,CHEM 283,A00,394443,Komives; Elizabeth A,2,0,4,2
1708250138436,CHEM 286,A00,477693,Paesani; Francesco & Gilson; Michael K.,26,0,34,8
1708250138965,CHEM 291,A00,394446,Komives; Elizabeth A,20,0,20,0
1708250139493,CHEM 294,A00,394447,Romero; Erik Anthony,50,0,50,0
1708250140025,CHIN 10CD,A01,394453,Liu; Mingming,17,0,17,0
1708250140025,CHIN 10CD,A02,394457,Liu; Mingming,18,0,18,0
1708250140554,CHIN 10CM,A01,394465,Chen; Pei-Chia,11,0,12,1
1708250140554,CHIN 10CM,A02,394466,Chen; Pei-Chia,12,0,12,0
1708250140554,CHIN 10CM,B01,394468,Liu; Mingming,11,0,13,2
1708250140554,CHIN 10CM,B02,394469,Liu; Mingming,13,0,13,0
1708250141082,CHIN 10CN,A01,394581,Xu; Li,14,0,14,0
1708250141082,CHIN 10CN,A02,394582,Xu; Li,14,0,14,0
1708250141082,CHIN 10CN,B01,394585,Xu; Li,14,0,14,0
1708250141082,CHIN 10CN,B02,394586,Xu; Li,13,0,14,1
1708250141610,CHIN 20CD,A01,394591,Wang; Xiao,11,0,12,1
1708250141610,CHIN 20CD,A02,394592,Wang; Xiao,11,0,12,1
1708250142142,CHIN 20CN,A01,394597,Anderson; Qin-Hong,7,0,8,1
1708250142142,CHIN 20CN,A02,394599,Anderson; Qin-Hong,8,0,8,0
1708250142142,CHIN 20CN,B01,394601,Anderson; Qin-Hong,14,0,15,1
1708250142672,CHIN 100CM,A00,394602,Anderson; Qin-Hong,19,0,20,1
1708250143199,CHIN 100CN,A00,394603,Chen; Pei-Chia,24,0,24,0
1708250143730,CHIN 169B,A00,394623,Wang; Xiao,19,0,20,1
1708250144262,CLAS 87,A00,394669,Herbst; Matthew,19,0,20,1
1708250144794,CLAS 121R,A01,394671,Herbst; Matthew,11,0,12,1
1708250144794,CLAS 121R,B01,486854,Herbst; Matthew,8,0,8,0
1708250145321,CLIN 294C,A00,476856,Wierenga; Christina E & Banks; Sarah Jane,20,0,20,0
1708250145852,CLIN 296,001,476768,Brookman; Lauren Irene,94,0,100,6
1708250145852,CLIN 296,002,476855,Brookman; Lauren Irene,10,0,10,0
1708250146384,CLRE 238R,A00,394675,Mehta; Ravindra L.,9998,0,9999,1
1708250146911,CLRE 254,A00,394678,Vaida; Florin,9999,0,9999,0
1708250147439,CLRE 256,A00,394685,Morris; Sheldon,9999,0,9999,0
1708250147972,CLRE 258,A00,394692,Mehta; Ravindra L.,9999,0,9999,0
1708250148505,CLRE 260,A00,394693,Cuomo; Raphael Eduardo,9999,0,9999,0
1708250149036,CLRE 264,A00,394696,Mehta; Ravindra L.,9999,0,9999,0
1708250149566,CLRE 267,A00,394703,Vaida; Florin,9999,0,9999,0
1708250150092,CLRE 297,001,394705,Cuomo; Raphael Eduardo,9999,0,9999,0
1708250150673,CMM 246,A00,492783,Gordts; Philip & Varki; Ajit P & Lewis; Amanda Lark & Godula; Kamil & Gagneux; Pascal & Esko; Jeffrey D. & Bode; Lars,9,0,10,1
1708250151205,CMM 250,A00,492943,Willert; Karl Heinrich,31,0,40,9
1708250151732,COGR 200B,A00,395746,Jack; Caroline Sarah,2,0,5,3
1708250152268,COGR 225B,A00,395750,Serlin; David,1,0,5,4
1708250152794,COGR 225C,A00,395753,Gates; Kelly,1,0,5,4
1708250153321,COGR 275,A00,395943,Goldfarb; Brian,6,0,10,4
1708250153321,COGR 275,B00,396046,Fattal; Alexander Leor,4,0,10,6
1708250153321,COGR 275,C00,396047,Kidman; Shawna F,4,0,10,6
1708250153849,COGR 280,A00,396048,Ahn; Patricia Jeehyun,6,0,10,4
1708250154390,COGS 1,A01,407484,Boyle; Mary E. T.,52,0,60,8
1708250154390,COGS 1,A02,407498,Boyle; Mary E. T.,54,0,60,6
1708250154390,COGS 1,A03,407504,Boyle; Mary E. T.,59,0,60,1
1708250154390,COGS 1,A04,407512,Boyle; Mary E. T.,57,0,60,3
1708250154390,COGS 1,A05,407513,Boyle; Mary E. T.,60,0,60,0
1708250154390,COGS 1,A06,407514,Boyle; Mary E. T.,58,0,60,2
1708250154390,COGS 1,A07,407515,Boyle; Mary E. T.,57,0,57,0
1708250154918,COGS 9,A01,407520,Shannon; Kyle Michael,54,0,60,6
1708250154918,COGS 9,A02,407521,Shannon; Kyle Michael,60,0,60,0
1708250154918,COGS 9,A03,407522,Shannon; Kyle Michael,59,0,60,1
1708250154918,COGS 9,A04,407524,Shannon; Kyle Michael,57,0,60,3
1708250154918,COGS 9,A05,407525,Shannon; Kyle Michael,59,0,60,1
1708250155450,COGS 10,A01,407527,Morgan; Eric,45,0,50,5
1708250155450,COGS 10,A02,407530,Morgan; Eric,46,0,50,4
1708250155450,COGS 10,A03,407531,Morgan; Eric,46,0,50,4
1708250155450,COGS 10,A04,407532,Morgan; Eric,47,0,50,3
1708250155450,COGS 10,A05,407534,Morgan; Eric,47,0,50,3
1708250155450,COGS 10,A06,407539,Morgan; Eric,50,0,50,0
1708250155450,COGS 10,A07,407628,Morgan; Eric,50,0,50,0
1708250155978,COGS 11,A01,407699,Boroditsky; Lera,179,0,180,1
1708250156508,COGS 12,A00,407702,Boroditsky; Lera,75,0,75,0
1708250157037,COGS 14A,A01,407706,Barrera; Steven James,51,0,57,6
1708250157037,COGS 14A,A02,407707,Barrera; Steven James,54,0,57,3
1708250157037,COGS 14A,A03,407712,Barrera; Steven James,0,0,0,1
1708250157037,COGS 14A,A04,407715,Barrera; Steven James,57,0,57,0
1708250157037,COGS 14A,A05,407717,Barrera; Steven James,55,0,56,1
1708250157037,COGS 14A,A06,407718,Barrera; Steven James,52,0,55,3
1708250157037,COGS 14A,A07,407720,Barrera; Steven James,49,0,55,6
1708250157565,COGS 14B,A01,407723,Hoffman; Drew Ellen,52,0,57,5
1708250157565,COGS 14B,A02,407726,Hoffman; Drew Ellen,48,0,55,7
1708250157565,COGS 14B,A03,407727,Hoffman; Drew Ellen,52,0,55,3
1708250157565,COGS 14B,A04,407729,Hoffman; Drew Ellen,52,0,55,3
1708250157565,COGS 14B,A05,407730,Hoffman; Drew Ellen,50,0,55,5
1708250158098,COGS 17,A01,407733,Johnson; Christine M.,50,0,50,0
1708250158098,COGS 17,A02,407734,Johnson; Christine M.,48,0,50,2
1708250158098,COGS 17,A03,407735,Johnson; Christine M.,46,0,50,4
1708250158098,COGS 17,A04,407740,Johnson; Christine M.,47,0,50,3
1708250158098,COGS 17,A05,407745,Johnson; Christine M.,48,0,50,2
1708250158098,COGS 17,A06,407824,Johnson; Christine M.,48,0,50,2
1708250158098,COGS 17,A07,407878,Johnson; Christine M.,50,0,55,5
1708250158098,COGS 17,A08,408015,Johnson; Christine M.,52,0,55,3
1708250158627,COGS 18,A01,408118,Ellis; Shannon Elizabeth,27,0,35,8
1708250158627,COGS 18,A02,408119,Ellis; Shannon Elizabeth,31,0,35,4
1708250158627,COGS 18,A03,408120,Ellis; Shannon Elizabeth,23,0,35,12
1708250158627,COGS 18,A04,408136,Ellis; Shannon Elizabeth,33,0,35,2
1708250158627,COGS 18,A05,408141,Ellis; Shannon Elizabeth,35,0,35,0
1708250158627,COGS 18,A06,408143,Ellis; Shannon Elizabeth,34,0,35,1
1708250158627,COGS 18,A07,408144,Ellis; Shannon Elizabeth,35,0,35,0
1708250158627,COGS 18,A08,408145,Ellis; Shannon Elizabeth,34,0,35,1
1708250158627,COGS 18,A09,408146,Ellis; Shannon Elizabeth,35,0,35,0
1708250158627,COGS 18,B01,408148,Ellis; Shannon Elizabeth,30,0,32,2
1708250158627,COGS 18,B02,408149,Ellis; Shannon Elizabeth,26,0,32,6
1708250158627,COGS 18,B03,408151,Ellis; Shannon Elizabeth,27,0,33,6
1708250158627,COGS 18,B04,408154,Ellis; Shannon Elizabeth,32,0,33,1
1708250158627,COGS 18,B05,408163,Ellis; Shannon Elizabeth,29,0,33,4
1708250158627,COGS 18,B06,408176,Ellis; Shannon Elizabeth,33,0,33,0
1708250158627,COGS 18,B07,408177,Ellis; Shannon Elizabeth,31,0,33,2
1708250158627,COGS 18,B08,408178,Ellis; Shannon Elizabeth,32,0,33,1
1708250158627,COGS 18,B09,408195,Ellis; Shannon Elizabeth,31,0,33,2
1708250159155,COGS 87,A00,408196,Deak; Gedeon O.,20,0,20,0
1708250159155,COGS 87,B00,479478,Fleischer; Jason G,20,0,20,0
1708250159689,COGS 100,A01,408262,Allen; Michael Gordon,54,0,56,2
1708250159689,COGS 100,A02,408263,Allen; Michael Gordon,52,0,56,4
1708250159689,COGS 100,A03,408264,Allen; Michael Gordon,55,0,56,1
1708250159689,COGS 100,A04,408265,Allen; Michael Gordon,56,0,56,0
1708250159689,COGS 100,A05,408266,Allen; Michael Gordon,56,0,56,0
1708250159689,COGS 100,A06,408349,Allen; Michael Gordon,55,0,56,1
1708250160215,COGS 101A,A01,408352,Morgan; Eric,60,0,60,0
1708250160215,COGS 101A,A02,408353,Morgan; Eric,58,0,60,2
1708250160215,COGS 101A,A03,408354,Morgan; Eric,57,0,60,3
1708250160215,COGS 101A,A04,408355,Morgan; Eric,59,0,60,1
1708250160746,COGS 101B,A01,408373,Barrera; Steven James,47,0,50,3
1708250160746,COGS 101B,A02,408380,Barrera; Steven James,46,0,50,4
1708250160746,COGS 101B,A03,408384,Barrera; Steven James,38,0,50,12
1708250160746,COGS 101B,A04,408385,Barrera; Steven James,37,0,50,13
1708250161280,COGS 101C,A01,408387,Trott; Sean Thomas,48,0,50,2
1708250161280,COGS 101C,A02,408388,Trott; Sean Thomas,43,0,50,7
1708250161280,COGS 101C,A03,408389,Trott; Sean Thomas,45,0,50,5
1708250161808,COGS 107A,A01,408396,Boyle; Mary E. T.,54,0,56,2
1708250161808,COGS 107A,A02,408397,Boyle; Mary E. T.,54,0,56,2
1708250161808,COGS 107A,A03,408399,Boyle; Mary E. T.,51,0,56,5
1708250161808,COGS 107A,A04,408409,Boyle; Mary E. T.,50,0,56,6
1708250161808,COGS 107A,A05,408410,Boyle; Mary E. T.,51,0,56,5
1708250161808,COGS 107A,A06,408411,Boyle; Mary E. T.,55,0,56,1
1708250162335,COGS 107B,A01,408413,Mooshagian; Eric Frederick,46,0,50,4
1708250162335,COGS 107B,A02,408414,Mooshagian; Eric Frederick,43,0,50,7
1708250162335,COGS 107B,A03,408428,Mooshagian; Eric Frederick,43,0,50,7
1708250162335,COGS 107B,A04,408434,Mooshagian; Eric Frederick,46,0,50,4
1708250162335,COGS 107B,A05,408435,Mooshagian; Eric Frederick,50,0,50,0
1708250162335,COGS 107B,A06,408446,Mooshagian; Eric Frederick,49,0,50,1
1708250162867,COGS 107C,A01,408500,Chiba; Andrea,51,0,60,9
1708250162867,COGS 107C,A02,408519,Chiba; Andrea,55,0,60,5
1708250162867,COGS 107C,A03,408524,Chiba; Andrea,56,0,60,4
1708250163393,COGS 108,A01,408532,Fleischer; Jason G,45,0,60,15
1708250163393,COGS 108,A02,408543,Fleischer; Jason G,58,0,60,2
1708250163393,COGS 108,A03,408544,Fleischer; Jason G,59,0,60,1
1708250163393,COGS 108,A04,408552,Fleischer; Jason G,32,0,60,28
1708250163393,COGS 108,A05,408554,Fleischer; Jason G,47,0,60,13
1708250163393,COGS 108,A06,408574,Fleischer; Jason G,43,0,60,17
1708250163393,COGS 108,A07,408576,Fleischer; Jason G,56,0,60,4
1708250163925,COGS 112,A01,408682,Hoffman; Drew Ellen,33,0,50,17
1708250163925,COGS 112,A02,408683,Hoffman; Drew Ellen,38,0,50,12
1708250163925,COGS 112,A03,408684,Hoffman; Drew Ellen,48,0,60,12
1708250164453,COGS 122,A01,408695,Dow; Steven P,21,0,50,29
1708250164980,COGS 125,A00,408697,Klemmer; Scott R,36,0,50,14
1708250165507,COGS 126,A01,408787,Hollan; James D.,44,0,50,6
1708250166040,COGS 138,A01,408866,Khosla; Meenakshi,71,0,75,4
1708250166567,COGS 142,A01,408868,Rossano; Federico,49,0,50,1
1708250167093,COGS 144,A01,408950,Rossano; Federico,48,0,50,2
1708250167619,COGS 155,A01,408993,Staff,49,0,50,1
1708250168151,COGS 157,A00,408994,Creel; Sarah,0,0,0,0
1708250168681,COGS 160,A00,409031,Deak; Gedeon O.,20,0,20,0
1708250169206,COGS 175,A01,409035,Rill; Bryan,67,0,75,8
1708250169738,COGS 178,A00,409274,Jernigan; Terry Lynne,68,0,70,2
1708250170265,COGS 179,A00,409278,Staff,40,0,40,0
1708250170795,COGS 184,A01,409317,Johnson; Christine M.,42,0,50,8
1708250171325,COGS 185,A01,409476,Tu; Zhuowen,33,0,50,17
1708250171325,COGS 185,A02,409525,Tu; Zhuowen,45,0,50,5
1708250171857,COGS 188,A01,409527,Fleischer; Jason G,45,0,75,30
1708250172391,COGS 190C,001,409528,Chiba; Andrea,9999,0,9999,0
1708250172391,COGS 190C,002,409530,Fleischer; Jason G,9999,0,9999,0
1708250172391,COGS 190C,003,409531,Boyle; Mary E. T.,9999,0,9999,0
1708250172391,COGS 190C,004,409532,Nitz; Douglas A.,9999,0,9999,0
1708250172391,COGS 190C,005,409535,Rangel; Lara M,9999,0,9999,0
1708250172391,COGS 190C,006,409536,Rossano; Federico,9999,0,9999,0
1708250172391,COGS 190C,007,409537,Deak; Gedeon O.,9999,0,9999,0
1708250172391,COGS 190C,008,409538,Trott; Sean Thomas,9999,0,9999,0
1708250172391,COGS 190C,009,409540,Creel; Sarah,9999,0,9999,0
1708250172391,COGS 190C,010,409541,Voytek; Bradley Thomas,9999,0,9999,0
1708250172391,COGS 190C,011,409542,Greene; Deanna Jacquelyn,9999,0,9999,0
1708250172391,COGS 190C,012,409543,Ellis; Shannon Elizabeth,9999,0,9999,0
1708250172391,COGS 190C,013,409546,Kirsh; David Joel,9999,0,9999,0
1708250172916,COGS 190D,A00,409547,Voytek; Bradley Thomas,20,0,20,0
1708250173442,COGS 194,A00,409548,Hill; Seth J,9999,0,9999,0
1708250173990,COGS 200,A01,406697,Creel; Sarah,0,0,0,0
1708250174516,COGS 205,A00,406698,Chiba; Andrea,20,0,20,0
1708250175046,COGS 209,A00,406699,Mukamel; Eran A,42,0,68,26
1708250175610,COGS 210C,001,406700,Kirsh; David Joel,9999,0,9999,0
1708250175610,COGS 210C,002,406701,Greene; Deanna Jacquelyn,9998,0,9999,1
1708250175610,COGS 210C,003,406702,Xia; Haijun,9999,0,9999,0
1708250175610,COGS 210C,004,406703,Nitz; Douglas A.,9998,0,9999,1
1708250175610,COGS 210C,005,406710,Hollan; James D.,9999,0,9999,0
1708250175610,COGS 210C,006,406713,De Sa; Virginia,9999,0,9999,0
1708250175610,COGS 210C,007,406714,Rossano; Federico,9999,0,9999,0
1708250175610,COGS 210C,008,406740,Kiyonaga; Anastasia,9999,0,9999,0
1708250175610,COGS 210C,009,406745,Guo; Philip J,9998,0,9999,1
1708250175610,COGS 210C,010,406746,Dow; Steven P,9999,0,9999,0
1708250175610,COGS 210C,011,406747,Bergen; Benjamin,9999,0,9999,0
1708250175610,COGS 210C,012,406758,Coulson; Seana M,9999,0,9999,0
1708250176140,COGS 211C,A00,406763,Coulson; Seana M,17,0,20,3
1708250176668,COGS 229,A00,406788,Hollan; James D. & Xia; Haijun,4,0,10,6
1708250177199,COGS 238,A00,406789,Bergen; Benjamin,17,0,20,3
1708250177729,COGS 278,A00,406794,Jernigan; Terry Lynne,18,0,20,2
1708250178271,COMM 10,A01,394711,Schmidt; Thomas Rainer,20,0,24,4
1708250178271,COMM 10,A02,394714,Schmidt; Thomas Rainer,24,0,24,0
1708250178271,COMM 10,A03,394716,Schmidt; Thomas Rainer,24,0,24,0
1708250178271,COMM 10,A04,394717,Schmidt; Thomas Rainer,22,0,24,2
1708250178271,COMM 10,A05,394731,Schmidt; Thomas Rainer,24,0,24,0
1708250178271,COMM 10,A06,394733,Schmidt; Thomas Rainer,24,0,24,0
1708250178271,COMM 10,A07,394740,Schmidt; Thomas Rainer,24,0,24,0
1708250178271,COMM 10,A08,394741,Schmidt; Thomas Rainer,24,0,24,0
1708250178271,COMM 10,A09,394751,Schmidt; Thomas Rainer,23,0,24,1
1708250178271,COMM 10,A10,394779,Schmidt; Thomas Rainer,24,0,24,0
1708250178271,COMM 10,A11,394809,Schmidt; Thomas Rainer,24,0,24,0
1708250178271,COMM 10,A12,394811,Schmidt; Thomas Rainer,24,0,24,0
1708250178271,COMM 10,A13,394818,Schmidt; Thomas Rainer,24,0,24,0
1708250178271,COMM 10,A14,394825,Schmidt; Thomas Rainer,23,0,24,1
1708250178271,COMM 10,A15,394828,Schmidt; Thomas Rainer,24,0,24,0
1708250178271,COMM 10,A16,394829,Schmidt; Thomas Rainer,0,0,0,0
1708250178271,COMM 10,A17,486828,Schmidt; Thomas Rainer,20,0,21,1
1708250178798,COMM 20,A01,394834,McKenna; Denise,69,0,70,1
1708250179326,COMM 80,A01,394849,Campbell; Robert Harold,120,0,120,0
1708250179855,COMM 100C,A01,394957,Kidman; Shawna F,24,0,25,1
1708250179855,COMM 100C,A02,394972,Kidman; Shawna F,25,0,25,0
1708250179855,COMM 100C,A03,394977,Kidman; Shawna F,22,0,25,3
1708250179855,COMM 100C,A04,394981,Kidman; Shawna F,25,0,25,0
1708250179855,COMM 100C,A05,394985,Kidman; Shawna F,24,0,25,1
1708250179855,COMM 100C,A06,394989,Kidman; Shawna F,23,0,25,2
1708250179855,COMM 100C,A07,394993,Kidman; Shawna F,24,0,25,1
1708250179855,COMM 100C,A08,394997,Kidman; Shawna F,23,0,25,2
1708250179855,COMM 100C,A09,394999,Kidman; Shawna F,25,0,25,0
1708250179855,COMM 100C,A10,395018,Kidman; Shawna F,25,0,25,0
1708250179855,COMM 100C,A11,395041,Kidman; Shawna F,24,0,25,1
1708250179855,COMM 100C,A12,395080,Kidman; Shawna F,24,0,25,1
1708250180385,COMM 101,A01,395135,Halm; Gavin Patrick,15,0,15,0
1708250180385,COMM 101,A02,395252,Halm; Gavin Patrick,15,0,15,0
1708250180385,COMM 101,A03,395253,Halm; Gavin Patrick,15,0,15,0
1708250180385,COMM 101,A04,395263,Halm; Gavin Patrick,15,0,15,0
1708250180967,COMM 101D,A00,395264,Martinico; Daniel J,13,0,16,3
1708250181493,COMM 101K,A00,395266,Ahn; Patricia Jeehyun,16,0,18,2
1708250182024,COMM 101N,A00,395267,Martinico; Daniel J,16,0,16,0
1708250182550,COMM 102C,A01,395270,Campion; Camille E,5,0,6,1
1708250182550,COMM 102C,A02,395271,Campion; Camille E,6,0,6,0
1708250182550,COMM 102C,A03,395272,Campion; Camille E,5,0,6,1
1708250183082,COMM 102M,A01,395285,Davis; Zeinabu I.,9,0,10,1
1708250183082,COMM 102M,A02,395288,Davis; Zeinabu I.,8,0,10,2
1708250183608,COMM 103D,A00,395343,Gates; Kelly,34,0,35,1
1708250184135,COMM 107,A00,395461,Serlin; David,33,0,35,2
1708250184662,COMM 109D,A00,395462,Halm; Gavin Patrick,72,0,75,3
1708250185193,COMM 110G,A00,395481,Whitworth-Smith; Andrew C,32,0,35,3
1708250185724,COMM 110M,A00,395482,Harb; Anthony Joseph,34,0,35,1
1708250186254,COMM 111A,A00,487217,Pavon Aramburu; Maria Laur,34,0,35,1
1708250186784,COMM 113T,A00,395516,Fields; Gary,35,0,35,0
1708250187310,COMM 114A,A00,395517,Zilberg; Elana,32,0,35,3
1708250187836,COMM 114B,A00,395523,Zilberg; Elana,19,0,20,1
1708250188365,COMM 114E,A00,487218,Pavon Aramburu; Maria Laur,34,0,35,1
1708250188897,COMM 114W,A00,395524,Walkover; Lillian B,17,0,18,1
1708250189423,COMM 126,A00,479341,Staff,26,0,30,4
1708250189950,COMM 132,A00,481491,Rojo Solis; Juan Jose,0,0,0,0
1708250190476,COMM 134,A00,395578,Abuelhiga; Soraya Jill,28,0,30,2
1708250191003,COMM 143,A00,395579,Rojo Solis; Juan Jose,28,0,30,2
1708250191531,COMM 146,A00,395584,Jack; Caroline Sarah,29,0,30,1
1708250192056,COMM 168,A00,395592,Harb; Anthony Joseph,29,0,30,1
1708250192583,COMM 170,A00,395608,Pavon Aramburu; Maria Laur,30,0,30,0
1708250193109,COMM 173,A00,395609,Alac; Morana,29,0,30,1
1708250193635,COMM 174,A00,395679,Alac; Morana,30,0,30,0
1708250194160,COMM 190,A00,395682,Abuelhiga; Soraya Jill,19,0,23,4
1708250194160,COMM 190,B00,395696,Staff,21,0,23,2
1708250194160,COMM 190,C00,395697,Fattal; Alexander Leor,22,0,23,1
1708250194697,CSE 8A,A50,459200,Miranda; Gregory Joseph,34,0,35,1
1708250194697,CSE 8A,A51,459205,Miranda; Gregory Joseph,34,0,35,1
1708250194697,CSE 8A,A52,459206,Miranda; Gregory Joseph,34,0,35,1
1708250194697,CSE 8A,A53,459212,Miranda; Gregory Joseph,34,0,35,1
1708250194697,CSE 8A,A54,459213,Miranda; Gregory Joseph,34,0,35,1
1708250194697,CSE 8A,A55,459232,Miranda; Gregory Joseph,34,0,35,1
1708250195230,CSE 11,A01,470735,Ochoa; Benjamin Lawrence,180,0,195,15
1708250195759,CSE 12,A01,470744,Cao; Yingjun,189,0,200,11
1708250195759,CSE 12,B01,470752,Miranda; Gregory Joseph,71,0,100,29
1708250195759,CSE 12,B02,470760,Miranda; Gregory Joseph,93,0,100,7
1708250196293,CSE 15L,A01,410174,Solares; Edwin A,6,0,10,4
1708250196293,CSE 15L,B01,410215,Solares; Edwin A,7,0,10,3
1708250196293,CSE 15L,C01,410305,Solares; Edwin A,3,0,10,7
1708250196293,CSE 15L,D01,410400,Solares; Edwin A,1,0,10,9
1708250196820,CSE 20,A01,470765,Minnes Kemp; Mor Mia,145,0,150,5
1708250197352,CSE 21,A01,470776,Jones; Miles E,68,0,73,5
1708250197352,CSE 21,A02,482889,Jones; Miles E,68,0,72,4
1708250197892,CSE 29,A01,494014,Soosai Raj; Adalbert Geral,48,0,50,2
1708250197892,CSE 29,A02,494016,Soosai Raj; Adalbert Geral,40,0,50,10
1708250197892,CSE 29,B01,494018,Shalev; Aaron D,16,0,20,4
1708250198430,CSE 30,A01,470784,Cao; Yingjun,141,0,150,9
1708250198430,CSE 30,B01,467469,Muller; P Keith,98,0,120,22
1708250198961,CSE 87,A00,410528,Moshiri; Niema,20,0,20,0
1708250199487,CSE 90,A00,486885,Minnes Kemp; Mor Mia,0,0,0,0
1708250200018,CSE 91,A00,486872,Minnes Kemp; Mor Mia,0,0,0,0
1708250200018,CSE 91,B00,486873,Minnes Kemp; Mor Mia,0,0,0,0
1708250200544,CSE 95,A00,410529,Minnes Kemp; Mor Mia,50,0,50,0
1708250201070,CSE 100,A01,470792,Sahoo; Debashis,55,0,70,15
1708250201596,CSE 100R,A01,410556,Moshiri; Niema,1,0,40,39
1708250202127,CSE 101,A01,470797,Jones; Miles E,14,0,44,30
1708250202127,CSE 101,A02,482892,Jones; Miles E,32,0,43,11
1708250202659,CSE 105,A01,470800,Micciancio; Daniele,85,0,98,13
1708250203186,CSE 107,A01,467479,Bellare; Mihir,141,0,146,5
1708250203716,CSE 109,A01,459538,Shang; Jingbo,0,0,25,25
1708250204245,CSE 110,A50,459395,Powell; Thomas Allan,49,0,50,1
1708250204245,CSE 110,A51,459512,Powell; Thomas Allan,37,0,50,13
1708250204245,CSE 110,A52,459513,Powell; Thomas Allan,46,0,50,4
1708250204245,CSE 110,A53,459514,Powell; Thomas Allan,48,0,50,2
1708250204245,CSE 110,A54,459515,Powell; Thomas Allan,48,0,50,2
1708250204245,CSE 110,A55,459516,Powell; Thomas Allan,45,0,50,5
1708250204245,CSE 110,A56,459517,Powell; Thomas Allan,47,0,48,1
1708250204771,CSE 112,A50,459518,Powell; Thomas Allan,132,0,146,14
1708250205298,CSE 120,A01,470808,Zhou; Yuan-Yuan,167,0,200,33
1708250205829,CSE 125,A00,410564,Voelker; Geoffrey M.,30,0,30,0
1708250206359,CSE 127,A01,467484,Fernandes; Earlence T,175,0,196,21
1708250206890,CSE 130,A01,467485,Polikarpova; Nadezhda,176,0,192,16
1708250207416,CSE 131,A01,459522,Ding; Yufei,36,0,50,14
1708250207947,CSE 132B,A01,470816,Deutsch; Alin Bernard,60,0,70,10
1708250208475,CSE 140,A01,410606,Orailoglu; Alex,99,0,100,1
1708250208475,CSE 140,B01,410622,Eldon; John,130,0,146,16
1708250209002,CSE 140L,A01,410655,Orailoglu; Alex,98,0,100,2
1708250209002,CSE 140L,B01,410658,Eldon; John,123,0,146,23
1708250209535,CSE 141,A01,467486,Zhao; Jishen,173,0,196,23
1708250210061,CSE 141L,A01,410685,Eldon; John,162,0,196,34
1708250210587,CSE 145,A01,410713,Kastner; Ryan Charles,25,0,25,0
1708250211114,CSE 150B,A01,470824,Gao; Sicun,310,0,362,52
1708250211645,CSE 156,A01,467487,Nakashole; Ndapandula,140,0,192,52
1708250212177,CSE 165,A01,410757,Weibel; Nadir & Schulze; Jurgen P.,40,0,50,10
1708250212709,CSE 168,A01,410759,Ramamoorthi; Ravi,24,0,25,1
1708250212709,CSE 168,A02,410761,Ramamoorthi; Ravi,24,0,25,1
1708250213236,CSE 175,A01,410764,Kumar; Rakesh,48,0,50,2
1708250213770,CSE 182,A01,455011,Bafna; Vineet,47,0,50,3
1708250214298,CSE 185,A01,410895,Gymrek; Melissa Ann,41,0,57,16
1708250214298,CSE 185,A02,479240,Gymrek; Melissa Ann,53,0,58,5
1708250214826,CSE 190,A00,410982,Grier; Daniel T,48,0,50,2
1708250214826,CSE 190,B00,410983,Riek; Laurel D,50,0,50,0
1708250214826,CSE 190,C00,410984,Staff,36,0,50,14
1708250214826,CSE 190,D00,481666,Saha; Barna & Impagliazzo; Russell,27,0,28,1
1708250215352,CSE 203A,A00,410985,Saha; Barna & Impagliazzo; Russell,0,0,0,0
1708250215877,CSE 209A,A00,410986,Grier; Daniel T,0,0,0,0
1708250216403,CSE 209B,A00,410987,Bellare; Mihir,0,0,0,0
1708250216930,CSE 217,A01,459553,Weibel; Nadir,0,0,0,0
1708250217463,CSE 218,A00,410989,Griswold; William G.,0,0,0,0
1708250217990,CSE 219,A00,410990,Hollan; James D. & Xia; Haijun,0,0,0,0
1708250218517,CSE 224,A01,470832,Snoeren; Alex C.,0,0,0,0
1708250219043,CSE 229A,A00,410993,Shalev; Aaron D,0,0,0,0
1708250219572,CSE 229C,A00,410994,Fernandes; Earlence T,0,0,0,0
1708250220101,CSE 231,A01,467488,Jhala; Ranjit,0,0,0,0
1708250220630,CSE 233,A00,410996,Vianu; Victor Dan,0,0,0,0
1708250221162,CSE 237D,A00,410998,Kastner; Ryan Charles,0,0,0,0
1708250221691,CSE 239A,A00,410999,Vianu; Victor Dan,0,0,0,0
1708250222220,CSE 239B,A00,411000,Coblenz; Michael J,0,0,0,0
1708250222746,CSE 240A,A00,411001,Chin; Bryan W.,0,0,0,0
1708250223272,CSE 252D,A00,411004,Chandraker; Manmohan Krishna,0,0,0,0
1708250223797,CSE 256,A00,411005,Nakashole; Ndapandula,0,0,0,0
1708250224324,CSE 260,A01,467491,Chin; Bryan W.,0,0,0,0
1708250224850,CSE 276B,A00,411007,Riek; Laurel D,0,0,0,0
1708250225376,CSE 276F,A01,459554,Su; Hao,0,0,0,0
1708250225906,CSE 283,A00,411009,Bafna; Vineet & Zhong; Sheng,0,0,0,0
1708250226441,CSE 290,A00,411010,Gao; Sicun,0,0,0,0
1708250226441,CSE 290,B00,411011,Chern; Albert Ren-Haur,0,0,0,0
1708250226441,CSE 290,C00,411012,Swanson; Steven James,0,0,0,0
1708250226441,CSE 290,E00,411013,Su; Hao,0,0,0,0
1708250226441,CSE 290,F00,411014,Riek; Laurel D,0,0,0,0
1708250226441,CSE 290,G00,411015,Gymrek; Melissa Ann,0,0,0,0
1708250226441,CSE 290,H00,479239,Dasgupta; Sanjoy & Gymrek; Melissa Ann,0,0,0,0
1708250226441,CSE 290,I00,481669,Bafna; Vineet,0,0,0,0
1708250226441,CSE 290,J00,494949,Paturi; Ramamohan,0,0,0,0
1708250226972,CSE 291,A00,411016,Li; Tzumao,0,0,0,0
1708250226972,CSE 291,B00,411017,Heninger; Nadia A,0,0,0,0
1708250226972,CSE 291,C00,411114,Chern; Albert Ren-Haur,0,0,0,0
1708250226972,CSE 291,D00,411115,Zhang; Yiying,0,0,0,0
1708250226972,CSE 291,E00,411116,Cheng; Chung Kuan,0,0,0,0
1708250226972,CSE 291,G00,411118,Lerner; Sorin,0,0,0,0
1708250226972,CSE 291,I00,481509,Shang; Jingbo,0,0,0,0
1708250226972,CSE 291,J00,494844,Savage; Stefan & Stefan; Deian,50,0,50,0
1708250227515,CSE 293,001,487239,Bafna; Vineet,9999,0,9999,0
1708250227515,CSE 293,002,487240,Bellare; Mihir,9999,0,9999,0
1708250227515,CSE 293,003,487241,Berg-Kirkpatrick; Taylor D,9999,0,9999,0
1708250227515,CSE 293,004,487242,Chandraker; Manmohan Krishna,9999,0,9999,0
1708250227515,CSE 293,005,487243,Cheng; Chung Kuan,9999,0,9999,0
1708250227515,CSE 293,006,487244,Christensen; Henrik I,9999,0,9999,0
1708250227515,CSE 293,007,487245,Coblenz; Michael J,9999,0,9999,0
1708250227515,CSE 293,008,487363,Cottrell; Garrison W,9999,0,9999,0
1708250227515,CSE 293,009,487366,Deutsch; Alin Bernard,9999,0,9999,0
1708250227515,CSE 293,010,487433,Esmaeilzadeh; Hadi,9999,0,9999,0
1708250227515,CSE 293,011,487434,Freund; Yoav,9999,0,9999,0
1708250227515,CSE 293,012,487455,Griswold; William G.,9999,0,9999,0
1708250227515,CSE 293,013,487469,Gymrek; Melissa Ann,9999,0,9999,0
1708250227515,CSE 293,014,487470,Heninger; Nadia A,9999,0,9999,0
1708250227515,CSE 293,015,487471,Impagliazzo; Russell,9999,0,9999,0
1708250227515,CSE 293,016,487472,Jhala; Ranjit,9999,0,9999,0
1708250227515,CSE 293,017,487473,Kahng; Andrew Byun,9999,0,9999,0
1708250227515,CSE 293,018,487474,Kane; Daniel Mertz,9999,0,9999,0
1708250227515,CSE 293,019,487475,Kriegman; David J,9999,0,9999,0
1708250227515,CSE 293,020,487476,Kumar; Arun Kumar,9999,0,9999,0
1708250227515,CSE 293,021,487477,Lerner; Sorin,9999,0,9999,0
1708250227515,CSE 293,022,487478,Lovett; Shachar,9999,0,9999,0
1708250227515,CSE 293,023,487520,McAuley; Julian John,9999,0,9999,0
1708250227515,CSE 293,024,487522,Micciancio; Daniele,9999,0,9999,0
1708250227515,CSE 293,025,487577,Orailoglu; Alex,9999,0,9999,0
1708250227515,CSE 293,026,487586,Pannuto; Patrick William,9999,0,9999,0
1708250227515,CSE 293,027,487598,Paturi; Ramamohan,9999,0,9999,0
1708250227515,CSE 293,028,487604,Polikarpova; Nadezhda,9999,0,9999,0
1708250227515,CSE 293,029,487609,Politz; Joseph Gibbs,9999,0,9999,0
1708250227515,CSE 293,030,487642,Porter; George M,9999,0,9999,0
1708250227515,CSE 293,031,487665,Porter; Leonard Emerson,9999,0,9999,0
1708250227515,CSE 293,032,487689,Ramamoorthi; Ravi,9999,0,9999,0
1708250227515,CSE 293,033,487698,Riek; Laurel D,9999,0,9999,0
1708250227515,CSE 293,034,487712,Sahoo; Debashis,9999,0,9999,0
1708250227515,CSE 293,035,487721,Saul; Lawrence,9999,0,9999,0
1708250227515,CSE 293,036,487735,Savage; Stefan,9999,0,9999,0
1708250227515,CSE 293,037,487744,Schulze; Jurgen P.,9999,0,9999,0
1708250227515,CSE 293,038,487758,Snoeren; Alex C.,9999,0,9999,0
1708250227515,CSE 293,039,487767,Shang; Jingbo,9999,0,9999,0
1708250227515,CSE 293,040,487790,Stefan; Deian,9999,0,9999,0
1708250227515,CSE 293,041,487817,Su; Hao,9999,0,9999,0
1708250227515,CSE 293,042,487827,Swanson; Steven James,9999,0,9999,0
1708250227515,CSE 293,043,487830,Tullsen; Dean Michael,9999,0,9999,0
1708250227515,CSE 293,044,487837,Vaccaro; Kristen Marie,9999,0,9999,0
1708250227515,CSE 293,045,487838,Voelker; Geoffrey M.,9999,0,9999,0
1708250227515,CSE 293,046,487842,Zhao; Jishen,9999,0,9999,0
1708250227515,CSE 293,047,487847,Zhou; Yuan-Yuan,9999,0,9999,0
1708250227515,CSE 293,048,487852,Gao; Sicun,9999,0,9999,0
1708250227515,CSE 293,049,487853,Weibel; Nadir,9999,0,9999,0
1708250227515,CSE 293,050,487854,Gupta; Rajesh K.,9999,0,9999,0
1708250227515,CSE 293,051,487855,Soosai Raj; Adalbert Geral,9999,0,9999,0
1708250227515,CSE 293,052,494373,Zhang; Hao,9999,0,9999,0
1708250228040,CSE 294,A00,411124,Voelker; Geoffrey M.,15,0,15,0
1708250228567,CSS 100,A01,396053,Trott; Sean Thomas,43,0,50,7
1708250229097,CSS 120,A01,479237,Mignozzetti; Umberto,47,0,50,3
1708250229097,CSS 120,A02,479238,Mignozzetti; Umberto,50,0,50,0
1708250229624,CSS 209,A00,396054,Styler; William Francis,21,0,35,14
1708250230150,CSS 296,001,396055,Mignozzetti; Umberto,0,0,0,1
1708250230150,CSS 296,002,396056,Styler; William Francis,0,0,0,1
1708250230150,CSS 296,003,396057,Broz; James Lawrence,0,0,0,2
1708250230150,CSS 296,004,396058,Elliott; Graham,0,0,0,5
1708250230150,CSS 296,005,396059,Sun; Feiyang,0,0,0,0
1708250230150,CSS 296,006,396060,Dewaard; Andrew Michael,0,0,0,0
1708250230679,DDPM 210,A00,400652,Ma; Joseph David,36,0,36,0
1708250231204,DDPM 211,A00,400653,Ma; Joseph David,36,0,36,0
1708250231729,DDPM 214,A00,400720,Ma; Joseph David,36,0,36,0
1708250232255,DERM 296,001,464131,Staff,50,0,50,0
1708250232255,DERM 296,002,464178,Staff,50,0,50,0
1708250232255,DERM 296,003,464181,Staff,50,0,50,0
1708250232800,DOC 3,A01,399409,Strom; Megan C.,0,0,0,0
1708250232800,DOC 3,A02,399414,Strom; Megan C.,0,0,0,0
1708250232800,DOC 3,A03,399432,Strom; Megan C.,0,0,0,0
1708250232800,DOC 3,A04,399461,Strom; Megan C.,0,0,0,0
1708250232800,DOC 3,A05,399470,Strom; Megan C.,0,0,0,0
1708250232800,DOC 3,A06,399476,Strom; Megan C.,0,0,0,0
1708250232800,DOC 3,A07,399547,Strom; Megan C.,0,0,0,0
1708250232800,DOC 3,A08,399548,Strom; Megan C.,0,0,0,0
1708250232800,DOC 3,A09,399675,Strom; Megan C.,0,0,0,0
1708250232800,DOC 3,A10,399687,Strom; Megan C.,0,0,0,0
1708250232800,DOC 3,A11,399704,Strom; Megan C.,0,0,0,0
1708250232800,DOC 3,A12,399707,Strom; Megan C.,0,0,0,0
1708250232800,DOC 3,A13,399714,Strom; Megan C.,0,0,0,0
1708250232800,DOC 3,A14,399721,Strom; Megan C.,0,0,0,0
1708250232800,DOC 3,A15,399765,Strom; Megan C.,0,0,0,0
1708250232800,DOC 3,A16,399766,Strom; Megan C.,0,0,0,0
1708250232800,DOC 3,B01,399786,Strom; Megan C.,0,0,0,0
1708250232800,DOC 3,B02,399787,Strom; Megan C.,0,0,0,0
1708250232800,DOC 3,B03,399788,Strom; Megan C.,0,0,0,0
1708250232800,DOC 3,B04,399845,Strom; Megan C.,0,0,0,0
1708250232800,DOC 3,B05,399846,Strom; Megan C.,0,0,0,0
1708250232800,DOC 3,B06,399895,Strom; Megan C.,0,0,0,0
1708250232800,DOC 3,B07,399916,Strom; Megan C.,0,0,0,0
1708250232800,DOC 3,B08,400073,Strom; Megan C.,0,0,0,0
1708250232800,DOC 3,B09,400074,Strom; Megan C.,0,0,0,0
1708250232800,DOC 3,B10,400076,Strom; Megan C.,0,0,0,0
1708250232800,DOC 3,B11,400077,Strom; Megan C.,0,0,0,0
1708250232800,DOC 3,B12,400078,Strom; Megan C.,0,0,0,0
1708250232800,DOC 3,B13,400079,Strom; Megan C.,0,0,0,0
1708250232800,DOC 3,B14,400080,Strom; Megan C.,0,0,0,0
1708250232800,DOC 3,B15,400081,Strom; Megan C.,0,0,0,0
1708250232800,DOC 3,B16,400082,Strom; Megan C.,0,0,0,0
1708250232800,DOC 3,C01,400084,Chapman; Dillon,0,0,0,0
1708250232800,DOC 3,C02,400085,Chapman; Dillon,0,0,0,0
1708250232800,DOC 3,C03,400086,Chapman; Dillon,0,0,0,0
1708250232800,DOC 3,C04,400087,Chapman; Dillon,0,0,0,0
1708250232800,DOC 3,C05,400113,Chapman; Dillon,0,0,0,0
1708250232800,DOC 3,C06,400114,Chapman; Dillon,0,0,0,0
1708250232800,DOC 3,C07,400117,Chapman; Dillon,0,0,0,0
1708250232800,DOC 3,C08,400118,Chapman; Dillon,0,0,0,0
1708250232800,DOC 3,C09,400119,Chapman; Dillon,0,0,0,0
1708250232800,DOC 3,C10,400121,Chapman; Dillon,0,0,0,0
1708250232800,DOC 3,C11,400122,Chapman; Dillon,0,0,0,0
1708250232800,DOC 3,C12,400126,Chapman; Dillon,0,0,0,0
1708250232800,DOC 3,C13,400157,Chapman; Dillon,0,0,0,0
1708250232800,DOC 3,C14,400240,Chapman; Dillon,0,0,0,0
1708250232800,DOC 3,C15,400241,Chapman; Dillon,0,0,0,0
1708250232800,DOC 3,C16,400242,Chapman; Dillon,0,0,0,0
1708250232800,DOC 3,D01,400253,Chapman; Dillon,0,0,0,0
1708250232800,DOC 3,D02,400294,Chapman; Dillon,0,0,0,0
1708250232800,DOC 3,D03,400295,Chapman; Dillon,0,0,0,0
1708250232800,DOC 3,D04,400430,Chapman; Dillon,0,0,0,0
1708250232800,DOC 3,D05,400438,Chapman; Dillon,0,0,0,0
1708250232800,DOC 3,D06,400439,Chapman; Dillon,0,0,0,0
1708250232800,DOC 3,D07,400441,Chapman; Dillon,0,0,0,0
1708250232800,DOC 3,D08,400442,Chapman; Dillon,0,0,0,0
1708250232800,DOC 3,D09,400443,Chapman; Dillon,0,0,0,0
1708250232800,DOC 3,D10,400445,Chapman; Dillon,0,0,0,0
1708250232800,DOC 3,D11,400446,Chapman; Dillon,0,0,0,0
1708250232800,DOC 3,D12,400447,Chapman; Dillon,0,0,0,0
1708250232800,DOC 3,D13,400448,Chapman; Dillon,0,0,0,0
1708250232800,DOC 3,D14,400646,Chapman; Dillon,0,0,0,0
1708250232800,DOC 3,D15,400647,Chapman; Dillon,0,0,0,0
1708250232800,DOC 3,D16,400648,Chapman; Dillon,0,0,0,0
1708250233328,DOC 100D,A00,400649,Pass; Natalye Joann,22,0,25,3
1708250233328,DOC 100D,B00,400650,Pass; Natalye Joann,25,0,25,0
1708250233866,DSC 10,A01,398041,Tiefenbruck; Janine LoBue,142,0,147,5
1708250233866,DSC 10,B01,398180,Tiefenbruck; Janine LoBue,144,0,147,3
1708250233866,DSC 10,C01,398400,Tiefenbruck; Janine LoBue,143,0,147,4
1708250234469,DSC 20,A01,398415,Langlois; Marina,200,0,200,0
1708250235002,DSC 30,A01,398436,Langlois; Marina,156,0,158,2
1708250235002,DSC 30,B01,398439,Langlois; Marina,144,0,150,6
1708250235529,DSC 40A,A01,398441,Rampure; Suraj,123,0,125,2
1708250235529,DSC 40A,B01,398443,Rampure; Suraj,125,0,125,0
1708250236061,DSC 40B,A01,398445,Staff,150,0,150,0
1708250236587,DSC 80,A01,398470,Lau; Samuel Ethan,70,0,70,0
1708250236587,DSC 80,B01,398541,Lau; Samuel Ethan,68,0,70,2
1708250237115,DSC 95,A01,398650,Rampure; Suraj,50,0,50,0
1708250237641,DSC 100,A01,398683,Salimi; Babak,147,0,150,3
1708250238166,DSC 102,A01,398708,Jin; Haojian,145,0,150,5
1708250238696,DSC 106,A01,398711,Wilber; Jared Dane,146,0,149,3
1708250239224,DSC 140A,A01,398724,Eldridge; Justin Matthew,98,0,100,2
1708250239224,DSC 140A,B01,479346,Ustun; Tevfik Berk,50,0,50,0
1708250239750,DSC 140B,A01,398726,Weng; Tsui-Wei (lily),144,0,150,6
1708250240284,DSC 190,A01,398738,Silberman; Jack,20,0,20,0
1708250240284,DSC 190,B01,479475,Ustun; Tevfik Berk,29,0,30,1
1708250240284,DSC 190,C01,481341,Rahman; Tauhidur,50,0,50,0
1708250240813,DSC 197,001,494360,Eldridge; Justin Matthew,9999,0,9999,0
1708250241339,DSC 214,A00,477322,Staff,21,0,60,39
1708250241865,DSC 231,A01,398863,Gupta; Rajesh K.,60,0,60,0
1708250242392,DSC 232R,A01,487133,Solares; Edwin A,39,0,60,21
1708250242918,DSC 240,A00,398957,Belkin; Mikhail,74,0,90,16
1708250243971,DSC 243,A00,398958,Ma; Yian,59,0,60,1
1708250244498,DSC 245,A00,398959,Huang; Biwei,41,0,60,19
1708250245022,DSC 253,A00,398960,Shang; Jingbo,0,0,30,30
1708250245549,DSC 258R,A01,398962,Shang; Jingbo,43,0,60,17
1708250246078,DSC 267R,A01,398964,Staff,56,0,60,4
1708250246607,DSC 291,A00,398965,Belkin; Mikhail,90,0,90,0
1708250246607,DSC 291,B00,398966,Weng; Tsui-Wei (lily),90,0,90,0
1708250246607,DSC 291,C00,398997,Staff,60,0,60,0
1708250246607,DSC 291,D00,398998,Zhang; Hao,40,0,40,0
1708250246607,DSC 291,E00,477386,Staff,50,0,50,0
1708250247133,DSC 293,A00,477388,Ustun; Tevfik Berk,9989,0,9999,10
1708250247660,DSC 295,A00,480826,Danks; David J,30,0,40,10
1708250248187,DSE 220,A00,398034,Dasgupta; Sanjoy,20,0,20,0
1708250248713,DSE 230,A00,398035,Nguyen; Mai Huong,20,0,20,0
1708250249242,DSE 260B,A00,398037,Altintas De Callaf; Ilkay,20,0,20,0
1708250249769,DSGN 1,A01,408210,Klemmer; Scott R,46,0,50,4
1708250249769,DSGN 1,A02,408245,Klemmer; Scott R,47,0,50,3
1708250250294,DSGN 119,A00,407467,Hollan; James D. & Xia; Haijun,76,0,90,14
1708250250824,DSGN 160,A00,494371,Aronoff-Spencer; Eliah Sea,15,0,20,5
1708250251350,DSGN 219,A00,474323,Hollan; James D. & Xia; Haijun,15,0,15,0
1708250251876,ECE 5,A01,428645,Morris; Karcher William,21,0,24,3
1708250251876,ECE 5,A02,428646,Morris; Karcher William,24,0,24,0
1708250251876,ECE 5,A03,428647,Morris; Karcher William,24,0,24,0
1708250251876,ECE 5,A04,428648,Morris; Karcher William,24,0,24,0
1708250252403,ECE 15,A01,428650,Sahay; Rajeev,119,0,120,1
1708250252936,ECE 16,A01,428652,Wang; Edward Jay,22,0,30,8
1708250253462,ECE 17,A01,428654,Sahay; Rajeev,48,0,60,12
1708250253996,ECE 25,A50,428657,Dey; Sujit,30,0,30,0
1708250253996,ECE 25,A51,428658,Dey; Sujit,30,0,30,0
1708250254529,ECE 30,A50,428674,Mir Arabbaygi; Siavash,28,0,30,2
1708250254529,ECE 30,A51,428675,Mir Arabbaygi; Siavash,28,0,30,2
1708250254529,ECE 30,A52,428676,Mir Arabbaygi; Siavash,28,0,30,2
1708250254529,ECE 30,A53,428679,Mir Arabbaygi; Siavash,29,0,30,1
1708250254529,ECE 30,A54,428680,Mir Arabbaygi; Siavash,30,0,30,0
1708250255059,ECE 35,A50,428684,Taur; Yuan,29,0,30,1
1708250255059,ECE 35,A51,428685,Taur; Yuan,30,0,30,0
1708250255059,ECE 35,A52,428686,Taur; Yuan,30,0,30,0
1708250255059,ECE 35,A53,428687,Taur; Yuan,29,0,30,1
1708250255585,ECE 45,A01,428689,Zeger; Kenneth A.,137,0,150,13
1708250256112,ECE 65,A50,428701,Baghdadchi; Saharnaz,28,0,30,2
1708250256112,ECE 65,A51,428742,Baghdadchi; Saharnaz,29,0,30,1
1708250256112,ECE 65,A52,428743,Baghdadchi; Saharnaz,30,0,30,0
1708250256112,ECE 65,A53,428754,Baghdadchi; Saharnaz,26,0,30,4
1708250256112,ECE 65,A54,428796,Baghdadchi; Saharnaz,30,0,30,0
1708250256112,ECE 65,A55,428797,Baghdadchi; Saharnaz,29,0,30,1
1708250256112,ECE 65,A56,428803,Baghdadchi; Saharnaz,30,0,30,0
1708250256640,ECE 100,A01,428978,Baghdadchi; Saharnaz,29,0,30,1
1708250256640,ECE 100,A02,428988,Baghdadchi; Saharnaz,30,0,30,0
1708250256640,ECE 100,A03,428989,Baghdadchi; Saharnaz,29,0,30,1
1708250256640,ECE 100,A04,429008,Baghdadchi; Saharnaz,29,0,30,1
1708250257169,ECE 101,A01,429017,Bharadia; Dinesh,57,0,60,3
1708250257169,ECE 101,A02,429019,Bharadia; Dinesh,60,0,60,0
1708250257694,ECE 103,A01,429027,Kuzum; Duygu,74,0,75,1
1708250258224,ECE 107,A01,429055,Fullerton; Eric E,73,0,75,2
1708250258758,ECE 108,A01,429068,Kang; Mingu,53,0,60,7
1708250259283,ECE 109,A01,429085,Orlitsky; Alon,98,0,100,2
1708250259283,ECE 109,A02,429098,Orlitsky; Alon,96,0,100,4
1708250259813,ECE 111,A01,429132,Turakhia; Yatish Girish,173,0,180,7
1708250260339,ECE 115,A01,429314,Yip; Michael,22,0,26,4
1708250260867,ECE 123,A01,429327,Sievenpiper; Daniel F.,56,0,60,4
1708250261394,ECE 125B,A50,429397,Esmaili; Gholamreza,23,0,24,1
1708250261394,ECE 125B,A51,429627,Esmaili; Gholamreza,23,0,24,1
1708250261920,ECE 134,A00,429630,Ng; Tse Nga,50,0,50,0
1708250262447,ECE 136L,A01,429634,Dayeh; Shadi Ahmad,3,0,5,2
1708250262447,ECE 136L,A02,429636,Dayeh; Shadi Ahmad,3,0,5,2
1708250262447,ECE 136L,A03,429637,Dayeh; Shadi Ahmad,5,0,5,0
1708250262447,ECE 136L,A04,429641,Dayeh; Shadi Ahmad,5,0,5,0
1708250262974,ECE 139,A00,429642,Nomura; Kenji,17,0,20,3
1708250263502,ECE 140B,A01,455349,Khoshabeh; Ramsin & Gessner; Richard K.,19,0,24,5
1708250263502,ECE 140B,A02,455351,Khoshabeh; Ramsin & Gessner; Richard K.,23,0,24,1
1708250263502,ECE 140B,A03,455354,Khoshabeh; Ramsin & Gessner; Richard K.,21,0,22,1
1708250264032,ECE 141B,A01,455355,Gessner; Richard K.,48,0,50,2
1708250264558,ECE 148,A01,492803,Silberman; Jack,0,0,0,0
1708250265089,ECE 153,A01,429655,Naghizadeh Ardabili; Parin,94,0,100,6
1708250265615,ECE 157A,A01,429657,Bharadia; Dinesh,22,0,25,3
1708250266141,ECE 158B,A01,429659,Zhang; Xinyu,14,0,20,6
1708250266667,ECE 161C,A00,429660,Cosman; Pamela C.,58,0,60,2
1708250267194,ECE 163,A00,429664,Hsueh; Tzu-Chien,95,0,100,5
1708250267721,ECE 165,A51,429672,Mercier; Patrick Philip,20,0,30,10
1708250267721,ECE 165,A52,429673,Mercier; Patrick Philip,22,0,30,8
1708250267721,ECE 165,A53,429674,Mercier; Patrick Philip,30,0,30,0
1708250267721,ECE 165,A54,429675,Mercier; Patrick Philip,30,0,30,0
1708250268247,ECE 171A,A01,429813,Zheng; Yang,96,0,100,4
1708250268773,ECE 175B,A01,429886,Xie; Pengtao,72,0,75,3
1708250269302,ECE 183,A01,430023,Mookherjea; Shayan,26,0,30,4
1708250269827,ECE 185,A01,430025,Papen; George C.,19,0,20,1
1708250270356,ECE 191,A00,430039,Zhang; Xinyu,30,0,30,0
1708250270886,ECE 196,A00,430040,Morris; Karcher William,18,0,24,6
1708250270886,ECE 196,B00,430045,Morris; Karcher William,23,0,24,1
1708250271420,ECE 198,001,430052,Nguyen; Truong Quang,9999,0,9999,0
1708250271965,ECE 200,001,438659,Atanasov; Nikolay A.,9999,0,9999,0
1708250271965,ECE 200,002,438660,Bharadia; Dinesh,9999,0,9999,0
1708250271965,ECE 200,003,438668,Cheng; Chung Kuan,9999,0,9999,0
1708250271965,ECE 200,004,438845,Cosman; Pamela C.,9999,0,9999,0
1708250271965,ECE 200,005,438846,Dayeh; Shadi Ahmad,9999,0,9999,0
1708250271965,ECE 200,006,438847,Fainman; Yeshaiahu,9999,0,9999,0
1708250271965,ECE 200,007,438848,Ford; Joseph Earl,9999,0,9999,0
1708250271965,ECE 200,008,438849,Franceschetti; Massimo,9999,0,9999,0
1708250271965,ECE 200,009,438850,Fullerton; Eric E,9999,0,9999,0
1708250271965,ECE 200,010,438851,Galton; Ian A,9999,0,9999,0
1708250271965,ECE 200,011,438852,Gilja; Vikash,9999,0,9999,0
1708250271965,ECE 200,012,438853,Hall; Drew A.,9999,0,9999,0
1708250271965,ECE 200,013,438854,Hsueh; Tzu-Chien,9999,0,9999,0
1708250271965,ECE 200,014,438855,Javidi; Tara,9999,0,9999,0
1708250271965,ECE 200,015,438865,Kahng; Andrew Byun,9999,0,9999,0
1708250271965,ECE 200,016,438866,Kim; Young-Han,9999,0,9999,0
1708250271965,ECE 200,017,438876,Koushanfar; Farinaz,9999,0,9999,0
1708250271965,ECE 200,018,438877,Kuzum; Duygu,9999,0,9999,0
1708250271965,ECE 200,019,438934,Le; Hanh-Phuc,9999,0,9999,0
1708250271965,ECE 200,020,438954,Lin; Bill,9999,0,9999,0
1708250271965,ECE 200,021,438955,Liu; Zhaowei,9999,0,9999,0
1708250271965,ECE 200,022,438957,Lo; Yu-Hwa,9999,0,9999,0
1708250271965,ECE 200,023,439086,Lomakin; Vitaliy,9999,0,9999,0
1708250271965,ECE 200,024,439087,Mercier; Patrick Philip,9999,0,9999,0
1708250271965,ECE 200,025,439088,Meyer; Florian,9999,0,9999,0
1708250271965,ECE 200,026,439090,Milstein; Laurence B.,9999,0,9999,0
1708250271965,ECE 200,027,439208,Mir Arabbaygi; Siavash,9999,0,9999,0
1708250271965,ECE 200,028,439209,Mookherjea; Shayan,9999,0,9999,0
1708250271965,ECE 200,029,439210,Morris; Karcher William,9999,0,9999,0
1708250271965,ECE 200,030,439211,Ng; Tse Nga,9999,0,9999,0
1708250271965,ECE 200,031,439219,Nguyen; Truong Quang,9999,0,9999,0
1708250271965,ECE 200,032,439220,Nomura; Kenji,9999,0,9999,0
1708250271965,ECE 200,033,439221,Orlitsky; Alon,9999,0,9999,0
1708250271965,ECE 200,034,439222,Pal; Piya,9999,0,9999,0
1708250271965,ECE 200,035,439223,Papen; George C.,9999,0,9999,0
1708250271965,ECE 200,036,439224,Radic; Stojan,9999,0,9999,0
1708250271965,ECE 200,037,439225,Rao; Bhaskar D.,9999,0,9999,0
1708250271965,ECE 200,038,439227,Rao; Ramesh R,9999,0,9999,0
1708250271965,ECE 200,039,439231,Rebeiz; Gabriel,9999,0,9999,0
1708250271965,ECE 200,040,439232,Sanford; John R,9999,0,9999,0
1708250271965,ECE 200,041,439302,Siegel; Paul H.,9999,0,9999,0
1708250271965,ECE 200,042,439303,Sievenpiper; Daniel F.,9999,0,9999,0
1708250271965,ECE 200,043,439305,Sworder; David D.,9999,0,9999,0
1708250271965,ECE 200,044,439306,Taur; Yuan,9999,0,9999,0
1708250271965,ECE 200,045,439419,Touri; Behrouz,9999,0,9999,0
1708250271965,ECE 200,046,439425,Trivedi; Mohan M.,9999,0,9999,0
1708250271965,ECE 200,047,439538,Vasconcelos; Nuno,9999,0,9999,0
1708250271965,ECE 200,048,439546,Wang; Xiaolong,9999,0,9999,0
1708250271965,ECE 200,049,439549,Xie; Pengtao,9999,0,9999,0
1708250271965,ECE 200,050,439551,Yip; Michael,9999,0,9999,0
1708250271965,ECE 200,051,439553,Zeger; Kenneth A.,9999,0,9999,0
1708250271965,ECE 200,052,439554,Zhang; Xinyu,9999,0,9999,0
1708250271965,ECE 200,053,439555,Zheng; Yang,9999,0,9999,0
1708250271965,ECE 200,054,439557,Turakhia; Yatish Girish,9999,0,9999,0
1708250271965,ECE 200,055,439558,Kang; Mingu,9999,0,9999,0
1708250271965,ECE 200,056,439560,Shi; Yuanyuan,9999,0,9999,0
1708250271965,ECE 200,057,439564,Wang; Edward Jay,9999,0,9999,0
1708250271965,ECE 200,058,439565,Antipa; Nicholas A,9999,0,9999,0
1708250271965,ECE 200,059,439566,Zheng; Yang,9999,0,9999,0
1708250271965,ECE 200,060,492991,Yu; Paul K L,9999,0,9999,0
1708250271965,ECE 200,061,492992,Ndao; Abdoulaye,9999,0,9999,0
1708250271965,ECE 200,062,493019,Naghizadeh Ardabili; Parin,9999,0,9999,0
1708250271965,ECE 200,063,493033,Sahay; Rajeev,9999,0,9999,0
1708250272492,ECE 208,A00,430053,Mir Arabbaygi; Siavash,0,0,0,0
1708250273021,ECE 212CN,A00,430054,Liu; Zhaowei,0,0,0,0
1708250273547,ECE 222C,A00,430055,Lomakin; Vitaliy,0,0,0,0
1708250274073,ECE 227,A00,430057,Franceschetti; Massimo,0,0,0,0
1708250274599,ECE 228,A00,430078,Shi; Yuanyuan,0,0,0,0
1708250275128,ECE 230C,A00,430079,Yu; Paul K L,0,0,0,0
1708250275658,ECE 235,A00,430081,Taur; Yuan,0,0,0,0
1708250276186,ECE 236B,A00,430082,Lo; Yu-Hwa,0,0,0,0
1708250276717,ECE 240C,A00,430083,Mookherjea; Shayan,0,0,0,0
1708250277243,ECE 250,A00,430115,Touri; Behrouz,0,0,0,0
1708250277770,ECE 251B,A00,430166,Vasconcelos; Manuela,0,0,0,0
1708250278303,ECE 258B,A00,430167,Milstein; Laurence B.,0,0,0,0
1708250278830,ECE 260C,A00,430168,Eldon; John,0,0,0,0
1708250279356,ECE 264B,A00,430169,Galton; Ian A,0,0,0,0
1708250279883,ECE 265B,A00,430170,Gudem; Prasad S.S.,0,0,0,0
1708250280409,ECE 266,A01,430273,Hall; Drew A.,0,0,0,0
1708250280938,ECE 271C,A00,430283,Vasconcelos; Nuno,0,0,0,0
1708250281464,ECE 272A,A01,430340,Poveda Fonseca; Jorge,0,0,0,0
1708250281988,ECE 273,A00,430352,Wang; Jun-Kun,0,0,0,0
1708250282514,ECE 276B,A00,430353,Atanasov; Nikolay A.,0,0,0,0
1708250283041,ECE 284,A00,430385,Wang; Edward,0,0,0,0
1708250283569,ECE 285,A00,430386,Wang; Xiaolong,0,0,0,0
1708250283569,ECE 285,B00,430387,Antipa; Nicholas A,0,0,0,0
1708250284100,ECON 1,A01,409576,Crane; Meredith Helen,87,0,100,13
1708250284100,ECON 1,A02,409577,Crane; Meredith Helen,96,0,100,4
1708250284100,ECON 1,A03,409578,Crane; Meredith Helen,97,0,100,3
1708250284635,ECON 2,A01,409580,Candido; Maria Teresa,70,0,75,5
1708250285162,ECON 3,A01,409582,Crane; Meredith Helen,109,0,120,11
1708250285162,ECON 3,A02,409583,Crane; Meredith Helen,114,0,115,1
1708250285162,ECON 3,A03,409584,Crane; Meredith Helen,110,0,115,5
1708250285688,ECON 4,A01,409586,Levkoff; Steven B.,88,0,92,4
1708250285688,ECON 4,A02,409587,Levkoff; Steven B.,89,0,90,1
1708250286217,ECON 5,A01,409589,Dai; Yinlin,53,0,58,5
1708250286217,ECON 5,A02,409590,Dai; Yinlin,56,0,58,2
1708250286217,ECON 5,A03,409591,Dai; Yinlin,54,0,54,0
1708250286217,ECON 5,A04,409593,Dai; Yinlin,55,0,55,0
1708250286217,ECON 5,B01,409595,Dai; Yinlin,57,0,58,1
1708250286217,ECON 5,B02,409596,Dai; Yinlin,49,0,49,0
1708250286217,ECON 5,B03,409597,Dai; Yinlin,59,0,59,0
1708250286217,ECON 5,B04,409598,Dai; Yinlin,55,0,55,0
1708250286217,ECON 5,C01,487209,Staff,40,0,45,5
1708250286745,ECON 100A,A01,409600,Famulari; Melissa,94,0,100,6
1708250286745,ECON 100A,A02,409601,Famulari; Melissa,98,0,100,2
1708250286745,ECON 100A,A03,409604,Famulari; Melissa,98,0,100,2
1708250286745,ECON 100A,B01,409610,Famulari; Melissa,76,0,80,4
1708250287272,ECON 100AH,A00,409612,Famulari; Melissa,19,0,20,1
1708250287854,ECON 100B,A01,409614,Grigoryan; Aram,109,0,120,11
1708250287854,ECON 100B,A02,409616,Grigoryan; Aram,117,0,120,3
1708250287854,ECON 100B,B01,409626,Grigoryan; Aram,47,0,50,3
1708250287854,ECON 100B,B02,409627,Grigoryan; Aram,49,0,50,1
1708250288385,ECON 100C,A01,409629,Levkoff; Steven B.,144,0,146,2
1708250288385,ECON 100C,B01,409632,Levkoff; Steven B.,143,0,146,3
1708250288916,ECON 106,A00,409633,Bowen; T. Renee,90,0,90,0
1708250289444,ECON 109T,A00,409634,Trevino; Isabel,18,0,20,2
1708250289973,ECON 110A,A01,409637,Staff,68,0,75,7
1708250290501,ECON 110B,A01,409663,Herreno Lopera; Juan,119,0,125,6
1708250290501,ECON 110B,A02,409682,Herreno Lopera; Juan,125,0,125,0
1708250290501,ECON 110B,B01,409734,Herreno Lopera; Juan,99,0,100,1
1708250291029,ECON 120A,A01,409739,Candido; Maria Teresa,84,0,90,6
1708250291029,ECON 120A,A02,409740,Candido; Maria Teresa,87,0,90,3
1708250291029,ECON 120A,B01,409742,Candido; Maria Teresa,85,0,90,5
1708250291029,ECON 120A,B02,409743,Candido; Maria Teresa,90,0,90,0
1708250291562,ECON 120B,A01,409748,Ma; Xinwei,128,0,130,2
1708250291562,ECON 120B,A02,409754,Ma; Xinwei,128,0,130,2
1708250291562,ECON 120B,B01,409756,Ma; Xinwei,25,0,40,15
1708250292088,ECON 120C,A01,409758,Sun; Yixiao,141,0,146,5
1708250292088,ECON 120C,B01,409762,Sun; Yixiao,144,0,146,2
1708250292619,ECON 129,A00,409763,Eckert; Fabian Paul,44,0,50,6
1708250293145,ECON 134,A00,409764,Gelber; Alexander Michael,45,0,50,5
1708250293145,ECON 134,B00,409765,Gelber; Alexander Michael,49,0,50,1
1708250293671,ECON 137,A00,409766,Niehaus; Paul,19,0,20,1
1708250294198,ECON 142,A00,409767,Trevino; Isabel,39,0,40,1
1708250294198,ECON 142,B00,409768,Trevino; Isabel,38,0,40,2
1708250294724,ECON 164,A00,409771,Muralidharan; Karthik,118,0,120,2
1708250295250,ECON 172A,A01,409773,Newhouse; Herbert S,67,0,75,8
1708250295776,ECON 172B,A01,409775,Newhouse; Herbert S,74,0,75,1
1708250295776,ECON 172B,B01,409777,Newhouse; Herbert S,71,0,75,4
1708250296830,ECON 191A,A00,409780,Cullen; Julie,20,0,20,0
1708250297360,ECON 200C,A00,409782,Du; Songzi,34,0,35,1
1708250297890,ECON 210C,A00,409784,Herreno Lopera; Juan & Wieland; Johannes Friedrich,35,0,35,0
1708250298415,ECON 220C,A00,409785,Sun; Yixiao,35,0,35,0
1708250298941,ECON 220F,A00,409786,Carson; Richard T,27,0,30,3
1708250299468,ECON 221,A00,409787,Zhu; Ying,25,0,25,0
1708250299997,ECON 241,A00,409788,Muralidharan; Karthik,18,0,20,2
1708250300523,ECON 243,A00,409789,Niehaus; Paul,18,0,20,2
1708250301049,ECON 248,A00,409790,Eckert; Fabian Paul,18,0,20,2
1708250301576,ECON 250C,A00,409791,Arnold; David Hall & Betts; Julian,25,0,25,0
1708250302103,ECON 268,A00,409792,Jacobsen; Mark,24,0,25,1
1708250302638,ECON 281,A00,409793,Meckel; Katherine Hunter,19,0,20,1
1708250302638,ECON 281,B00,409794,Herreno Lopera; Juan & Wieland; Johannes Friedrich,19,0,20,1
1708250302638,ECON 281,C00,477854,Herreno Lopera; Juan & Wieland; Johannes Friedrich,18,0,20,2
1708250303164,ECON 285,A00,409795,Eckert; Fabian Paul,20,0,20,0
1708250303693,ECON 286,A00,409796,Ma; Xinwei,15,0,15,0
1708250303693,ECON 286,B00,409797,Hamilton; James D.,15,0,15,0
1708250303693,ECON 286,C00,409798,Grigoryan; Aram,15,0,15,0
1708250303693,ECON 286,D00,409799,Niehaus; Paul,15,0,15,0
1708250304219,ECON 296,A00,409800,Eckert; Fabian Paul,20,0,20,0
1708250304745,EDS 31,A00,409801,Bussey; Thomas J,9,0,10,1
1708250305277,EDS 38,A01,409803,Chung; Luz Marina,25,0,25,0
1708250305803,EDS 39,A01,409805,Heinzman; Erica M.,24,0,25,1
1708250306329,EDS 102,A01,409807,Ambo; Theresa Jean,37,0,45,8
1708250306855,EDS 110R,A01,409809,Staff,42,0,50,8
1708250306855,EDS 110R,B01,481358,Staff,20,0,20,0
1708250307382,EDS 111,A00,479044,Wishard Guerra; Alison G.,56,0,60,4
1708250307910,EDS 117,A01,409818,Jones; Gabrielle Anastasia,21,0,23,2
1708250307910,EDS 117,A02,409819,Jones; Gabrielle Anastasia,23,0,23,0
1708250307910,EDS 117,A03,409820,Jones; Gabrielle Anastasia,22,0,23,1
1708250307910,EDS 117,A04,409821,Jones; Gabrielle Anastasia,21,0,21,0
1708250308437,EDS 118,A00,409828,Warstadt; Melissa Fawn,46,0,50,4
1708250308962,EDS 123,A00,409831,Bussey; Thomas J,10,0,10,0
1708250309491,EDS 124AR,A00,419352,Simon; Elizabeth A,82,0,100,18
1708250309491,EDS 124AR,B00,419377,Simon; Elizabeth A,97,0,100,3
1708250309491,EDS 124AR,C00,481485,Simon; Elizabeth A,25,0,25,0
1708250309491,EDS 124AR,D00,481490,Simon; Elizabeth A,25,0,25,0
1708250310018,EDS 124BR,A00,409838,Eguchi; Emi,53,0,75,22
1708250310018,EDS 124BR,B00,481363,Eguchi; Emi,25,0,25,0
1708250310545,EDS 125,A00,409839,Aragon; Maria Jose,48,0,50,2
1708250311072,EDS 126,A01,409843,Jones; Makeba,19,0,25,6
1708250311072,EDS 126,A02,409844,Jones; Makeba,25,0,25,0
1708250311072,EDS 126,A03,409846,Jones; Makeba,25,0,25,0
1708250311072,EDS 126,A04,409847,Jones; Makeba,25,0,25,0
1708250311598,EDS 128B,A01,409851,Pappas; Elizabeth,49,0,50,1
1708250312132,EDS 129C,A01,409906,Millstone; Rachel Diana,44,0,50,6
1708250312664,EDS 130,A01,409954,Mendez; Kathrina Mendoza,14,0,15,1
1708250312664,EDS 130,A02,409955,Mendez; Kathrina Mendoza,24,0,25,1
1708250312664,EDS 130,A03,409956,Mendez; Kathrina Mendoza,20,0,20,0
1708250313192,EDS 133,A01,409961,Bintliff; Amy S.V.,15,0,20,5
1708250313192,EDS 133,A02,409962,Bintliff; Amy S.V.,20,0,20,0
1708250313192,EDS 133,A03,489636,Bintliff; Amy S.V.,15,0,15,0
1708250313722,EDS 136,A01,409964,Chung; Luz Marina,30,0,30,0
1708250313722,EDS 136,A02,409977,Chung; Luz Marina,30,0,30,0
1708250314256,EDS 139,A00,479197,Millstone; Rachel Diana,42,0,50,8
1708250314256,EDS 139,B00,479198,Pappas; Elizabeth,49,0,50,1
1708250314256,EDS 139,C00,479199,Mendez; Kathrina Mendoza,58,0,60,2
1708250314256,EDS 139,D00,479200,Bintliff; Amy S.V.,56,0,60,4
1708250314256,EDS 139,E00,479201,Chung; Luz Marina,59,0,60,1
1708250314256,EDS 139,F00,479202,Bintliff; Amy S.V.,15,0,15,0
1708250314256,EDS 139,G00,479203,Mamas; Christoforos,27,0,30,3
1708250314256,EDS 139,H00,493997,Choi; Bailey Miyeon,28,0,30,2
1708250314784,EDS 141,A00,409979,Mamas; Christoforos,38,0,40,2
1708250315310,EDS 145,A01,409989,Choi; Bailey Miyeon,13,0,15,2
1708250315310,EDS 145,A02,409990,Choi; Bailey Miyeon,15,0,15,0
1708250315844,EDS 180,A00,409991,Chapman; Thandeka K,30,0,30,0
1708250315844,EDS 180,B00,409992,Ambo; Theresa Jean,24,0,25,1
1708250315844,EDS 180,C00,409993,Jones; Gabrielle Anastasia,20,0,20,0
1708250315844,EDS 180,D00,409994,Phuong; Andrew,24,0,24,0
1708250316369,EDS 198,001,487216,Eguchi; Emi,20,0,20,0
1708250316895,EDS 205B,A00,409995,Staff,40,0,45,5
1708250316895,EDS 205B,B00,409997,Staff,42,0,45,3
1708250317425,EDS 232,A00,409999,Hopkins; Megan Beth,9,0,12,3
1708250317952,EDS 255,A00,410001,Phuong; Andrew,14,0,15,1
1708250318492,EDS 257,A00,410003,Datnow; Amanda Lee,14,0,15,1
1708250319018,EDS 282,A00,479192,Daly; Alan J.,16,0,16,0
1708250319542,EDS 287B,A00,479193,Daly; Alan J.,16,0,16,0
1708250320071,EDS 288A,A00,410005,Staff,18,0,18,0
1708250320597,EDS 288C,A00,410007,Staff,18,0,18,0
1708250321124,EDS 289B,A01,410009,Daly; Alan J.,18,0,18,0
1708250321650,EDS 290,A00,410010,Black; Alison Michelle,30,0,30,0
1708250321650,EDS 290,B00,410012,Choi; Bailey Miyeon,29,0,30,1
1708250321650,EDS 290,C00,479205,Heinzman; Erica M.,0,0,0,0
1708250322179,EDS 291B,A01,479195,Daly; Alan J.,16,0,16,0
1708250322706,EDS 293B,A01,410016,Staff,18,0,18,0
1708250323236,EDS 294B,A00,479196,Burrell; Sade Renee,16,0,16,0
1708250323768,EDS 296,001,478927,Ambo; Theresa Jean,0,0,0,0
1708250323768,EDS 296,002,478935,Aragon; Maria Jose,0,0,0,1
1708250323768,EDS 296,003,478936,Chapman; Thandeka K,0,0,0,0
1708250323768,EDS 296,004,478942,Bintliff; Amy S.V.,0,0,0,0
1708250323768,EDS 296,005,478943,Clarke; Sherice Nicole,0,0,0,0
1708250323768,EDS 296,006,478967,Cohen; Shana R,0,0,0,1
1708250323768,EDS 296,007,478968,Datnow; Amanda Lee,0,0,0,0
1708250323768,EDS 296,008,478969,Daly; Alan J.,0,0,0,0
1708250323768,EDS 296,009,478970,Eguchi; Emi,0,0,0,0
1708250323768,EDS 296,010,478971,Fine; Sarah,0,0,0,0
1708250323768,EDS 296,011,478972,Jones; Gabrielle Anastasia,0,0,0,0
1708250323768,EDS 296,012,479020,Jones; Makeba,0,0,0,0
1708250323768,EDS 296,013,479021,Halter; Christopher P.,0,0,0,0
1708250323768,EDS 296,014,479027,Hofstetter; Carolyn,0,0,0,0
1708250323768,EDS 296,015,479028,Hopkins; Megan Beth,0,0,0,0
1708250323768,EDS 296,016,479034,Mamas; Christoforos,0,0,0,0
1708250323768,EDS 296,017,479035,Pollock; Mica,0,0,0,0
1708250323768,EDS 296,018,479036,Wishard Guerra; Alison G.,0,0,0,0
1708250323768,EDS 296,019,494549,Phuong; Andrew,0,0,0,0
1708250324295,EMED 296,001,464428,Singh; Sukhdeep,49,0,50,1
1708250324295,EMED 296,002,464438,Subramony; Rachna,49,0,50,1
1708250324295,EMED 296,003,464490,Staff,50,0,50,0
1708250324828,ENG 10,A00,399006,Evdokimenko; Ekaterina,30,0,30,0
1708250325355,ENG 100D,A00,399084,Ngo; Anh-Thu T.,33,0,50,17
1708250325882,ENG 100DR,A00,479230,Ngo; Anh-Thu T.,29,0,40,11
1708250326413,ENG 100L,A00,399163,Kleissl; Jan,6,0,6,0
1708250326413,ENG 100L,B00,399217,Bratton; Maryann,8,0,8,0
1708250326413,ENG 100L,C00,399218,Yu; Paul K L,8,0,8,0
1708250326413,ENG 100L,D00,399257,Bratton; Maryann,6,0,6,0
1708250326413,ENG 100L,E00,399258,de Oliveira; Mauricio,9,0,10,1
1708250326413,ENG 100L,F00,399314,Bratton; Maryann,7,0,7,0
1708250326413,ENG 100L,G00,399394,Boyle; Mary E. T.,14,0,15,1
1708250326941,ENVR 102,A00,400777,Daly; Heather Marie,19,0,20,1
1708250326941,ENVR 102,B00,400778,Montejo; Carolina,24,0,25,1
1708250326941,ENVR 102,C00,400791,Staff,23,0,25,2
1708250327475,ENVR 140,A01,400813,Siapno; Jacqueline A,12,0,15,3
1708250327475,ENVR 140,A02,400870,Siapno; Jacqueline A,15,0,15,0
1708250327475,ENVR 140,A03,400889,Siapno; Jacqueline A,15,0,15,0
1708250327475,ENVR 140,A04,400890,Siapno; Jacqueline A,15,0,15,0
1708250328002,ENVR 144,A01,400929,Herbst; Matthew,20,0,20,0
1708250328529,ERC 20,A00,400722,Evans; Ivan T,30,0,30,0
1708250329056,ESYS 103,A01,400931,Lerner; Amy M,32,0,34,2
1708250329056,ESYS 103,A02,400934,Lerner; Amy M,34,0,34,0
1708250329056,ESYS 103,A03,400938,Lerner; Amy M,28,0,34,6
1708250329056,ESYS 103,A04,400939,Lerner; Amy M,33,0,34,1
1708250329056,ESYS 103,A05,400940,Lerner; Amy M,34,0,34,0
1708250329056,ESYS 103,A06,400941,Lerner; Amy M,33,0,34,1
1708250329588,ESYS 187C,A01,400945,Hetherington; Elizabeth Dorsey,28,0,40,12
1708250329588,ESYS 187C,A02,400946,Hetherington; Elizabeth Dorsey,39,0,40,1
1708250330116,ETHN 3R,A01,400948,Streeby; Shelley,21,0,25,4
1708250330116,ETHN 3R,A02,401220,Streeby; Shelley,24,0,25,1
1708250330116,ETHN 3R,A03,401231,Streeby; Shelley,22,0,25,3
1708250330116,ETHN 3R,A04,401236,Streeby; Shelley,23,0,25,2
1708250330116,ETHN 3R,A05,401241,Streeby; Shelley,21,0,25,4
1708250330116,ETHN 3R,A06,401311,Streeby; Shelley,21,0,25,4
1708250330116,ETHN 3R,A07,401318,Streeby; Shelley,25,0,25,0
1708250330116,ETHN 3R,A08,401319,Streeby; Shelley,25,0,25,0
1708250330116,ETHN 3R,A09,401397,Streeby; Shelley,25,0,25,0
1708250330116,ETHN 3R,A10,401398,Streeby; Shelley,25,0,25,0
1708250330116,ETHN 3R,A11,401399,Streeby; Shelley,24,0,25,1
1708250330116,ETHN 3R,A12,401518,Streeby; Shelley,25,0,25,0
1708250330116,ETHN 3R,A13,401551,Streeby; Shelley,24,0,25,1
1708250330116,ETHN 3R,A14,401552,Streeby; Shelley,23,0,25,2
1708250330643,ETHN 30,A01,401554,Fuste; Jose Ignacio,24,0,25,1
1708250330643,ETHN 30,A02,401555,Fuste; Jose Ignacio,25,0,25,0
1708250330643,ETHN 30,A03,401556,Fuste; Jose Ignacio,25,0,25,0
1708250330643,ETHN 30,A04,401557,Fuste; Jose Ignacio,25,0,25,0
1708250331174,ETHN 100C,A00,401558,Museus; Samuel David,36,0,40,4
1708250331707,ETHN 101TV,A01,401560,Marez; Curtis F.,21,0,25,4
1708250331707,ETHN 101TV,A02,401564,Marez; Curtis F.,25,0,25,0
1708250332236,ETHN 108,A00,401584,Hankins; Sarah E.,25,0,29,4
1708250332762,ETHN 113A,A00,401657,Werner; Bradley T.,15,0,15,0
1708250333290,ETHN 114B,A00,401724,Frank; Ross H.,19,0,20,1
1708250333817,ETHN 120D,A01,401848,Alvarez; Luis A,8,0,10,2
1708250333817,ETHN 120D,A02,401853,Alvarez; Luis A,10,0,10,0
1708250334345,ETHN 125R,A00,401858,Sasaki; Christen T,39,0,50,11
1708250334872,ETHN 126,A00,401865,Tran; Ly Thi Hai,39,0,40,1
1708250335403,ETHN 127,A00,401866,Martin Sandino; Amanda Maria Yoland,24,0,25,1
1708250335933,ETHN 137,A00,401867,Martin Sandino; Amanda Maria Yoland,19,0,19,0
1708250336464,ETHN 139,A00,401992,Perreira; Christopher Michael,25,0,25,0
1708250336992,ETHN 143,A00,402059,Marez; Curtis F.,39,0,40,1
1708250337518,ETHN 144M,A00,402060,Jolivette; Andrew J,62,0,65,3
1708250338050,ETHN 150,A00,402158,Taylor-Garcia; Daphne,16,0,18,2
1708250338577,ETHN 153,A00,402160,Martinez-Matsuda; Veronica,24,0,25,1
1708250339103,ETHN 179,A00,402165,Richards; Stephanie F,23,0,25,2
1708250339631,ETHN 183,A00,402217,Steelman; Katherine Wallis,16,0,16,0
1708250340158,ETHN 186,A00,402313,Perez; Roy,15,0,15,0
1708250340690,ETHN 189,A00,479226,Museus; Samuel David,29,0,30,1
1708250341275,ETHN 196H,A00,402314,Espiritu; Yen,0,0,0,0
1708250341275,ETHN 196H,B00,402325,Perreira; Christopher Michael,0,0,0,0
1708250341275,ETHN 196H,C00,402344,Perez; Roy,0,0,0,0
1708250341275,ETHN 196H,D00,402345,Streeby; Shelley,0,0,0,0
1708250341275,ETHN 196H,E00,402346,Taylor-Garcia; Daphne,0,0,0,0
1708250341799,ETHN 200C,A00,402358,Fuste; Jose Ignacio,19,0,20,1
1708250342326,ETHN 230,A00,402359,Streeby; Shelley,16,0,20,4
1708250342858,ETHN 291,A00,402363,Perreira; Christopher Michael,16,0,20,4
1708250343385,EXPR 100,A00,477778,Staff,9999,0,9999,0
1708250343911,EXPR 105,A00,477779,Staff,9999,0,9999,0
1708250344442,EXPR 201,A00,477780,Staff,9999,0,9999,0
1708250344970,EXPR 205,A00,477781,Staff,9999,0,9999,0
1708250345502,FILM 87,A00,402794,Rahimi; Babak,19,0,20,1
1708250345502,FILM 87,B00,402796,Rahimi; Babak,20,0,20,0
1708250345502,FILM 87,C00,402821,Havis; Allan,19,0,20,1
1708250346030,FMPH 95,A00,481734,Larsen; Britta Ann,0,0,0,2
1708250347578,FMPH 101,A00,404648,Tan; Gene Brian,31,0,40,9
1708250348129,FMPH 102,A01,404692,Rana; Brinda Kanti,25,0,28,3
1708250348129,FMPH 102,A02,404714,Rana; Brinda Kanti,28,0,28,0
1708250348129,FMPH 102,B01,404739,Rana; Brinda Kanti,26,0,28,2
1708250348129,FMPH 102,B02,404746,Rana; Brinda Kanti,28,0,28,0
1708250348674,FMPH 110,A00,404747,Campbell; Chadwick Karl,52,0,55,3
1708250348674,FMPH 110,B00,404789,Zoumas-Morse; Christine E.,24,0,30,6
1708250349221,FMPH 120,A00,404792,Nguyen-Grozavu; France T.,48,0,60,12
1708250349755,FMPH 130,A00,404859,Gould; Carlos Francisco,49,0,55,6
1708250349755,FMPH 130,B00,479047,Ciborowski; Haley Minae,52,0,55,3
1708250350286,FMPH 155,A00,404864,Fielding-Miller; Rebecca,65,0,65,0
1708250350828,FMPH 161,A00,404865,Zoumas-Morse; Christine E.,27,0,35,8
1708250351353,FMPH 191,A00,404866,Eikey; Elizabeth Victoria,35,0,35,0
1708250351896,FMPH 194,A00,404938,Larsen; Britta Ann,0,0,0,0
1708250351896,FMPH 194,B00,404939,Marquez; Becky,0,0,0,0
1708250351896,FMPH 194,C00,404949,Nguyen-Grozavu; France T.,0,0,0,0
1708250351896,FMPH 194,D00,404950,Stone; Matthew David,0,0,0,0
1708250351896,FMPH 194,E00,404958,White; Anne Elizabeth Clar,0,0,0,0
1708250351896,FMPH 194,F00,404969,Zoumas-Morse; Christine E.,0,0,0,0
1708250352422,FMPH 223,A00,404977,Vaida; Florin,7,0,26,19
1708250352948,FMPH 225,A00,404978,Zou; Jingjing,0,0,0,0
1708250353479,FMPH 291,A00,404992,Salem; Rany Mansour,15,0,15,0
1708250353479,FMPH 291,C00,405005,Schwartzman; Armin,0,0,0,11
1708250353479,FMPH 291,D00,479113,Shadyab; Aladdin Hassan,0,0,0,0
1708250353479,FMPH 291,E00,479114,Shadyab; Aladdin Hassan,0,0,0,0
1708250353479,FMPH 291,F00,479115,Wynn; Adriane Michelle,0,0,0,3
1708250353479,FMPH 291,G00,479116,Xu; Ronghui,0,0,0,10
1708250353479,FMPH 291,H00,479119,Vaida; Florin,0,0,0,2
1708250354020,FPM 258C,A00,405129,Chen; Brian Hwa-Yang,11,0,15,4
1708250354564,FPM 259C,A00,405130,Nguyen; Annie Lu & Araneta; Maria Rosario Gorrez,4,0,5,1
1708250355091,FPM 278,A00,405131,Strong; David R,13,0,15,2
1708250355618,FPM 280C,A01,405133,Banegas; Matthew Patrick,10,0,10,0
1708250356146,FPM 296,001,464651,Johnson; Michelle Lee,49,0,50,1
1708250356146,FPM 296,002,464652,Staff,50,0,50,0
1708250356146,FPM 296,003,464653,Staff,50,0,50,0
1708250356676,FPM 297,001,479175,Vaida; Florin,9999,0,9999,0
1708250356676,FPM 297,002,494007,Strong; David R,9999,0,9999,0
1708250356676,FPM 297,003,494364,Bazzi; Angela Robertson,9999,0,9999,0
1708250357208,GLBH 20,A00,405134,Elwardani; Nile Regina,143,0,146,3
1708250357742,GLBH 100,A00,405135,Bhavsar; Radhika,68,0,70,2
1708250357742,GLBH 100,B00,477773,Villarino; Margarita,39,0,44,5
1708250357742,GLBH 100,C00,477855,Jenkins; Janis A.,20,0,20,0
1708250357742,GLBH 100,D00,481337,Mishra; Jyoti,40,0,40,0
1708250358267,GLBH 101,A00,405136,Sloane; Julia Kathryn,40,0,40,0
1708250358809,GLBH 107,A00,405137,Wilson; Brenda K,63,0,70,7
1708250359335,GLBH 111,A01,486865,Burgos; Jose L.,0,0,0,0
1708250359335,GLBH 111,B01,486867,Burgos; Jose L.,0,0,0,0
1708250359864,GLBH 114W,A00,405138,Walkover; Lillian B,17,0,17,0
1708250360390,GLBH 118,A00,405140,Wilson; Brenda K,31,0,32,1
1708250360917,GLBH 147,A00,405141,Stewart; Alexander B,40,0,40,0
1708250361445,GLBH 148,A00,405142,Olivas Hernandez; Olga Lid,93,0,100,7
1708250361976,GLBH 150B,A00,486855,Sanchez; Giselle,0,0,0,0
1708250362501,GLBH 181,A00,405154,Burgos; Jose L.,211,0,216,5
1708250363030,GLBH 215,A00,479241,Walkover; Lillian B,18,0,18,0
1708250363559,GLBH 260,A00,480722,Elwardani; Nile Regina,18,0,18,0
1708250364089,GSS 20,A00,405155,Siapno; Jacqueline A,25,0,30,5
1708250364618,GSS 25,A00,405156,Batarseh; Amanda Alicia,24,0,30,6
1708250365145,HDS 1,A01,405160,Reese; Clarissa Jane,25,0,25,0
1708250365145,HDS 1,A02,405168,Reese; Clarissa Jane,25,0,25,0
1708250365145,HDS 1,A03,405169,Reese; Clarissa Jane,22,0,25,3
1708250365145,HDS 1,A04,405170,Reese; Clarissa Jane,24,0,25,1
1708250365145,HDS 1,A05,405171,Reese; Clarissa Jane,23,0,25,2
1708250365145,HDS 1,A06,405172,Reese; Clarissa Jane,24,0,25,1
1708250365145,HDS 1,A07,405173,Reese; Clarissa Jane,24,0,25,1
1708250365671,HDS 60,A01,405175,Warstadt; Melissa Fawn,34,0,35,1
1708250365671,HDS 60,A02,405176,Warstadt; Melissa Fawn,33,0,35,2
1708250366197,HDS 95,A00,405177,Staff,38,0,40,2
1708250366728,HDS 120,A00,405178,Staff,0,0,0,0
1708250367253,HDS 122,A00,405179,Rodriguez; Victoria Calip,64,0,75,11
1708250367785,HDS 150,A00,405180,Staff,20,0,20,0
1708250367785,HDS 150,B00,405181,Staff,20,0,20,0
1708250367785,HDS 150,C00,405182,Staff,20,0,20,0
1708250368311,HDS 181,A01,405185,Bjorklund; Peter,30,0,30,0
1708250368837,HDS 191,A01,405187,Reese; Clarissa Jane,40,0,40,0
1708250368837,HDS 191,B01,405194,Staff,25,0,25,0
1708250369363,HIAF 113,A00,403736,Prestholdt; Jeremy,74,0,75,1
1708250369892,HIAF 114,A00,403738,Gyamfi; Bright,49,0,50,1
1708250370423,HIEA 132,A00,403740,Kletzer; Benjamin Nathan,25,0,30,5
1708250370949,HIEA 154,A00,403741,Henry; Todd A.,62,0,64,2
1708250371475,HIEU 139,A00,403742,Strasser; Ulrike,52,0,56,4
1708250372005,HIEU 171,A00,403743,Hansen; Jan Eric,62,0,64,2
1708250372531,HIEU 176,A00,403744,Hertz; Deborah,14,0,15,1
1708250373057,HIEU 183,A00,403800,Gallant; Thomas W.,15,0,15,0
1708250373583,HIEU 276,A00,403862,Hertz; Deborah,0,0,0,0
1708250374113,HIGL 127,A00,403802,Ivey; James Alexander,56,0,56,0
1708250374640,HIGR 201,A00,494372,Pineda De Avila; Nydia,9,0,10,1
1708250375166,HIGR 205,A00,403863,Strasser; Ulrike,11,0,15,4
1708250375693,HIGR 217C,A00,403864,Lu; Weijing,9,0,10,1
1708250376225,HIGR 239,A00,403865,Serlin; David,4,0,5,1
1708250376753,HIGR 240,A00,403875,Gates; Kelly,2,0,5,3
1708250377281,HILA 101,A00,403818,LeNeave; Kimiko Nicole,62,0,64,2
1708250377811,HILA 119,A00,403819,Kozameh; Sara J,47,0,50,3
1708250378339,HILA 144,A00,403821,Kozameh; Sara J,50,0,50,0
1708250378866,HILD 2C,A01,402843,Hendrickson; Gerald M.,31,0,32,1
1708250378866,HILD 2C,A02,403030,Hendrickson; Gerald M.,31,0,32,1
1708250378866,HILD 2C,A03,403042,Hendrickson; Gerald M.,32,0,32,0
1708250378866,HILD 2C,A04,403048,Hendrickson; Gerald M.,30,0,32,2
1708250378866,HILD 2C,A05,403049,Hendrickson; Gerald M.,32,0,32,0
1708250378866,HILD 2C,A06,403098,Hendrickson; Gerald M.,32,0,32,0
1708250379408,HILD 7C,A01,403501,Bermudez; Rosie Cano,27,0,32,5
1708250379408,HILD 7C,A02,403513,Bermudez; Rosie Cano,30,0,32,2
1708250379408,HILD 7C,A03,403570,Bermudez; Rosie Cano,32,0,32,0
1708250379408,HILD 7C,A04,403572,Bermudez; Rosie Cano,32,0,32,0
1708250379408,HILD 7C,A05,403587,Bermudez; Rosie Cano,32,0,32,0
1708250379408,HILD 7C,A06,403588,Bermudez; Rosie Cano,32,0,32,0
1708250379408,HILD 7C,A07,403589,Bermudez; Rosie Cano,29,0,32,3
1708250379408,HILD 7C,A08,403590,Bermudez; Rosie Cano,32,0,32,0
1708250379408,HILD 7C,A09,403601,Bermudez; Rosie Cano,30,0,32,2
1708250379408,HILD 7C,A10,403602,Bermudez; Rosie Cano,32,0,32,0
1708250379408,HILD 7C,A11,403603,Bermudez; Rosie Cano,32,0,32,0
1708250379408,HILD 7C,A12,403604,Bermudez; Rosie Cano,32,0,32,0
1708250379936,HILD 12,A01,403607,Henry; Todd A.,32,0,32,0
1708250379936,HILD 12,A02,403608,Henry; Todd A.,31,0,32,1
1708250379936,HILD 12,A03,403609,Henry; Todd A.,32,0,32,0
1708250379936,HILD 12,A04,403699,Henry; Todd A.,32,0,32,0
1708250379936,HILD 12,A05,403700,Henry; Todd A.,32,0,32,0
1708250379936,HILD 12,A06,403701,Henry; Todd A.,32,0,32,0
1708250380465,HILD 30,A01,403703,Soleiman; Matthew Teymour,29,0,32,3
1708250380465,HILD 30,A02,403704,Soleiman; Matthew Teymour,30,0,32,2
1708250380991,HINE 118,A00,403822,Kayali; Hasan,50,0,50,0
1708250381517,HISC 119,A00,403823,Golan; Tal,26,0,30,4
1708250382043,HISC 123,A00,403839,Pineda De Avila; Nydia,45,0,50,5
1708250382569,HITO 87,A00,403707,Patterson; Patrick H.,15,0,15,0
1708250382569,HITO 87,B00,403709,Patterson; Patrick H.,15,0,15,0
1708250382569,HITO 87,C00,403735,Schneewind; Sarah,15,0,15,0
1708250383112,HITO 100,B00,403841,Klann; Mary Cameron,24,0,25,1
1708250383638,HITO 170,A00,403842,Watts; Edward J.,8,0,10,2
1708250384167,HITO 193,A00,455333,Hill; Seth J,0,0,0,0
1708250384694,HIUS 114A,A00,403843,Lewandoski; Julia Mavis,52,0,56,4
1708250385221,HIUS 120D,A01,403854,Alvarez; Luis A,8,0,10,2
1708250385221,HIUS 120D,A02,403855,Alvarez; Luis A,10,0,10,0
1708250385747,HIUS 136,A00,403857,Martinez-Matsuda; Veronica,21,0,25,4
1708250386292,HIUS 144,A00,403858,Martinez-Matsuda; Veronica,55,0,56,1
1708250386292,HIUS 144,B00,403859,Vandevelde; Kenneth Joseph,54,0,56,2
1708250386292,HIUS 144,C00,403860,Klann; Mary Cameron,52,0,56,4
1708250386292,HIUS 144,D00,403861,Lewandoski; Julia Mavis,55,0,56,1
1708250386906,HUM 2,A01,422723,Watts; Edward J.,16,0,16,0
1708250386906,HUM 2,A02,422735,Watts; Edward J.,15,0,16,1
1708250386906,HUM 2,A03,422736,Watts; Edward J.,15,0,16,1
1708250386906,HUM 2,A04,422737,Watts; Edward J.,16,0,16,0
1708250386906,HUM 2,A05,422738,Watts; Edward J.,15,0,16,1
1708250386906,HUM 2,A06,422760,Watts; Edward J.,15,0,16,1
1708250386906,HUM 2,A07,422778,Watts; Edward J.,16,0,16,0
1708250386906,HUM 2,A08,422793,Watts; Edward J.,16,0,16,0
1708250386906,HUM 2,A09,422794,Watts; Edward J.,16,0,16,0
1708250386906,HUM 2,A10,422795,Watts; Edward J.,16,0,16,0
1708250386906,HUM 2,B01,422805,Markman; Kristina,13,0,16,3
1708250386906,HUM 2,B02,422806,Markman; Kristina,14,0,16,2
1708250386906,HUM 2,B03,422807,Markman; Kristina,14,0,16,2
1708250386906,HUM 2,B04,422808,Markman; Kristina,16,0,16,0
1708250386906,HUM 2,B05,422809,Markman; Kristina,16,0,16,0
1708250386906,HUM 2,B06,422842,Markman; Kristina,16,0,16,0
1708250386906,HUM 2,B07,422843,Markman; Kristina,15,0,16,1
1708250386906,HUM 2,B08,422848,Markman; Kristina,16,0,16,0
1708250386906,HUM 2,B09,422850,Markman; Kristina,15,0,16,1
1708250386906,HUM 2,B10,422851,Markman; Kristina,12,0,16,4
1708250386906,HUM 2,B11,422852,Markman; Kristina,15,0,16,1
1708250386906,HUM 2,B12,422853,Markman; Kristina,16,0,16,0
1708250386906,HUM 2,C01,422855,Rodriguez; Bretton Sigfred,15,0,16,1
1708250386906,HUM 2,C02,422856,Rodriguez; Bretton Sigfred,16,0,16,0
1708250386906,HUM 2,C03,422859,Rodriguez; Bretton Sigfred,15,0,16,1
1708250386906,HUM 2,C04,423106,Rodriguez; Bretton Sigfred,12,0,16,4
1708250386906,HUM 2,C05,423107,Rodriguez; Bretton Sigfred,15,0,16,1
1708250386906,HUM 2,C06,423108,Rodriguez; Bretton Sigfred,14,0,16,2
1708250386906,HUM 2,C07,423109,Rodriguez; Bretton Sigfred,15,0,16,1
1708250386906,HUM 2,C08,423110,Rodriguez; Bretton Sigfred,15,0,16,1
1708250386906,HUM 2,C09,423133,Rodriguez; Bretton Sigfred,14,0,16,2
1708250386906,HUM 2,C10,423134,Rodriguez; Bretton Sigfred,14,0,16,2
1708250386906,HUM 2,C11,423135,Rodriguez; Bretton Sigfred,16,0,16,0
1708250386906,HUM 2,C12,423136,Rodriguez; Bretton Sigfred,15,0,16,1
1708250386906,HUM 2,C13,423137,Rodriguez; Bretton Sigfred,16,0,16,0
1708250386906,HUM 2,C14,423138,Rodriguez; Bretton Sigfred,16,0,16,0
1708250386906,HUM 2,D01,423140,West; Geoffrey Scott,13,0,16,3
1708250386906,HUM 2,D02,423141,West; Geoffrey Scott,15,0,16,1
1708250386906,HUM 2,D03,423142,West; Geoffrey Scott,15,0,16,1
1708250386906,HUM 2,D04,423143,West; Geoffrey Scott,14,0,16,2
1708250386906,HUM 2,D05,423144,West; Geoffrey Scott,16,0,16,0
1708250386906,HUM 2,D06,423145,West; Geoffrey Scott,16,0,16,0
1708250386906,HUM 2,D07,423146,West; Geoffrey Scott,16,0,16,0
1708250386906,HUM 2,D08,423158,West; Geoffrey Scott,16,0,16,0
1708250386906,HUM 2,D09,423169,West; Geoffrey Scott,16,0,16,0
1708250386906,HUM 2,D10,423174,West; Geoffrey Scott,16,0,16,0
1708250386906,HUM 2,D11,423175,West; Geoffrey Scott,16,0,16,0
1708250386906,HUM 2,D12,423179,West; Geoffrey Scott,15,0,16,1
1708250386906,HUM 2,D13,423188,West; Geoffrey Scott,15,0,16,1
1708250386906,HUM 2,D14,423204,West; Geoffrey Scott,16,0,16,0
1708250387482,HUM 5,A01,423221,Lyon; Antony J.,26,0,30,4
1708250387482,HUM 5,A02,423232,Lyon; Antony J.,24,0,30,6
1708250387482,HUM 5,A03,423237,Lyon; Antony J.,18,0,30,12
1708250387482,HUM 5,A04,423240,Lyon; Antony J.,25,0,30,5
1708250387482,HUM 5,A05,423242,Lyon; Antony J.,28,0,30,2
1708250387482,HUM 5,A06,423244,Lyon; Antony J.,23,0,30,7
1708250387482,HUM 5,A07,423247,Lyon; Antony J.,27,0,30,3
1708250387482,HUM 5,A08,423254,Lyon; Antony J.,27,0,30,3
1708250387482,HUM 5,B01,423286,Patterson; Patrick H.,28,0,30,2
1708250387482,HUM 5,B02,423291,Patterson; Patrick H.,29,0,30,1
1708250387482,HUM 5,B03,423294,Patterson; Patrick H.,28,0,30,2
1708250387482,HUM 5,B04,423297,Patterson; Patrick H.,29,0,30,1
1708250387482,HUM 5,B05,423313,Patterson; Patrick H.,30,0,30,0
1708250387482,HUM 5,B06,423318,Patterson; Patrick H.,30,0,30,0
1708250387482,HUM 5,B07,423362,Patterson; Patrick H.,29,0,30,1
1708250387482,HUM 5,B08,423363,Patterson; Patrick H.,29,0,30,1
1708250387482,HUM 5,C01,423365,Caldwell; Michael Alan,23,0,30,7
1708250387482,HUM 5,C02,423474,Caldwell; Michael Alan,24,0,30,6
1708250387482,HUM 5,C03,423528,Caldwell; Michael Alan,30,0,30,0
1708250387482,HUM 5,C04,423529,Caldwell; Michael Alan,27,0,30,3
1708250387482,HUM 5,C05,423545,Caldwell; Michael Alan,30,0,30,0
1708250387482,HUM 5,C06,423546,Caldwell; Michael Alan,30,0,30,0
1708250387482,HUM 5,C07,423547,Caldwell; Michael Alan,29,0,30,1
1708250387482,HUM 5,C08,423548,Caldwell; Michael Alan,28,0,30,2
1708250388012,INTL 101,A01,404350,Day; Joel Keith,23,0,25,2
1708250388012,INTL 101,A02,404356,Day; Joel Keith,25,0,25,0
1708250388012,INTL 101,A03,404357,Day; Joel Keith,24,0,25,1
1708250388012,INTL 101,A04,404360,Day; Joel Keith,25,0,25,0
1708250388555,INTL 102,A01,404375,Fisk; David Lee,25,0,25,0
1708250388555,INTL 102,A02,404376,Fisk; David Lee,22,0,25,3
1708250388555,INTL 102,A03,404377,Fisk; David Lee,20,0,25,5
1708250388555,INTL 102,A04,404381,Fisk; David Lee,25,0,25,0
1708250389125,INTL 190,A00,404396,Samphantharak; Krislert,24,0,25,1
1708250389125,INTL 190,B00,404402,McIntosh; Justin Daniel,24,0,25,1
1708250389125,INTL 190,C00,404403,Vos; Stacie N.,24,0,25,1
1708250389125,INTL 190,D00,404404,Nadkarni; Vidya,24,0,25,1
1708250389125,INTL 190,E00,404407,Scott; Jeffrey F,25,0,25,0
1708250389125,INTL 190,F00,404409,Auerbach; Bradford C,25,0,25,0
1708250389125,INTL 190,G00,404442,Auerbach; Bradford C,25,0,25,0
1708250389125,INTL 190,H00,404465,Segui; Alan S,25,0,25,0
1708250389125,INTL 190,I00,404481,Segui; Alan S,25,0,25,0
1708250389817,JAPN 10C,A01,403881,Iwamoto; Naoki,15,0,15,0
1708250389817,JAPN 10C,B01,403884,McKee; Mayumi Mochizuki,15,0,15,0
1708250389817,JAPN 10C,C01,403887,Sato; Kyoko,10,0,10,0
1708250389817,JAPN 10C,C02,403888,Sato; Kyoko,10,0,10,0
1708250389817,JAPN 10C,D01,403890,Inada; Minori,8,0,10,2
1708250389817,JAPN 10C,D02,403891,Inada; Minori,10,0,10,0
1708250389817,JAPN 10C,E01,403893,Sato; Kyoko,10,0,10,0
1708250389817,JAPN 10C,E02,403894,Sato; Kyoko,10,0,10,0
1708250389817,JAPN 10C,F01,403896,McKee; Mayumi Mochizuki,10,0,10,0
1708250389817,JAPN 10C,F02,403897,McKee; Mayumi Mochizuki,10,0,10,0
1708250389817,JAPN 10C,G01,403899,Homma; Kunihiko,10,0,10,0
1708250389817,JAPN 10C,G02,403900,Homma; Kunihiko,10,0,10,0
1708250389817,JAPN 10C,H01,403902,Maruyama; Rie,10,0,10,0
1708250389817,JAPN 10C,H02,403903,Maruyama; Rie,9,0,10,1
1708250389817,JAPN 10C,I01,403905,Inada; Minori,10,0,10,0
1708250389817,JAPN 10C,I02,403906,Inada; Minori,9,0,10,1
1708250389817,JAPN 10C,J01,403915,Iwamoto; Naoki,10,0,10,0
1708250389817,JAPN 10C,J02,403916,Iwamoto; Naoki,9,0,10,1
1708250389817,JAPN 10C,K01,403918,Ross; Kayoko F,10,0,10,0
1708250389817,JAPN 10C,K02,403928,Ross; Kayoko F,10,0,10,0
1708250389817,JAPN 10C,L01,403935,Homma; Kunihiko,9,0,10,1
1708250389817,JAPN 10C,L02,403936,Homma; Kunihiko,10,0,10,0
1708250389817,JAPN 10C,M02,403939,Kamioka; Sachiko,13,0,15,2
1708250389817,JAPN 10C,N01,479041,Iwamoto; Naoki,15,0,15,0
1708250390344,JAPN 10CR,A01,403982,Inada; Minori,12,0,12,0
1708250390344,JAPN 10CR,A02,403983,Inada; Minori,12,0,12,0
1708250390886,JAPN 20C,A01,403988,Homma; Kunihiko,10,0,12,2
1708250390886,JAPN 20C,B02,404029,Kamioka; Sachiko,10,0,12,2
1708250390886,JAPN 20C,C01,404033,Takeda; Izumi,8,0,12,4
1708250390886,JAPN 20C,D02,404114,Kamioka; Sachiko,11,0,12,1
1708250390886,JAPN 20C,E01,404135,Simpson; Junko Tokuda,12,0,12,0
1708250391413,JAPN 130C,A01,404144,Maruyama; Rie,9,0,9,0
1708250391413,JAPN 130C,A02,404145,Maruyama; Rie,9,0,9,0
1708250391413,JAPN 130C,B01,404147,Simpson; Junko Tokuda,8,0,9,1
1708250391413,JAPN 130C,B02,404148,Simpson; Junko Tokuda,9,0,9,0
1708250391941,JAPN 135C,A00,404176,Ross; Kayoko F,16,0,16,0
1708250391941,JAPN 135C,B00,404253,Takeda; Izumi,14,0,16,2
1708250392469,JAPN 140C,A00,404255,Sato; Kyoko,18,0,20,2
1708250393012,JAPN 150C,A00,404258,McKee; Mayumi Mochizuki,14,0,14,0
1708250393542,JAPN 190,A00,404260,Miyao; Daisuke,17,0,20,3
1708250394072,JAPN 196B,001,487237,Turner; Christena L.,9999,0,9999,0
1708250394603,JWSP 3,A01,404485,Shuster; Alana,20,0,20,0
1708250395130,LATI 10,A01,405201,Kennemore; Amy Michelle,27,0,30,3
1708250395130,LATI 10,A02,405202,Kennemore; Amy Michelle,27,0,30,3
1708250395130,LATI 10,A03,405208,Kennemore; Amy Michelle,28,0,30,2
1708250395657,LATI 50,A01,405214,Kokinis; Troy Andreas,34,0,35,1
1708250395657,LATI 50,A02,405215,Kokinis; Troy Andreas,34,0,35,1
1708250396244,LATI 130,A01,482880,Alvarez; Camila Huerta,29,0,30,1
1708250396768,LATI 160,A01,477482,Kokinis; Troy Andreas,30,0,30,0
1708250397297,LATI 180,A00,405221,Kennemore; Amy Michelle,28,0,30,2
1708250397297,LATI 180,B00,405222,Mostajo; Lorena,30,0,30,0
1708250397824,LIAB 1C,A00,405278,Saab; Dima,13,0,14,1
1708250397824,LIAB 1C,B00,405279,Saab; Dima,11,0,14,3
1708250398356,LIAB 1CX,A00,405281,Akjeje; Abdelhak,19,0,20,1
1708250398356,LIAB 1CX,B00,405291,Akjeje; Abdelhak,20,0,20,0
1708250398885,LIAB 1F,A00,482814,El Cheddadi; Youniss,14,0,14,0
1708250399413,LIDS 19,001,492979,Goodall; Grant Todd,9999,0,9999,0
1708250399413,LIDS 19,002,492980,Goodall; Grant Todd,9999,0,9999,0
1708250399413,LIDS 19,003,492981,Goodall; Grant Todd,9999,0,9999,0
1708250399413,LIDS 19,004,492982,Goodall; Grant Todd,9999,0,9999,0
1708250399413,LIDS 19,005,492983,Goodall; Grant Todd,9999,0,9999,0
1708250399413,LIDS 19,006,492984,Goodall; Grant Todd,9999,0,9999,0
1708250399413,LIDS 19,007,492985,Goodall; Grant Todd,9999,0,9999,0
1708250399413,LIDS 19,008,492986,Goodall; Grant Todd,9999,0,9999,0
1708250399413,LIDS 19,009,492987,Goodall; Grant Todd,9999,0,9999,0
1708250399413,LIDS 19,010,492988,Goodall; Grant Todd,9999,0,9999,0
1708250399413,LIDS 19,011,492989,Goodall; Grant Todd,9999,0,9999,0
1708250399413,LIDS 19,012,492990,Goodall; Grant Todd,9999,0,9999,0
1708250399943,LIFR 1A,A00,405299,Van Moer; Vinciane G,13,0,14,1
1708250399943,LIFR 1A,B00,405300,Van Moer; Vinciane G,13,0,14,1
1708250399943,LIFR 1A,C00,405301,Van Moer; Vinciane G,13,0,14,1
1708250399943,LIFR 1A,D00,405307,Van Moer; Vinciane G,14,0,14,0
1708250400469,LIFR 1AX,A00,405308,Van Moer; Vinciane G,27,0,28,1
1708250400469,LIFR 1AX,B00,405309,Van Moer; Vinciane G,27,0,28,1
1708250400996,LIFR 1C,A00,405310,Van Moer; Vinciane G,14,0,14,0
1708250400996,LIFR 1C,B00,405311,Van Moer; Vinciane G,12,0,14,2
1708250400996,LIFR 1C,C00,405325,Van Moer; Vinciane G,13,0,14,1
1708250400996,LIFR 1C,D00,405326,Van Moer; Vinciane G,11,0,14,3
1708250401523,LIFR 1CX,A00,405332,Van Moer; Vinciane G,25,0,28,3
1708250401523,LIFR 1CX,B00,405333,Van Moer; Vinciane G,27,0,28,1
1708250402053,LIFR 1D,A00,405334,Van Moer; Vinciane G,13,0,14,1
1708250402053,LIFR 1D,B00,405335,Van Moer; Vinciane G,13,0,14,1
1708250402053,LIFR 1D,C00,405336,Van Moer; Vinciane G,13,0,14,1
1708250402053,LIFR 1D,D00,405337,Van Moer; Vinciane G,13,0,14,1
1708250402579,LIFR 1DX,A00,405338,Van Moer; Vinciane G,25,0,28,3
1708250402579,LIFR 1DX,B00,405394,Van Moer; Vinciane G,27,0,28,1
1708250403105,LIFR 11,001,405395,Goodall; Grant Todd,999,0,999,0
1708250403636,LIGM 1C,A00,405398,Fischer-Grunski; Eva K,12,0,14,2
1708250403636,LIGM 1C,B00,405400,Fischer-Grunski; Eva K,13,0,14,1
1708250403636,LIGM 1C,C00,405403,Fischer-Grunski; Eva K,13,0,14,1
1708250403636,LIGM 1C,D00,405404,Fischer-Grunski; Eva K,13,0,14,1
1708250404163,LIGM 1CX,A00,405407,Fischer-Grunski; Eva K,27,0,28,1
1708250404163,LIGM 1CX,B00,405408,Fischer-Grunski; Eva K,26,0,28,2
1708250404688,LIGM 11,001,405464,Goodall; Grant Todd,999,0,999,0
1708250405215,LIGN 8,A00,411133,McIntosh; Justin Daniel,232,0,240,8
1708250405740,LIGN 17,A00,411141,Kehler; Andrew Scott,287,0,300,13
1708250406269,LIGN 101,A01,411144,Staff,28,0,30,2
1708250406269,LIGN 101,A02,411147,Staff,29,0,30,1
1708250406269,LIGN 101,A03,411154,Staff,27,0,30,3
1708250406269,LIGN 101,A04,411163,Staff,29,0,30,1
1708250406809,LIGN 120,A01,411165,Ackerman; Farrell,28,0,30,2
1708250406809,LIGN 120,A02,411177,Ackerman; Farrell,23,0,27,4
1708250407336,LIGN 130,A01,411223,Staff,29,0,30,1
1708250407336,LIGN 130,A02,411231,Staff,30,0,30,0
1708250407336,LIGN 130,A03,411232,Staff,29,0,30,1
1708250407864,LIGN 141,A00,411276,Rose; Sharon,37,0,40,3
1708250408390,LIGN 144,A00,411277,Lott; Margaret S.,22,0,24,2
1708250408917,LIGN 148,A00,411278,Mayberry; Rachel,71,0,75,4
1708250409448,LIGN 165,A00,411279,Bergen; Leon,41,0,70,29
1708250409975,LIGN 168,A01,411281,Styler; William Francis,65,0,70,5
1708250410505,LIGN 175,A00,482816,Rodriguez Aispuro; Alejandro,35,0,40,5
1708250411035,LIGN 230,A00,411293,Caponigro; Ivano,19,0,20,1
1708250411564,LIGN 238,A00,411308,Bergen; Benjamin,20,0,20,0
1708250412097,LIGN 252,A00,411309,Bergen; Leon,28,0,30,2
1708250412623,LIGN 256,A00,411310,Nakashole; Ndapandula,0,0,5,5
1708250413150,LIGN 272,A00,482887,Kluender; Robert,10,0,10,0
1708250413677,LIHL 112P,A00,405228,Pagkalinawan; Leticia Cant,27,0,28,1
1708250414203,LIHL 114P,A00,405229,Nguyen; Hoan Thi,26,0,28,2
1708250414732,LIHL 117P,A00,405256,Sadegholvad; Elham,27,0,28,1
1708250415258,LIHL 118,A00,405257,Chen; Areana Yen,28,0,28,0
1708250415789,LIHL 124P,A00,405262,Nguyen; Hoan Thi,28,0,28,0
1708250416319,LIHL 132P,A00,405263,Pagkalinawan; Leticia Cant,28,0,28,0
1708250416845,LIHL 134P,A00,405269,Nguyen; Hoan Thi,28,0,28,0
1708250417371,LIHL 138,A00,405270,Chen; Areana Yen,27,0,28,1
1708250417903,LIIT 1C,A00,405465,Carnelos; Chiara,12,0,14,2
1708250417903,LIIT 1C,B00,405466,Carnelos; Chiara,14,0,14,0
1708250418430,LIIT 1CX,A00,405594,Carnelos; Chiara,28,0,28,0
1708250418964,LIPO 1C,A00,405595,Paladini; Denise,13,0,14,1
1708250418964,LIPO 1C,B00,405596,Paladini; Denise,14,0,14,0
1708250419499,LIPO 1CX,A00,405597,De Abreu; Cassia,28,0,28,0
1708250420052,LISL 1A,C00,405600,Lott; Margaret S.,13,0,14,1
1708250420052,LISL 1A,D00,405601,Lott; Margaret S.,10,0,14,4
1708250420052,LISL 1A,E00,405602,Lott; Margaret S.,13,0,14,1
1708250420052,LISL 1A,F00,405603,Lott; Margaret S.,13,0,14,1
1708250420585,LISL 1AR,A00,480605,Lott; Margaret S.,13,0,15,2
1708250420585,LISL 1AR,B00,480606,Lott; Margaret S.,14,0,15,1
1708250421111,LISL 1AX,A00,405754,Lott; Margaret S.,26,0,28,2
1708250421111,LISL 1AX,B00,405755,Lott; Margaret S.,23,0,28,5
1708250421649,LISL 1C,A00,405776,Lott; Margaret S.,13,0,14,1
1708250421649,LISL 1C,B00,405779,Lott; Margaret S.,14,0,14,0
1708250421649,LISL 1C,C00,405785,Lott; Margaret S.,14,0,14,0
1708250421649,LISL 1C,D00,405787,Lott; Margaret S.,9,0,14,5
1708250421649,LISL 1C,E00,405827,Lott; Margaret S.,12,0,14,2
1708250421649,LISL 1C,F00,405830,Lott; Margaret S.,13,0,14,1
1708250422180,LISL 1CX,A00,405844,Lott; Margaret S.,25,0,28,3
1708250422180,LISL 1CX,B00,405848,Lott; Margaret S.,25,0,28,3
1708250422180,LISL 1CX,C00,405849,Lott; Margaret S.,28,0,28,0
1708250422713,LISL 1D,A00,405850,Lott; Margaret S.,8,0,14,6
1708250422713,LISL 1D,B00,405851,Lott; Margaret S.,13,0,14,1
1708250422713,LISL 1D,C00,405852,Lott; Margaret S.,10,0,14,4
1708250423245,LISL 1DX,A00,405854,Lott; Margaret S.,17,0,22,5
1708250423245,LISL 1DX,B00,405855,Lott; Margaret S.,18,0,22,4
1708250423774,LISP 1A,001,405856,Munoz Sanchez; Alicia,11,0,14,3
1708250423774,LISP 1A,002,405857,Munoz Sanchez; Alicia,13,0,14,1
1708250423774,LISP 1A,003,405858,Munoz Sanchez; Alicia,14,0,14,0
1708250423774,LISP 1A,004,405861,Munoz Sanchez; Alicia,14,0,14,0
1708250424304,LISP 1AX,001,405862,Munoz Sanchez; Alicia,28,0,28,0
1708250424304,LISP 1AX,002,405863,Munoz Sanchez; Alicia,25,0,28,3
1708250424839,LISP 1C,001,405864,Munoz Sanchez; Alicia,13,0,14,1
1708250424839,LISP 1C,002,405865,Munoz Sanchez; Alicia,12,0,14,2
1708250424839,LISP 1C,003,405879,Munoz Sanchez; Alicia,12,0,14,2
1708250424839,LISP 1C,004,405880,Munoz Sanchez; Alicia,13,0,14,1
1708250424839,LISP 1C,005,405881,Munoz Sanchez; Alicia,12,0,14,2
1708250424839,LISP 1C,006,405882,Munoz Sanchez; Alicia,12,0,14,2
1708250424839,LISP 1C,007,405904,Munoz Sanchez; Alicia,14,0,14,0
1708250424839,LISP 1C,008,405905,Munoz Sanchez; Alicia,14,0,14,0
1708250424839,LISP 1C,009,405908,Munoz Sanchez; Alicia,14,0,14,0
1708250424839,LISP 1C,010,405917,Munoz Sanchez; Alicia,13,0,14,1
1708250425367,LISP 1CX,001,405922,Munoz Sanchez; Alicia,24,0,28,4
1708250425367,LISP 1CX,002,405990,Munoz Sanchez; Alicia,26,0,28,2
1708250425367,LISP 1CX,003,406007,Munoz Sanchez; Alicia,27,0,28,1
1708250425367,LISP 1CX,004,406008,Munoz Sanchez; Alicia,25,0,28,3
1708250425367,LISP 1CX,005,406015,Munoz Sanchez; Alicia,26,0,28,2
1708250425898,LISP 1D,001,406016,Munoz Sanchez; Alicia,12,0,14,2
1708250425898,LISP 1D,002,406017,Munoz Sanchez; Alicia,13,0,14,1
1708250425898,LISP 1D,003,406018,Munoz Sanchez; Alicia,14,0,14,0
1708250425898,LISP 1D,004,406019,Munoz Sanchez; Alicia,11,0,14,3
1708250425898,LISP 1D,005,406020,Munoz Sanchez; Alicia,13,0,14,1
1708250425898,LISP 1D,006,406021,Munoz Sanchez; Alicia,10,0,14,4
1708250425898,LISP 1D,007,406022,Munoz Sanchez; Alicia,12,0,14,2
1708250425898,LISP 1D,008,406023,Munoz Sanchez; Alicia,13,0,14,1
1708250425898,LISP 1D,009,406024,Munoz Sanchez; Alicia,11,0,14,3
1708250425898,LISP 1D,010,406025,Munoz Sanchez; Alicia,12,0,14,2
1708250425898,LISP 1D,011,406026,Munoz Sanchez; Alicia,13,0,14,1
1708250425898,LISP 1D,012,406027,Munoz Sanchez; Alicia,13,0,14,1
1708250425898,LISP 1D,013,406028,Munoz Sanchez; Alicia,12,0,14,2
1708250425898,LISP 1D,014,406029,Munoz Sanchez; Alicia,12,0,14,2
1708250425898,LISP 1D,015,406030,Munoz Sanchez; Alicia,10,0,14,4
1708250425898,LISP 1D,016,406031,Munoz Sanchez; Alicia,14,0,14,0
1708250425898,LISP 1D,017,406032,Munoz Sanchez; Alicia,14,0,14,0
1708250425898,LISP 1D,018,406033,Munoz Sanchez; Alicia,12,0,14,2
1708250425898,LISP 1D,019,406034,Munoz Sanchez; Alicia,13,0,14,1
1708250425898,LISP 1D,020,406035,Munoz Sanchez; Alicia,14,0,14,0
1708250425898,LISP 1D,021,406036,Munoz Sanchez; Alicia,13,0,14,1
1708250425898,LISP 1D,022,406037,Munoz Sanchez; Alicia,14,0,14,0
1708250425898,LISP 1D,023,406038,Munoz Sanchez; Alicia,14,0,14,0
1708250425898,LISP 1D,024,406039,Munoz Sanchez; Alicia,13,0,14,1
1708250426435,LISP 1DX,001,406040,Munoz Sanchez; Alicia,28,0,28,0
1708250426435,LISP 1DX,002,406041,Munoz Sanchez; Alicia,27,0,28,1
1708250426435,LISP 1DX,003,406127,Munoz Sanchez; Alicia,24,0,28,4
1708250426435,LISP 1DX,004,406128,Munoz Sanchez; Alicia,17,0,28,11
1708250426435,LISP 1DX,005,406418,Munoz Sanchez; Alicia,24,0,28,4
1708250426435,LISP 1DX,006,406536,Munoz Sanchez; Alicia,27,0,28,1
1708250426435,LISP 1DX,007,406561,Munoz Sanchez; Alicia,23,0,28,5
1708250426435,LISP 1DX,008,406576,Munoz Sanchez; Alicia,25,0,28,3
1708250426435,LISP 1DX,009,406679,Munoz Sanchez; Alicia,28,0,28,0
1708250426435,LISP 1DX,010,406691,Munoz Sanchez; Alicia,26,0,28,2
1708250426435,LISP 1DX,011,406692,Munoz Sanchez; Alicia,28,0,28,0
1708250426435,LISP 1DX,012,406693,Munoz Sanchez; Alicia,28,0,28,0
1708250426962,LISP 17,001,406694,Munoz Sanchez; Alicia,18,0,20,2
1708250427491,LISP 18,001,406695,Munoz Sanchez; Alicia,20,0,20,0
1708250428019,LTAM 105,A00,412520,Ruiz; Ariana,28,0,40,12
1708250428551,LTCH 101,A00,479214,Zhu; Ping,39,0,40,1
1708250429081,LTCS 87,A00,492906,Nguyen; Hoang Tan,20,0,20,0
1708250429081,LTCS 87,B00,492907,Nguyen; Hoang Tan,20,0,20,0
1708250429611,LTCS 150,A00,412543,Liao; Ping H,39,0,40,1
1708250430142,LTCS 225,A00,412819,Mendoza; Andrea,14,0,15,1
1708250430674,LTCS 250,A00,412821,Lee; Jin-Kyung,15,0,15,0
1708250431205,LTEA 110B,A00,412548,Liao; Ping H,60,0,60,0
1708250431735,LTEA 120A,A00,479216,Zhu; Ping,36,0,40,4
1708250432261,LTEA 120C,A00,412552,Fiss; Geraldine Anna,295,0,300,5
1708250432791,LTEA 132,A00,412561,Mendoza; Andrea,51,0,60,9
1708250433316,LTEA 141,A00,412565,Lee; Jin-Kyung,37,0,40,3
1708250433844,LTEN 23,A01,411317,Vijay; Ameeth Varma,24,0,25,1
1708250433844,LTEN 23,A02,411318,Vijay; Ameeth Varma,24,0,25,1
1708250433844,LTEN 23,A03,411371,Vijay; Ameeth Varma,25,0,25,0
1708250433844,LTEN 23,A04,411375,Vijay; Ameeth Varma,24,0,25,1
1708250434378,LTEN 28,A01,411632,Blanco; John D,25,0,25,0
1708250434378,LTEN 28,A02,411697,Blanco; John D,25,0,25,0
1708250434378,LTEN 28,A03,411698,Blanco; John D,25,0,25,0
1708250434378,LTEN 28,A04,411709,Blanco; John D,25,0,25,0
1708250434378,LTEN 28,A05,411719,Blanco; John D,25,0,25,0
1708250434378,LTEN 28,A06,411744,Blanco; John D,25,0,25,0
1708250434378,LTEN 28,A07,411780,Blanco; John D,25,0,25,0
1708250434378,LTEN 28,A08,411820,Blanco; John D,25,0,25,0
1708250434905,LTEN 110,A00,486891,Vitkus; Daniel J.,38,0,40,2
1708250435431,LTEN 144,A00,412570,Vijay; Ameeth Varma,39,0,40,1
1708250435966,LTEN 180,A00,412581,Perreira; Christopher Michael,18,0,25,7
1708250436493,LTEN 181,A00,412582,Mukherjee; Silpa,55,0,60,5
1708250437020,LTEN 245,A00,412824,Johnson; Sara E.,13,0,15,2
1708250437552,LTEN 259,A00,412825,Streeby; Shelley,13,0,15,2
1708250438082,LTEU 111,A00,412588,Kontje; Todd Curtis,38,0,40,2
1708250438614,LTEU 140,A00,480172,De Marchi Gherini; Adriana,36,0,37,1
1708250439140,LTEU 141,A00,412592,Cohen; Alain J. J.,40,0,40,0
1708250439673,LTFR 2A,A01,411996,Ploye; Catherine,25,0,25,0
1708250440203,LTFR 2C,A00,411997,Ploye; Catherine,24,0,25,1
1708250440732,LTFR 142,A00,412597,Zhiri; Oumelbanine,20,0,20,0
1708250441261,LTGK 3,A00,412001,Murray; Kourtney Kristine,30,0,30,0
1708250441786,LTGM 2C,A00,412002,Fischer-Grunski; Eva K,25,0,25,0
1708250442315,LTKO 1C,A01,412029,Cho; Hye Jin,24,0,25,1
1708250442315,LTKO 1C,B01,412164,Cho; Hye Jin,23,0,25,2
1708250442315,LTKO 1C,C01,412168,Cho; Hye Jin,25,0,25,0
1708250442315,LTKO 1C,D01,412353,Yim; Nancy,24,0,25,1
1708250442315,LTKO 1C,E01,412372,Yim; Nancy,25,0,25,0
1708250442843,LTKO 2C,A01,412374,Yim; Nancy,21,0,25,4
1708250443373,LTKO 130P,A00,412601,Lee; Jeyseon,25,0,25,0
1708250443900,LTKO 135,A00,412606,Lee; Jeyseon,25,0,25,0
1708250444427,LTLA 3,A00,412375,Murray; Kourtney Kristine,36,0,40,4
1708250444952,LTRU 1C,A01,412491,Wells; Patricia Rebecca,24,0,25,1
1708250445477,LTRU 104A,A01,412614,Wells; Patricia Rebecca,20,0,20,0
1708250446003,LTSP 2A,A01,412493,Lampell; Toni,24,0,25,1
1708250446536,LTSP 2B,A01,412497,Lampell; Toni,22,0,25,3
1708250446536,LTSP 2B,B01,479218,Lampell; Toni,24,0,25,1
1708250447067,LTSP 2C,A01,412499,Mastromartino; Alexandra L,23,0,25,2
1708250447605,LTSP 2D,A00,412500,Dominguez; Noelia,24,0,25,1
1708250448132,LTSP 2E,A00,412501,Mastromartino; Alexandra L,24,0,25,1
1708250448132,LTSP 2E,B00,412502,Mastromartino; Alexandra L,25,0,25,0
1708250448659,LTSP 87,A00,479212,Bessett; Ryan Matthew,20,0,20,0
1708250449184,LTSP 100B,A00,412619,Dominguez; Noelia,25,0,25,0
1708250449184,LTSP 100B,B00,412623,Dominguez; Noelia,24,0,25,1
1708250449781,LTSP 116,A00,412628,Blanco; John D,28,0,30,2
1708250450311,LTSP 135A,A00,412631,Parra; Max,27,0,30,3
1708250450837,LTSP 174,A00,479213,Staff,28,0,30,2
1708250451368,LTTH 115,A00,412632,Kontje; Todd Curtis,35,0,40,5
1708250451895,LTTH 210C,A00,412826,Batarseh; Amanda Alicia,14,0,15,1
1708250452421,LTTH 255,A00,412827,Ali; Mohammad Kazim,13,0,15,2
1708250452954,LTTH 260,A00,412828,Kim; Joo Ok,30,0,30,0
1708250453491,LTWL 19C,A00,412503,Kelting; Edward William,40,0,40,0
1708250454020,LTWL 101,A00,412633,Kelting; Edward William,39,0,40,1
1708250454548,LTWL 114,A00,412656,Fiss; Geraldine Anna,60,0,60,0
1708250455078,LTWL 123,A00,412674,Lampert-Weissig; Lisa,31,0,40,9
1708250455609,LTWL 172,A00,412729,De Marchi Gherini; Adriana,37,0,40,3
1708250456136,LTWL 183,A00,412731,Cohen; Alain J. J.,38,0,40,2
1708250456667,LTWL 184,A00,479219,Mukherjee; Silpa,38,0,40,2
1708250457195,LTWL 194A,A00,489635,Vijay; Ameeth Varma,27,0,31,4
1708250457723,LTWR 8A,A01,412505,Springer; Anna Joy,24,0,25,1
1708250457723,LTWR 8A,A02,412506,Springer; Anna Joy,24,0,25,1
1708250457723,LTWR 8A,A03,412507,Springer; Anna Joy,25,0,25,0
1708250457723,LTWR 8A,A04,412508,Springer; Anna Joy,23,0,25,2
1708250458257,LTWR 8C,A01,412511,Forbes; Camille,23,0,25,2
1708250458257,LTWR 8C,A02,412512,Forbes; Camille,25,0,25,0
1708250458257,LTWR 8C,A03,412514,Forbes; Camille,25,0,25,0
1708250458257,LTWR 8C,A04,412519,Forbes; Camille,24,0,25,1
1708250458784,LTWR 100,A00,412734,Forbes; Camille,7,0,15,8
1708250459313,LTWR 113,A00,412816,Carroll; Amy Sara,28,0,30,2
1708250459840,LTWR 114,A00,412817,Springer; Anna Joy,23,0,30,7
1708250460365,LTWR 126,A00,412818,Hoang; Lily Kim,25,0,30,5
1708250460890,LTWR 215,A00,412880,Carroll; Amy Sara,19,0,20,1
1708250461448,MAE 3,A01,435606,Qi; Huihui,16,0,20,4
1708250461448,MAE 3,A02,435607,Qi; Huihui,15,0,20,5
1708250461448,MAE 3,A03,435608,Qi; Huihui,19,0,20,1
1708250461448,MAE 3,B01,435618,Delson; Nathan Joseph & Mullin; Jennifer S,20,0,20,0
1708250461448,MAE 3,B02,435626,Delson; Nathan Joseph & Mullin; Jennifer S,20,0,20,0
1708250461448,MAE 3,B03,435666,Delson; Nathan Joseph & Mullin; Jennifer S,20,0,20,0
1708250461448,MAE 3,B04,435679,Delson; Nathan Joseph & Mullin; Jennifer S,20,0,20,0
1708250461448,MAE 3,B05,494545,Delson; Nathan Joseph & Mullin; Jennifer S,20,0,20,0
1708250461980,MAE 8,A01,435688,Pham; Hieu Tan,197,0,200,3
1708250462509,MAE 30B,A00,435689,Lubarda; Marko,128,0,130,2
1708250462509,MAE 30B,B00,435701,Ghazinejad; Maziar,117,0,130,13
1708250463043,MAE 101B,A00,435702,Saintillan; David,146,0,150,4
1708250463043,MAE 101B,B00,435703,Nomura; Keiko K.,138,0,146,8
1708250463572,MAE 101C,A00,435704,Sadeghizadeh; Zahra,53,0,65,12
1708250464099,MAE 101D,A00,435705,Chen; Renkun,14,0,20,6
1708250464631,MAE 105,A00,435706,Becker; Janet Maria,115,0,120,5
1708250465160,MAE 107,A00,435707,Lindsey; Stephanie,48,0,50,2
1708250465160,MAE 107,B00,435708,Davidson; Michael R,55,0,60,5
1708250465693,MAE 119,A00,435710,Hidalgo-Gonzalez; Patricia,100,0,120,20
1708250466219,MAE 120,A00,435722,Arefiev; Alexey,49,0,65,16
1708250466746,MAE 125,A00,435723,Kleissl; Jan,60,0,65,5
1708250467274,MAE 131A,A00,435724,Qi; Huihui,119,0,125,6
1708250467274,MAE 131A,B00,435725,Meyers; Marc,123,0,125,2
1708250467805,MAE 143B,A00,435726,Morimoto; Tania,114,0,120,6
1708250467805,MAE 143B,B00,435727,Herbert; Sylvia Lee,117,0,120,3
1708250467805,MAE 143B,C00,435728,Diagne; Mamadou Lamine,108,0,120,12
1708250468337,MAE 145,A00,435729,Martinez; Sonia,41,0,60,19
1708250468864,MAE 148,A01,492802,Silberman; Jack,14,0,24,10
1708250469391,MAE 150,A00,435730,Pham; Hieu Tan,52,0,60,8
1708250469919,MAE 152,A00,435731,Llewellyn Smith; Stefan G.,14,0,14,0
1708250469919,MAE 152,B00,435747,Llewellyn Smith; Stefan G.,12,0,14,2
1708250469919,MAE 152,C00,435748,Llewellyn Smith; Stefan G.,12,0,14,2
1708250469919,MAE 152,D00,435749,Llewellyn Smith; Stefan G.,8,0,14,6
1708250469919,MAE 152,E00,435750,Llewellyn Smith; Stefan G.,13,0,14,1
1708250470453,MAE 155B,A01,435752,Hwang; John T,36,0,50,14
1708250470453,MAE 155B,B01,435768,Anderson; Mark Ronald,27,0,50,23
1708250470453,MAE 155B,C01,494006,Saha; Abhishek,0,0,0,0
1708250470989,MAE 156B,A01,435770,Tustaniwskyj; Jerry I,33,0,40,7
1708250470989,MAE 156B,B01,435772,Ghazinejad; Maziar,35,0,40,5
1708250470989,MAE 156B,C01,435774,Delson; Nathan Joseph,38,0,40,2
1708250470989,MAE 156B,D01,435776,Saha; Abhishek,31,0,40,9
1708250471523,MAE 166,A00,435777,Fullerton; Eric E,44,0,50,6
1708250472050,MAE 170,A01,435779,Lubarda; Marko,30,0,32,2
1708250472050,MAE 170,A02,435780,Lubarda; Marko,27,0,32,5
1708250472050,MAE 170,A03,435781,Lubarda; Marko,32,0,32,0
1708250472050,MAE 170,A04,435782,Lubarda; Marko,31,0,32,1
1708250472050,MAE 170,A05,435783,Lubarda; Marko,29,0,32,3
1708250472050,MAE 170,A06,435784,Lubarda; Marko,30,0,32,2
1708250472050,MAE 170,B01,435786,Evdokimenko; Ekaterina,23,0,24,1
1708250472050,MAE 170,B02,435787,Evdokimenko; Ekaterina,20,0,24,4
1708250472050,MAE 170,B03,435788,Evdokimenko; Ekaterina,23,0,24,1
1708250472050,MAE 170,B04,435789,Evdokimenko; Ekaterina,23,0,24,1
1708250472050,MAE 170,B05,435790,Evdokimenko; Ekaterina,19,0,24,5
1708250472050,MAE 170,B06,435791,Evdokimenko; Ekaterina,23,0,24,1
1708250472576,MAE 180,A00,479477,Sadeghizadeh; Zahra,56,0,60,4
1708250473106,MAE 184,A00,435792,Anderson; Mark Ronald,7,0,50,43
1708250473636,MAE 190,A00,435793,Beg; Farhat N.,17,0,20,3
1708250473636,MAE 190,B00,479209,Gerardo; Hortense Flotilde,12,0,15,3
1708250474161,MAE 202,A00,435794,Bandaru; Prabhakar,32,0,70,38
1708250474689,MAE 205,A00,435804,Hwang; John T & Tynan; George Robert & Seshadri; Kalyanasundaram & Rangamani; Padmini & Bandaru; Prabhakar,9990,0,9999,9
1708250475215,MAE 207,A00,435805,Beg; Farhat N.,9,0,10,1
1708250475215,MAE 207,B00,435815,Campbell; Edward Michael,6,0,10,4
1708250475215,MAE 207,C00,477499,Gerardo; Hortense Flotilde,6,0,30,24
1708250475743,MAE 209,A00,435816,Scholtes Acevedo; Claire,25,0,30,5
1708250476271,MAE 210C,A00,435817,Becker; Janet Maria,22,0,30,8
1708250476799,MAE 211,A00,435818,Seshadri; Kalyanasundaram,20,0,30,10
1708250477329,MAE 214A,A00,435819,Sarkar; Sutanu,27,0,35,8
1708250477854,MAE 217C,A00,435820,Marinoni; Alessandro,10,0,10,0
1708250478380,MAE 221C,A00,435821,Seshadri; Kalyanasundaram,9,0,15,6
1708250478906,MAE 221D,A00,435822,Poulikakos; Lisa Voula,23,0,30,7
1708250479440,MAE 224A,A00,435823,Pawlak; Geno Ronald,5,0,10,5
1708250479967,MAE 227,A00,435824,Hidalgo-Gonzalez; Patricia,21,0,35,14
1708250480492,MAE 231A,A00,435825,Boechler; Nicholas Sebastia,14,0,30,16
1708250481023,MAE 240,A00,435826,Rosengren; Aaron,19,0,30,11
1708250481555,MAE 242,A00,435827,Martinez; Sonia,0,0,45,45
1708250482085,MAE 249,A00,435842,Tolley; Michael Thomas,0,0,35,35
1708250482612,MAE 253,A00,435891,Staff,24,0,25,1
1708250483139,MAE 256,A00,435949,Coimbra; Carlos F.,6,0,10,4
1708250483668,MAE 263,A00,435987,Rangamani; Padmini,10,0,10,0
1708250484194,MAE 266,A00,435988,Evdokimenko; Ekaterina,7,0,30,23
1708250484724,MAE 271C,A00,435990,Arzt; Eduard,10,0,10,0
1708250485258,MAE 281B,A00,435991,Cortes; Jorge,9,0,25,16
1708250485786,MAE 288A,A00,435998,McEneaney; William Michael,6,0,40,34
1708250486317,MAE 288B,A00,435999,Bitmead; Robert R.,41,0,45,4
1708250486843,MAE 290C,A00,436008,Schmidt; Oliver,26,0,30,4
1708250487371,MAE 294C,A01,436010,Young; William Roy,19,0,20,1
1708250487905,MATH 2,A01,431271,Staff,31,0,35,4
1708250487905,MATH 2,B01,431273,Staff,29,0,35,6
1708250487905,MATH 2,C01,431275,Staff,31,0,35,4
1708250488433,MATH 3C,A01,431277,Safii; Soheil,12,0,15,3
1708250488433,MATH 3C,A02,431278,Safii; Soheil,12,0,15,3
1708250488433,MATH 3C,A03,431279,Safii; Soheil,12,0,15,3
1708250488433,MATH 3C,A04,431280,Safii; Soheil,15,0,15,0
1708250488433,MATH 3C,A05,431281,Safii; Soheil,14,0,15,1
1708250488433,MATH 3C,A06,431282,Safii; Soheil,15,0,15,0
1708250488976,MATH 10A,A01,431284,Bowers; Adam R.,20,0,30,10
1708250488976,MATH 10A,A02,431285,Bowers; Adam R.,18,0,30,12
1708250488976,MATH 10A,A03,431369,Bowers; Adam R.,28,0,30,2
1708250488976,MATH 10A,A04,431395,Bowers; Adam R.,27,0,30,3
1708250488976,MATH 10A,A05,431450,Bowers; Adam R.,28,0,30,2
1708250488976,MATH 10A,A06,431508,Bowers; Adam R.,30,0,30,0
1708250488976,MATH 10A,B01,431572,Kowalenko; Ethan J,24,0,30,6
1708250488976,MATH 10A,B02,431573,Kowalenko; Ethan J,29,0,30,1
1708250488976,MATH 10A,B03,431574,Kowalenko; Ethan J,30,0,30,0
1708250488976,MATH 10A,B04,431576,Kowalenko; Ethan J,30,0,30,0
1708250488976,MATH 10A,B05,431577,Kowalenko; Ethan J,30,0,30,0
1708250488976,MATH 10A,B06,431583,Kowalenko; Ethan J,30,0,30,0
1708250489509,MATH 10B,A01,431595,Habib; Yousaf,29,0,36,7
1708250489509,MATH 10B,A02,431597,Habib; Yousaf,35,0,36,1
1708250489509,MATH 10B,A03,431669,Habib; Yousaf,37,0,37,0
1708250489509,MATH 10B,A04,431670,Habib; Yousaf,36,0,37,1
1708250489509,MATH 10B,A05,431671,Habib; Yousaf,70,0,70,0
1708250489509,MATH 10B,B01,431673,Habib; Yousaf,25,0,33,8
1708250489509,MATH 10B,B02,431712,Habib; Yousaf,33,0,33,0
1708250489509,MATH 10B,B03,431713,Habib; Yousaf,33,0,33,0
1708250489509,MATH 10B,B04,431714,Habib; Yousaf,33,0,33,0
1708250489509,MATH 10B,B05,431715,Habib; Yousaf,60,0,60,0
1708250489509,MATH 10B,C01,431717,Bach; Quang Tran,57,0,60,3
1708250489509,MATH 10B,C02,431718,Bach; Quang Tran,18,0,34,16
1708250489509,MATH 10B,C03,431719,Bach; Quang Tran,34,0,34,0
1708250489509,MATH 10B,C04,431720,Bach; Quang Tran,33,0,34,1
1708250489509,MATH 10B,C05,431721,Bach; Quang Tran,32,0,34,2
1708250489509,MATH 10B,D01,431723,Staff,28,0,34,6
1708250489509,MATH 10B,D02,431724,Staff,34,0,34,0
1708250489509,MATH 10B,D03,431725,Staff,34,0,34,0
1708250489509,MATH 10B,D04,431726,Staff,34,0,34,0
1708250489509,MATH 10B,D05,431727,Staff,57,0,60,3
1708250490036,MATH 10C,A01,431741,Staff,94,0,96,2
1708250490036,MATH 10C,A02,431742,Staff,39,0,40,1
1708250490036,MATH 10C,B01,431744,Staff,95,0,96,1
1708250490036,MATH 10C,B02,431746,Staff,27,0,40,13
1708250490036,MATH 10C,C01,431748,Pardo Guerra; Sebastian,30,0,40,10
1708250490036,MATH 10C,C02,431885,Pardo Guerra; Sebastian,40,0,40,0
1708250490036,MATH 10C,C03,431895,Pardo Guerra; Sebastian,32,0,33,1
1708250490036,MATH 10C,C04,431896,Pardo Guerra; Sebastian,32,0,32,0
1708250490574,MATH 11,A01,431933,Rava; Denise,82,0,100,18
1708250490574,MATH 11,A02,431960,Rava; Denise,66,0,70,4
1708250490574,MATH 11,A03,431971,Rava; Denise,39,0,40,1
1708250490574,MATH 11,B01,432053,Staff,99,0,100,1
1708250490574,MATH 11,B02,432064,Staff,37,0,45,8
1708250490574,MATH 11,B03,432073,Staff,44,0,45,1
1708250491105,MATH 18,A01,432082,Mackall; Eoin Travis,65,0,70,5
1708250491105,MATH 18,A02,432086,Mackall; Eoin Travis,68,0,70,2
1708250491105,MATH 18,B01,432089,Suk; Andrew Hoon,39,0,40,1
1708250491105,MATH 18,B02,432090,Suk; Andrew Hoon,35,0,40,5
1708250491105,MATH 18,B03,432091,Suk; Andrew Hoon,33,0,40,7
1708250491105,MATH 18,B04,432092,Suk; Andrew Hoon,30,0,40,10
1708250491105,MATH 18,B05,432093,Suk; Andrew Hoon,34,0,35,1
1708250491105,MATH 18,B06,432094,Suk; Andrew Hoon,33,0,35,2
1708250491105,MATH 18,B07,432095,Suk; Andrew Hoon,98,0,100,2
1708250491105,MATH 18,B08,432096,Suk; Andrew Hoon,100,0,100,0
1708250491105,MATH 18,B09,432097,Suk; Andrew Hoon,98,0,100,2
1708250491105,MATH 18,B10,432098,Suk; Andrew Hoon,69,0,70,1
1708250491634,MATH 20A,A01,432101,Briones; Jor-el Thomas Caparas,30,0,40,10
1708250491634,MATH 20A,A02,432102,Briones; Jor-el Thomas Caparas,98,0,100,2
1708250491634,MATH 20A,B01,432104,Briones; Jor-el Thomas Caparas,99,0,100,1
1708250491634,MATH 20A,B02,432105,Briones; Jor-el Thomas Caparas,40,0,40,0
1708250492163,MATH 20B,A01,432107,Quarfoot; David James,33,0,35,2
1708250492163,MATH 20B,A02,432108,Quarfoot; David James,18,0,35,17
1708250492163,MATH 20B,A03,432109,Quarfoot; David James,32,0,35,3
1708250492163,MATH 20B,A04,432110,Quarfoot; David James,34,0,35,1
1708250492163,MATH 20B,A05,432331,Quarfoot; David James,26,0,32,6
1708250492163,MATH 20B,A06,432411,Quarfoot; David James,31,0,32,1
1708250492163,MATH 20B,B01,432413,Mackall; Eoin Travis,62,0,65,3
1708250492163,MATH 20B,B02,432443,Mackall; Eoin Travis,65,0,65,0
1708250492163,MATH 20B,B03,432444,Mackall; Eoin Travis,60,0,60,0
1708250492163,MATH 20B,B04,432471,Mackall; Eoin Travis,60,0,60,0
1708250492702,MATH 20C,A01,432473,Ohm; Ko Woon,26,0,38,12
1708250492702,MATH 20C,A02,432474,Ohm; Ko Woon,36,0,38,2
1708250492702,MATH 20C,A03,432475,Ohm; Ko Woon,34,0,37,3
1708250492702,MATH 20C,A04,432546,Ohm; Ko Woon,36,0,37,1
1708250492702,MATH 20C,A05,432550,Ohm; Ko Woon,88,0,90,2
1708250492702,MATH 20C,B01,432568,Ohm; Ko Woon,43,0,45,2
1708250492702,MATH 20C,B02,432594,Ohm; Ko Woon,40,0,45,5
1708250492702,MATH 20C,B03,432609,Ohm; Ko Woon,85,0,90,5
1708250492702,MATH 20C,C01,432613,Cheng; Hsiao-Bing,67,0,70,3
1708250492702,MATH 20C,C02,432614,Cheng; Hsiao-Bing,68,0,70,2
1708250492702,MATH 20C,C03,432615,Cheng; Hsiao-Bing,70,0,70,0
1708250492702,MATH 20C,D01,432617,Cheng; Hsiao-Bing,69,0,70,1
1708250492702,MATH 20C,D02,432618,Cheng; Hsiao-Bing,68,0,70,2
1708250492702,MATH 20C,D03,432619,Cheng; Hsiao-Bing,70,0,70,0
1708250493232,MATH 20D,A01,432622,Hammock; Frances H,58,0,60,2
1708250493232,MATH 20D,A02,432623,Hammock; Frances H,58,0,60,2
1708250493232,MATH 20D,A03,432658,Hammock; Frances H,35,0,35,0
1708250493232,MATH 20D,A04,432660,Hammock; Frances H,35,0,35,0
1708250493232,MATH 20D,B01,432702,Hammock; Frances H,66,0,70,4
1708250493232,MATH 20D,B02,432703,Hammock; Frances H,70,0,70,0
1708250493232,MATH 20D,B03,432766,Hammock; Frances H,30,0,30,0
1708250493232,MATH 20D,B04,432782,Hammock; Frances H,20,0,30,10
1708250493232,MATH 20D,C01,432811,Sheng; Hongyi,60,0,60,0
1708250493232,MATH 20D,C02,432931,Sheng; Hongyi,60,0,60,0
1708250493232,MATH 20D,C03,432945,Sheng; Hongyi,28,0,30,2
1708250493232,MATH 20D,C04,432949,Sheng; Hongyi,30,0,30,0
1708250493761,MATH 20E,A01,433007,Eggers; John Dietrich,70,0,80,10
1708250493761,MATH 20E,A02,433070,Eggers; John Dietrich,77,0,80,3
1708250493761,MATH 20E,A03,433079,Eggers; John Dietrich,32,0,35,3
1708250493761,MATH 20E,B01,433092,Staff,86,0,90,4
1708250493761,MATH 20E,B02,433093,Staff,90,0,90,0
1708250493761,MATH 20E,C01,433237,Bach; Quang Tran,52,0,60,8
1708250493761,MATH 20E,C02,433238,Bach; Quang Tran,69,0,70,1
1708250493761,MATH 20E,C03,433239,Bach; Quang Tran,70,0,70,0
1708250494293,MATH 31CH,A01,433241,Rabin; Jeffrey Mark,35,0,35,0
1708250494824,MATH 95,A00,433242,Stevens; Laura Jeanne,30,0,30,0
1708250495351,MATH 100C,A01,433244,Pollack; Aaron,31,0,35,4
1708250495351,MATH 100C,A02,433245,Pollack; Aaron,35,0,35,0
1708250495881,MATH 102,A01,433298,Ophir; Amit,29,0,30,1
1708250495881,MATH 102,A02,433369,Ophir; Amit,30,0,30,0
1708250495881,MATH 102,A03,433373,Ophir; Amit,30,0,30,0
1708250495881,MATH 102,A04,433374,Ophir; Amit,29,0,30,1
1708250495881,MATH 102,B01,433572,Zhang; Ming,28,0,30,2
1708250495881,MATH 102,B02,433732,Zhang; Ming,30,0,30,0
1708250495881,MATH 102,B03,433733,Zhang; Ming,30,0,30,0
1708250495881,MATH 102,B04,433734,Zhang; Ming,29,0,30,1
1708250496409,MATH 103B,A01,433793,Lu; Yunze,23,0,30,7
1708250496409,MATH 103B,A02,433795,Lu; Yunze,30,0,30,0
1708250496409,MATH 103B,A03,433830,Lu; Yunze,28,0,30,2
1708250496409,MATH 103B,B01,433845,Lahiri; Aranya,24,0,30,6
1708250496409,MATH 103B,B02,433846,Lahiri; Aranya,28,0,30,2
1708250496409,MATH 103B,B03,433847,Lahiri; Aranya,27,0,30,3
1708250496947,MATH 109,A01,433849,Aycock; Jon Merrill,6,0,10,4
1708250496947,MATH 109,A02,433850,Aycock; Jon Merrill,9,0,10,1
1708250496947,MATH 109,B01,433852,Klevdal; Christian Sleek,10,0,10,0
1708250496947,MATH 109,B02,433859,Klevdal; Christian Sleek,10,0,10,0
1708250496947,MATH 109,C01,433861,Treuer; John N,5,0,10,5
1708250496947,MATH 109,C02,433862,Treuer; John N,10,0,10,0
1708250496947,MATH 109,D01,433864,Treuer; John N,8,0,10,2
1708250496947,MATH 109,D02,433865,Treuer; John N,8,0,10,2
1708250496947,MATH 109,E01,433868,Sheng; Hongyi,10,0,10,0
1708250496947,MATH 109,E02,433869,Sheng; Hongyi,19,0,20,1
1708250497481,MATH 110,A01,433871,Pillai; Mohandas K,24,0,35,11
1708250497481,MATH 110,A02,433872,Pillai; Mohandas K,33,0,35,2
1708250498011,MATH 112B,A01,480683,Komarova; Natalia,27,0,27,0
1708250498538,MATH 120B,A01,433885,Xiao; Ming,32,0,35,3
1708250498538,MATH 120B,A02,433886,Xiao; Ming,34,0,35,1
1708250499064,MATH 121B,A01,433888,Stevens; Laura Jeanne,29,0,30,1
1708250499613,MATH 140B,A01,433890,Seward; Brandon M.,31,0,35,4
1708250499613,MATH 140B,A02,433891,Seward; Brandon M.,35,0,35,0
1708250500141,MATH 140C,A01,433895,Spolaor; Luca,32,0,35,3
1708250500141,MATH 140C,A02,433896,Spolaor; Luca,35,0,35,0
1708250500671,MATH 142B,A01,433966,Eggers; John Dietrich,25,0,35,10
1708250500671,MATH 142B,A02,434063,Eggers; John Dietrich,32,0,35,3
1708250500671,MATH 142B,B01,434071,Sanchez; Anthony,32,0,35,3
1708250500671,MATH 142B,B02,434083,Sanchez; Anthony,34,0,35,1
1708250500671,MATH 142B,C01,434094,Kunnawalkam Elayavalli; Sr,31,0,35,4
1708250500671,MATH 142B,C02,434095,Kunnawalkam Elayavalli; Sr,34,0,35,1
1708250501197,MATH 144,A01,434097,Cloninger; Alexander,30,0,30,0
1708250501729,MATH 150B,A01,434104,Parise; Davide,33,0,35,2
1708250502261,MATH 152,A01,434107,Grier; Daniel T,20,0,40,20
1708250502788,MATH 154,A01,434109,Wesley; William J,31,0,35,4
1708250502788,MATH 154,A02,434119,Wesley; William J,35,0,35,0
1708250502788,MATH 154,A03,434120,Wesley; William J,35,0,35,0
1708250502788,MATH 154,A04,434121,Wesley; William J,34,0,35,1
1708250502788,MATH 154,B01,434126,Aliabadi Sr.; Mohsen,26,0,35,9
1708250502788,MATH 154,B02,434127,Aliabadi Sr.; Mohsen,34,0,35,1
1708250502788,MATH 154,B03,434138,Aliabadi Sr.; Mohsen,35,0,35,0
1708250502788,MATH 154,B04,434139,Aliabadi Sr.; Mohsen,35,0,35,0
1708250503373,MATH 163,A01,434144,Bowers; Adam R.,0,0,5,5
1708250503907,MATH 170A,A01,434148,Nag; Panchali,36,0,36,0
1708250503907,MATH 170A,A02,434149,Nag; Panchali,36,0,36,0
1708250503907,MATH 170A,A03,434150,Nag; Panchali,36,0,37,1
1708250503907,MATH 170A,A04,434151,Nag; Panchali,36,0,36,0
1708250504433,MATH 170B,A01,434155,Huang; Lei,31,0,35,4
1708250504433,MATH 170B,A02,434160,Huang; Lei,35,0,35,0
1708250504433,MATH 170B,A03,434161,Huang; Lei,35,0,35,0
1708250504433,MATH 170B,A04,434162,Huang; Lei,35,0,35,0
1708250504961,MATH 170C,A01,434176,Leok; Melvin,30,0,35,5
1708250504961,MATH 170C,A02,434300,Leok; Melvin,34,0,35,1
1708250505490,MATH 171B,A01,434576,Nie; Jiawang,25,0,35,10
1708250505490,MATH 171B,A02,434583,Nie; Jiawang,35,0,35,0
1708250505490,MATH 171B,A03,434584,Nie; Jiawang,35,0,35,0
1708250505490,MATH 171B,A04,434609,Nie; Jiawang,35,0,35,0
1708250506023,MATH 180A,A01,434638,Gartland; Christopher John,29,0,30,1
1708250506023,MATH 180A,A02,434821,Gartland; Christopher John,28,0,30,2
1708250506023,MATH 180A,A03,434833,Gartland; Christopher John,24,0,30,6
1708250506023,MATH 180A,A04,434839,Gartland; Christopher John,30,0,30,0
1708250506023,MATH 180A,A05,434843,Gartland; Christopher John,30,0,30,0
1708250506023,MATH 180A,A06,434895,Gartland; Christopher John,30,0,30,0
1708250506553,MATH 180B,A01,435085,Gartland; Christopher John,30,0,35,5
1708250506553,MATH 180B,A02,435086,Gartland; Christopher John,35,0,35,0
1708250506553,MATH 180B,A03,435087,Gartland; Christopher John,34,0,35,1
1708250506553,MATH 180B,A04,435088,Gartland; Christopher John,35,0,35,0
1708250507080,MATH 180C,A01,435090,Carfagnini; Marco,29,0,35,6
1708250507080,MATH 180C,A02,435091,Carfagnini; Marco,35,0,35,0
1708250507080,MATH 180C,A03,435092,Carfagnini; Marco,32,0,35,3
1708250507080,MATH 180C,A04,435113,Carfagnini; Marco,35,0,35,0
1708250507606,MATH 181A,A01,435279,Zhang; Danna,30,0,35,5
1708250507606,MATH 181A,A02,435300,Zhang; Danna,35,0,35,0
1708250507606,MATH 181A,A03,435301,Zhang; Danna,21,0,35,14
1708250507606,MATH 181A,A04,435302,Zhang; Danna,31,0,35,4
1708250508136,MATH 181B,A01,435315,Rava; Denise,33,0,35,2
1708250508136,MATH 181B,A02,435316,Rava; Denise,32,0,35,3
1708250508136,MATH 181B,A03,435317,Rava; Denise,33,0,35,2
1708250508136,MATH 181B,A04,435318,Rava; Denise,35,0,35,0
1708250508663,MATH 183,A01,435320,Quarfoot; David James,26,0,35,9
1708250508663,MATH 183,A02,435321,Quarfoot; David James,35,0,35,0
1708250508663,MATH 183,A03,435322,Quarfoot; David James,32,0,35,3
1708250508663,MATH 183,A04,435323,Quarfoot; David James,34,0,35,1
1708250508663,MATH 183,A05,435327,Quarfoot; David James,34,0,35,1
1708250508663,MATH 183,A06,435329,Quarfoot; David James,33,0,35,2
1708250509196,MATH 184,A01,435337,Verstraete; Jacques Allan,32,0,35,3
1708250509196,MATH 184,A02,435338,Verstraete; Jacques Allan,35,0,35,0
1708250509196,MATH 184,A03,435339,Verstraete; Jacques Allan,34,0,35,1
1708250509196,MATH 184,A04,435347,Verstraete; Jacques Allan,30,0,35,5
1708250509722,MATH 185,A01,435432,Arias-Castro; Ery,15,0,30,15
1708250509722,MATH 185,A02,435436,Arias-Castro; Ery,30,0,30,0
1708250509722,MATH 185,A03,435437,Arias-Castro; Ery,30,0,30,0
1708250509722,MATH 185,A04,435438,Arias-Castro; Ery,30,0,30,0
1708250510250,MATH 187A,A01,435443,Agrawal; Shishir,15,0,30,15
1708250510250,MATH 187A,A02,435444,Agrawal; Shishir,30,0,30,0
1708250510250,MATH 187A,A03,435503,Agrawal; Shishir,28,0,30,2
1708250510250,MATH 187A,A04,435507,Agrawal; Shishir,30,0,30,0
1708250510250,MATH 187A,A05,435554,Agrawal; Shishir,22,0,30,8
1708250510250,MATH 187A,A06,435558,Agrawal; Shishir,28,0,30,2
1708250510779,MATH 187B,A01,435570,Bucur; Alina Ioana,24,0,35,11
1708250510779,MATH 187B,A02,435571,Bucur; Alina Ioana,35,0,35,0
1708250511307,MATH 188,A01,435573,Kunnawalkam Elayavalli; Sr,35,0,35,0
1708250511834,MATH 189,A01,435577,Vishwanath; Siddharth,0,0,10,10
1708250511834,MATH 189,A02,435594,Vishwanath; Siddharth,0,0,10,10
1708250511834,MATH 189,A03,435595,Vishwanath; Siddharth,0,0,10,10
1708250511834,MATH 189,A04,435596,Vishwanath; Siddharth,0,0,10,10
1708250511834,MATH 189,A05,480706,Vishwanath; Siddharth,2,0,10,8
1708250511834,MATH 189,A06,481362,Vishwanath; Siddharth,6,0,10,4
1708250512360,MATH 200C,A00,430388,Bucur; Alina Ioana,15,0,15,0
1708250512887,MATH 202C,A00,430389,Rhoades; Brendon Patrick,15,0,15,0
1708250513414,MATH 203C,A00,430390,Izadi; Elham,15,0,15,0
1708250513943,MATH 204C,A00,430391,Sorensen; Claus M,15,0,15,0
1708250514471,MATH 208,A00,430392,Izadi; Elham,8,0,10,2
1708250514997,MATH 209,A00,430393,Pollack; Aaron,10,0,10,0
1708250515530,MATH 211A,A00,430394,Salehi Golsefidy; Alireza,10,0,10,0
1708250516058,MATH 211B,A00,430395,Seward; Brandon M.,10,0,10,0
1708250516585,MATH 212B,A01,480692,Komarova; Natalia,5,0,5,0
1708250517110,MATH 216C,A00,430429,Saab; Rayan,13,0,15,2
1708250517643,MATH 217,A00,430430,Li; Bo,13,0,15,2
1708250518168,MATH 218,A00,430431,Li; Bo,8,0,10,2
1708250518698,MATH 220C,A00,430432,Xiao; Ming,15,0,15,0
1708250519224,MATH 240C,A00,430433,Ebenfelt; Peter F,14,0,15,1
1708250519753,MATH 241B,A00,430434,Ioana; Adrian,14,0,15,1
1708250520280,MATH 243,A00,430435,Kunnawalkam Elayavalli; Sr,9,0,10,1
1708250520807,MATH 248,A00,430436,Bejenaru; Ioan,9,0,10,1
1708250521337,MATH 251C,A00,430437,Wenzl; Hans G,15,0,15,0
1708250521863,MATH 258,A00,430438,Spolaor; Luca,10,0,10,0
1708250522391,MATH 261C,A00,430439,Manners; Frederick,14,0,15,1
1708250522918,MATH 262A,A00,430440,Warnke; Lutz Peter,14,0,15,1
1708250523448,MATH 268,A00,430441,Buss; Samuel R,10,0,10,0
1708250523974,MATH 269,A00,430442,Rhoades; Brendon Patrick & Warnke; Lutz Peter,10,0,10,0
1708250524500,MATH 270C,A00,430445,Cheng; Li-Tien,15,0,15,0
1708250525029,MATH 273B,A00,430452,Zhu; Yuhua,15,0,15,0
1708250525556,MATH 276,A00,430458,Mc Culloch; Andrew Douglas & Amaro; Rommie E,0,0,0,0
1708250526083,MATH 277A,A00,430464,Dumitriu; Ioana,14,0,15,1
1708250526610,MATH 278A,A00,430470,Cheng; Li-Tien,9,0,10,1
1708250527139,MATH 278B,A00,430471,Cloninger; Alexander,10,0,10,0
1708250527664,MATH 278C,A00,430472,Nie; Jiawang,9,0,10,1
1708250528191,MATH 280C,A00,430485,Schweinsberg; Jason,13,0,15,2
1708250528717,MATH 281C,A00,430496,Arias-Castro; Ery,8,0,15,7
1708250529246,MATH 284,A00,430503,Xu; Ronghui,11,0,15,4
1708250529777,MATH 287C,A00,430520,Zhang; Danna,14,0,15,1
1708250530314,MATH 288,A00,430527,Carfagnini; Marco,9,0,10,1
1708250530843,MATH 289A,A00,430541,Novak; Jonathan I,14,0,15,1
1708250531370,MATH 290C,A00,430548,Roberts; Justin Deritter,13,0,15,2
1708250531900,MATH 292,A00,430660,Lu; Yunze,10,0,10,0
1708250532426,MATH 294,A00,430678,Fitzsimmons; Patrick J,11,0,15,4
1708250532952,MATH 295,A00,430692,Bejenaru; Ioan,15,0,15,0
1708250533481,MATH 297,001,430721,Gamst; Anthony Collins,0,0,0,0
1708250534006,MATS 200,A00,414457,Graeve; Olivia A,9995,0,9999,4
1708250534536,MATS 201C,A00,414465,Arzt; Eduard,38,0,50,12
1708250535062,MATS 236,A00,414466,Staff,17,0,20,3
1708250535592,MATS 252,A00,414467,Evdokimenko; Ekaterina,42,0,45,3
1708250536118,MATS 261B,A00,414468,Qiao; Yu,17,0,25,8
1708250536649,MATS 295,A00,414469,Graeve; Olivia A,9999,0,9999,0
1708250536649,MATS 295,B00,478858,Kummel; Andrew C,9999,0,9999,0
1708250537186,MCWP 40,001,414476,Montejo; Carolina,19,0,20,1
1708250537186,MCWP 40,004,414480,Wastal; Carrie King,13,0,15,2
1708250537186,MCWP 40,005,414481,Wastal; Carrie King,10,0,15,5
1708250537186,MCWP 40,006,414482,Wastal; Carrie King,12,0,15,3
1708250537186,MCWP 40,007,414483,Wastal; Carrie King,13,0,15,2
1708250537186,MCWP 40,008,414484,Wastal; Carrie King,15,0,15,0
1708250537186,MCWP 40,009,414487,Wastal; Carrie King,12,0,15,3
1708250537186,MCWP 40,014,414505,Staff,20,0,20,0
1708250537186,MCWP 40,015,494362,Wastal; Carrie King,14,0,15,1
1708250537721,MCWP 50,002,414534,Bartulis; Jason Michael,20,0,20,0
1708250537721,MCWP 50,003,414536,Bartulis; Jason Michael,20,0,20,0
1708250537721,MCWP 50,004,414538,Krone; Jarret,16,0,20,4
1708250537721,MCWP 50,005,414539,Krone; Jarret,19,0,20,1
1708250537721,MCWP 50,006,414540,Smith; Haydee Marie,16,0,20,4
1708250537721,MCWP 50,007,414544,Compas; Sean Matthew,14,0,20,6
1708250537721,MCWP 50,008,414549,Redela; Pamela Morgan,20,0,20,0
1708250537721,MCWP 50,011,414557,Carter; Andrea L,16,0,20,4
1708250537721,MCWP 50,012,414592,Silva; Kelly B,20,0,20,0
1708250537721,MCWP 50,013,414593,Silva; Kelly B,19,0,20,1
1708250537721,MCWP 50,014,414594,Carter; Andrea L,20,0,20,0
1708250537721,MCWP 50,016,414596,Morshed; Michael James,14,0,20,6
1708250537721,MCWP 50,017,414598,Morshed; Michael James,17,0,20,3
1708250537721,MCWP 50,019,414601,Redela; Pamela Morgan,17,0,20,3
1708250537721,MCWP 50,020,414606,Carter; Jennifer A,20,0,20,0
1708250537721,MCWP 50,021,414607,Carter; Jennifer A,19,0,20,1
1708250537721,MCWP 50,022,414649,Compas; Sean Matthew,11,0,20,9
1708250537721,MCWP 50,023,414650,Smith; Haydee Marie,20,0,20,0
1708250537721,MCWP 50,024,414651,Nies; Laurie Elizabeth,19,0,20,1
1708250537721,MCWP 50,025,414655,Nies; Laurie Elizabeth,18,0,20,2
1708250537721,MCWP 50,026,414656,Pham; Vincent Minhduc,19,0,20,1
1708250537721,MCWP 50,027,414657,Pham; Vincent Minhduc,20,0,20,0
1708250537721,MCWP 50,028,414668,Morshed; Michael James,16,0,20,4
1708250537721,MCWP 50,029,414669,Morshed; Michael James,19,0,20,1
1708250538247,MCWP 50R,A00,486838,Miller; Elizabeth Deen,19,0,20,1
1708250538247,MCWP 50R,B00,486843,Miller; Elizabeth Deen,16,0,20,4
1708250538247,MCWP 50R,C00,486844,Miller; Elizabeth Deen,19,0,20,1
1708250538774,MCWP 125,A00,414670,Wilson; Marion E.,20,0,20,0
1708250538774,MCWP 125,B00,414674,Guillen; Melinda,20,0,20,0
1708250538774,MCWP 125,C00,414678,Guillen; Melinda,20,0,20,0
1708250538774,MCWP 125,D00,414682,Guillen; Melinda,20,0,20,0
1708250539299,MED 231,A00,476440,Hurst; Samantha,7,0,7,0
1708250539825,MED 246,A00,492785,Gordts; Philip & Varki; Ajit P & Lewis; Amanda Lark & Godula; Kamil & Gagneux; Pascal & Esko; Jeffrey D. & Bode; Lars,10,0,10,0
1708250540353,MED 262,A00,492942,Koola; Jejo David,28,0,30,2
1708250540880,MED 267,A01,492789,Hogarth; Michael Andrew,25,0,30,5
1708250541407,MED 275,A00,464684,Liu; George Yenhsi,10,0,10,0
1708250541935,MED 276,A00,492786,Sitapati; Amy,23,0,25,2
1708250542463,MED 278,A00,492787,Carter; Hannah Kathryn & Mesirov; Jill P. & Curtius; Kathleen Mary,20,0,20,0
1708250542990,MED 296,001,464685,Chi; Neil C.,48,0,50,2
1708250542990,MED 296,002,464686,Hong; Kimberly N,49,0,50,1
1708250542990,MED 296,003,464687,Staff,50,0,50,0
1708250543516,MGT 3,A00,442429,Wagner; Timothy Ryan,95,0,98,3
1708250544044,MGT 4,A01,442443,Levkoff; Steven B.,0,0,5,5
1708250544044,MGT 4,A02,442444,Levkoff; Steven B.,4,0,5,1
1708250544576,MGT 5,A00,442446,Molloie Jr.; William H,184,0,196,12
1708250545106,MGT 12,A00,442447,Lindenberger; Wade Douglas,83,0,100,17
1708250545106,MGT 12,B00,442448,Lindenberger; Wade Douglas,72,0,100,28
1708250545106,MGT 12,C00,442449,Pecore; Joseph P.,88,0,100,12
1708250545633,MGT 16,A00,442452,Buchanan; Harold G,97,0,100,3
1708250545633,MGT 16,B00,442459,Buchanan; Harold G,92,0,100,8
1708250545633,MGT 16,C00,442461,Campbell; Robert Harold,113,0,120,7
1708250545633,MGT 16,D00,442475,Campbell; Robert Harold,118,0,120,2
1708250546161,MGT 18,A00,442477,McKay; Michael J,98,0,98,0
1708250546161,MGT 18,B00,442491,McKay; Michael J,96,0,98,2
1708250546161,MGT 18,C00,442493,McKay; Michael J,98,0,98,0
1708250546161,MGT 18,D00,442503,Chamberlain; Travis Dean,98,0,98,0
1708250546690,MGT 45,A00,442508,Pecore; Joseph P.,146,0,150,4
1708250546690,MGT 45,B00,442510,Pecore; Joseph P.,142,0,150,8
1708250547215,MGT 71,A00,442524,Lee; Hyun Seok,77,0,98,21
1708250547742,MGT 71R,A00,442526,Phiroz; Zal Navroze,77,0,98,21
1708250548273,MGT 100,A00,442541,Wilbur; Kenneth C,82,0,98,16
1708250548273,MGT 100,B00,442542,Wilbur; Kenneth C,89,0,98,9
1708250548800,MGT 103,A00,442543,Eberhard; Craig A,98,0,98,0
1708250548800,MGT 103,B00,442544,Eberhard; Craig A,95,0,98,3
1708250548800,MGT 103,C00,442545,Ehrich; Kristine R,90,0,98,8
1708250548800,MGT 103,D00,442547,Ehrich; Kristine R,96,0,98,2
1708250548800,MGT 103,E00,442548,Ehrich; Kristine R,97,0,98,1
1708250548800,MGT 103,F00,442549,Demill; Burritt,92,0,98,6
1708250548800,MGT 103,G00,442550,Bates; Kenneth Walter,97,0,98,1
1708250549325,MGT 105,A00,442558,Bates; Kenneth Walter,86,0,98,12
1708250549854,MGT 106,A00,442560,Eberhard; Craig A,95,0,98,3
1708250550381,MGT 109,A00,442574,Campbell; Colin Leslie,90,0,98,8
1708250550908,MGT 112,A00,442576,Somasundaram; Tyagarajan,96,0,98,2
1708250550908,MGT 112,B00,442590,Somasundaram; Tyagarajan,94,0,98,4
1708250550908,MGT 112,C00,442592,Zimmermann; Carsten,87,0,98,11
1708250551434,MGT 119,A00,442602,Staff,97,0,98,1
1708250551434,MGT 119,B00,442603,Anderson; Jon Marcus,96,0,98,2
1708250551960,MGT 121B,A00,442606,Klaas; Jeffrey David,94,0,98,4
1708250552488,MGT 128R,A00,442607,Krishnan; Viswanathan,84,0,98,14
1708250553015,MGT 131A,A00,442608,Houskeeper; Robert,148,0,150,2
1708250553541,MGT 131B,A00,442609,Houskeeper; Robert,100,0,100,0
1708250554071,MGT 132,A00,442610,Blakley; Bruce,97,0,98,1
1708250554597,MGT 137,A00,442611,Lindenberger; Wade Douglas,86,0,98,12
1708250555123,MGT 147,A00,442612,Anderson; John Charles,32,0,40,8
1708250555652,MGT 151R,A00,442613,Phiroz; Zal Navroze,92,0,98,6
1708250556177,MGT 153,A00,442650,Perols; Johan Lars,55,0,80,25
1708250556759,MGT 162,A00,442652,Demill; Burritt,81,0,98,17
1708250556759,MGT 162,B00,442654,Demill; Burritt,88,0,98,10
1708250556759,MGT 162,C00,442776,Staff,95,0,98,3
1708250556759,MGT 162,D00,442778,Staff,96,0,98,2
1708250557293,MGT 164,A00,442780,McKay; Mary A,97,0,98,1
1708250557293,MGT 164,B00,442849,McKay; Mary A,96,0,98,2
1708250557293,MGT 164,C00,442917,McKay; Mary A,97,0,98,1
1708250557293,MGT 164,D00,442949,Meyer; Alison Bloomfield,90,0,98,8
1708250557820,MGT 166,A00,443017,Moran; Cathleen L.,95,0,98,3
1708250557820,MGT 166,B00,443045,Moran; Cathleen L.,97,0,98,1
1708250557820,MGT 166,C00,443046,Moran; Cathleen L.,98,0,98,0
1708250558347,MGT 167,A00,443047,Klaas; Jeffrey David,93,0,98,5
1708250558874,MGT 171R,A00,443048,Phiroz; Zal Navroze,86,0,98,12
1708250559400,MGT 172,A00,443049,Hedges; Kathleen & Royal; Rebecca,116,0,120,4
1708250559400,MGT 172,B00,443050,Hedges; Kathleen,95,0,98,3
1708250559400,MGT 172,C00,443051,Zimmermann; Carsten,96,0,98,2
1708250559930,MGT 173,A00,443052,Hayes; Sherry Lorine,92,0,100,8
1708250560456,MGT 175,A00,443053,Gopal; Christopher S.,98,0,98,0
1708250560986,MGT 180,A00,443055,Bliss; Barbara Ann,139,0,150,11
1708250560986,MGT 180,B00,443069,Bliss; Barbara Ann,145,0,150,5
1708250561511,MGT 181,A00,443120,Buchanan; Harold G,147,0,150,3
1708250562039,MGT 183,A00,443121,Banerjee; Snehal,88,0,98,10
1708250562566,MGT 185,A00,443122,Dunn; Louis Jean,90,0,98,8
1708250563092,MGT 187,A00,443133,Dunn; Louis Jean,95,0,100,5
1708250563622,MGT 189,A00,443134,Avenancio-Leon; Carlos,98,0,98,0
1708250564148,MGT 227,A00,479242,Serra Garcia; Marta,19,0,20,1
1708250564674,MGT 259,A00,443135,Oveis; Christopher S,19,0,20,1
1708250565203,MGT 296,001,481416,Gneezy; Ayelet,3,0,3,0
1708250565203,MGT 296,002,481420,Amir; On,3,0,3,0
1708250565203,MGT 296,003,481466,Amir; On & Karmarkar; Uma R,3,0,3,0
1708250565203,MGT 296,004,481468,Liu; Jun,3,0,3,0
1708250565203,MGT 296,005,481469,Misra; Kanishka,3,0,3,0
1708250565203,MGT 296,006,481470,Erat; Sanjiv,3,0,3,0
1708250565203,MGT 296,007,481473,Timmermann; Allan,3,0,3,0
1708250565203,MGT 296,008,481474,Smith; Pamela Karen,3,0,3,0
1708250565203,MGT 296,009,481477,Zhang; Zhe,3,0,3,0
1708250565203,MGT 296,010,481478,Oveis; Christopher S,3,0,3,0
1708250565203,MGT 296,011,481479,Amir; On & Gneezy; Ayelet,3,0,3,0
1708250565203,MGT 296,012,481481,Wilbur; Kenneth C,3,0,3,0
1708250565740,MMW 13,A01,412918,Chang; Edmond Yi-Teh,15,0,16,1
1708250565740,MMW 13,A02,412928,Chang; Edmond Yi-Teh,16,0,16,0
1708250565740,MMW 13,A03,413017,Chang; Edmond Yi-Teh,16,0,16,0
1708250565740,MMW 13,A04,413018,Chang; Edmond Yi-Teh,16,0,16,0
1708250565740,MMW 13,A05,413019,Chang; Edmond Yi-Teh,15,0,16,1
1708250565740,MMW 13,A06,413020,Chang; Edmond Yi-Teh,16,0,16,0
1708250565740,MMW 13,A07,413021,Chang; Edmond Yi-Teh,15,0,16,1
1708250565740,MMW 13,A08,413023,Chang; Edmond Yi-Teh,16,0,16,0
1708250565740,MMW 13,A09,413024,Chang; Edmond Yi-Teh,16,0,16,0
1708250565740,MMW 13,A10,413025,Chang; Edmond Yi-Teh,16,0,16,0
1708250565740,MMW 13,A11,413026,Chang; Edmond Yi-Teh,16,0,16,0
1708250565740,MMW 13,A12,413027,Chang; Edmond Yi-Teh,16,0,16,0
1708250565740,MMW 13,A13,413028,Chang; Edmond Yi-Teh,0,0,0,0
1708250565740,MMW 13,A14,413029,Chang; Edmond Yi-Teh,0,0,0,0
1708250565740,MMW 13,A15,413030,Chang; Edmond Yi-Teh,14,0,16,2
1708250565740,MMW 13,A16,413031,Chang; Edmond Yi-Teh,15,0,16,1
1708250565740,MMW 13,A17,413032,Chang; Edmond Yi-Teh,16,0,16,0
1708250565740,MMW 13,A18,413034,Chang; Edmond Yi-Teh,14,0,16,2
1708250565740,MMW 13,A19,413035,Chang; Edmond Yi-Teh,16,0,16,0
1708250565740,MMW 13,A20,413036,Chang; Edmond Yi-Teh,16,0,16,0
1708250565740,MMW 13,A21,413037,Chang; Edmond Yi-Teh,0,0,0,0
1708250565740,MMW 13,A22,413038,Chang; Edmond Yi-Teh,0,0,0,0
1708250565740,MMW 13,B01,413290,Zhiri; Oumelbanine,15,0,16,1
1708250565740,MMW 13,B02,413291,Zhiri; Oumelbanine,15,0,16,1
1708250565740,MMW 13,B03,413308,Zhiri; Oumelbanine,14,0,16,2
1708250565740,MMW 13,B04,413322,Zhiri; Oumelbanine,14,0,16,2
1708250565740,MMW 13,B05,413343,Zhiri; Oumelbanine,12,0,16,4
1708250565740,MMW 13,B06,413344,Zhiri; Oumelbanine,14,0,16,2
1708250565740,MMW 13,B07,413524,Zhiri; Oumelbanine,16,0,16,0
1708250565740,MMW 13,B08,413584,Zhiri; Oumelbanine,16,0,16,0
1708250565740,MMW 13,B09,413588,Zhiri; Oumelbanine,15,0,16,1
1708250565740,MMW 13,B10,413590,Zhiri; Oumelbanine,16,0,16,0
1708250565740,MMW 13,B11,413779,Zhiri; Oumelbanine,12,0,16,4
1708250565740,MMW 13,B12,413780,Zhiri; Oumelbanine,9,0,16,7
1708250565740,MMW 13,B13,413781,Zhiri; Oumelbanine,0,0,0,0
1708250565740,MMW 13,B14,413782,Zhiri; Oumelbanine,0,0,0,0
1708250565740,MMW 13,B15,413808,Zhiri; Oumelbanine,16,0,16,0
1708250565740,MMW 13,B16,413815,Zhiri; Oumelbanine,15,0,16,1
1708250565740,MMW 13,B17,413816,Zhiri; Oumelbanine,15,0,16,1
1708250565740,MMW 13,B18,413817,Zhiri; Oumelbanine,12,0,16,4
1708250565740,MMW 13,B19,413822,Zhiri; Oumelbanine,16,0,16,0
1708250565740,MMW 13,B20,413823,Zhiri; Oumelbanine,14,0,16,2
1708250565740,MMW 13,B21,413825,Zhiri; Oumelbanine,0,0,0,0
1708250565740,MMW 13,B22,413826,Zhiri; Oumelbanine,0,0,0,0
1708250565740,MMW 13,B23,413827,Zhiri; Oumelbanine,16,0,16,0
1708250565740,MMW 13,B24,413834,Zhiri; Oumelbanine,15,0,16,1
1708250565740,MMW 13,C01,413859,Vitkus; Daniel J.,16,0,16,0
1708250565740,MMW 13,C02,413860,Vitkus; Daniel J.,16,0,16,0
1708250565740,MMW 13,C04,413868,Vitkus; Daniel J.,0,0,0,0
1708250565740,MMW 13,C05,413869,Vitkus; Daniel J.,16,0,16,0
1708250565740,MMW 13,C06,413871,Vitkus; Daniel J.,16,0,16,0
1708250565740,MMW 13,C07,413886,Vitkus; Daniel J.,16,0,16,0
1708250565740,MMW 13,C08,413908,Vitkus; Daniel J.,16,0,16,0
1708250565740,MMW 13,C09,413930,Vitkus; Daniel J.,16,0,16,0
1708250565740,MMW 13,C10,413952,Vitkus; Daniel J.,15,0,16,1
1708250565740,MMW 13,C11,413972,Vitkus; Daniel J.,16,0,16,0
1708250565740,MMW 13,C12,413991,Vitkus; Daniel J.,16,0,16,0
1708250565740,MMW 13,C13,414007,Vitkus; Daniel J.,0,0,0,0
1708250565740,MMW 13,C14,414017,Vitkus; Daniel J.,0,0,0,0
1708250565740,MMW 13,C15,414030,Vitkus; Daniel J.,16,0,16,0
1708250565740,MMW 13,C16,414032,Vitkus; Daniel J.,16,0,16,0
1708250565740,MMW 13,C17,414033,Vitkus; Daniel J.,15,0,16,1
1708250565740,MMW 13,C18,414034,Vitkus; Daniel J.,16,0,16,0
1708250565740,MMW 13,C19,414041,Vitkus; Daniel J.,16,0,16,0
1708250565740,MMW 13,C20,414056,Vitkus; Daniel J.,16,0,16,0
1708250565740,MMW 13,C21,414057,Vitkus; Daniel J.,15,0,16,1
1708250565740,MMW 13,C22,414059,Vitkus; Daniel J.,16,0,16,0
1708250566277,MMW 15,A01,414065,Chang; Edmond Yi-Teh,28,0,28,0
1708250566277,MMW 15,A02,414067,Chang; Edmond Yi-Teh,27,0,28,1
1708250566277,MMW 15,A03,414092,Chang; Edmond Yi-Teh,26,0,28,2
1708250566277,MMW 15,A04,414104,Chang; Edmond Yi-Teh,28,0,28,0
1708250566277,MMW 15,A05,414121,Chang; Edmond Yi-Teh,0,0,0,0
1708250566277,MMW 15,A06,414122,Chang; Edmond Yi-Teh,0,0,0,0
1708250566277,MMW 15,A07,414123,Chang; Edmond Yi-Teh,28,0,28,0
1708250566277,MMW 15,A08,414124,Chang; Edmond Yi-Teh,28,0,28,0
1708250566277,MMW 15,A09,414125,Chang; Edmond Yi-Teh,0,0,0,0
1708250566277,MMW 15,A10,414130,Chang; Edmond Yi-Teh,0,0,0,0
1708250566277,MMW 15,B01,414132,Radcliff; Pamela B.,27,0,28,1
1708250566277,MMW 15,B02,414134,Radcliff; Pamela B.,27,0,28,1
1708250566277,MMW 15,B03,414135,Radcliff; Pamela B.,26,0,28,2
1708250566277,MMW 15,B04,414136,Radcliff; Pamela B.,27,0,28,1
1708250566277,MMW 15,B05,414137,Radcliff; Pamela B.,28,0,28,0
1708250566277,MMW 15,B06,414138,Radcliff; Pamela B.,27,0,28,1
1708250566277,MMW 15,B07,414140,Radcliff; Pamela B.,26,0,28,2
1708250566277,MMW 15,B08,414141,Radcliff; Pamela B.,28,0,28,0
1708250566277,MMW 15,C01,414143,Prestholdt; Jeremy,0,0,0,0
1708250566277,MMW 15,C02,414144,Prestholdt; Jeremy,0,0,0,0
1708250566277,MMW 15,C03,414145,Prestholdt; Jeremy,24,0,28,4
1708250566277,MMW 15,C04,414147,Prestholdt; Jeremy,17,0,28,11
1708250566277,MMW 15,C05,414148,Prestholdt; Jeremy,28,0,28,0
1708250566277,MMW 15,C06,414149,Prestholdt; Jeremy,26,0,28,2
1708250566277,MMW 15,C07,414152,Prestholdt; Jeremy,25,0,28,3
1708250566277,MMW 15,C08,414153,Prestholdt; Jeremy,23,0,28,5
1708250566808,MSED 295,A00,477850,Rabin; Jeffrey Mark,5,0,5,0
1708250566808,MSED 295,B00,477852,Lo; Stanley M.,5,0,5,0
1708250567334,MSED 296C,A00,477853,Staff,14,0,15,1
1708250567865,MUS 1C,A01,416488,Ishov; Alexander Alexandrovich,24,0,25,1
1708250567865,MUS 1C,A02,416502,Ishov; Alexander Alexandrovich,25,0,25,0
1708250567865,MUS 1C,A03,416519,Ishov; Alexander Alexandrovich,25,0,25,0
1708250567865,MUS 1C,A04,416520,Ishov; Alexander Alexandrovich,25,0,25,0
1708250567865,MUS 1C,A05,416521,Ishov; Alexander Alexandrovich,25,0,25,0
1708250568391,MUS 2C,A01,416523,Richards; Stephanie F,30,0,30,0
1708250568918,MUS 2CK,A00,416524,Ohnishi; Takae,15,0,15,0
1708250568918,MUS 2CK,B00,416547,Ohnishi; Takae,15,0,15,0
1708250569450,MUS 2JK,A00,416548,Kenyatta; Kamau,15,0,15,0
1708250569978,MUS 4,A01,416562,Staff,25,0,25,0
1708250569978,MUS 4,A02,416634,Staff,24,0,25,1
1708250569978,MUS 4,A03,416644,Staff,25,0,25,0
1708250569978,MUS 4,A04,416659,Staff,24,0,25,1
1708250569978,MUS 4,A05,416667,Staff,25,0,25,0
1708250569978,MUS 4,A06,416757,Staff,25,0,25,0
1708250569978,MUS 4,A07,416830,Staff,25,0,25,0
1708250569978,MUS 4,A08,416953,Staff,23,0,25,2
1708250569978,MUS 4,A09,417005,Staff,25,0,25,0
1708250569978,MUS 4,A10,417007,Staff,24,0,25,1
1708250570504,MUS 7,A01,417048,Staff,23,0,24,1
1708250570504,MUS 7,A02,417102,Staff,23,0,24,1
1708250570504,MUS 7,A03,417103,Staff,23,0,24,1
1708250570504,MUS 7,A04,417114,Staff,22,0,24,2
1708250571033,MUS 8,A01,417119,Staff,14,0,20,6
1708250571033,MUS 8,A02,417163,Staff,16,0,20,4
1708250571033,MUS 8,A03,417164,Staff,16,0,20,4
1708250571033,MUS 8,A04,417165,Staff,17,0,20,3
1708250571033,MUS 8,A05,417194,Staff,18,0,20,2
1708250571033,MUS 8,A06,417198,Staff,20,0,20,0
1708250571559,MUS 11,A01,417201,Terrazas Perez; Wilfrido D,21,0,25,4
1708250571559,MUS 11,A02,417219,Terrazas Perez; Wilfrido D,23,0,25,2
1708250571559,MUS 11,A03,417220,Terrazas Perez; Wilfrido D,25,0,25,0
1708250571559,MUS 11,A04,417222,Terrazas Perez; Wilfrido D,25,0,25,0
1708250571559,MUS 11,A05,417223,Terrazas Perez; Wilfrido D,24,0,25,1
1708250571559,MUS 11,A06,417295,Terrazas Perez; Wilfrido D,23,0,25,2
1708250571559,MUS 11,A07,417297,Terrazas Perez; Wilfrido D,24,0,25,1
1708250571559,MUS 11,A08,417298,Terrazas Perez; Wilfrido D,25,0,25,0
1708250572090,MUS 12,A01,417300,Guy; Nancy,25,0,25,0
1708250572090,MUS 12,A02,417301,Guy; Nancy,25,0,25,0
1708250572090,MUS 12,A03,417302,Guy; Nancy,25,0,25,0
1708250572090,MUS 12,A04,417303,Guy; Nancy,25,0,25,0
1708250572615,MUS 13,A01,417305,Leslie Santana; Myrta,25,0,25,0
1708250572615,MUS 13,A02,417306,Leslie Santana; Myrta,25,0,25,0
1708250572615,MUS 13,A03,417307,Leslie Santana; Myrta,25,0,25,0
1708250572615,MUS 13,A04,417308,Leslie Santana; Myrta,25,0,25,0
1708250573147,MUS 15,A01,417327,Schaffer; Max Benjamin,18,0,20,2
1708250573147,MUS 15,A02,417331,Schaffer; Max Benjamin,19,0,20,1
1708250573147,MUS 15,A03,417358,Schaffer; Max Benjamin,19,0,20,1
1708250573147,MUS 15,A04,417359,Schaffer; Max Benjamin,17,0,20,3
1708250573147,MUS 15,A05,417360,Schaffer; Max Benjamin,20,0,20,0
1708250573147,MUS 15,A06,417370,Schaffer; Max Benjamin,20,0,20,0
1708250573147,MUS 15,A07,417371,Schaffer; Max Benjamin,17,0,20,3
1708250573147,MUS 15,A08,417372,Schaffer; Max Benjamin,18,0,20,2
1708250573147,MUS 15,A09,417378,Schaffer; Max Benjamin,19,0,20,1
1708250573147,MUS 15,A10,417379,Schaffer; Max Benjamin,19,0,20,1
1708250573674,MUS 17,A01,417381,Staff,22,0,25,3
1708250573674,MUS 17,A02,417406,Staff,24,0,25,1
1708250573674,MUS 17,A03,417420,Staff,24,0,25,1
1708250573674,MUS 17,A04,417594,Staff,24,0,25,1
1708250573674,MUS 17,A05,417595,Staff,25,0,25,0
1708250573674,MUS 17,A06,417605,Staff,21,0,25,4
1708250573674,MUS 17,A07,417606,Staff,25,0,25,0
1708250573674,MUS 17,A08,417627,Staff,25,0,25,0
1708250573674,MUS 17,A09,417628,Staff,21,0,25,4
1708250573674,MUS 17,A10,417629,Staff,24,0,25,1
1708250573674,MUS 17,A11,417630,Staff,25,0,25,0
1708250573674,MUS 17,A12,417631,Staff,24,0,25,1
1708250573674,MUS 17,A13,417632,Staff,25,0,25,0
1708250573674,MUS 17,A14,417633,Staff,25,0,25,0
1708250574201,MUS 32,001,418855,Dresser; Mark Stuart,10,0,10,0
1708250574201,MUS 32,002,418856,Kenyatta; Kamau,9,0,10,1
1708250574201,MUS 32,003,418864,Curtis; Charles Rector,10,0,10,0
1708250574201,MUS 32,004,418865,Carlstrom; Mitchell Kraig,9,0,10,1
1708250574201,MUS 32,005,418868,Terrazas Perez; Wilfrido D,10,0,10,0
1708250574201,MUS 32,006,418869,Ohnishi; Takae,10,0,10,0
1708250574201,MUS 32,007,418872,Burr; Anthony I,10,0,10,0
1708250574201,MUS 32,008,418873,Carlson; Erik Norman,10,0,10,0
1708250574201,MUS 32,009,418874,Blair; Kyle Adam,10,0,10,0
1708250574201,MUS 32,010,418875,Richards; Stephanie F,10,0,10,0
1708250574729,MUS 32V,A00,417634,Narucki; Susan M,10,0,10,0
1708250574729,MUS 32V,B00,417635,Staff,10,0,10,0
1708250575257,MUS 32VM,A00,417636,Staff,15,0,15,0
1708250575789,MUS 33C,A00,417637,Taylor; Alexander Lawther,20,0,20,0
1708250576315,MUS 43,A00,417647,Burr; Anthony I,83,0,90,7
1708250576844,MUS 95D,A00,417919,Staff,40,0,40,0
1708250577371,MUS 95E,A00,417933,Henson; Matthew Alexander,55,0,55,0
1708250577898,MUS 95G,A00,417935,Anderson; Kenneth,387,0,395,8
1708250577898,MUS 95G,B00,417937,Anderson; Kenneth,394,0,395,1
1708250578426,MUS 95JC,A00,417939,Kenyatta; Kamau,30,0,30,0
1708250578956,MUS 95L,A00,417940,Jones; Michael David,50,0,50,0
1708250579481,MUS 95W,A00,417946,Seshadri; Kartik,29,0,30,1
1708250579481,MUS 95W,B00,417948,Seshadri; Kartik,30,0,30,0
1708250580008,MUS 101C,A01,417951,Burr; Anthony I,33,0,35,2
1708250580543,MUS 103C,A00,417952,Davis; Anthony Curtis,14,0,15,1
1708250581071,MUS 103F,A00,417959,Obermueller; Karola,1,0,1,0
1708250581602,MUS 113,A00,418015,Narucki; Susan M,13,0,15,2
1708250582127,MUS 120C,A01,418032,Leslie Santana; Myrta,25,0,25,0
1708250582656,MUS 127,A00,418037,Richards; Stephanie F,92,0,100,8
1708250583182,MUS 130,A00,418047,Ohnishi; Takae,30,0,30,0
1708250583707,MUS 131,A00,418065,Roberts; Matana,30,0,30,0
1708250584238,MUS 132,001,418883,Dresser; Mark Stuart,10,0,10,0
1708250584238,MUS 132,002,418885,Kenyatta; Kamau,10,0,10,0
1708250584238,MUS 132,003,418886,Curtis; Charles Rector,10,0,10,0
1708250584238,MUS 132,004,418887,Carlstrom; Mitchell Kraig,10,0,10,0
1708250584238,MUS 132,005,418888,Jones; Michael David,10,0,10,0
1708250584238,MUS 132,006,418889,Terrazas Perez; Wilfrido D,10,0,10,0
1708250584238,MUS 132,007,418893,Ohnishi; Takae,10,0,10,0
1708250584238,MUS 132,008,418894,Burr; Anthony I,10,0,10,0
1708250584238,MUS 132,009,418896,Carlson; Erik Norman,10,0,10,0
1708250584238,MUS 132,010,418900,Blair; Kyle Adam,10,0,10,0
1708250584238,MUS 132,011,418932,Richards; Stephanie F,10,0,10,0
1708250584238,MUS 132,012,418933,Nourai; Keyarash,10,0,10,0
1708250584766,MUS 132R,A00,418067,Burr; Anthony I,5,0,5,0
1708250584766,MUS 132R,B00,418078,Jones; Michael David,5,0,5,0
1708250585291,MUS 132V,A00,418092,Narucki; Susan M,15,0,15,0
1708250585291,MUS 132V,B00,418096,Staff,15,0,15,0
1708250585817,MUS 134,A00,418098,Staff,40,0,40,0
1708250586342,MUS 137C,A00,418109,Kenyatta; Kamau,25,0,25,0
1708250586868,MUS 143,A00,418123,Burr; Anthony I,33,0,40,7
1708250587397,MUS 150,A00,418127,Davis; Anthony Curtis,28,0,30,2
1708250587923,MUS 151,A00,418129,Hankins; Sarah E.,20,0,30,10
1708250588449,MUS 160B,A00,418172,Staff,11,0,15,4
1708250588449,MUS 160B,B00,418175,Dubnov; Shlomo,14,0,15,1
1708250588979,MUS 172,A01,418178,Staff,36,0,40,4
1708250589507,MUS 174C,A00,418179,Erbe; Tom,24,0,27,3
1708250590038,MUS 175,A00,418247,Smyth; Tamara R.,28,0,30,2
1708250590563,MUS 177,A00,418265,Erbe; Tom,11,0,15,4
1708250591092,MUS 201A,A00,418267,Narucki; Susan M,15,0,15,0
1708250591092,MUS 201A,B00,418268,Dresser; Mark Stuart,13,0,15,2
1708250591622,MUS 203C,A00,418269,Lou; Michelle Siulai,15,0,15,0
1708250592146,MUS 203D,A00,418272,Davis; Anthony Curtis,4,0,5,1
1708250592146,MUS 203D,B00,418275,Obermueller; Karola,5,0,5,0
1708250592146,MUS 203D,C00,418277,Liang; Lei,5,0,5,0
1708250592146,MUS 203D,D00,418323,Lou; Michelle Siulai,5,0,5,0
1708250592672,MUS 204,A00,418324,Obermueller; Karola,24,0,25,1
1708250593202,MUS 205,A00,418325,Cimini; Amy Marie,22,0,25,3
1708250593727,MUS 206,A00,418326,Liang; Lei,13,0,15,2
1708250593727,MUS 206,B00,418327,Roberts; Matana,13,0,15,2
1708250594252,MUS 215C,A00,418328,Cimini; Amy Marie,14,0,15,1
1708250594779,MUS 232,001,418937,Dresser; Mark Stuart,9,0,10,1
1708250594779,MUS 232,002,418969,Kenyatta; Kamau,10,0,10,0
1708250594779,MUS 232,003,418971,Curtis; Charles Rector,10,0,10,0
1708250594779,MUS 232,004,418974,Terrazas Perez; Wilfrido D,10,0,10,0
1708250594779,MUS 232,005,418979,Ohnishi; Takae,10,0,10,0
1708250594779,MUS 232,006,418980,Burr; Anthony I,10,0,10,0
1708250594779,MUS 232,007,418981,Carlson; Erik Norman,10,0,10,0
1708250594779,MUS 232,008,418982,Richards; Stephanie F,10,0,10,0
1708250594779,MUS 232,009,418985,Narucki; Susan M,10,0,10,0
1708250595306,MUS 234,A00,418329,Staff,15,0,15,0
1708250595834,MUS 245,A00,418330,Carlson; Erik Norman,14,0,15,1
1708250596363,MUS 267,A00,418331,Erbe; Tom,15,0,15,0
1708250596891,MUS 270B,A00,418332,Staff,15,0,15,0
1708250597417,MUS 270D,A00,479231,Smyth; Tamara R.,15,0,15,0
1708250597947,NANO 103,A00,414714,Jahed Motlagh; Zeinab,40,0,40,0
1708250598474,NANO 108,A00,414740,Lubarda; Vlado,70,0,70,0
1708250599001,NANO 112,A01,414825,Vazquez Mena; Oscar,70,0,70,0
1708250599532,NANO 115L,A01,414830,Yang; Kesong,37,0,38,1
1708250599532,NANO 115L,B01,414832,Xu; Sheng,35,0,38,3
1708250600062,NANO 120B,A01,414835,Vecchio; Kenneth S,33,0,35,2
1708250600062,NANO 120B,B01,414841,Fenning; David,30,0,35,5
1708250600587,NANO 156,A00,414843,Fullerton; Eric E,24,0,30,6
1708250601113,NANO 158,A00,414844,Luo; Jian,29,0,30,1
1708250601644,NANO 175,A00,414850,Steinmetz; Nicole F,30,0,35,5
1708250602169,NANO 200,A00,414852,Jahed Motlagh; Zeinab,118,0,120,2
1708250602699,NANO 241,A00,414854,Pokorski; Jonathan Kyle,18,0,25,7
1708250603224,NANO 262,A00,414858,Wang; Joseph,50,0,50,0
1708250603751,NANO 271,A00,414862,Cubukcu; Ertugrul,22,0,25,3
1708250604280,NANO 272,A00,414877,Xu; Sheng,42,0,50,8
1708250604806,NANO 279,A00,414878,Liu; Ping,32,0,40,8
1708250605332,NANO 282,A00,414879,Steinmetz; Nicole F,30,0,30,0
1708250605857,NEU 200C,A00,455013,Staff,0,0,0,1
1708250606385,NEU 276,A01,479489,Staff,35,0,36,1
1708250606911,NEU 277,A00,479492,Risbrough; Victoria Blythe,0,0,0,0
1708250607441,NEU 296,001,464921,Evans; Sean Jeffrey,48,0,50,2
1708250607441,NEU 296,002,464922,Staff,50,0,50,0
1708250607441,NEU 296,003,464925,Staff,50,0,50,0
1708250607968,NEUG 221,A00,479490,Zheng; Binhai,15,0,15,0
1708250608503,NEUG 280,A00,479491,Chen; Xu,0,0,0,0
1708250609030,NEUG 296,A00,479493,Bloodgood; Brenda Laurie,9998,0,9999,1
1708250609557,OPTH 296,001,465054,Baxter; Sally Liu,49,0,50,1
1708250609557,OPTH 296,002,465068,Afshari; Natalie,49,0,50,1
1708250609557,OPTH 296,003,465074,Staff,50,0,50,0
1708250610138,ORTH 296,A00,465104,Staff,50,0,50,0
1708250610138,ORTH 296,001,465111,Staff,50,0,50,0
1708250610138,ORTH 296,002,465120,Staff,50,0,50,0
1708250610668,PATH 224,A01,494386,Ross; Camille,11,0,12,1
1708250611194,PATH 296,001,465373,Calcutt; Nigel A,49,0,50,1
1708250611194,PATH 296,002,465374,Staff,50,0,50,0
1708250611194,PATH 296,003,465375,Staff,50,0,50,0
1708250611723,PEDS 296,001,465527,Weiss; Katherine Jean,49,0,50,1
1708250611723,PEDS 296,002,465528,Staff,50,0,50,0
1708250611723,PEDS 296,003,465529,Staff,50,0,50,0
1708250612250,PH 196BH,A01,405158,Binkin; Nancy Jeanne,20,0,20,0
1708250612779,PHAR 219,A00,415016,Ross; Camille,1,0,1,0
1708250613305,PHAR 231,A00,415017,Furnari; Frank,20,0,20,0
1708250613305,PHAR 231,B00,415018,Lopez Ramirez; Miguel Alej,20,0,20,0
1708250613831,PHAR 276,A00,415020,Mc Culloch; Andrew Douglas & Amaro; Rommie E,1,0,1,0
1708250614357,PHAR 295,A00,415022,Brown; Joan Heller,15,0,15,0
1708250614899,PHIL 1,A00,415023,Harrell; Maralee Mae,58,0,60,2
1708250615429,PHIL 10,A01,415026,Grush; Rick Scott,40,0,44,4
1708250615429,PHIL 10,A02,415028,Grush; Rick Scott,42,0,44,2
1708250615429,PHIL 10,A03,415029,Grush; Rick Scott,0,0,0,0
1708250615429,PHIL 10,A04,415031,Grush; Rick Scott,0,0,0,0
1708250615429,PHIL 10,A05,415113,Grush; Rick Scott,43,0,44,1
1708250615429,PHIL 10,A06,415114,Grush; Rick Scott,43,0,44,1
1708250615429,PHIL 10,A07,415116,Grush; Rick Scott,44,0,44,0
1708250615429,PHIL 10,A08,415118,Grush; Rick Scott,43,0,44,1
1708250615956,PHIL 12,A01,415120,McKenzie; Kerry V.,28,0,30,2
1708250615956,PHIL 12,A02,415136,McKenzie; Kerry V.,30,0,30,0
1708250615956,PHIL 12,A03,415137,McKenzie; Kerry V.,27,0,30,3
1708250615956,PHIL 12,A04,415142,McKenzie; Kerry V.,30,0,30,0
1708250616482,PHIL 13,A01,415165,Brink; David O.,25,0,25,0
1708250616482,PHIL 13,A02,415179,Brink; David O.,22,0,25,3
1708250616482,PHIL 13,A03,415185,Brink; David O.,24,0,25,1
1708250616482,PHIL 13,A04,415201,Brink; David O.,25,0,25,0
1708250616482,PHIL 13,A05,415204,Brink; David O.,25,0,25,0
1708250616482,PHIL 13,A06,415220,Brink; David O.,25,0,25,0
1708250617008,PHIL 15,A01,415250,Fulkerson; Matthew Todd,26,0,30,4
1708250617008,PHIL 15,A02,415281,Fulkerson; Matthew Todd,29,0,30,1
1708250617540,PHIL 27,A01,415293,Brandt; Reuven A,20,0,25,5
1708250617540,PHIL 27,A02,415296,Brandt; Reuven A,0,0,0,0
1708250617540,PHIL 27,A03,415332,Brandt; Reuven A,22,0,25,3
1708250617540,PHIL 27,A04,415333,Brandt; Reuven A,22,0,25,3
1708250617540,PHIL 27,A05,415342,Brandt; Reuven A,20,0,25,5
1708250617540,PHIL 27,A06,415384,Brandt; Reuven A,24,0,25,1
1708250617540,PHIL 27,A07,415385,Brandt; Reuven A,25,0,25,0
1708250617540,PHIL 27,A08,415391,Brandt; Reuven A,0,0,0,0
1708250617540,PHIL 27,A09,415406,Brandt; Reuven A,0,0,0,0
1708250617540,PHIL 27,A10,415407,Brandt; Reuven A,0,0,0,0
1708250618066,PHIL 28,A01,415412,Lamey; Andy M.,24,0,25,1
1708250618066,PHIL 28,A02,415470,Lamey; Andy M.,20,0,25,5
1708250618066,PHIL 28,A03,415474,Lamey; Andy M.,0,0,0,0
1708250618066,PHIL 28,A04,415475,Lamey; Andy M.,22,0,25,3
1708250618066,PHIL 28,A05,415487,Lamey; Andy M.,24,0,25,1
1708250618066,PHIL 28,A06,415506,Lamey; Andy M.,21,0,25,4
1708250618066,PHIL 28,A07,415507,Lamey; Andy M.,25,0,25,0
1708250618066,PHIL 28,A08,415508,Lamey; Andy M.,24,0,25,1
1708250618066,PHIL 28,A09,415509,Lamey; Andy M.,25,0,25,0
1708250618066,PHIL 28,A10,415510,Lamey; Andy M.,0,0,0,0
1708250618592,PHIL 33,A01,415521,Hardimon; Michael O.,35,0,35,0
1708250618592,PHIL 33,A02,415522,Hardimon; Michael O.,35,0,35,0
1708250619120,PHIL 60,A00,415523,Marechal; Patricia,55,0,60,5
1708250619650,PHIL 102,A00,415524,Johnson; Monte,37,0,40,3
1708250620182,PHIL 106,A00,415544,Watkins; Eric,40,0,40,0
1708250620709,PHIL 112,A00,415545,Watkins; Eric,34,0,40,6
1708250621237,PHIL 115,A00,415548,Nelkin; Dana Kay,20,0,20,0
1708250621763,PHIL 120,A00,415549,Carr; Jennifer Rose,64,0,65,1
1708250622291,PHIL 134,A00,415552,Carr; Jennifer Rose,40,0,40,0
1708250622822,PHIL 150,A00,415553,Cohen; Jonathan David,38,0,40,2
1708250623347,PHIL 171,A00,415561,Brink; David O.,39,0,40,1
1708250623879,PHIL 172,A00,415563,Lamey; Andy M.,40,0,40,0
1708250624405,PHIL 174,A01,415576,Danks; David J,21,0,25,4
1708250624405,PHIL 174,A02,415582,Danks; David J,22,0,25,3
1708250624405,PHIL 174,A03,415583,Danks; David J,24,0,25,1
1708250624405,PHIL 174,A04,415584,Danks; David J,25,0,25,0
1708250624932,PHIL 175,A00,415585,Shields; Christopher John,40,0,40,0
1708250625462,PHIL 181,A00,415601,Tolley; Clinton,34,0,40,6
1708250625993,PHIL 209B,A00,415655,Serlin; David,4,0,5,1
1708250626522,PHIL 209C,A00,415658,Gates; Kelly,5,0,5,0
1708250627048,PHIL 210,A00,415659,Marechal; Patricia,20,0,20,0
1708250627579,PHIL 230,A00,415661,Grush; Rick Scott,20,0,20,0
1708250628105,PHIL 232,A00,415662,Sher; Gila,20,0,20,0
1708250628633,PHIL 260,A00,415675,Bazargan-Forward; Saba,20,0,20,0
1708250629163,PHIL 277,A00,479176,Tolley; Clinton,9,0,10,1
1708250629689,PHIL 285,A00,415685,Kovaka; Karenc,20,0,20,0
1708250630232,PHIL 287,A00,415697,Marechal; Patricia,5,0,5,0
1708250630768,PHIL 290,001,415701,Nelkin; Dana Kay,9999,0,9999,0
1708250630768,PHIL 290,002,415721,Bazargan-Forward; Saba,9999,0,9999,0
1708250630768,PHIL 290,003,415731,Brandt; Reuven A,9999,0,9999,0
1708250630768,PHIL 290,004,415743,Brink; David O.,9999,0,9999,0
1708250630768,PHIL 290,005,415747,Callender; Craig Adam,9999,0,9999,0
1708250630768,PHIL 290,006,415779,Carr; Jennifer Rose,9999,0,9999,0
1708250630768,PHIL 290,007,415780,Cartwright; Nancy D.,9999,0,9999,0
1708250630768,PHIL 290,008,415781,Cohen; Jonathan David,9999,0,9999,0
1708250630768,PHIL 290,009,415782,Danks; David J,9999,0,9999,0
1708250630768,PHIL 290,010,415783,Fulkerson; Matthew Todd,9999,0,9999,0
1708250630768,PHIL 290,011,415784,Grush; Rick Scott,9999,0,9999,0
1708250630768,PHIL 290,012,415785,Hardimon; Michael O.,9999,0,9999,0
1708250630768,PHIL 290,013,415786,Harrell; Maralee Mae,9999,0,9999,0
1708250630768,PHIL 290,014,415787,Johnson; Monte,9999,0,9999,0
1708250630768,PHIL 290,015,415788,Kovaka; Karenc,9999,0,9999,0
1708250630768,PHIL 290,016,415789,Lamey; Andy M.,9999,0,9999,0
1708250630768,PHIL 290,017,415790,Marechal; Patricia,9999,0,9999,0
1708250630768,PHIL 290,018,415791,McKenzie; Kerry V.,9999,0,9999,0
1708250630768,PHIL 290,019,415792,Rickless; Samuel Charles,9999,0,9999,0
1708250630768,PHIL 290,020,415793,Sher; Gila,9999,0,9999,0
1708250630768,PHIL 290,021,415794,Shields; Christopher John,9999,0,9999,0
1708250630768,PHIL 290,022,415805,Tolley; Clinton,9999,0,9999,0
1708250630768,PHIL 290,023,415806,Vargas; Manuel Rogelio,9999,0,9999,0
1708250630768,PHIL 290,024,415807,Watkins; Eric,9999,0,9999,0
1708250630768,PHIL 290,025,415815,Chen; Keming,9999,0,9999,0
1708250631295,PHIL 295,001,415816,Bazargan-Forward; Saba,9999,0,9999,0
1708250631295,PHIL 295,002,415857,Brandt; Reuven A,9999,0,9999,0
1708250631295,PHIL 295,003,415858,Brink; David O.,9999,0,9999,0
1708250631295,PHIL 295,004,415877,Callender; Craig Adam,9999,0,9999,0
1708250631295,PHIL 295,005,415878,Carr; Jennifer Rose,9999,0,9999,0
1708250631295,PHIL 295,006,415884,Cartwright; Nancy D.,9999,0,9999,0
1708250631295,PHIL 295,007,415885,Chen; Keming,9999,0,9999,0
1708250631295,PHIL 295,008,415891,Cohen; Jonathan David,9999,0,9999,0
1708250631295,PHIL 295,009,415892,Danks; David J,9999,0,9999,0
1708250631295,PHIL 295,010,415937,Fulkerson; Matthew Todd,9999,0,9999,0
1708250631295,PHIL 295,011,415940,Grush; Rick Scott,9999,0,9999,0
1708250631295,PHIL 295,012,415945,Hardimon; Michael O.,9999,0,9999,0
1708250631295,PHIL 295,013,415946,Harrell; Maralee Mae,9999,0,9999,0
1708250631295,PHIL 295,014,415953,Johnson; Monte,9999,0,9999,0
1708250631295,PHIL 295,015,415954,Kovaka; Karenc,9999,0,9999,0
1708250631295,PHIL 295,016,415957,Lamey; Andy M.,9999,0,9999,0
1708250631295,PHIL 295,017,415958,Marechal; Patricia,9999,0,9999,0
1708250631295,PHIL 295,018,415959,McKenzie; Kerry V.,9999,0,9999,0
1708250631295,PHIL 295,019,415960,Nelkin; Dana Kay,9999,0,9999,0
1708250631295,PHIL 295,020,415961,Rickless; Samuel Charles,9999,0,9999,0
1708250631295,PHIL 295,021,415987,Sher; Gila,9999,0,9999,0
1708250631295,PHIL 295,022,416027,Shields; Christopher John,9999,0,9999,0
1708250631295,PHIL 295,023,416030,Tolley; Clinton,9999,0,9999,0
1708250631295,PHIL 295,024,416033,Vargas; Manuel Rogelio,9999,0,9999,0
1708250631295,PHIL 295,025,416034,Watkins; Eric,9999,0,9999,0
1708250631820,PHYA 224,A00,442106,Sandstrom; Karin Marie,30,0,30,0
1708250632348,PHYS 1A,A00,441607,Gilbert; Dylan Paul,346,0,362,16
1708250632883,PHYS 1AL,001,441608,Arlett; Jessica Lynn & Yagil; Avi,30,0,30,0
1708250632883,PHYS 1AL,002,441609,Arlett; Jessica Lynn & Yagil; Avi,28,0,30,2
1708250632883,PHYS 1AL,003,441610,Arlett; Jessica Lynn & Yagil; Avi,26,0,30,4
1708250632883,PHYS 1AL,004,441611,Arlett; Jessica Lynn & Yagil; Avi,29,0,30,1
1708250632883,PHYS 1AL,005,441612,Arlett; Jessica Lynn & Yagil; Avi,28,0,30,2
1708250632883,PHYS 1AL,006,441616,Arlett; Jessica Lynn & Yagil; Avi,28,0,30,2
1708250632883,PHYS 1AL,007,441618,Arlett; Jessica Lynn & Yagil; Avi,26,0,30,4
1708250632883,PHYS 1AL,008,441620,Arlett; Jessica Lynn & Yagil; Avi,29,0,30,1
1708250632883,PHYS 1AL,009,441623,Arlett; Jessica Lynn & Yagil; Avi,29,0,30,1
1708250632883,PHYS 1AL,010,441625,Arlett; Jessica Lynn & Yagil; Avi,29,0,30,1
1708250632883,PHYS 1AL,011,441626,Arlett; Jessica Lynn & Yagil; Avi,29,0,30,1
1708250632883,PHYS 1AL,012,441627,Arlett; Jessica Lynn & Yagil; Avi,29,0,30,1
1708250633414,PHYS 1B,A00,441630,Groisman; Alexander,351,0,362,11
1708250633940,PHYS 1BL,001,441632,Arlett; Jessica Lynn & Yagil; Avi,28,0,30,2
1708250633940,PHYS 1BL,002,441634,Arlett; Jessica Lynn & Yagil; Avi,29,0,30,1
1708250633940,PHYS 1BL,003,441636,Arlett; Jessica Lynn & Yagil; Avi,29,0,30,1
1708250633940,PHYS 1BL,004,441637,Arlett; Jessica Lynn & Yagil; Avi,29,0,30,1
1708250633940,PHYS 1BL,005,441639,Arlett; Jessica Lynn & Yagil; Avi,29,0,30,1
1708250633940,PHYS 1BL,006,441641,Arlett; Jessica Lynn & Yagil; Avi,26,0,30,4
1708250633940,PHYS 1BL,007,441642,Arlett; Jessica Lynn & Yagil; Avi,23,0,30,7
1708250633940,PHYS 1BL,008,441643,Arlett; Jessica Lynn & Yagil; Avi,30,0,30,0
1708250633940,PHYS 1BL,009,441646,Arlett; Jessica Lynn & Yagil; Avi,29,0,30,1
1708250633940,PHYS 1BL,010,441648,Arlett; Jessica Lynn & Yagil; Avi,29,0,30,1
1708250633940,PHYS 1BL,011,441652,Arlett; Jessica Lynn & Yagil; Avi,29,0,30,1
1708250633940,PHYS 1BL,012,441654,Arlett; Jessica Lynn & Yagil; Avi,30,0,30,0
1708250634468,PHYS 1C,A00,441658,Popmintchev; Tenio,587,0,600,13
1708250634468,PHYS 1C,B00,441662,Popmintchev; Tenio,558,0,600,42
1708250634998,PHYS 1CL,001,441664,Arlett; Jessica Lynn & Yagil; Avi,29,0,30,1
1708250634998,PHYS 1CL,002,441665,Arlett; Jessica Lynn & Yagil; Avi,27,0,30,3
1708250634998,PHYS 1CL,003,441666,Arlett; Jessica Lynn & Yagil; Avi,25,0,30,5
1708250634998,PHYS 1CL,004,441667,Arlett; Jessica Lynn & Yagil; Avi,30,0,30,0
1708250634998,PHYS 1CL,005,441668,Arlett; Jessica Lynn & Yagil; Avi,28,0,30,2
1708250634998,PHYS 1CL,006,441669,Arlett; Jessica Lynn & Yagil; Avi,25,0,30,5
1708250634998,PHYS 1CL,007,441671,Arlett; Jessica Lynn & Yagil; Avi,27,0,30,3
1708250634998,PHYS 1CL,008,441673,Arlett; Jessica Lynn & Yagil; Avi,30,0,30,0
1708250634998,PHYS 1CL,009,441674,Arlett; Jessica Lynn & Yagil; Avi,26,0,30,4
1708250634998,PHYS 1CL,010,441676,Arlett; Jessica Lynn & Yagil; Avi,30,0,30,0
1708250634998,PHYS 1CL,011,441677,Arlett; Jessica Lynn & Yagil; Avi,30,0,30,0
1708250634998,PHYS 1CL,012,441683,Arlett; Jessica Lynn & Yagil; Avi,30,0,30,0
1708250634998,PHYS 1CL,013,441685,Arlett; Jessica Lynn & Yagil; Avi,28,0,30,2
1708250634998,PHYS 1CL,014,441687,Arlett; Jessica Lynn & Yagil; Avi,30,0,30,0
1708250634998,PHYS 1CL,015,441689,Arlett; Jessica Lynn & Yagil; Avi,17,0,30,13
1708250634998,PHYS 1CL,016,441692,Arlett; Jessica Lynn & Yagil; Avi,29,0,30,1
1708250634998,PHYS 1CL,017,441696,Arlett; Jessica Lynn & Yagil; Avi,24,0,30,6
1708250634998,PHYS 1CL,018,441698,Arlett; Jessica Lynn & Yagil; Avi,25,0,30,5
1708250634998,PHYS 1CL,019,441702,Arlett; Jessica Lynn & Yagil; Avi,25,0,30,5
1708250634998,PHYS 1CL,020,441705,Arlett; Jessica Lynn & Yagil; Avi,29,0,30,1
1708250634998,PHYS 1CL,021,441706,Arlett; Jessica Lynn & Yagil; Avi,30,0,30,0
1708250634998,PHYS 1CL,022,441707,Arlett; Jessica Lynn & Yagil; Avi,30,0,30,0
1708250634998,PHYS 1CL,023,441708,Arlett; Jessica Lynn & Yagil; Avi,27,0,30,3
1708250634998,PHYS 1CL,024,441710,Arlett; Jessica Lynn & Yagil; Avi,29,0,30,1
1708250634998,PHYS 1CL,025,441711,Arlett; Jessica Lynn & Yagil; Avi,28,0,30,2
1708250634998,PHYS 1CL,026,441712,Arlett; Jessica Lynn & Yagil; Avi,29,0,30,1
1708250634998,PHYS 1CL,027,441713,Arlett; Jessica Lynn & Yagil; Avi,26,0,30,4
1708250634998,PHYS 1CL,028,441714,Arlett; Jessica Lynn & Yagil; Avi,29,0,30,1
1708250634998,PHYS 1CL,029,441715,Arlett; Jessica Lynn & Yagil; Avi,25,0,30,5
1708250634998,PHYS 1CL,030,441717,Arlett; Jessica Lynn & Yagil; Avi,29,0,30,1
1708250634998,PHYS 1CL,031,441718,Arlett; Jessica Lynn & Yagil; Avi,27,0,30,3
1708250634998,PHYS 1CL,032,441721,Arlett; Jessica Lynn & Yagil; Avi,30,0,30,0
1708250634998,PHYS 1CL,033,441724,Arlett; Jessica Lynn & Yagil; Avi,28,0,30,2
1708250634998,PHYS 1CL,034,441726,Arlett; Jessica Lynn & Yagil; Avi,29,0,30,1
1708250634998,PHYS 1CL,035,441728,Arlett; Jessica Lynn & Yagil; Avi,29,0,30,1
1708250634998,PHYS 1CL,036,441729,Arlett; Jessica Lynn & Yagil; Avi,30,0,30,0
1708250634998,PHYS 1CL,037,441730,Arlett; Jessica Lynn & Yagil; Avi,27,0,30,3
1708250634998,PHYS 1CL,038,441732,Arlett; Jessica Lynn & Yagil; Avi,29,0,30,1
1708250634998,PHYS 1CL,039,441733,Arlett; Jessica Lynn & Yagil; Avi,27,0,30,3
1708250634998,PHYS 1CL,040,441734,Arlett; Jessica Lynn & Yagil; Avi,30,0,30,0
1708250634998,PHYS 1CL,041,441735,Arlett; Jessica Lynn & Yagil; Avi,29,0,30,1
1708250634998,PHYS 1CL,042,441766,Arlett; Jessica Lynn & Yagil; Avi,30,0,30,0
1708250634998,PHYS 1CL,043,441768,Arlett; Jessica Lynn & Yagil; Avi,29,0,30,1
1708250634998,PHYS 1CL,044,441770,Arlett; Jessica Lynn & Yagil; Avi,30,0,30,0
1708250635526,PHYS 2A,A01,460308,Bal; Gurleen K,28,0,30,2
1708250635526,PHYS 2A,A02,460320,Bal; Gurleen K,30,0,30,0
1708250635526,PHYS 2A,A03,460321,Bal; Gurleen K,29,0,30,1
1708250635526,PHYS 2A,A04,460325,Bal; Gurleen K,28,0,30,2
1708250635526,PHYS 2A,A05,460326,Bal; Gurleen K,29,0,30,1
1708250635526,PHYS 2A,A06,460327,Bal; Gurleen K,30,0,30,0
1708250635526,PHYS 2A,A07,460495,Bal; Gurleen K,28,0,30,2
1708250635526,PHYS 2A,A08,460535,Bal; Gurleen K,27,0,30,3
1708250635526,PHYS 2A,A09,460536,Bal; Gurleen K,30,0,30,0
1708250635526,PHYS 2A,A10,460537,Bal; Gurleen K,30,0,30,0
1708250635526,PHYS 2A,A11,460538,Bal; Gurleen K,30,0,30,0
1708250635526,PHYS 2A,A12,460539,Bal; Gurleen K,30,0,30,0
1708250636055,PHYS 2B,A01,460620,Barreiro Guerrero; Julio,30,0,30,0
1708250636055,PHYS 2B,A02,460625,Barreiro Guerrero; Julio,30,0,30,0
1708250636055,PHYS 2B,A03,460626,Barreiro Guerrero; Julio,29,0,30,1
1708250636055,PHYS 2B,A04,460716,Barreiro Guerrero; Julio,26,0,30,4
1708250636055,PHYS 2B,A05,460756,Barreiro Guerrero; Julio,29,0,30,1
1708250636055,PHYS 2B,A06,460837,Barreiro Guerrero; Julio,30,0,30,0
1708250636055,PHYS 2B,A07,460865,Barreiro Guerrero; Julio,30,0,30,0
1708250636055,PHYS 2B,A08,460866,Barreiro Guerrero; Julio,30,0,30,0
1708250636055,PHYS 2B,A09,460867,Barreiro Guerrero; Julio,29,0,30,1
1708250636055,PHYS 2B,A10,460868,Barreiro Guerrero; Julio,30,0,30,0
1708250636055,PHYS 2B,A11,460869,Barreiro Guerrero; Julio,30,0,30,0
1708250636055,PHYS 2B,A12,460874,Barreiro Guerrero; Julio,30,0,30,0
1708250636055,PHYS 2B,B01,469381,Barreiro Guerrero; Julio,30,0,30,0
1708250636055,PHYS 2B,B02,469382,Barreiro Guerrero; Julio,29,0,30,1
1708250636055,PHYS 2B,B03,469402,Barreiro Guerrero; Julio,27,0,30,3
1708250636055,PHYS 2B,B04,469403,Barreiro Guerrero; Julio,28,0,30,2
1708250636055,PHYS 2B,B05,469442,Barreiro Guerrero; Julio,30,0,30,0
1708250636055,PHYS 2B,B06,469449,Barreiro Guerrero; Julio,30,0,30,0
1708250636055,PHYS 2B,B07,469450,Barreiro Guerrero; Julio,29,0,30,1
1708250636055,PHYS 2B,B08,469451,Barreiro Guerrero; Julio,30,0,30,0
1708250636055,PHYS 2B,B09,469457,Barreiro Guerrero; Julio,29,0,30,1
1708250636055,PHYS 2B,B10,469460,Barreiro Guerrero; Julio,30,0,30,0
1708250636055,PHYS 2B,B11,469468,Barreiro Guerrero; Julio,30,0,30,0
1708250636055,PHYS 2B,B12,469475,Barreiro Guerrero; Julio,30,0,30,0
1708250636588,PHYS 2BL,A01,441779,Meyertholen; Andrew D.,21,0,24,3
1708250636588,PHYS 2BL,A02,441780,Meyertholen; Andrew D.,17,0,24,7
1708250636588,PHYS 2BL,A03,441781,Meyertholen; Andrew D.,21,0,24,3
1708250636588,PHYS 2BL,A04,441782,Meyertholen; Andrew D.,21,0,24,3
1708250636588,PHYS 2BL,A05,441784,Meyertholen; Andrew D.,23,0,24,1
1708250636588,PHYS 2BL,A06,441786,Meyertholen; Andrew D.,23,0,24,1
1708250636588,PHYS 2BL,A07,441788,Meyertholen; Andrew D.,23,0,24,1
1708250636588,PHYS 2BL,A08,441790,Meyertholen; Andrew D.,24,0,24,0
1708250636588,PHYS 2BL,A09,441792,Meyertholen; Andrew D.,24,0,24,0
1708250636588,PHYS 2BL,A10,441794,Meyertholen; Andrew D.,23,0,24,1
1708250636588,PHYS 2BL,A11,441796,Meyertholen; Andrew D.,22,0,24,2
1708250636588,PHYS 2BL,A12,441798,Meyertholen; Andrew D.,24,0,24,0
1708250636588,PHYS 2BL,A13,441800,Meyertholen; Andrew D.,24,0,24,0
1708250636588,PHYS 2BL,A14,441802,Meyertholen; Andrew D.,24,0,24,0
1708250636588,PHYS 2BL,A15,441804,Meyertholen; Andrew D.,23,0,24,1
1708250637115,PHYS 2C,A01,460540,Tan; Tzer Han,30,0,30,0
1708250637115,PHYS 2C,A02,460541,Tan; Tzer Han,28,0,30,2
1708250637115,PHYS 2C,A03,460542,Tan; Tzer Han,28,0,30,2
1708250637115,PHYS 2C,A04,460543,Tan; Tzer Han,28,0,30,2
1708250637115,PHYS 2C,A05,460544,Tan; Tzer Han,28,0,30,2
1708250637115,PHYS 2C,A06,460545,Tan; Tzer Han,29,0,30,1
1708250637115,PHYS 2C,A07,460553,Tan; Tzer Han,30,0,30,0
1708250637115,PHYS 2C,A08,460561,Tan; Tzer Han,30,0,30,0
1708250637115,PHYS 2C,A09,460562,Tan; Tzer Han,28,0,30,2
1708250637115,PHYS 2C,A10,460563,Tan; Tzer Han,29,0,30,1
1708250637115,PHYS 2C,A11,460567,Tan; Tzer Han,30,0,30,0
1708250637115,PHYS 2C,A12,460568,Tan; Tzer Han,28,0,30,2
1708250637645,PHYS 2CL,A01,441809,Ni; Kaixuan,25,0,28,3
1708250637645,PHYS 2CL,A02,441811,Ni; Kaixuan,27,0,28,1
1708250637645,PHYS 2CL,A03,441814,Ni; Kaixuan,23,0,28,5
1708250637645,PHYS 2CL,A04,441817,Ni; Kaixuan,28,0,28,0
1708250637645,PHYS 2CL,A05,441819,Ni; Kaixuan,26,0,28,2
1708250637645,PHYS 2CL,A06,441820,Ni; Kaixuan,27,0,28,1
1708250638176,PHYS 2D,A01,460569,Sharma; Vivek A.,24,0,25,1
1708250638176,PHYS 2D,A02,460574,Sharma; Vivek A.,24,0,25,1
1708250638176,PHYS 2D,A03,460575,Sharma; Vivek A.,25,0,25,0
1708250638702,PHYS 4B,A01,441829,Grinstein; Benjamin,34,0,38,4
1708250638702,PHYS 4B,A02,441831,Grinstein; Benjamin,30,0,32,2
1708250638702,PHYS 4B,A03,441832,Grinstein; Benjamin,30,0,30,0
1708250638702,PHYS 4B,A04,441833,Grinstein; Benjamin,30,0,30,0
1708250639232,PHYS 4E,A01,441907,Frano Pereira; Alex M,33,0,34,1
1708250639232,PHYS 4E,A02,441958,Frano Pereira; Alex M,34,0,34,0
1708250639757,PHYS 10,A01,441971,Burgasser; Adam Jonathan,118,0,120,2
1708250640283,PHYS 13,A01,441974,Wright; Shelley Adams,61,0,65,4
1708250640812,PHYS 87,A00,486898,Grinstein; Benjamin,19,0,20,1
1708250641347,PHYS 100C,A01,441978,Averitt; Richard Douglas,58,0,60,2
1708250641874,PHYS 105B,A01,441985,Green; Daniel Richard,37,0,40,3
1708250642405,PHYS 120,A01,441995,Arnold; Kam S,40,0,44,4
1708250642405,PHYS 120,A02,442011,Arnold; Kam S,41,0,44,3
1708250642932,PHYS 130A,A01,442032,Parker; Daniel E,74,0,75,1
1708250643464,PHYS 130B,A01,442056,Branson; James G,47,0,50,3
1708250643992,PHYS 139,A00,442057,Jun; Suckjoon,30,0,30,0
1708250643992,PHYS 139,B00,442059,Duarte; Javier Mauricio & Li; Aobo,42,0,50,8
1708250644523,PHYS 140A,A01,442065,Shotwell; Brian,49,0,50,1
1708250645049,PHYS 152B,A01,442067,Hirsch; Jorge Eduardo,17,0,20,3
1708250645577,PHYS 154,A01,442069,Jenkins; Elizabeth,29,0,30,1
1708250646109,PHYS 162,A01,442096,Keating; Brian,64,0,65,1
1708250646641,PHYS 170,A01,486870,Oh; Seungeun,39,0,40,1
1708250647168,PHYS 177,A00,442103,Dudko; Olga,20,0,20,0
1708250647701,PHYS 203B,A01,442132,Fogler; Michael M.,20,0,20,0
1708250648229,PHYS 210A,A01,442143,Hwa; Terence T.,20,0,20,0
1708250648756,PHYS 212C,A01,442200,Chivukula; Raja S,18,0,20,2
1708250649289,PHYS 215C,A00,442201,Intriligator; Kenneth Arthur,19,0,20,1
1708250649819,PHYS 225C,A01,442203,Flauger; Raphael M,19,0,20,1
1708250650348,PHYS 227,A00,442204,Tytler; David Robert,29,0,30,1
1708250650876,PHYS 230,A01,442206,McGreevy; John A.,20,0,20,0
1708250651402,PHYS 239,A00,442207,Goldenfeld; Nigel,20,0,20,0
1708250651402,PHYS 239,B00,442208,Duarte; Javier Mauricio & Li; Aobo,5,0,5,0
1708250651929,PHYS 244,A01,442280,Norman; Michael L,12,0,20,8
1708250652456,PHYS 250,A00,442300,Fogler; Michael M.,50,0,50,0
1708250652986,PHYS 251,A00,442307,Grinstein; Benjamin,20,0,20,0
1708250653517,PHYS 252,A00,442348,Diamond; Patrick H,10,0,10,0
1708250654043,PHYS 253,A00,442349,Theissen; Christopher Alexander,30,0,30,0
1708250654572,PHYS 254,A00,442352,Hwa; Terence T.,30,0,30,0
1708250655098,PHYS 255,A00,442423,Hwa; Terence T.,30,0,30,0
1708250655627,PHYS 258,A00,442426,Theissen; Christopher Alexander,30,0,30,0
1708250656157,PHYS 260,A00,442427,Frano Pereira; Alex M,50,0,50,0
1708250656684,PHYS 277,A00,442428,Dudko; Olga,20,0,20,0
1708250657213,POLI 5D,A01,419010,Dai; Yinlin,5,0,7,2
1708250657213,POLI 5D,A02,419020,Dai; Yinlin,7,0,7,0
1708250657213,POLI 5D,A03,419022,Dai; Yinlin,4,0,6,2
1708250657213,POLI 5D,A04,419040,Dai; Yinlin,5,0,5,0
1708250657213,POLI 5D,B01,419065,Dai; Yinlin,7,0,7,0
1708250657213,POLI 5D,B02,419068,Dai; Yinlin,7,0,7,0
1708250657213,POLI 5D,B03,419069,Dai; Yinlin,6,0,6,0
1708250657213,POLI 5D,B04,419070,Dai; Yinlin,5,0,5,0
1708250657213,POLI 5D,C01,487211,Staff,3,0,5,2
1708250657741,POLI 11D,A01,419072,Desposato; Scott,32,0,34,2
1708250657741,POLI 11D,A02,419073,Desposato; Scott,33,0,34,1
1708250657741,POLI 11D,A03,419082,Desposato; Scott,32,0,34,2
1708250657741,POLI 11D,A04,419123,Desposato; Scott,34,0,34,0
1708250657741,POLI 11D,A05,419124,Desposato; Scott,34,0,34,0
1708250657741,POLI 11D,A06,419125,Desposato; Scott,34,0,34,0
1708250658266,POLI 12D,A01,419127,Gartzke; Erik,29,0,34,5
1708250658266,POLI 12D,A02,419128,Gartzke; Erik,34,0,34,0
1708250658266,POLI 12D,A03,419129,Gartzke; Erik,34,0,34,0
1708250658266,POLI 12D,A04,419130,Gartzke; Erik,34,0,34,0
1708250658266,POLI 12D,A05,419131,Gartzke; Erik,32,0,34,2
1708250658266,POLI 12D,A06,419168,Gartzke; Erik,34,0,34,0
1708250658795,POLI 13DR,A01,477733,Draper; Matthew William,28,0,34,6
1708250658795,POLI 13DR,A02,477734,Draper; Matthew William,32,0,34,2
1708250658795,POLI 13DR,A03,477736,Draper; Matthew William,33,0,34,1
1708250658795,POLI 13DR,A04,477737,Draper; Matthew William,32,0,34,2
1708250658795,POLI 13DR,A05,477739,Draper; Matthew William,31,0,34,3
1708250658795,POLI 13DR,A06,477740,Draper; Matthew William,34,0,34,0
1708250659325,POLI 30D,A01,419179,Desposato; Scott,19,0,28,9
1708250659325,POLI 30D,A02,419180,Desposato; Scott,25,0,28,3
1708250659325,POLI 30D,A03,419181,Desposato; Scott,27,0,28,1
1708250659325,POLI 30D,A04,419182,Desposato; Scott,28,0,28,0
1708250659325,POLI 30D,A05,419187,Desposato; Scott,24,0,28,4
1708250659325,POLI 30D,A06,419189,Desposato; Scott,28,0,28,0
1708250659853,POLI 100E,A00,419191,Pitcher; Kennedy Anell,105,0,115,10
1708250660380,POLI 104P,A00,419192,Orfield; Michael Bennett,183,0,196,13
1708250660909,POLI 104U,A00,419193,Nichter; Maysa,88,0,115,27
1708250661435,POLI 108,A00,419194,Adida; Claire,293,0,295,2
1708250661969,POLI 110C,A00,419195,Soon; Valerie,47,0,50,3
1708250662501,POLI 120D,A00,419207,Hansen; Jan Eric,48,0,50,2
1708250663031,POLI 124A,A00,419209,Fortunato; David,48,0,50,2
1708250663626,POLI 131CR,A00,419211,Hoston; Germaine,41,0,50,9
1708250663626,POLI 131CR,B00,481592,Hoston; Germaine,10,0,10,0
1708250664151,POLI 136A,A00,419212,Roeder; Philip G,111,0,115,4
1708250664682,POLI 140D,A00,419213,Wong; Tak Kei,183,0,192,9
1708250665213,POLI 142D,A00,419214,Gartzke; Erik,227,0,230,3
1708250665739,POLI 145C,A00,419222,Fisk; David Lee,101,0,115,14
1708250666267,POLI 150A,A00,419225,Wong; Tak Kei,216,0,230,14
1708250666793,POLI 170A,A00,419226,Skillman; Rachel Diane,115,0,115,0
1708250667319,POLI 179,A00,419238,Staff,95,0,104,9
1708250667845,POLI 194,A00,455332,Hill; Seth J,0,0,0,0
1708250668371,POLI 194SD,A00,419248,Nichter; Maysa,999,0,999,0
1708250668897,POLI 197SD,001,419258,Nichter; Maysa,999,0,999,0
1708250669428,POLI 203B,A00,419265,Slantchev; Branislav,21,0,25,4
1708250669952,POLI 214R,A00,419275,Hoston; Germaine,23,0,25,2
1708250670478,POLI 219,A00,419289,Soon; Valerie,24,0,25,1
1708250671005,POLI 220A,A00,419299,Ferree; Karen E,21,0,25,4
1708250671532,POLI 233,A00,419333,Adida; Claire,23,0,25,2
1708250672063,POLI 243,A00,479118,Joseph; Michael F,23,0,25,2
1708250672590,POLI 251,A00,419334,Ban; Pamela M,23,0,25,2
1708250673116,POLI 257,A00,419335,Hill; Seth J,25,0,25,0
1708250673646,POLI 273,A00,419336,Mignozzetti; Umberto,16,0,25,9
1708250674172,POLI 280,A00,419337,Hafner-Burton; Emilie,18,0,25,7
1708250674698,POLI 281,A00,419338,Ban; Pamela M,21,0,25,4
1708250675224,POLI 282,A00,419339,Ferree; Karen E,19,0,25,6
1708250675753,POLI 283,A00,419340,Naoi; Megumi,23,0,25,2
1708250676279,POLI 285,A00,419341,Ingham; Sean,25,0,25,0
1708250676807,POLI 286,A00,419342,Mignozzetti; Umberto,23,0,25,2
1708250677337,POLI 288,A00,479174,Fowler; James,13,0,15,2
1708250677868,PSY 296,001,465760,Besterman; Aaron David,49,0,50,1
1708250677868,PSY 296,002,465765,Eyler; Lisa T.,49,0,50,1
1708250677868,PSY 296,003,465767,Patel; Ekta Himanshu,49,0,50,1
1708250678395,PSYC 3R,A00,419378,Pilegard; Celeste Cristine,314,0,325,11
1708250678923,PSYC 7,A00,419384,Powell; Lindsey Jane,288,0,295,7
1708250679460,PSYC 60,A01,460208,Lowe; Angela Beth,31,0,35,4
1708250679460,PSYC 60,A02,460209,Lowe; Angela Beth,28,0,35,7
1708250679460,PSYC 60,A03,460210,Lowe; Angela Beth,35,0,35,0
1708250679460,PSYC 60,A04,460211,Lowe; Angela Beth,33,0,35,2
1708250679460,PSYC 60,A05,460212,Lowe; Angela Beth,34,0,35,1
1708250679460,PSYC 60,A06,460213,Lowe; Angela Beth,35,0,35,0
1708250679460,PSYC 60,A07,460214,Lowe; Angela Beth,33,0,35,2
1708250679460,PSYC 60,B01,460215,Rose; Fred E.,35,0,35,0
1708250679460,PSYC 60,B02,460216,Rose; Fred E.,35,0,35,0
1708250679460,PSYC 60,B03,460218,Rose; Fred E.,35,0,35,0
1708250679460,PSYC 60,B04,460219,Rose; Fred E.,35,0,35,0
1708250679460,PSYC 60,B05,460220,Rose; Fred E.,32,0,35,3
1708250679460,PSYC 60,B06,460221,Rose; Fred E.,35,0,35,0
1708250679460,PSYC 60,B07,460222,Rose; Fred E.,35,0,35,0
1708250679988,PSYC 70,A01,460223,Pilegard; Celeste Cristine,29,0,35,6
1708250679988,PSYC 70,A02,460224,Pilegard; Celeste Cristine,32,0,35,3
1708250679988,PSYC 70,A03,460225,Pilegard; Celeste Cristine,34,0,35,1
1708250679988,PSYC 70,A04,460266,Pilegard; Celeste Cristine,33,0,35,2
1708250679988,PSYC 70,A05,460267,Pilegard; Celeste Cristine,35,0,35,0
1708250679988,PSYC 70,A06,460277,Pilegard; Celeste Cristine,34,0,35,1
1708250680520,PSYC 71,A01,419620,Staff,19,0,21,2
1708250680520,PSYC 71,A02,419662,Staff,20,0,21,1
1708250680520,PSYC 71,B01,419682,Geller; Emma Harlan,24,0,25,1
1708250680520,PSYC 71,B02,419732,Geller; Emma Harlan,26,0,26,0
1708250681045,PSYC 88,A00,419733,Dobkins; Karen R.,47,0,65,18
1708250681577,PSYC 100,A00,419734,Chapman; Eddie Nathaniel,388,0,410,22
1708250682106,PSYC 101,A00,419735,Walker; Caren Michelle,272,0,295,23
1708250682634,PSYC 102,A00,419779,Moranton; Nirelia Melbina-,292,0,295,3
1708250683162,PSYC 104,A00,419880,Fine; Rachel,267,0,295,28
1708250683690,PSYC 105,A00,419946,Lowe; Angela Beth,276,0,295,19
1708250684220,PSYC 111B,A01,419948,Geller; Emma Harlan,35,0,35,0
1708250684746,PSYC 116C,A01,420046,Lang; Ariel,25,0,25,0
1708250685272,PSYC 117,A01,420092,Bajic; Daniel Andrew,25,0,25,0
1708250685802,PSYC 118,A01,420095,Miller; Cory T.,37,0,45,8
1708250686328,PSYC 124,A00,420096,Chapman; Eddie Nathaniel,381,0,410,29
1708250686856,PSYC 127,A00,420097,Dickenson; Janna Alene,14,0,20,6
1708250687397,PSYC 132,A00,420121,Staff,114,0,120,6
1708250687926,PSYC 133R,A01,420172,Golden; Susan S. & Gorman; Michael R.,10,0,16,6
1708250687926,PSYC 133R,A02,420173,Golden; Susan S. & Gorman; Michael R.,16,0,16,0
1708250687926,PSYC 133R,A03,420175,Golden; Susan S. & Gorman; Michael R.,16,0,16,0
1708250687926,PSYC 133R,A04,420249,Golden; Susan S. & Gorman; Michael R.,13,0,16,3
1708250688451,PSYC 134,A00,420311,Kaye; Walter H.,296,0,300,4
1708250688988,PSYC 137,A00,420312,Lin; Chujun,292,0,295,3
1708250689515,PSYC 144,A00,420313,Wixted; John T,287,0,295,8
1708250690047,PSYC 147,A00,420315,Wong; Lauren Hitomi,120,0,146,26
1708250690574,PSYC 164,A00,420328,Kaplan; Paul,259,0,295,36
1708250691099,PSYC 172,A00,420336,Dickenson; Janna Alene,294,0,300,6
1708250691628,PSYC 178,A00,420337,Glaser; Dale,131,0,146,15
1708250692163,PSYC 179,A00,420338,Lacefield; Katharine I,256,0,328,72
1708250692689,PSYC 181,A00,420339,Anagnostaras; Stephan,333,0,350,17
1708250693222,PSYC 184,A00,420367,Wilson; Brent M,275,0,295,20
1708250693749,PSYC 188,A00,420368,Lacefield; Katharine I,234,0,300,66
1708250694278,PSYC 190,A00,420378,Barner; David A.,374,0,395,21
1708250694806,PSYC 193,B00,420626,Brashier; Nadia Marie,215,0,216,1
1708250694806,PSYC 193,C00,420643,Gremel; Christina M,33,0,35,2
1708250695335,PSYC 193L,A01,420817,Brown; Sandra A,65,0,65,0
1708250695335,PSYC 193L,B01,420830,Staff,26,0,30,4
1708250695335,PSYC 193L,C01,420832,Staff,49,0,49,0
1708250695335,PSYC 193L,D01,420834,Staff,27,0,30,3
1708250695335,PSYC 193L,E01,493996,Aron; Adam,24,0,24,0
1708250695862,PSYC 194C,A01,420905,Heyman; Gail D.,1,0,1,0
1708250696395,PSYC 205,A00,420906,Harris; Christine Renee,17,0,20,3
1708250696923,PSYC 218,A00,420907,Brady; Timothy Francis,11,0,20,9
1708250697449,PSYC 224,A00,420908,Gremel; Christina M,30,0,30,0
1708250697977,PSYC 242,A00,421469,Walker; Caren Michelle,27,0,30,3
1708250698502,PSYC 247,A00,421473,Walker; Caren Michelle,14,0,20,6
1708250699029,PSYC 270C,A00,421554,Dobkins; Karen R.,13,0,20,7
1708250699559,PSYC 272,A00,421561,Gentner; Tim,20,0,20,0
1708250700089,PSYC 274,A00,421564,McCullough; Michael E,29,0,30,1
1708250700615,PSYC 275,A00,421620,Staff,23,0,30,7
1708250701143,PSYC 276,A00,421622,McCullough; Michael E,14,0,20,6
1708250701669,PSYC 280,A00,421623,Serences; John Thomas,76,0,85,9
1708250702198,PSYC 296,001,421667,Anagnostaras; Stephan,9999,0,9999,0
1708250702198,PSYC 296,002,421773,Aron; Adam,9999,0,9999,0
1708250702198,PSYC 296,003,421794,Mukku; Dhananjaya,9999,0,9999,0
1708250702198,PSYC 296,004,421795,Barner; David A.,9998,0,9999,1
1708250702198,PSYC 296,005,421796,Schachner; Adena,9999,0,9999,0
1708250702198,PSYC 296,006,421797,Brown; Sandra A,9999,0,9999,0
1708250702198,PSYC 296,007,421798,Chapman; Eddie Nathaniel,9999,0,9999,0
1708250702198,PSYC 296,008,421799,Dickenson; Janna Alene,9999,0,9999,0
1708250702198,PSYC 296,009,421800,Dobkins; Karen R.,9998,0,9999,1
1708250702198,PSYC 296,010,421801,Fan; Judith Ellen,9999,0,9999,0
1708250702198,PSYC 296,011,421803,Ferreira; Victor,9999,0,9999,0
1708250702198,PSYC 296,012,421814,Geller; Emma Harlan,9998,0,9999,1
1708250702198,PSYC 296,013,422102,Gentner; Tim,9999,0,9999,0
1708250702198,PSYC 296,014,422103,Gorman; Michael R.,9999,0,9999,0
1708250702198,PSYC 296,015,422104,Gremel; Christina M,9999,0,9999,0
1708250702198,PSYC 296,016,422106,Harris; Christine Renee,9999,0,9999,0
1708250702198,PSYC 296,017,422107,Heyman; Gail D.,9999,0,9999,0
1708250702198,PSYC 296,018,422108,McCullough; Michael E,9999,0,9999,0
1708250702198,PSYC 296,019,422109,Mc Kenzie; Craig R.M.,9999,0,9999,0
1708250702198,PSYC 296,020,422122,Miller; Cory T.,9999,0,9999,0
1708250702198,PSYC 296,021,422123,Pashler; Harold E,9999,0,9999,0
1708250702198,PSYC 296,022,422124,Pilegard; Celeste Cristine,9999,0,9999,0
1708250702198,PSYC 296,023,422125,Powell; Lindsey Jane,9999,0,9999,0
1708250702198,PSYC 296,025,422127,Rickard; Timothy C.,9998,0,9999,1
1708250702198,PSYC 296,026,422128,Serences; John Thomas,9998,0,9999,1
1708250702198,PSYC 296,027,422130,Walker; Caren Michelle,9998,0,9999,1
1708250702198,PSYC 296,028,422132,Winkielman; Piotr,9999,0,9999,0
1708250702198,PSYC 296,029,422134,Wixted; John T,9996,0,9999,3
1708250702198,PSYC 296,030,422146,Brady; Timothy Francis,9998,0,9999,1
1708250702198,PSYC 296,031,422154,Carver; Leslie J.,9999,0,9999,0
1708250702198,PSYC 296,032,422161,Lin; Chujun,9999,0,9999,0
1708250702198,PSYC 296,033,422169,Brashier; Nadia Marie,9998,0,9999,1
1708250702198,PSYC 296,034,422177,Oesch; Nicholas W,9999,0,9999,0
1708250702723,RAD 296,001,465795,Staff,50,0,50,0
1708250702723,RAD 296,002,465796,Staff,50,0,50,0
1708250702723,RAD 296,003,465797,Staff,50,0,50,0
1708250703250,RELI 150,A00,419353,Rahimi; Babak,37,0,40,3
1708250703777,REV 87,A00,422721,Lyon; Antony J.,19,0,20,1
1708250704303,RMAS 296,001,465827,Murphy; James D,49,0,50,1
1708250704303,RMAS 296,002,465828,Staff,50,0,50,0
1708250704303,RMAS 296,003,465831,Staff,50,0,50,0
1708250704830,RMED 296,001,466791,Staff,50,0,50,0
1708250704830,RMED 296,002,466792,Staff,50,0,50,0
1708250704830,RMED 296,003,466793,Staff,50,0,50,0
1708250705358,SE 3,A01,446938,Van Den Einde; Yael Dahlia,50,0,52,2
1708250705358,SE 3,A02,446942,Van Den Einde; Yael Dahlia,49,0,52,3
1708250705358,SE 3,A03,446948,Van Den Einde; Yael Dahlia,52,0,53,1
1708250705358,SE 3,A04,446965,Van Den Einde; Yael Dahlia,53,0,53,0
1708250705885,SE 9,A01,447015,Kuester; Falko,30,0,34,4
1708250705885,SE 9,A02,447017,Kuester; Falko,33,0,33,0
1708250705885,SE 9,A03,447022,Kuester; Falko,31,0,33,2
1708250706416,SE 101B,A01,447040,Kosmatka; John B,55,0,56,1
1708250706947,SE 105,A01,447042,Qiao; Yu,118,0,120,2
1708250707477,SE 110A,A01,467467,Asaro; Robert J,56,0,56,0
1708250708003,SE 110B,A00,447045,Zhu; Qiang,122,0,125,3
1708250708532,SE 130B,A01,447049,Chadha; Mayank,92,0,100,8
1708250709058,SE 131A,A01,447059,Krysl; Petr,102,0,110,8
1708250709588,SE 132,A01,447078,Chen; Jiun-Shyan,48,0,50,2
1708250710115,SE 140B,A01,447086,Restrepo; Jose,29,0,34,5
1708250710115,SE 140B,A02,447123,Restrepo; Jose,21,0,33,12
1708250710115,SE 140B,A03,447124,Restrepo; Jose,30,0,33,3
1708250710648,SE 143B,A01,447133,Tehrani; Mehran,11,0,15,4
1708250710648,SE 143B,A02,447134,Tehrani; Mehran,13,0,15,2
1708250711177,SE 150A,A01,447136,Uang; Chia-Ming,94,0,100,6
1708250711711,SE 150B,A01,447214,Morrison; Machel Leigh,49,0,50,1
1708250712243,SE 151B,A00,447215,Shing; P. Benson,71,0,75,4
1708250712772,SE 160B,A01,467468,Kim; Hyunsun Alicia,91,0,100,9
1708250713300,SE 165,A00,447238,Farrar; Charles R.,9,0,10,1
1708250713826,SE 184,A00,447253,Hutchinson; Tara,20,0,20,0
1708250714353,SE 202,A00,447392,Kosmatka; John B,25,0,30,5
1708250714885,SE 204,A00,447482,Todd; Michael,12,0,20,8
1708250715414,SE 206,A00,447483,Conte; Joel P,30,0,30,0
1708250715945,SE 213,A00,447499,Palermo; Alessandro,17,0,30,13
1708250716479,SE 215,A00,447500,Zhu; Qiang,34,0,45,11
1708250717058,SE 222,A00,447507,Elgamal; Ahmed,30,0,30,0
1708250717583,SE 227,A00,447576,Hutchinson; Tara,20,0,25,5
1708250718109,SE 244,A00,447577,Elgamal; Ahmed,29,0,30,1
1708250718634,SE 247,A00,447580,Hutchinson; Tara,0,0,5,5
1708250719160,SE 251B,A00,447612,Qiao; Yu,15,0,25,10
1708250719686,SE 253B,A00,447613,Kim; Hyonny,28,0,30,2
1708250720216,SE 260B,A00,447614,Kim; Hyunsun Alicia,10,0,10,0
1708250720742,SE 265,A00,447615,Farrar; Charles R.,20,0,25,5
1708250721271,SE 266,A00,447616,Loh; Chin Hsiung,23,0,25,2
1708250722325,SE 280,A00,447650,Krysl; Petr,22,0,25,3
1708250722856,SE 281,A01,447658,Kuester; Falko,12,0,30,18
1708250723383,SE 290,A00,447659,Qiao; Yu,78,0,100,22
1708250723915,SE 296,001,447666,Asaro; Robert J,9999,0,9999,0
1708250723915,SE 296,002,447669,Chen; Jiun-Shyan,9999,0,9999,0
1708250723915,SE 296,003,447689,Conte; Joel P,9999,0,9999,0
1708250723915,SE 296,004,447690,Elgamal; Ahmed,9999,0,9999,0
1708250723915,SE 296,005,447728,Hutchinson; Tara,9999,0,9999,0
1708250723915,SE 296,006,447733,Jandaghi Semnani; Shabnam,9999,0,9999,0
1708250723915,SE 296,007,447734,Kim; Hyonny,9999,0,9999,0
1708250723915,SE 296,008,447737,Kim; Hyunsun Alicia,9999,0,9999,0
1708250723915,SE 296,009,447738,Kosmatka; John B,9999,0,9999,0
1708250723915,SE 296,010,447739,Krysl; Petr,9999,0,9999,0
1708250723915,SE 296,011,447740,Kuester; Falko,9999,0,9999,0
1708250723915,SE 296,012,447741,Lanza Di Scalea; Francesco,9999,0,9999,0
1708250723915,SE 296,013,447742,Loh; Kenneth J. H.,9999,0,9999,0
1708250723915,SE 296,014,447745,McCartney; John Scott,9999,0,9999,0
1708250723915,SE 296,015,447747,Morrison; Machel Leigh,9999,0,9999,0
1708250723915,SE 296,016,447749,Mosqueda; Gilberto,9999,0,9999,0
1708250723915,SE 296,017,447874,Qiao; Yu,9999,0,9999,0
1708250723915,SE 296,018,447875,Restrepo; Jose,9999,0,9999,0
1708250723915,SE 296,019,447886,Shing; P. Benson,9999,0,9999,0
1708250723915,SE 296,020,447887,Todd; Michael,9999,0,9999,0
1708250723915,SE 296,021,447888,Tomac; Ingrid,9999,0,9999,0
1708250723915,SE 296,022,447889,Tsampras; Georgios,9999,0,9999,0
1708250723915,SE 296,023,447890,Uang; Chia-Ming,9999,0,9999,0
1708250723915,SE 296,024,447931,Van Den Einde; Yael Dahlia,9999,0,9999,0
1708250723915,SE 296,025,447932,Zhu; Qiang,9999,0,9999,0
1708250723915,SE 296,026,448007,Tehrani; Mehran,9999,0,9999,0
1708250723915,SE 296,027,448008,Palermo; Alessandro,9999,0,9999,0
1708250723915,SE 296,028,492941,Farrar; Charles R.,9998,0,9999,1
1708250724447,SIO 10,A00,446025,Borsa; Adrian Antal,573,0,590,17
1708250724973,SIO 16,A00,446031,Gee; Jeffrey S,119,0,120,1
1708250725501,SIO 50,A01,446057,Cook; Geoffrey W,19,0,22,3
1708250725501,SIO 50,A02,446058,Cook; Geoffrey W,21,0,22,1
1708250726031,SIO 75,A00,446060,Norris; Richard D.,32,0,35,3
1708250726562,SIO 87,A00,479215,Feddersen; Falk & Morzfeld; Matthias,20,0,20,0
1708250726562,SIO 87,B00,489613,Cook; Geoffrey W,19,0,20,1
1708250726562,SIO 87,C00,489620,Cook; Geoffrey W,20,0,20,0
1708250727086,SIO 90,A00,446061,Staff,61,0,70,9
1708250727612,SIO 113,A01,446064,May; David Alexander,27,0,30,3
1708250728672,SIO 128,A00,446115,Bartlett; Douglas H,110,0,120,10
1708250729199,SIO 135,A01,446153,Fricker; Helen A.,16,0,17,1
1708250729199,SIO 135,A02,446156,Fricker; Helen A.,14,0,18,4
1708250729735,SIO 136,A01,446159,Kacev; David & Wegner; Nicholas Craig & Bartlett; Douglas H,31,0,33,2
1708250729735,SIO 136,A02,446160,Kacev; David & Wegner; Nicholas Craig & Bartlett; Douglas H,33,0,33,0
1708250730262,SIO 139,A00,446164,Kacev; David,66,0,70,4
1708250730793,SIO 141,A01,446173,Pomeroy; Robert S.,11,0,12,1
1708250731324,SIO 143,A01,446175,Andersson; Andreas Jerry,20,0,30,10
1708250731850,SIO 145,A01,446181,Choy; Carolyn Anela,6,0,18,12
1708250732381,SIO 152,A01,446184,Van Allen; Emily Joyce,8,0,10,2
1708250732381,SIO 152,A02,479204,Van Allen; Emily Joyce,10,0,10,0
1708250732907,SIO 153,A01,446188,Capaldi; Tomas,24,0,26,2
1708250733437,SIO 160,A00,446189,Stegman; David,21,0,25,4
1708250733970,SIO 164,A00,446193,Staff,27,0,35,8
1708250734497,SIO 173,A00,446194,Lutsko; Nicholas J.,28,0,30,2
1708250735029,SIO 174,A00,446197,Aluwihare; Lihini & Russell; Lynn M.,26,0,30,4
1708250735556,SIO 181,A01,446200,Tresguerres; Martin,18,0,25,7
1708250735556,SIO 181,A02,446201,Tresguerres; Martin,23,0,25,2
1708250735556,SIO 181,A03,446209,Tresguerres; Martin,24,0,25,1
1708250735556,SIO 181,A04,446211,Tresguerres; Martin,24,0,25,1
1708250735556,SIO 181,A05,446223,Tresguerres; Martin,24,0,25,1
1708250735556,SIO 181,A06,446236,Tresguerres; Martin,24,0,25,1
1708250736083,SIO 192,A00,479211,Gerwick; William Henry,20,0,20,0
1708250736611,SIO 194,A00,455340,Hill; Seth J,0,0,0,0
1708250737143,SIOB 262,A00,446243,Gerwick; William Henry,23,0,25,2
1708250737670,SIOB 269,A00,446244,Staff,19,0,20,1
1708250738205,SIOB 270,A01,446261,Allen; Andrew Ellis & Petrik; Colleen Mary,18,0,20,2
1708250738732,SIOB 278,A00,446273,Arcila; Dahiana K,13,0,15,2
1708250738732,SIOB 278,B00,481742,Aburto Oropeza; Marco Octavio,18,0,20,2
1708250739258,SIOB 279,A00,446286,Franks; Peter,31,0,35,4
1708250739791,SIOB 291,A00,446292,Hechinger; Ryan F.,20,0,20,0
1708250740318,SIOB 296,A00,446293,Mongiardino Koch; Nicolas,16,0,20,4
1708250740845,SIOB 297,A00,446294,Allen; Eric,66,0,70,4
1708250741371,SIOC 202B,A00,446312,Stramski; Dariusz & Gabriel; Anne Alice-Agnes,17,0,20,3
1708250741898,SIOC 203C,A01,446314,Young; William Roy,5,0,5,0
1708250742431,SIOC 207C,A00,492798,Vasconcelos; Manuela,5,0,5,0
1708250742957,SIOC 208,A00,446315,Merrifield; Mark A,16,0,20,4
1708250743486,SIOC 209,A00,478924,Werner; Bradley T.,11,0,15,4
1708250743486,SIOC 209,B00,479224,Watson-Parris; Duncan,15,0,25,10
1708250743486,SIOC 209,C00,480739,Ricke; Katharine L,24,0,24,0
1708250744013,SIOC 212B,A01,446324,Cessi; Paola,40,0,40,0
1708250744542,SIOC 217C,A00,446325,Lutsko; Nicholas J.,25,0,25,0
1708250745072,SIOC 220,A00,446326,Rudnick; Daniel Lars,13,0,15,2
1708250745600,SIOC 224,A00,446327,Eisenman; Ian,20,0,25,5
1708250746130,SIOC 228,A00,446328,Shi; Yuanyuan,1,0,10,9
1708250746656,SIOC 235,A00,446342,Xie; Shang-Ping,14,0,15,1
1708250747184,SIOC 251,A00,446343,Evan; Amato Tomas,19,0,20,1
1708250747737,SIOG 200B,A00,446344,Gabriel; Anne Alice-Agnes,9,0,10,1
1708250748266,SIOG 221,A00,446354,Parnell-Turner; Ross Ernes,29,0,30,1
1708250748793,SIOG 227B,A00,446355,Laske; Gabi & Shearer; Peter M,19,0,20,1
1708250749322,SIOG 228,A00,446356,Van Allen; Emily Joyce,7,0,20,13
1708250749848,SIOG 230,A00,446359,Constable; Catherine G,25,0,25,0
1708250750380,SIOG 232,A00,446360,Constable; Catherine G & Constable; Steven C,37,0,40,3
1708250750907,SIOG 234,A00,446361,Sandwell; David T,15,0,15,0
1708250751435,SIOG 236,A01,477658,Fricker; Helen A.,5,0,5,0
1708250751435,SIOG 236,A02,477685,Fricker; Helen A.,3,0,5,2
1708250751967,SIOG 239,A00,446362,Gabriel; Anne Alice-Agnes,19,0,20,1
1708250751967,SIOG 239,B00,481507,May; David Alexander,6,0,6,0
1708250751967,SIOG 239,C00,486863,Fialko; Yuri A.,15,0,15,0
1708250752493,SIOG 268,A00,446364,Barbeau; Katherine,12,0,15,3
1708250753022,SOCE 194,A00,455341,Hill; Seth J,0,0,0,0
1708250753550,SOCG 204,A00,446551,Ng; Kwai,0,0,8,8
1708250754079,SOCG 206,A00,446552,Alvarez; Camila Huerta,4,0,8,4
1708250754606,SOCG 214,A00,446553,Raudenbush; Danielle,3,0,8,5
1708250755133,SOCG 255B,A00,446602,Serlin; David,2,0,5,3
1708250755659,SOCG 255C,A00,446813,Gates; Kelly,3,0,5,2
1708250756191,SOCG 290,A00,446910,Thorpe; Charles Robert,0,0,10,10
1708250756191,SOCG 290,B00,446911,Goldman; Harvey Stern,1,0,10,9
1708250756191,SOCG 290,C00,446914,Lampland; Martha,5,0,10,5
1708250756719,SOCI 2,A01,446373,Rogers; Julia Ellen,28,0,30,2
1708250756719,SOCI 2,A02,446374,Rogers; Julia Ellen,29,0,30,1
1708250756719,SOCI 2,A03,446382,Rogers; Julia Ellen,29,0,30,1
1708250756719,SOCI 2,A04,446384,Rogers; Julia Ellen,30,0,30,0
1708250756719,SOCI 2,A05,446389,Rogers; Julia Ellen,30,0,30,0
1708250756719,SOCI 2,A06,446393,Rogers; Julia Ellen,29,0,30,1
1708250757249,SOCI 20,A01,446396,Calderon-Zaks; Michael Aar,33,0,34,1
1708250757249,SOCI 20,A02,446409,Calderon-Zaks; Michael Aar,34,0,34,0
1708250757780,SOCI 40,A01,446417,Raudenbush; Danielle,30,0,32,2
1708250757780,SOCI 40,A02,446419,Raudenbush; Danielle,31,0,32,1
1708250757780,SOCI 40,A03,446434,Raudenbush; Danielle,31,0,32,1
1708250757780,SOCI 40,A04,446436,Raudenbush; Danielle,28,0,32,4
1708250757780,SOCI 40,A05,446441,Raudenbush; Danielle,29,0,32,3
1708250757780,SOCI 40,A06,446445,Raudenbush; Danielle,32,0,32,0
1708250758306,SOCI 60,A01,446461,Sutton; April Marie,30,0,32,2
1708250758306,SOCI 60,A02,446468,Sutton; April Marie,30,0,32,2
1708250758306,SOCI 60,A03,446469,Sutton; April Marie,26,0,32,6
1708250758306,SOCI 60,A04,446471,Sutton; April Marie,31,0,32,1
1708250758836,SOCI 100,A01,446480,Payne; Christine Anna,28,0,30,2
1708250758836,SOCI 100,A02,446491,Payne; Christine Anna,29,0,30,1
1708250758836,SOCI 100,A03,446492,Payne; Christine Anna,28,0,30,2
1708250758836,SOCI 100,A04,446493,Payne; Christine Anna,27,0,30,3
1708250759361,SOCI 103M,A00,481672,Kilpatrick; Kevin,27,0,28,1
1708250759891,SOCI 104,A00,446494,Turner; Christena L.,28,0,30,2
1708250760417,SOCI 104Q,A00,446495,Rogers; Julia Ellen,27,0,30,3
1708250760949,SOCI 106,A00,446496,Payne; Christine Anna,25,0,30,5
1708250761477,SOCI 107,A00,446497,Staff,30,0,30,0
1708250762008,SOCI 109,A00,446498,Rona-Tas; Akos,20,0,25,5
1708250762535,SOCI 111,A00,446499,Ribas Norris; Janet Vanesa,54,0,56,2
1708250763062,SOCI 114,A00,446500,Lampland; Martha,73,0,75,2
1708250763589,SOCI 117,A01,446502,Jones; Gabrielle Anastasia,14,0,17,3
1708250763589,SOCI 117,A02,446516,Jones; Gabrielle Anastasia,17,0,17,0
1708250763589,SOCI 117,A03,458787,Jones; Gabrielle Anastasia,17,0,17,0
1708250763589,SOCI 117,A04,458835,Jones; Gabrielle Anastasia,19,0,19,0
1708250764120,SOCI 120T,A00,446518,Staff,56,0,56,0
1708250764647,SOCI 123,A00,446519,Staff,79,0,80,1
1708250765173,SOCI 125,A00,487186,Calderon-Zaks; Michael Aar,55,0,56,1
1708250765705,SOCI 126,A01,446532,Jones; Makeba,15,0,15,0
1708250765705,SOCI 126,A02,446533,Jones; Makeba,15,0,15,0
1708250765705,SOCI 126,A03,458839,Jones; Makeba,15,0,15,0
1708250765705,SOCI 126,A04,458840,Jones; Makeba,15,0,15,0
1708250766231,SOCI 133,A00,446534,Calderon-Zaks; Michael Aar,53,0,56,3
1708250766757,SOCI 135,A00,486886,Ruiz; Jonathan Joseph,55,0,56,1
1708250767287,SOCI 136,A00,486887,Ruiz; Jonathan Joseph,56,0,56,0
1708250767814,SOCI 139,A00,446535,Ribas Norris; Janet Vanesa,78,0,80,2
1708250768340,SOCI 140J,A00,446537,Estefan; Michel,75,0,100,25
1708250768896,SOCI 142,A00,477639,Crofts; Christine,43,0,50,7
1708250769426,SOCI 146,A00,446538,Summers; Valerie R.,113,0,120,7
1708250769953,SOCI 151,A00,446540,Goldman; Harvey Stern,56,0,56,0
1708250770536,SOCI 156,A00,446541,Ostovany; Khashayar,55,0,56,1
1708250771062,SOCI 157,A00,446542,Jules-Rosette; Bennetta W.,28,0,28,0
1708250771592,SOCI 159,A00,494493,Estefan; Michel,93,0,96,3
1708250772118,SOCI 161,A00,477638,Staff,45,0,45,0
1708250772645,SOCI 162,A00,477642,Staff,54,0,55,1
1708250773173,SOCI 165,A00,446543,Rona-Tas; Akos,49,0,56,7
1708250773698,SOCI 171,A00,446544,Thorpe; Charles Robert,56,0,56,0
1708250774229,SOCI 173,A00,482888,Crofts; Christine,92,0,100,8
1708250774754,SOCI 180,A00,446545,Ostovany; Khashayar,55,0,56,1
1708250775283,SOCI 183,A00,446546,Sutton; April Marie,43,0,45,2
1708250775814,SOCI 185,A00,494495,Staff,30,0,30,0
1708250776342,SOCI 188D,A00,446549,Kokinis; Troy Andreas,24,0,25,1
1708250776868,SOCI 198RA,001,446550,Ng; Kwai,30,0,30,0
1708250777395,SOMC 224C,A00,466928,Bhakta; Savita Ganapathi,160,0,160,0
1708250777921,SOMC 229,A00,466925,Hoang; Mai Phuong,160,0,160,0
1708250778450,SOMC 240,A00,466937,Coyne; Christopher John,150,0,150,0
1708250778976,SOMC 242,A00,466931,Kline; Ahnika Sarah,160,0,160,0
1708250779503,SOMC 244,A00,466939,Mandel; Jess,150,0,150,0
1708250780034,SOMC 245C,A01,466935,Noel; Geoffroy Pierre Jean,160,0,160,0
1708250780563,SOMC 246C,A00,487163,Eyler; Lisa T.,160,0,160,0
1708250781088,SOMC 247C,A50,466950,Calcutt; Nigel A,160,0,160,0
1708250781616,SOMC 248C,A00,466936,Joshi; Weena Erin,160,0,160,0
1708250782143,SOMC 255C,A00,466951,Allison; Matthew,160,0,160,0
1708250782670,SPPH 161R,A01,476600,Chambers; Christina D,99,0,100,1
1708250783200,SPPH 263B,A01,460901,Hook; Vivian Yuan-Ho,25,0,25,0
1708250783726,SPPS 200A,A00,460907,Luli; Alex J,99,0,99,0
1708250784250,SPPS 200B,A00,460928,Luli; Alex J,99,0,99,0
1708250784776,SPPS 200C,A00,460934,Luli; Alex J,95,0,99,4
1708250785306,SPPS 203,A00,460955,Painter; Nathan A.,83,0,99,16
1708250785832,SPPS 205,A01,460978,Bandeira; Nuno Filipe Cabrita,64,0,80,16
1708250786358,SPPS 209,A00,460979,Bounthavong; Mark,94,0,99,5
1708250786884,SPPS 210,001,460980,Gustafsson; Asa Birgitta,99,0,99,0
1708250787409,SPPS 211A,A00,460987,Ferguson; Fleur,85,0,99,14
1708250787936,SPPS 211B,A00,460991,Ferguson; Fleur,96,0,99,3
1708250788462,SPPS 211C,A00,460992,Ferguson; Fleur,95,0,99,4
1708250788992,SPPS 211D,A00,460993,Tsunoda; Shirley M.,99,0,99,0
1708250789520,SPPS 212C,A01,460995,Saunders; Ila Maewal,95,0,99,4
1708250790051,SPPS 213C,A00,460996,Awdishu; Linda,95,0,99,4
1708250790577,SPPS 218B,A00,460997,Mandyam; Chitra,95,0,99,4
1708250791106,SPPS 225,A01,460999,Reed; Chantal,83,0,99,16
1708250791633,SPPS 236,A00,461000,Reid; Erin G.,96,0,99,3
1708250792160,SPPS 237,A00,461002,Mimoto; Mizuho Stacy,96,0,99,3
1708250792692,SPPS 238,A00,461041,Beyhan; Sinem,96,0,99,3
1708250793217,SPPS 241,A01,461122,Tsunoda; Shirley M.,83,0,99,16
1708250793743,SPPS 249,A00,461123,Brandl; Katharina,96,0,99,3
1708250794269,SPPS 250,A00,461126,Tsunoda; Shirley M.,45,0,50,5
1708250794795,SPPS 251,A00,461127,Chen; Timothy,99,0,99,0
1708250795326,SPPS 252,A00,461128,Abdul-Mutakabbir; Jacinda,74,0,80,6
1708250795852,SPPS 254,A00,481670,Shapiro; Desiree Nicolette,77,0,80,3
1708250796379,SPPS 261,A00,461129,Chambers; Christina D,93,0,99,6
1708250796906,SPPS 278,A00,459983,Fricovsky; Eduardo Santiago,98,0,99,1
1708250797435,SPPS 280,A00,461259,Fricovsky; Eduardo Santiago,19,0,20,1
1708250797966,SPPS 283,A00,461283,Tsunoda; Shirley M.,96,0,99,3
1708250798505,SURG 261,A00,466973,Staff,50,0,50,0
1708250799037,SURG 296,001,467004,Agha Hosseini; Ava,49,0,50,1
1708250799037,SURG 296,002,467005,Hinchcliff; Katharine Moss,49,0,50,1
1708250799037,SURG 296,003,467006,Eliceiri; Brian,49,0,50,1
1708250799592,SYN 1,001,448577,Bishop; Graham,19,0,20,1
1708250799592,SYN 1,002,448578,Iatarola; Briana Marie,19,0,20,1
1708250799592,SYN 1,003,448579,Browne; Emily,20,0,20,0
1708250799592,SYN 1,004,448580,Vega; Adrian,20,0,20,0
1708250799592,SYN 1,005,448581,Browne; Emily,20,0,20,0
1708250799592,SYN 1,006,448582,Rock; Martin,20,0,20,0
1708250799592,SYN 1,007,448583,Rock; Martin,20,0,20,0
1708250799592,SYN 1,008,448584,Iatarola; Briana Marie,19,0,20,1
1708250799592,SYN 1,009,448585,Bishop; Graham,20,0,20,0
1708250799592,SYN 1,010,448586,Bishop; Graham,20,0,20,0
1708250799592,SYN 1,011,448587,Gladstein; Jill M,15,0,15,0
1708250799592,SYN 1,012,448588,Meyer; Leslie Rose,20,0,20,0
1708250799592,SYN 1,013,448589,Rosenberg; Ryan Glenn,20,0,20,0
1708250799592,SYN 1,014,448627,Rosenberg; Ryan Glenn,19,0,20,1
1708250799592,SYN 1,015,448630,Atkinson; Arthur Laird,20,0,20,0
1708250799592,SYN 1,016,448651,Hom; Kirstyn Courtney,20,0,20,0
1708250799592,SYN 1,017,448652,Difruscio; Mark,20,0,20,0
1708250799592,SYN 1,018,448669,Hom; Kirstyn Courtney,20,0,20,0
1708250799592,SYN 1,019,448674,Hom; Kirstyn Courtney,18,0,20,2
1708250799592,SYN 1,020,448675,Atkinson; Arthur Laird,20,0,20,0
1708250799592,SYN 1,021,448678,Gladstein; Jill M,15,0,15,0
1708250799592,SYN 1,022,448682,Iatarola; Briana Marie,20,0,20,0
1708250799592,SYN 1,023,448691,Birberick; Brittany Celest,20,0,20,0
1708250799592,SYN 1,024,448751,Birberick; Brittany Celest,20,0,20,0
1708250799592,SYN 1,027,448766,Deavenport; James Cary,19,0,20,1
1708250799592,SYN 1,028,448767,Meyer; Leslie Rose,20,0,20,0
1708250799592,SYN 1,029,448775,Tawater; Hanna Jean,20,0,20,0
1708250799592,SYN 1,030,448777,Tawater; Hanna Jean,20,0,20,0
1708250799592,SYN 1,031,448792,Deavenport; James Cary,20,0,20,0
1708250799592,SYN 1,032,480169,Tawater; Hanna Jean,18,0,20,2
1708250800118,SYN 1R,001,448793,Difruscio; Mark,20,0,20,0
1708250800118,SYN 1R,004,449146,Difruscio; Mark,20,0,20,0
1708250800648,SYN 100,A01,449148,Staff,11,0,15,4
1708250800648,SYN 100,A02,449149,Staff,15,0,15,0
1708250800648,SYN 100,B01,449164,Gladstein; Jill M,0,0,0,0
1708250800648,SYN 100,B02,449166,Gladstein; Jill M,0,0,0,1
1708250800648,SYN 100,C01,449244,Staff,7,0,15,8
1708250800648,SYN 100,C02,449274,Staff,13,0,15,2
1708250800648,SYN 100,D01,449278,Staff,20,0,20,0
1708250800648,SYN 100,D02,449279,Staff,20,0,20,0
1708250800648,SYN 100,E01,449281,Rock; Martin,9,0,15,6
1708250800648,SYN 100,E02,449282,Rock; Martin,14,0,15,1
1708250800648,SYN 100,F01,449304,Browne; Emily,12,0,15,3
1708250800648,SYN 100,F02,449306,Browne; Emily,14,0,15,1
1708250800648,SYN 100,I01,449390,Gormally; Brenna,0,0,0,0
1708250800648,SYN 100,I02,449391,Gormally; Brenna,0,0,0,0
1708250800648,SYN 100,J01,449401,Atkinson; Arthur Laird,11,0,15,4
1708250800648,SYN 100,J02,449402,Atkinson; Arthur Laird,14,0,15,1
1708250800648,SYN 100,K01,449404,Deavenport; James Cary,11,0,15,4
1708250800648,SYN 100,K02,449405,Deavenport; James Cary,14,0,15,1
1708250800648,SYN 100,L01,449408,Rosenberg; Ryan Glenn,10,0,15,5
1708250800648,SYN 100,L02,449420,Rosenberg; Ryan Glenn,15,0,15,0
1708250801180,SYN 150,001,450016,Vega; Adrian,19,0,19,0
1708250801180,SYN 150,003,450031,Birberick; Brittany Celest,20,0,20,0
1708250801706,SYN 150R,001,494950,Vega; Adrian,20,0,20,0
1708250802231,SYN 198,001,494388,Staff,9999,0,9999,0
1708250802761,TDAC 1,A00,450042,Walsh; Kim C.,14,0,20,6
1708250802761,TDAC 1,B00,450043,Walsh; Kim C.,11,0,20,9
1708250802761,TDAC 1,C00,450044,Walsh; Kim C.,15,0,20,5
1708250802761,TDAC 1,D00,486830,Basso; Beatrice,20,0,20,0
1708250802761,TDAC 1,E00,492912,Walsh; Kim C.,15,0,20,5
1708250802761,TDAC 1,F00,492936,Walsh; Kim C.,18,0,20,2
1708250803288,TDAC 101,A00,450895,Celik; Aysan Karagasli,18,0,20,2
1708250803815,TDAC 102,A00,450904,Walsh; Kim C.,20,0,20,0
1708250803815,TDAC 102,B00,450916,Harting; Carla Kelso,20,0,20,0
1708250804342,TDAC 108,A00,450917,Buescher; Stephen W.,18,0,20,2
1708250804872,TDAC 109,A00,450924,Blair; Kyle Adam,20,0,20,0
1708250805399,TDAC 122,A00,451025,Perry; Lamar,30,0,30,0
1708250805399,TDAC 122,B00,480845,Perry; Lamar,30,0,30,0
1708250805926,TDAC 123,A00,451026,Buescher; Stephen W.,30,0,30,0
1708250805926,TDAC 123,B00,451028,Celik; Aysan Karagasli,30,0,30,0
1708250805926,TDAC 123,C00,480851,Perry; Lamar,30,0,30,0
1708250806458,TDDE 101,A00,451030,Guirguis; Mark C,18,0,20,2
1708250806984,TDDE 112,A00,451032,Staff,20,0,20,0
1708250807515,TDDE 130,A00,451033,Guirguis; Mark C,19,0,20,1
1708250808040,TDDE 132,A00,451034,Guirguis; Mark C,20,0,20,0
1708250808566,TDDE 169A,A00,481304,Petrovich; Victoria A.,19,0,20,1
1708250809095,TDDM 1,A00,450045,Weinberg; Sadie,27,0,30,3
1708250809624,TDDM 101,A00,451067,Staff,29,0,30,1
1708250810150,TDDR 101,A00,451068,Powell; Lora,29,0,34,5
1708250810677,TDDR 102,A00,451069,Powell; Lora,19,0,20,1
1708250811209,TDDR 111,A00,451070,Castro; Robert Jess,15,0,16,1
1708250811209,TDDR 111,B00,451071,Castro; Robert Jess,15,0,16,1
1708250811734,TDDR 190,A00,451073,Perry; Lamar,1,0,1,0
1708250812262,TDGE 1,A01,450047,Salovey; Todd,20,0,20,0
1708250812262,TDGE 1,A02,450048,Salovey; Todd,20,0,20,0
1708250812262,TDGE 1,A03,450085,Salovey; Todd,18,0,20,2
1708250812262,TDGE 1,A04,450093,Salovey; Todd,20,0,20,0
1708250812262,TDGE 1,A05,450096,Salovey; Todd,19,0,20,1
1708250812262,TDGE 1,A06,450132,Salovey; Todd,16,0,20,4
1708250812793,TDGE 25,A00,450236,Harting; Carla Kelso,12,0,20,8
1708250812793,TDGE 25,B00,450240,Harting; Carla Kelso,16,0,20,4
1708250812793,TDGE 25,C00,450243,Harting; Carla Kelso,14,0,20,6
1708250812793,TDGE 25,D00,450388,Harting; Carla Kelso,16,0,20,4
1708250813319,TDGE 100,A01,451098,Salovey; Todd,24,0,25,1
1708250813319,TDGE 100,A02,451099,Salovey; Todd,24,0,25,1
1708250813848,TDGE 124,A00,451122,Fulton; Julia,168,0,200,32
1708250814381,TDGE 125,A00,480853,Havis; Allan,197,0,200,3
1708250814381,TDGE 125,B00,480886,Staff,216,0,220,4
1708250814910,TDGE 133,A00,481097,Brill; Robert L.,20,0,20,0
1708250815451,TDGE 196B,A00,493144,Barricelli; Marc Alexander,1,0,1,0
1708250815451,TDGE 196B,B00,493148,Buescher; Stephen W.,2,0,2,0
1708250815451,TDGE 196B,C00,493151,Burelle; Julie Sara Veronique,1,0,1,0
1708250815451,TDGE 196B,D00,493189,Castro; Robert Jess,2,0,2,0
1708250815451,TDGE 196B,E00,493190,Guirguis; Mark C,1,0,1,0
1708250815451,TDGE 196B,F00,493240,Iizuka; Naomi Hisako,1,0,1,0
1708250815451,TDGE 196B,G00,493241,Perry; Lamar,1,0,1,0
1708250815451,TDGE 196B,H00,493249,Powell; Lora,1,0,1,0
1708250815451,TDGE 196B,I00,493296,Stein; Deborah Isobel,6,0,6,0
1708250815980,TDGR 213C,A00,451385,Buescher; Stephen W.,10,0,10,0
1708250816507,TDGR 220A,A00,451386,Barricelli; Marc Alexander,10,0,10,0
1708250817038,TDGR 239,A00,451387,Blair; Kyle Adam,10,0,10,0
1708250817567,TDGR 240,A00,481306,Portes; Elizabeth Marie,5,0,5,0
1708250818093,TDGR 245,A00,451388,Perry; Lamar,7,0,7,0
1708250818621,TDGR 250,A00,451395,Iizuka; Naomi Hisako,8,0,10,2
1708250819152,TDGR 251,A00,451397,Iizuka; Naomi Hisako,9,0,10,1
1708250819152,TDGR 251,B00,451398,Stein; Deborah Isobel,9,0,10,1
1708250819682,TDGR 257B,A00,451399,Finch; Michael S,8,0,10,2
1708250820208,TDGR 278,A00,481307,Petrovich; Victoria A.,4,0,5,1
1708250820737,TDGR 279,A00,451400,Bokovikova; Alina V,9,0,10,1
1708250820737,TDGR 279,B00,451401,Brill; Robert L.,10,0,10,0
1708250820737,TDGR 279,C00,451402,Petrovich; Victoria A.,10,0,10,0
1708250820737,TDGR 279,D00,451403,McElver; Robert Harrison,10,0,10,0
1708250820737,TDGR 279,E00,451404,Kuhl; Christopher August,10,0,10,0
1708250821264,TDGR 286,A00,451405,Knox; Leila Elizabeth,9,0,10,1
1708250821789,TDGR 288,A00,451406,Powell; Lora,6,0,7,1
1708250822321,TDGR 292,A00,451407,Power; Jade Yukana,10,0,10,0
1708250822321,TDGR 292,B00,451408,Mehrishi; Rishika,10,0,10,0
1708250822847,TDGR 293,001,451417,Power; Jade Yukana,7,0,7,0
1708250822847,TDGR 293,002,451418,Burelle; Julie Sara Veronique,7,0,7,0
1708250822847,TDGR 293,003,451419,Yapp; Hentyle T,7,0,7,0
1708250822847,TDGR 293,005,451421,Anderson; Mysia Anyse,7,0,7,0
1708250823373,TDGR 294,001,451429,Burelle; Julie Sara Veronique,7,0,7,0
1708250823373,TDGR 294,002,451431,Power; Jade Yukana,7,0,7,0
1708250823373,TDGR 294,003,451432,Yapp; Hentyle T,7,0,7,0
1708250823970,TDGR 295,A00,451433,Barricelli; Marc Alexander,10,0,10,0
1708250824497,TDGR 296,A00,451489,Powell; Lora,6,0,7,1
1708250824497,TDGR 296,B00,451497,Porter; Lisa,6,0,7,1
1708250825024,TDHD 175,A00,451123,Jun; Grace Shin Hae,40,0,40,0
1708250825551,TDHD 176,A00,451124,Caligagan; Maria T.,40,0,40,0
1708250826083,TDHT 10,A00,450409,Power; Jade Yukana,20,0,20,0
1708250826083,TDHT 10,B00,450450,Power; Jade Yukana,19,0,20,1
1708250826620,TDHT 23,A01,450546,Salimi; Rana,24,0,24,0
1708250826620,TDHT 23,A02,450549,Salimi; Rana,22,0,24,2
1708250826620,TDHT 23,A03,450553,Salimi; Rana,24,0,24,0
1708250827150,TDHT 101,A00,451125,Anderson; Mysia Anyse,25,0,25,0
1708250827150,TDHT 101,B00,451126,Mehrishi; Rishika,23,0,25,2
1708250827676,TDHT 104,A00,451225,Basso; Beatrice,22,0,25,3
1708250828201,TDHT 109,A01,451227,Anderson; Mysia Anyse,25,0,25,0
1708250828728,TDHT 122,A00,451228,Power; Jade Yukana,21,0,25,4
1708250829254,TDMV 1,A00,450558,Caligagan; Maria T.,15,0,30,15
1708250829780,TDMV 2,A00,450627,Anabo; Cherry,24,0,30,6
1708250830311,TDMV 3,A00,450630,Arcidiacono; Kristin,37,0,40,3
1708250830848,TDMV 11,A00,481244,Fyall; DauntÉ Edward,30,0,30,0
1708250831381,TDMV 20,A00,450789,Smith; Alison D,38,0,40,2
1708250831907,TDMV 110,A00,451229,Caligagan; Maria T.,28,0,30,2
1708250832437,TDMV 111,A00,451234,Smith; Alison D,28,0,30,2
1708250832963,TDMV 120,A00,451260,Weinberg; Sadie,30,0,30,0
1708250832963,TDMV 120,B00,451261,Sammartano; Tonnie,30,0,30,0
1708250833490,TDMV 122,A00,451262,Staff,28,0,30,2
1708250834018,TDMV 123,A00,451263,Duran; Marcos Antonio,28,0,30,2
1708250834544,TDMV 130,A00,451272,Mack; Kara Shanai',30,0,30,0
1708250835075,TDMV 138,A00,451275,Jun; Grace Shin Hae,4,0,30,26
1708250835603,TDMV 140,A00,451276,Lima; Paulo Henrique,40,0,40,0
1708250835603,TDMV 140,B00,451308,Power; Jade Yukana,39,0,40,1
1708250835603,TDMV 140,C00,451371,Caligagan; Tony,40,0,40,0
1708250835603,TDMV 140,D00,451373,Corrales; Joseph Bernales,28,0,30,2
1708250836129,TDMV 141,A00,451374,Caligagan; Tony,26,0,30,4
1708250836659,TDMV 142,A00,451375,Blanco; Juan Carlos,26,0,40,14
1708250837189,TDMV 143,A00,451376,Fyall; DauntÉ Edward,39,0,40,1
1708250837714,TDMV 144,A00,451377,Anabo; Cherry,39,0,40,1
1708250838241,TDMV 149,A00,451378,Jun; Grace Shin Hae,36,0,40,4
1708250838772,TDPF 162,A00,451379,Alvarez; Ana Maria,40,0,40,0
1708250839298,TDPR 6,A01,450799,Guirguis; Mark C,50,0,50,0
1708250839298,TDPR 6,A02,450801,Guirguis; Mark C,50,0,50,0
1708250839827,TDPR 102,A00,451380,Guirguis; Mark C,20,0,20,0
1708250840369,TDPR 104,A00,451381,Powell; Lora,15,0,15,0
1708250840903,TDPW 1,A00,450808,Stein; Deborah Isobel,14,0,15,1
1708250840903,TDPW 1,B00,450864,Stein; Deborah Isobel,13,0,15,2
1708250840903,TDPW 1,C00,450865,Stein; Deborah Isobel,15,0,15,0
1708250840903,TDPW 1,D00,450868,Stein; Deborah Isobel,13,0,15,2
1708250840903,TDPW 1,E00,450874,Stein; Deborah Isobel,14,0,15,1
1708250841433,TDPW 102,A00,451382,Staff,18,0,20,2
1708250841958,TDPW 104,A00,481182,Staff,17,0,20,3
1708250842487,TDTR 10,A00,450881,Wilson; Terry A.,28,0,30,2
1708250843014,TDTR 15,A00,450882,Smith; Alison D,30,0,30,0
1708250843542,TMC 15,A00,479039,Hemans; Patricia Ann Benitez,25,0,25,0
1708250844068,TMC 87,A00,479049,Solomon; Amanda Lee Albaniel,20,0,20,0
1708250844600,UROL 296,001,467060,Anger; Jennifer Tash,49,0,50,1
1708250844600,UROL 296,002,467061,Staff,50,0,50,0
1708250845129,USP 3,A01,458852,Martin; Isaac,34,0,35,1
1708250845129,USP 3,A02,458853,Martin; Isaac,35,0,35,0
1708250845129,USP 3,A03,458861,Martin; Isaac,34,0,35,1
1708250845129,USP 3,A04,458862,Martin; Isaac,32,0,35,3
1708250845660,USP 4,A00,451772,Schwaller; Nora Louise,19,0,25,6
1708250846193,USP 5,A01,458863,Shenkman; Michael Thomas,33,0,35,2
1708250846193,USP 5,A02,458864,Shenkman; Michael Thomas,31,0,35,4
1708250847735,USP 15,A01,458931,Staff,33,0,35,2
1708250847735,USP 15,A02,459024,Staff,31,0,35,4
1708250848277,USP 25,A00,451786,Sun; Feiyang,57,0,60,3
1708250848804,USP 100,A00,451787,Moses; Kelema Lee,55,0,60,5
1708250849336,USP 108,A00,477594,Martin; Isaac,25,0,25,0
1708250849864,USP 119,A00,477595,Schwaller; Nora Louise,23,0,25,2
1708250850393,USP 124,A00,451790,Hinds; Juli Beth,62,0,70,8
1708250850919,USP 128B,A01,451910,Lewis; Leslie R,12,0,13,1
1708250851458,USP 142B,A01,451954,Lewis; Leslie R,24,0,25,1
1708250851989,USP 142C,A00,451977,Lerner; Amy M,0,0,0,0
1708250852516,USP 145,A00,451999,Yaghmaee; Saman,140,0,146,6
1708250853047,USP 150,A00,452165,Staff,44,0,50,6
1708250853573,USP 151,A00,452166,Staff,49,0,50,1
1708250854105,USP 152A,A01,459025,Weaver; Todd D,25,0,25,0
1708250854105,USP 152A,A02,459074,Weaver; Todd D,24,0,25,1
1708250854632,USP 152B,A00,452224,Moeder; Nathan L,21,0,25,4
1708250855166,USP 153,A00,452339,Shenkman; Michael Thomas,50,0,50,0
1708250855693,USP 158A,A00,452410,Sun; Feiyang,25,0,25,0
1708250856220,USP 159B,A00,452411,Gherini; Paul Pier-Carlo,6,0,8,2
1708250856754,USP 160,A00,452412,Wartell; Julie Dara,25,0,25,0
1708250857284,USP 164,A00,452413,Moses; Kelema Lee,22,0,25,3
1708250857810,USP 165C,A00,452442,Frank; Lawrence Douglas,20,0,20,0
1708250858343,USP 169,A00,452598,Bajaj; Ravi Siddharth,32,0,35,3
1708250858869,USP 170,A00,477593,Entezam; Maryam,60,0,60,0
1708250859397,USP 172,A00,452676,Peerson; Susan,19,0,25,6
1708250859929,USP 175,A00,452848,Velasco; Diego,18,0,20,2
1708250860455,USP 177A,A00,453084,Velasco; Diego,21,0,25,4
1708250860981,USP 177B,A00,453127,Peerson; Susan,22,0,25,3
1708250861508,USP 183,A00,453128,Sutton; April Marie,19,0,20,1
1708250862040,USP 188B,A00,453187,Pezzoli; Keith,30,0,30,0
1708250862566,USP 190,A00,453234,Pezzoli; Keith,0,0,0,1
1708250863092,USP 191B,A00,453240,Polat; Soydan Alihan,18,0,20,2
1708250863620,USP 193,A00,453251,Bussell; Mirle Rabinowitz,24,0,25,1
1708250864147,USP 194,A00,455342,Hill; Seth J,0,0,0,0
1708250864677,USP 265C,A00,453264,Frank; Lawrence Douglas,10,0,10,0
1708250865208,VIS 3,A01,453427,Staff,25,0,25,0
1708250865208,VIS 3,A02,453428,Staff,15,0,25,10
1708250865208,VIS 3,A03,453429,Staff,25,0,25,0
1708250865208,VIS 3,A04,453430,Staff,21,0,25,4
1708250865208,VIS 3,A05,453431,Staff,25,0,25,0
1708250865208,VIS 3,A06,453432,Staff,23,0,25,2
1708250865208,VIS 3,A07,453433,Staff,17,0,25,8
1708250865208,VIS 3,A08,453434,Staff,23,0,25,2
1708250865208,VIS 3,A09,453435,Staff,21,0,25,4
1708250865208,VIS 3,A10,453436,Staff,23,0,25,2
1708250865734,VIS 9,A00,453437,Camargo; William,116,0,146,30
1708250866264,VIS 10,A00,453438,Kiratli; Solen,189,0,200,11
1708250866792,VIS 21B,A01,453440,Shen; Kuiyi,31,0,32,1
1708250866792,VIS 21B,A02,453441,Shen; Kuiyi,31,0,32,1
1708250866792,VIS 21B,A03,453442,Shen; Kuiyi,31,0,32,1
1708250866792,VIS 21B,A04,453443,Shen; Kuiyi,32,0,32,0
1708250866792,VIS 21B,A05,453444,Shen; Kuiyi,32,0,32,0
1708250866792,VIS 21B,A06,453452,Shen; Kuiyi,32,0,32,0
1708250866792,VIS 21B,A07,453468,Shen; Kuiyi,30,0,32,2
1708250866792,VIS 21B,A08,453587,Shen; Kuiyi,32,0,32,0
1708250867335,VIS 22,A01,453589,Rose; Jordan M,32,0,32,0
1708250867335,VIS 22,A02,453590,Rose; Jordan M,32,0,32,0
1708250867335,VIS 22,A03,453615,Rose; Jordan M,31,0,32,1
1708250867335,VIS 22,A04,453616,Rose; Jordan M,32,0,32,0
1708250867335,VIS 22,A05,453617,Rose; Jordan M,30,0,32,2
1708250867335,VIS 22,A06,453618,Rose; Jordan M,30,0,32,2
1708250867335,VIS 22,A07,453620,Rose; Jordan M,32,0,32,0
1708250867335,VIS 22,A08,453621,Rose; Jordan M,32,0,32,0
1708250867335,VIS 22,A09,453635,Rose; Jordan M,32,0,32,0
1708250867335,VIS 22,A10,453636,Rose; Jordan M,32,0,32,0
1708250867866,VIS 31,A00,453637,Dominguez; Ricardo,133,0,146,13
1708250868393,VIS 41,A01,453644,D'Elena-Tweed; Jessica Erin,23,0,25,2
1708250868393,VIS 41,A02,453645,D'Elena-Tweed; Jessica Erin,22,0,25,3
1708250868393,VIS 41,A03,453646,D'Elena-Tweed; Jessica Erin,25,0,25,0
1708250868393,VIS 41,A04,453647,D'Elena-Tweed; Jessica Erin,18,0,25,7
1708250868393,VIS 41,A05,453648,D'Elena-Tweed; Jessica Erin,25,0,25,0
1708250868393,VIS 41,A06,453650,D'Elena-Tweed; Jessica Erin,24,0,25,1
1708250868927,VIS 70N,A01,453652,Garnett; Mariah J,21,0,22,1
1708250868927,VIS 70N,A02,453653,Garnett; Mariah J,21,0,22,1
1708250868927,VIS 70N,A03,453654,Garnett; Mariah J,22,0,22,0
1708250868927,VIS 70N,A04,453657,Garnett; Mariah J,22,0,22,0
1708250868927,VIS 70N,A05,453662,Garnett; Mariah J,20,0,22,2
1708250868927,VIS 70N,A06,453663,Garnett; Mariah J,22,0,22,0
1708250869454,VIS 83,A00,453664,Kester; Grant,137,0,146,9
1708250869982,VIS 101A,A00,453666,Cruz; Edwin Teddy,10,0,15,5
1708250870508,VIS 102,A00,453668,Cruz; Edwin Teddy,81,0,85,4
1708250871040,VIS 105A,A00,453669,Adler; Amy,29,0,30,1
1708250871568,VIS 105B,A00,453738,Herc-Balaszek; Malgorzata,25,0,30,5
1708250871568,VIS 105B,B00,453739,Staff,27,0,30,3
1708250872093,VIS 106A,A00,453740,Staff,22,0,25,3
1708250872624,VIS 106B,A00,453741,De Luca; Mara Julia,20,0,25,5
1708250873149,VIS 106C,A00,453746,Vangenderen; Monique Luise,11,0,15,4
1708250873677,VIS 107A,A00,453747,Gregoire; Mathieu,19,0,25,6
1708250874202,VIS 107B,A00,453748,Dean; Danielle Adobi,23,0,25,2
1708250874731,VIS 110A,A00,453749,Adler; Amy,13,0,15,2
1708250875264,VIS 110E,A00,453798,Gregoire; Mathieu,14,0,15,1
1708250875788,VIS 110F,A00,453799,Staff,15,0,15,0
1708250876317,VIS 110N,A00,453803,Dean; Danielle Adobi,15,0,15,0
1708250876844,VIS 123B,A00,453804,Gaines; Malik Julian,75,0,75,0
1708250877376,VIS 125BN,A00,453813,Welchman; John C.,75,0,75,0
1708250877903,VIS 126P,A00,453814,Wardwell; Mariana Razo,74,0,75,1
1708250878487,VIS 128E,A00,453815,Staff,75,0,75,0
1708250879018,VIS 129E,A00,453855,Shen; Kuiyi,12,0,15,3
1708250879547,VIS 131,A00,453859,Trigilio; Michael,12,0,15,3
1708250879547,VIS 131,B00,479342,Mangolte; Babette,15,0,15,0
1708250880072,VIS 133A,A00,454231,Barbosa; Erika Katrina,13,0,15,2
1708250880596,VIS 134,A00,454232,Yoldas; Pinar,59,0,75,16
1708250881128,VIS 141B,A00,454233,Stalbaum; Brett,12,0,15,3
1708250881655,VIS 145B,A00,454234,Alexander; Amy J,14,0,15,1
1708250881655,VIS 145B,B00,454235,Kiratli; Solen,8,0,15,7
1708250882181,VIS 147A,A01,454237,Stalbaum; Brett,20,0,22,2
1708250882181,VIS 147A,A02,454238,Stalbaum; Brett,18,0,22,4
1708250882713,VIS 157,A01,454240,Cartwright; Lisa,32,0,34,2
1708250882713,VIS 157,A02,454241,Cartwright; Lisa,32,0,34,2
1708250883239,VIS 159,A01,454243,Akten; Mehmet,34,0,34,0
1708250883239,VIS 159,A02,454244,Akten; Mehmet,32,0,34,2
1708250883239,VIS 159,A03,454300,Akten; Mehmet,30,0,34,4
1708250883239,VIS 159,A04,454301,Akten; Mehmet,33,0,34,1
1708250883239,VIS 159,A05,454302,Akten; Mehmet,30,0,34,4
1708250883239,VIS 159,A06,454307,Akten; Mehmet,33,0,34,1
1708250883239,VIS 159,A07,454308,Akten; Mehmet,34,0,34,0
1708250883239,VIS 159,A08,454309,Akten; Mehmet,33,0,34,1
1708250883766,VIS 160B,A00,454310,Alexander; Amy J,13,0,15,2
1708250883766,VIS 160B,B00,454311,Akten; Mehmet,14,0,15,1
1708250883766,VIS 160B,C00,454312,Stone; Patricia,12,0,15,3
1708250884293,VIS 164,A00,454313,Cross; Brian R,19,0,22,3
1708250884293,VIS 164,B00,454314,Camargo; William,22,0,22,0
1708250884825,VIS 165,A00,454315,Erdmann; Dean,22,0,22,0
1708250885351,VIS 167,A00,454316,Staff,18,0,22,4
1708250885878,VIS 169A,A00,454317,Mostajo; Lorena,21,0,22,1
1708250886404,VIS 171,A00,454318,Nakayama; Yue,21,0,22,1
1708250886941,VIS 174,A00,454319,Staff,19,0,22,3
1708250887470,VIS 177,A00,454320,Cho; Erica,21,0,22,1
1708250887997,VIS 178,A00,454321,Staff,0,0,0,0
1708250888544,VIS 179,A00,454322,Erdmann; Dean,22,0,22,0
1708250889070,VIS 180A,A00,454323,Nakayama; Yue,21,0,22,1
1708250889597,VIS 180B,A00,454341,Cross; Brian R,20,0,22,2
1708250890123,VIS 183A,A00,454342,Cho; Erica,17,0,22,5
1708250893790,VIS 185,A00,454343,Miller; Nicole L,18,0,22,4
1708250900456,VIS 190,A00,454360,Crandall; Jordan,15,0,15,0
1708250900456,VIS 190,B00,454361,D'Elena-Tweed; Jessica Erin,10,0,15,5
1708250900981,VIS 202,A00,454369,Miller; Nicole L,12,0,15,3
1708250901507,VIS 203,A00,454370,Garnett; Mariah J,8,0,15,7
1708250902034,VIS 206,A00,454376,Kester; Grant,10,0,15,5
1708250902568,VIS 208,A00,454377,Moss; Ceci,15,0,15,0
1708250903094,VIS 211,A00,454413,Segade; Alexandro Abraham,0,0,0,2
1708250903645,VIS 243,A00,454429,Rose; Jordan M,5,0,15,10
1708250904177,VIS 255,A00,454430,Welchman; John C.,8,0,15,7
1708250904703,VIS 262,A00,454431,Yoldas; Pinar,11,0,15,4
1708250905232,WCWP 10A,001,454442,Uriarte; Emma,17,0,20,3
1708250905232,WCWP 10A,002,454443,Uriarte; Emma,14,0,20,6
1708250905232,WCWP 10A,003,454479,Uriarte; Emma,19,0,20,1
1708250905232,WCWP 10A,004,454480,Staff,0,0,0,0
1708250905232,WCWP 10A,005,454484,Staff,0,0,0,0
1708250905232,WCWP 10A,006,454485,Staff,0,0,0,0
1708250905232,WCWP 10A,007,454487,Staff,0,0,0,0
1708250905232,WCWP 10A,008,454488,Susi; Natalie,14,0,20,6
1708250905232,WCWP 10A,009,454489,Staff,0,0,0,0
1708250905232,WCWP 10A,010,454490,Staff,0,0,0,0
1708250905839,WCWP 10B,001,454492,Ornelas; Tricia,20,0,20,0
1708250905839,WCWP 10B,002,454501,Ornelas; Tricia,20,0,20,0
1708250905839,WCWP 10B,003,454565,Gagnon; Jeffrey C,2,0,20,18
1708250905839,WCWP 10B,004,454604,Ornelas; Tricia,16,0,20,4
1708250905839,WCWP 10B,005,454668,Staff,16,0,16,0
1708250905839,WCWP 10B,006,454724,Staff,16,0,16,0
1708250905839,WCWP 10B,007,454725,Staff,14,0,16,2
1708250905839,WCWP 10B,008,454768,Staff,0,0,0,0
1708250905839,WCWP 10B,009,454769,Staff,0,0,0,0
1708250905839,WCWP 10B,010,454770,Staff,0,0,0,0
1708250905839,WCWP 10B,011,454771,Dhir; Simrita,16,0,20,4
1708250905839,WCWP 10B,012,454772,Dhir; Simrita,16,0,20,4
1708250905839,WCWP 10B,013,454773,Merryman; Walter,17,0,20,3
1708250905839,WCWP 10B,014,454774,Dhir; Simrita,18,0,20,2
1708250905839,WCWP 10B,015,454775,Merryman; Walter,17,0,20,3
1708250905839,WCWP 10B,016,454776,Merryman; Walter,18,0,20,2
1708250905839,WCWP 10B,017,454777,Welji; Haleema Nazir,14,0,16,2
1708250905839,WCWP 10B,018,478868,Staff,16,0,16,0
1708250905839,WCWP 10B,019,478869,Staff,0,0,0,0
1708250905839,WCWP 10B,020,478876,Staff,0,0,0,0
1708250905839,WCWP 10B,021,478877,Staff,0,0,0,0
1708250905839,WCWP 10B,022,478887,Staff,0,0,0,0
1708250905839,WCWP 10B,023,478889,Staff,16,0,16,0
1708250905839,WCWP 10B,024,478892,Staff,0,0,0,0
1708250905839,WCWP 10B,025,478907,Staff,0,0,0,0
1708250906400,WCWP 100,A00,454800,McCleary; Keith Long,20,0,20,0
1708250906400,WCWP 100,B00,454804,McCleary; Keith Long,20,0,20,0
1708250906400,WCWP 100,C00,454822,Twohig; Niall Ivan,19,0,20,1
1708250906400,WCWP 100,D00,454855,Young; Mark T,20,0,20,0
1708250906400,WCWP 100,E00,454860,Twohig; Niall Ivan,20,0,20,0
1708250906400,WCWP 100,F00,454932,Young; Mark T,20,0,20,0
1708250906400,WCWP 100,G00,454933,Young; Mark T,20,0,20,0
1708250906926,WES 207,A00,454941,Kastner; Ryan Charles,20,0,20,0
1708250907451,WES 265,A00,454942,Staff,19,0,20,1
1708250909796,AAS 10,A01,392963,Butler; Elizabeth Annette,34,0,34,0
1708250909796,AAS 10,A02,392965,Butler; Elizabeth Annette,33,0,34,1
1708250910320,AAS 170,A00,392977,Butler; Elizabeth Annette,31,0,32,1
1708250910848,AAS 198,001,479182,Childs; Dennis R.,20,0,20,0
1708250911384,AESE 261,A00,387945,Staff,33,0,33,0
1708250911910,AESE 278D,A00,387953,Staff,33,0,33,0
1708250912461,AESE 278E,A00,387954,Staff,33,0,33,0
1708250912988,AESE 279A,A00,387956,Staff,33,0,33,0
1708250913515,AIP 197P,001,494494,Goldfarb; Brian,9999,0,9999,0
1708250914056,ANAR 100,A00,387884,Shtienberg; Gilad,15,0,16,1
1708250914587,ANAR 104,A01,387886,Tamberino; Anthony Thomas,21,0,25,4
1708250915116,ANAR 111,A00,387888,Staff,36,0,36,0
1708250915642,ANAR 115,A00,387889,Shtienberg; Gilad,36,0,36,0
1708250916178,ANAR 120,A00,387890,Staff,36,0,36,0
1708250916716,ANAR 155,A00,387891,Braswell; Geoffrey E.,15,0,25,10
1708250917243,ANAR 164,A00,387892,Staff,32,0,35,3
1708250917770,ANBI 100,A00,489626,Fox; Patrick Keolu Ozer,39,0,40,1
1708250918297,ANBI 111,A00,387893,Hrvoj Mihic; Branka,37,0,40,3
1708250919373,ANBI 144,A00,387896,Wilder; Linnea Lorene,72,0,75,3
1708250919899,ANBI 149,A00,489628,Non; Amy L,0,0,0,0
1708250920430,ANBI 173,A00,387897,Wilder; Linnea Lorene,74,0,75,1
1708250920957,ANBI 174,A00,489627,Strum; Shirley C.,13,0,15,2
1708250921485,ANES 296,001,463968,Gabriel; Rodney A,49,0,50,1
1708250921485,ANES 296,002,463969,Staff,50,0,50,0
1708250921485,ANES 296,003,463970,Staff,50,0,50,0
1708250922013,ANSC 100,A00,387898,Bialecki; Jon Anthony,40,0,40,0
1708250922541,ANSC 101,A00,387900,Sloane; Julia Kathryn,34,0,40,6
1708250923073,ANSC 117,A00,387901,Martin Sandino; Amanda Maria Yoland,13,0,15,2
1708250923600,ANSC 134,A00,387902,Staff,38,0,40,2
1708250924126,ANSC 137,A00,387903,Stewart; Alexander B,80,0,80,0
1708250924658,ANSC 138,A00,387904,Parish; Steven Martin,14,0,15,1
1708250925189,ANSC 142,A00,387905,Stone; Annika Britt,34,0,40,6
1708250925715,ANSC 147,A00,387906,Stewart; Alexander B,40,0,40,0
1708250926243,ANSC 148,A00,387907,Olivas Hernandez; Olga Lid,92,0,92,0
1708250926770,ANSC 186,A00,387910,Hankins; Joseph D.,28,0,30,2
1708250927297,ANTH 2,A01,387863,Marchetto; Maria Carolina,37,0,40,3
1708250927297,ANTH 2,A02,387864,Marchetto; Maria Carolina,40,0,40,0
1708250927297,ANTH 2,A03,387865,Marchetto; Maria Carolina,36,0,40,4
1708250927297,ANTH 2,A04,387866,Marchetto; Maria Carolina,39,0,40,1
1708250928063,ANTH 3,A01,387868,Stroth; Luke Reyneri,28,0,30,2
1708250928063,ANTH 3,A02,387869,Stroth; Luke Reyneri,29,0,30,1
1708250928063,ANTH 3,A03,387870,Stroth; Luke Reyneri,30,0,30,0
1708250928063,ANTH 3,A04,387871,Stroth; Luke Reyneri,29,0,30,1
1708250928590,ANTH 10,A00,387872,Stewart; Alexander B,80,0,80,0
1708250929120,ANTH 21,A01,387874,Stone; Annika Britt,40,0,40,0
1708250929120,ANTH 21,A02,387875,Stone; Annika Britt,40,0,40,0
1708250929120,ANTH 21,A03,387876,Stone; Annika Britt,40,0,40,0
1708250929120,ANTH 21,A04,387877,Stone; Annika Britt,39,0,40,1
1708250930677,ANTH 23,A01,387879,Staff,40,0,40,0
1708250930677,ANTH 23,A02,387880,Staff,40,0,40,0
1708250930677,ANTH 23,A03,387881,Staff,40,0,40,0
1708250930677,ANTH 23,A04,387882,Staff,40,0,40,0
1708250931203,ANTH 24,A00,387883,Pedersen; David,40,0,40,0
1708250931730,ANTH 103,A00,387911,Staff,343,0,350,7
1708250932257,ANTH 105,A00,387912,Staff,73,0,75,2
1708250932783,ANTH 112,A00,387913,Staff,23,0,25,2
1708250933314,ANTH 120,A00,479486,Parish; Steven Martin,28,0,30,2
1708250933857,ANTH 128B,A01,387923,Lewis; Leslie R,12,0,12,0
1708250934384,ANTH 192,A00,387925,Varma; Saiba,20,0,20,0
1708250934913,ANTH 196C,A00,387927,Varma; Saiba,15,0,15,0
1708250935439,ANTH 212,A00,387931,Marchetto; Maria Carolina,25,0,25,0
1708250935439,ANTH 212,B00,479487,Semendeferi; Ekaterini,25,0,25,0
1708250935967,ANTH 220,A00,387932,Csordas; Thomas J.,9,0,12,3
1708250936500,ANTH 230,001,493297,Goldstein; Paul S,18,0,20,2
1708250937028,ANTH 260,A00,479223,Jenkins; Janis A.,25,0,25,0
1708250937555,ANTH 272,A00,387936,Serlin; David,5,0,5,0
1708250938082,ANTH 273,A00,387938,Gates; Kelly,5,0,5,0
1708250938612,ANTH 288,A00,387940,Braswell; Geoffrey E.,25,0,25,0
1708250939158,ANTH 295,001,493298,Algaze; Guillermo,3,0,3,0
1708250939158,ANTH 295,002,493299,Brenner; Suzanne A,3,0,3,0
1708250939158,ANTH 295,003,493300,Csordas; Thomas J.,3,0,3,0
1708250939158,ANTH 295,004,493422,Fox; Patrick Keolu Ozer,3,0,3,0
1708250939158,ANTH 295,005,493472,Gagneux; Pascal,3,0,3,0
1708250939158,ANTH 295,006,493515,Goldstein; Paul S,3,0,3,0
1708250939158,ANTH 295,007,493592,Hankins; Joseph D.,3,0,3,0
1708250939158,ANTH 295,008,493631,Jassal; Aftab,3,0,3,0
1708250939158,ANTH 295,009,493639,Jenkins; Janis A.,3,0,3,0
1708250939158,ANTH 295,010,493657,Kaiser; Bronwyn Nicole,3,0,3,0
1708250939158,ANTH 295,011,493692,Kang; Byung Chu,3,0,3,0
1708250939158,ANTH 295,012,493758,Marchetto; Maria Carolina,3,0,3,0
1708250939158,ANTH 295,013,493761,Non; Amy L,3,0,3,0
1708250939158,ANTH 295,014,493762,Pedersen; David,3,0,3,0
1708250939158,ANTH 295,015,493825,Rivera-Collazo; Isabel C,3,0,3,0
1708250939158,ANTH 295,016,493826,Varma; Saiba,3,0,3,0
1708250939158,ANTH 295,017,493828,Yeh; Rihan Wen Xin,3,0,3,0
1708250939718,ANTH 296,001,493830,Braswell; Geoffrey E.,3,0,3,0
1708250939718,ANTH 296,002,493836,Marchetto; Maria Carolina,3,0,3,0
1708250939718,ANTH 296,003,493838,Rivera-Collazo; Isabel C,3,0,3,0
1708250939718,ANTH 296,004,493840,Varma; Saiba,3,0,3,0
1708250939718,ANTH 296,005,493842,Algaze; Guillermo,3,0,3,0
1708250939718,ANTH 296,006,493845,Brenner; Suzanne A,3,0,3,0
1708250939718,ANTH 296,007,493846,Csordas; Thomas J.,3,0,3,0
1708250939718,ANTH 296,008,493907,Fox; Patrick Keolu Ozer,3,0,3,0
1708250939718,ANTH 296,009,493949,Gagneux; Pascal,3,0,3,0
1708250939718,ANTH 296,010,493960,Goldstein; Paul S,3,0,3,0
1708250939718,ANTH 296,011,493961,Hankins; Joseph D.,3,0,3,0
1708250939718,ANTH 296,012,493962,Jassal; Aftab,3,0,3,0
1708250939718,ANTH 296,013,493963,Jenkins; Janis A.,3,0,3,0
1708250939718,ANTH 296,014,493964,Kaiser; Bronwyn Nicole,3,0,3,0
1708250939718,ANTH 296,015,493965,Kang; Byung Chu,3,0,3,0
1708250939718,ANTH 296,016,493966,Levy; Thomas E,3,0,3,0
1708250939718,ANTH 296,017,493967,Non; Amy L,3,0,3,0
1708250939718,ANTH 296,018,493968,Pedersen; David,3,0,3,0
1708250939718,ANTH 296,019,493969,Postero; Nancy Grey,3,0,3,0
1708250939718,ANTH 296,020,493970,Semendeferi; Ekaterini,3,0,3,0
1708250939718,ANTH 296,021,493971,Yeh; Rihan Wen Xin,3,0,3,0
1708250940249,AUD 236,A00,480192,Harris; Jeffrey Paul,12,0,12,0
1708250940775,AUD 260,A00,480227,Spriggs; Meghan K,12,0,12,0
1708250941325,AUD 272,A00,480367,Zettner; Erika,12,0,12,0
1708250941853,AUD 275,A00,480369,Zettner; Erika,12,0,12,0
1708250942379,AUD 284,A00,480370,Zettner; Erika,12,0,12,0
1708250942379,AUD 284,B00,480372,Spriggs; Meghan K,12,0,12,0
1708250942909,AUD 291,A00,480374,Zettner; Erika,12,0,12,0
1708250943434,AUD 296,A00,480375,Zettner; Erika,12,0,12,0
1708250943434,AUD 296,B00,480376,Harris; Jeffrey Paul,12,0,12,0
1708250943434,AUD 296,C00,480377,Ryan; Allen F.,12,0,12,0
1708250944032,AWP 3,002,387672,Given; William Allan,9,0,9,0
1708250944032,AWP 3,003,387678,Staff,5,0,5,0
1708250944032,AWP 3,004,387681,Staff,0,0,0,0
1708250944032,AWP 3,007,387784,West; Geoffrey Scott,4,0,5,1
1708250944032,AWP 3,009,387786,Kolodezh; Samuel,5,0,5,0
1708250944032,AWP 3,010,387787,Gilbert; Peter W,5,0,5,0
1708250944560,AWP 4A,001,387791,Staff,12,0,12,0
1708250944560,AWP 4A,002,387792,Staff,0,0,0,0
1708250945119,AWP 4B,001,387793,Bolin; Jillian,0,0,0,0
1708250945119,AWP 4B,002,387794,Bolin; Jillian,0,0,0,0
1708250945119,AWP 4B,003,387795,Bauer; Holly Jean,0,0,0,0
1708250945119,AWP 4B,004,387796,Vaughn; Kelsey Sara,0,0,0,0
1708250945119,AWP 4B,005,387797,Vaughn; Kelsey Sara,0,0,0,0
1708250945119,AWP 4B,007,387799,Ajo; Frances Margaret,0,0,0,0
1708250945119,AWP 4B,008,387800,Ajo; Frances Margaret,0,0,0,0
1708250945119,AWP 4B,009,387801,Hall; Graham T,0,0,0,0
1708250945119,AWP 4B,010,387802,Hall; Graham T,0,0,0,0
1708250945119,AWP 4B,011,387803,Heiser; Jerrod A,0,0,0,0
1708250945119,AWP 4B,012,387804,Heiser; Jerrod A,0,0,0,0
1708250945119,AWP 4B,013,387805,Jones; William Jadie,0,0,0,0
1708250945119,AWP 4B,014,387806,Jones; William Jadie,0,0,0,0
1708250945119,AWP 4B,015,387807,Christie; Veronica Ann,0,0,0,0
1708250945119,AWP 4B,016,387808,Christie; Veronica Ann,0,0,0,0
1708250945119,AWP 4B,019,387820,Falcon; Jennifer A,0,0,0,0
1708250945119,AWP 4B,020,387821,Falcon; Jennifer A,0,0,0,0
1708250945119,AWP 4B,021,387822,Eastin; Schuyler E.,0,0,0,0
1708250945119,AWP 4B,023,387824,Coulter; Jane Elisabeth,0,0,0,0
1708250945119,AWP 4B,025,387826,O'Neil; Courtney L,0,0,0,0
1708250945119,AWP 4B,026,387827,O'Neil; Courtney L,0,0,0,0
1708250945119,AWP 4B,027,387828,Tsurska Svetina; Olena,0,0,0,0
1708250945119,AWP 4B,028,387829,Tsurska Svetina; Olena,0,0,0,0
1708250945119,AWP 4B,029,387830,Spicer; Jacqueline,0,0,0,0
1708250945119,AWP 4B,030,387831,Spicer; Jacqueline,0,0,0,0
1708250945119,AWP 4B,031,387832,Steinberg; Stacy A,0,0,0,0
1708250945119,AWP 4B,032,387833,Steinberg; Stacy A,0,0,0,0
1708250945119,AWP 4B,033,387834,Chandler; Bailee Daniele,0,0,0,0
1708250945119,AWP 4B,034,387835,Chandler; Bailee Daniele,0,0,0,0
1708250945119,AWP 4B,035,387836,Tiernan; Christa Michelle,0,0,0,0
1708250945119,AWP 4B,036,387837,Tiernan; Christa Michelle,0,0,0,0
1708250945119,AWP 4B,037,387840,Gardella; Alexander Drew,0,0,0,0
1708250945119,AWP 4B,038,387841,Gardella; Alexander Drew,0,0,0,0
1708250945119,AWP 4B,039,387857,Zimmerman; Guy,0,0,0,0
1708250945119,AWP 4B,040,387858,Zimmerman; Guy,0,0,0,0
1708250945119,AWP 4B,041,387859,Zroka; Amy Liane,0,0,0,0
1708250945119,AWP 4B,042,387860,Zroka; Amy Liane,0,0,0,0
1708250945648,BENG 87,A00,489656,Sah; Robert Lie-Yuan,20,0,20,0
1708250945648,BENG 87,B00,489657,Sah; Robert Lie-Yuan,20,0,20,0
1708250945648,BENG 87,C00,494754,Omens; Jeffrey Howard,20,0,20,0
1708250946177,BENG 100,A01,387959,Alexandrov; Ludmil B,26,0,28,2
1708250946177,BENG 100,A02,387960,Alexandrov; Ludmil B,26,0,28,2
1708250946177,BENG 100,A03,387984,Alexandrov; Ludmil B,26,0,28,2
1708250946177,BENG 100,A04,387985,Alexandrov; Ludmil B,25,0,28,3
1708250946177,BENG 100,A05,387986,Alexandrov; Ludmil B,27,0,28,1
1708250946708,BENG 102,A00,387987,Chapelin; Fanny,55,0,56,1
1708250947236,BENG 103B,A00,387993,Fraley; Stephanie I.,116,0,120,4
1708250947763,BENG 112B,A01,388053,Shi; Lingyan,26,0,30,4
1708250947763,BENG 112B,A02,388054,Shi; Lingyan,29,0,30,1
1708250948298,BENG 125,A00,388055,Hasty; Jeff M,120,0,160,40
1708250948828,BENG 133,A01,388866,Mali; Prashant Gulab Ram,36,0,40,4
1708250949356,BENG 140B,A01,388884,Cabrales; Pedro,28,0,30,2
1708250949356,BENG 140B,A02,388885,Cabrales; Pedro,30,0,30,0
1708250949356,BENG 140B,A03,388886,Cabrales; Pedro,26,0,30,4
1708250949889,BENG 160,A50,388889,Aguado; Brian Alberto,23,0,25,2
1708250949889,BENG 160,A51,388919,Aguado; Brian Alberto,25,0,25,0
1708250949889,BENG 160,A52,388920,Aguado; Brian Alberto,25,0,25,0
1708250950416,BENG 168,A01,388961,Khojah; Reem I,30,0,30,0
1708250950943,BENG 172,A50,389087,Omens; Jeffrey Howard & Cabrales; Pedro,15,0,20,5
1708250950943,BENG 172,A51,389088,Omens; Jeffrey Howard & Cabrales; Pedro,14,0,20,6
1708250951476,BENG 182,A01,389128,Bafna; Vineet,28,0,30,2
1708250952010,BENG 186A,A00,389130,Kwon; Ester Jihae,105,0,120,15
1708250952537,BENG 187A,A00,389289,Taylor Amos; Alyssa C,157,0,170,13
1708250953063,BENG 187D,A00,389290,Taylor Amos; Alyssa C,33,0,60,27
1708250953063,BENG 187D,B00,389300,Taylor Amos; Alyssa C,51,0,60,9
1708250953063,BENG 187D,C00,389302,Taylor Amos; Alyssa C,35,0,60,25
1708250953588,BENG 189,A00,389303,Contijoch; Francisco,26,0,30,4
1708250954115,BENG 193,A00,389328,Engler; Adam J.,0,0,0,0
1708250954643,BENG 196,A00,436038,Engler; Adam J.,9999,0,9999,0
1708250955170,BENG 197,A00,436081,Engler; Adam J.,9999,0,9999,0
1708250955704,BENG 203,A00,389385,Bafna; Vineet & Zhong; Sheng,20,0,20,0
1708250956231,BENG 207,A00,389386,Kwon; Ester Jihae,10,0,40,30
1708250956231,BENG 207,B00,389400,Taylor Amos; Alyssa C,8,0,30,22
1708250956231,BENG 207,C00,389432,Khojah; Reem I,20,0,40,20
1708250956762,BENG 209,A00,389456,Scholtes Acevedo; Claire,30,0,30,0
1708250957288,BENG 213,A00,389496,Palsson; Bernhard O.,16,0,20,4
1708250958346,BENG 224,A00,389515,Staff,0,0,0,0
1708250958881,BENG 226,A01,479043,Schmid-Schoenbein; Geert W,7,0,30,23
1708250959408,BENG 227,A00,389591,Fraley; Stephanie I.,55,0,120,65
1708250959935,BENG 230C,A00,389810,Mc Culloch; Andrew Douglas,43,0,90,47
1708250960487,BENG 232,A01,390161,Sah; Robert Lie-Yuan,6,0,50,44
1708250961015,BENG 233,A00,390290,Shah; Sameer B,33,0,50,17
1708250961542,BENG 234,A00,390291,Silva; Gabriel,20,0,56,36
1708250962074,BENG 235,A00,390318,Bintu; Bogdan,16,0,40,24
1708250962606,BENG 276,A00,390357,Mc Culloch; Andrew Douglas & Amaro; Rommie E,0,0,0,0
1708250963138,BENG 280C,A01,390443,McVeigh; Elliot R.,45,0,56,11
1708250963668,BENG 281,A00,390444,Kravets; Vira V.,50,0,110,60
1708250964194,BENG 283,A00,390445,Komives; Elizabeth A,4,0,4,0
1708250964719,BENG 292,A01,390623,Ross; Camille,20,0,20,0
1708250965246,BENG 294C,A00,390709,Engler; Adam J.,17,0,20,3
1708250965777,BENG 295,A00,436300,Watson; John Thomas,9999,0,9999,0
1708250966304,BGGN 205,A00,423656,Daugherty; Matthew Dorton,47,0,60,13
1708250966834,BGGN 207,A01,423703,Ross; Camille,0,0,0,0
1708250967367,BGGN 215,A00,423704,Petrie; Katherine Lynn,22,0,30,8
1708250967894,BGGN 216,A01,423855,Mueller; Liam O'Connor,37,0,50,13
1708250968421,BGGN 218,A00,423861,David; Michael,19,0,30,11
1708250968947,BGGN 223,A00,423862,Bier; Ethan,17,0,35,18
1708250969479,BGGN 230,A00,423863,Taylor; Susan S.,8,0,15,7
1708250970013,BGGN 232,A00,423864,Briggs; Steven & Troemel; Emily Ruth,25,0,30,5
1708250970539,BGGN 239,A01,424014,Kronenberg; Mitchell E.,30,0,30,0
1708250971067,BGGN 240,A01,424016,Juavinett; Ashley Lauren,0,0,6,6
1708250971617,BGGN 248,A00,424017,Halpain; Shelley,26,0,30,4
1708250972143,BGGN 249C,A00,424052,Staff,33,0,33,0
1708250972687,BGGN 250,A01,424091,Zou; Yimin,7,0,8,1
1708250973216,BGGN 252,A01,424093,Sejnowski; Terrence J,5,0,6,1
1708250973742,BGGN 255,A00,424094,Root; Cory Matthew,29,0,30,1
1708250974273,BGGN 262,A01,424096,Villa Rodriguez; Elizabeth,30,0,30,0
1708250974800,BGGN 267,A01,424099,Benna; Marcus K & Aljadeff; Johnatan,5,0,6,1
1708250975325,BGGN 270,A00,477483,Juavinett; Ashley Lauren,67,0,75,8
1708250976000,BGGN 271,001,481745,Ackerman; Susan,9998,0,9999,1
1708250976000,BGGN 271,002,481746,Akbari; Omar Sultan,9999,0,9999,0
1708250976000,BGGN 271,003,481747,Allen; Nicola J,9999,0,9999,0
1708250976000,BGGN 271,004,481748,Banegas; Matthew Patrick,9999,0,9999,0
1708250976000,BGGN 271,005,481749,Breen; Ellen C.,9998,0,9999,1
1708250976000,BGGN 271,006,481750,Briggs; Steven,9998,0,9999,1
1708250976000,BGGN 271,007,481751,Bui; Jack D,9999,0,9999,0
1708250976000,BGGN 271,008,481762,Busch; Wolfgang,9999,0,9999,0
1708250976000,BGGN 271,009,481763,Castle; Michael James,9999,0,9999,0
1708250976000,BGGN 271,010,481764,Chang; John Tzu-yu,9999,0,9999,0
1708250976000,BGGN 271,011,481765,Chen; Ju,9998,0,9999,1
1708250976000,BGGN 271,012,481766,Chen; Xu,9999,0,9999,0
1708250976000,BGGN 271,013,481767,Cheng; Christine Shiang-Ling,9999,0,9999,0
1708250976000,BGGN 271,014,481768,Cherqui; Stephanie,9999,0,9999,0
1708250976000,BGGN 271,015,481769,Cho; Yoshitake,9999,0,9999,0
1708250976000,BGGN 271,016,481770,Church; Kellie Breen,9998,0,9999,1
1708250976000,BGGN 271,017,481771,Cleland; Elsa Eleanor,9999,0,9999,0
1708250976000,BGGN 271,018,481779,Cohen; Shiran,9998,0,9999,1
1708250976000,BGGN 271,019,481814,Cook-Andersen; Heidi Leigh,9999,0,9999,0
1708250976000,BGGN 271,020,481815,Cooke; James Edward,9999,0,9999,0
1708250976000,BGGN 271,021,481816,Coufal; Nicole Gabriele,9998,0,9999,1
1708250976000,BGGN 271,022,481818,Crotty Alexander; Laura E,9999,0,9999,0
1708250976000,BGGN 271,023,481819,Daugherty; Matthew Dorton,9998,0,9999,1
1708250976000,BGGN 271,024,481820,De Guglielmo; Giordano,9998,0,9999,1
1708250976000,BGGN 271,025,481821,Doherty; Taylor Alan,9998,0,9999,1
1708250976000,BGGN 271,026,481822,Dulawa; Stephanie Carole,9999,0,9999,0
1708250976000,BGGN 271,027,481823,Esko; Jeffrey D.,9998,0,9999,1
1708250976000,BGGN 271,028,481824,Feldstein; Ariel E,9998,0,9999,1
1708250976000,BGGN 271,029,481825,Friedman; Rick Adam,9999,0,9999,0
1708250976000,BGGN 271,030,481826,Furnari; Frank,9999,0,9999,0
1708250976000,BGGN 271,031,481829,Ghosh; Pradipta,9998,0,9999,1
1708250976000,BGGN 271,032,481830,Gleeson; Joseph Gerard,9999,0,9999,0
1708250976000,BGGN 271,033,481831,Golden; Susan S.,9998,0,9999,1
1708250976000,BGGN 271,034,481832,Goren; Alon M,9998,0,9999,1
1708250976000,BGGN 271,035,481834,Gustafsson; Asa Birgitta,9999,0,9999,0
1708250976000,BGGN 271,036,481836,Hamdoun; Amr,9999,0,9999,0
1708250976000,BGGN 271,037,481837,Hao; Nan,9999,0,9999,0
1708250976000,BGGN 271,038,481840,Holway; David A.,9998,0,9999,1
1708250976000,BGGN 271,039,481841,Huffaker; Alisa,9998,0,9999,1
1708250976000,BGGN 271,040,481843,Sebat; Lilia Mikhailovna,9998,0,9999,1
1708250976000,BGGN 271,041,481889,Ideker; Trey,9999,0,9999,0
1708250976000,BGGN 271,042,481890,Jiang; Qingfei,9998,0,9999,1
1708250976000,BGGN 271,043,482311,Jin; Yishi,9999,0,9999,0
1708250976000,BGGN 271,044,482334,Joiner; William J.,9999,0,9999,0
1708250976000,BGGN 271,045,482353,Kaech; Susan Michelle,9998,0,9999,1
1708250976000,BGGN 271,046,482378,Karin; Michael,9999,0,9999,0
1708250976000,BGGN 271,047,482379,Kleinfeld; David,9999,0,9999,0
1708250976000,BGGN 271,048,482413,Koffler; Yacov,9999,0,9999,0
1708250976000,BGGN 271,049,482414,Komiyama; Takaki,9999,0,9999,0
1708250976000,BGGN 271,050,482415,Kryazhimskiy; Sergey A,9999,0,9999,0
1708250976000,BGGN 271,051,482416,Lawson; Mark Andrew,9999,0,9999,0
1708250976000,BGGN 271,052,482417,Lee; Yun Sok,9999,0,9999,0
1708250976000,BGGN 271,053,482451,Leutgeb; Stefan,9998,0,9999,1
1708250976000,BGGN 271,054,482452,Lo; Stanley M.,9999,0,9999,0
1708250976000,BGGN 271,055,482453,Lu; Pengzhe,9998,0,9999,1
1708250976000,BGGN 271,056,482454,Lykke-Andersen; Jens,9998,0,9999,1
1708250976000,BGGN 271,057,482456,McDonnell; Lisa Marie,9999,0,9999,0
1708250976000,BGGN 271,058,482461,McHugh; Colleen A,9998,0,9999,1
1708250976000,BGGN 271,059,482478,Meharena; Hiruy Sibhatu,9999,0,9999,0
1708250976000,BGGN 271,060,482497,Morris; Gerald P,9999,0,9999,0
1708250976000,BGGN 271,061,482499,Mukamel; Eran A,9998,0,9999,1
1708250976000,BGGN 271,062,482535,Muotri; Alysson,9999,0,9999,0
1708250976000,BGGN 271,063,482551,Muroyama; Andrew David,9999,0,9999,0
1708250976000,BGGN 271,064,482552,Neal; Sonya E,9999,0,9999,0
1708250976000,BGGN 271,065,482618,Nieh; James Charles,9999,0,9999,0
1708250976000,BGGN 271,066,482619,O'Donoghue; Anthony John,9999,0,9999,0
1708250976000,BGGN 271,067,482626,Pantham; Priyadarshini,9999,0,9999,0
1708250976000,BGGN 271,068,482633,Parast; Mana,9999,0,9999,0
1708250976000,BGGN 271,069,482634,Perry; Michael William,9999,0,9999,0
1708250976000,BGGN 271,070,482639,Pride; David Tevis,9999,0,9999,0
1708250976000,BGGN 271,071,482645,Pruneda-Paz; Jose L.,9999,0,9999,0
1708250976000,BGGN 271,072,482648,Rana; Tariq,9999,0,9999,0
1708250976000,BGGN 271,073,482650,Risbrough; Victoria Blythe,9999,0,9999,0
1708250976000,BGGN 271,074,482655,Rissman; Robert Andrew,9999,0,9999,0
1708250976000,BGGN 271,075,482656,Rosenfeld; Michael G,9999,0,9999,0
1708250976000,BGGN 271,076,482657,Saier; Milton H.,9999,0,9999,0
1708250976000,BGGN 271,077,482663,Sander; Maike,9999,0,9999,0
1708250976000,BGGN 271,078,482664,Schenk; Simon,9999,0,9999,0
1708250976000,BGGN 271,079,482665,Schoeneberg; Johannes,9998,0,9999,1
1708250976000,BGGN 271,080,482666,Schroeder; Julian I,9998,0,9999,1
1708250976000,BGGN 271,081,482667,Shaner; Nathan C.,9999,0,9999,0
1708250976000,BGGN 271,082,482668,Sheikh; Farah,9999,0,9999,0
1708250976000,BGGN 271,083,482669,Shurin; Jonathan,9999,0,9999,0
1708250976000,BGGN 271,084,482675,Sigurdson; Christina,9999,0,9999,0
1708250976000,BGGN 271,085,482676,Smith; David M.,9999,0,9999,0
1708250976000,BGGN 271,086,482677,Steinmetz; Nicole F,9999,0,9999,0
1708250976000,BGGN 271,087,482692,Su; Chih-Ying,9999,0,9999,0
1708250976000,BGGN 271,088,482694,Suel; Gurol Mehmet,9999,0,9999,0
1708250976000,BGGN 271,089,482695,Telese; Francesca,9999,0,9999,0
1708250976000,BGGN 271,090,482745,Thackray; Varykina G.,9999,0,9999,0
1708250976000,BGGN 271,091,482746,Towers; Christina Garlingt,9999,0,9999,0
1708250976000,BGGN 271,092,482747,Troemel; Emily Ruth,9997,0,9999,2
1708250976000,BGGN 271,093,482748,Tye; Kay M,9999,0,9999,0
1708250976000,BGGN 271,094,482749,Valdez-Jasso; Daniela,9998,0,9999,1
1708250976000,BGGN 271,095,482750,Wahlin; Karl Jonas,9997,0,9999,2
1708250976000,BGGN 271,096,482751,Welsbie; Derek,9999,0,9999,0
1708250976000,BGGN 271,097,482752,Wilkinson; Miles Frome,9999,0,9999,0
1708250976000,BGGN 271,098,482754,Yaksh; Tony L.,9999,0,9999,0
1708250976000,BGGN 271,099,482760,Yang; Jing,9999,0,9999,0
1708250976000,BGGN 271,100,482761,Yeo; Eugene Wei-Ming,9998,0,9999,1
1708250976000,BGGN 271,101,482763,Ying; Wei,9999,0,9999,0
1708250976000,BGGN 271,102,482764,Zarrinpar; Amir,9999,0,9999,0
1708250976000,BGGN 271,103,482765,Zengler; Karsten B,9999,0,9999,0
1708250976000,BGGN 271,104,482766,Zhang; Dong-Er,9999,0,9999,0
1708250976000,BGGN 271,105,482768,Zhao; Yunde,9999,0,9999,0
1708250976000,BGGN 271,106,482776,Zheng; Binhai,9999,0,9999,0
1708250976000,BGGN 271,107,482777,Zheng; Ye,9998,0,9999,1
1708250976000,BGGN 271,108,482806,Zuniga; Elina I,9999,0,9999,0
1708250976527,BGGN 273,A01,424101,Mueller; Liam O'Connor,43,0,50,7
1708250977059,BGGN 280,A00,424102,Ernst; Andreas,3,0,5,2
1708250977059,BGGN 280,C00,481361,Amaro; Rommie E,2,0,5,3
1708250977585,BGGN 281,A00,424103,Desai; Arshad & Oegema; Karen,0,0,5,5
1708250978116,BGGN 283,A00,424104,Rivera; Fabian Chavez,0,0,5,5
1708250978116,BGGN 283,B00,424105,Russell; Alistair B,4,0,5,1
1708250978116,BGGN 283,D00,424107,Wildonger; Jill Cathleen,1,0,5,4
1708250978645,BGGN 284,A00,424108,Glasgow; Stacey Marie,2,0,5,3
1708250979171,BGGN 285,A00,424109,Chisholm; Andrew D.,1,0,5,4
1708250979171,BGGN 285,B00,424110,Farley; Emma Kristen,2,0,5,3
1708250979699,BGGN 295,A00,424120,Tour; Ella,9,0,30,21
1708250980224,BGJC 204,A00,424138,Lu; Li-Fan & Chang; John Tzu-yu,9998,0,9999,1
1708250980750,BGJC 215,A00,424139,Cooke; James Edward & Lo; Stanley M.,10,0,10,0
1708250981588,BGRD 200,001,485528,Ackerman; Susan,9998,0,9999,1
1708250981588,BGRD 200,002,485529,Akbari; Omar Sultan,9999,0,9999,0
1708250981588,BGRD 200,003,485530,Allen; Eric,9999,0,9999,0
1708250981588,BGRD 200,004,485531,Allen; Nicola J,9999,0,9999,0
1708250981588,BGRD 200,005,485533,Amaro; Rommie E,9999,0,9999,0
1708250981588,BGRD 200,006,485535,Augustine; Vineet,9999,0,9999,0
1708250981588,BGRD 200,007,485536,Ayres; Janelle Samantha,9999,0,9999,0
1708250981588,BGRD 200,008,485538,Banegas; Matthew Patrick,9999,0,9999,0
1708250981588,BGRD 200,009,485539,Banghart; Matthew Ryan,9999,0,9999,0
1708250981588,BGRD 200,010,485542,Benna; Marcus K,9999,0,9999,0
1708250981588,BGRD 200,011,485543,Bennett; Eric J,9999,0,9999,0
1708250981588,BGRD 200,012,485545,Bloodgood; Brenda Laurie,9999,0,9999,0
1708250981588,BGRD 200,013,485546,Breen; Ellen C.,9998,0,9999,1
1708250981588,BGRD 200,014,485548,Briggs; Steven,9998,0,9999,1
1708250981588,BGRD 200,015,485549,Bui; Jack D,9999,0,9999,0
1708250981588,BGRD 200,016,485552,Busch; Wolfgang,9999,0,9999,0
1708250981588,BGRD 200,017,485621,Callaway; Edward M,9999,0,9999,0
1708250981588,BGRD 200,018,485622,Castle; Michael James,9999,0,9999,0
1708250981588,BGRD 200,019,485623,Chaim; Isaac,9999,0,9999,0
1708250981588,BGRD 200,020,485624,Chang; John Tzu-yu,9999,0,9999,0
1708250981588,BGRD 200,021,485625,Chen; Ju,9999,0,9999,0
1708250981588,BGRD 200,022,485626,Chen; Xu,9999,0,9999,0
1708250981588,BGRD 200,023,485627,Cheng; Christine Shiang-Ling,9999,0,9999,0
1708250981588,BGRD 200,024,485632,Cherqui; Stephanie,9999,0,9999,0
1708250981588,BGRD 200,025,485633,Cho; Yoshitake,9999,0,9999,0
1708250981588,BGRD 200,026,485634,Church; Kellie Breen,9999,0,9999,0
1708250981588,BGRD 200,027,485635,Cleland; Elsa Eleanor,9999,0,9999,0
1708250981588,BGRD 200,028,485636,Cohen; Shiran,9998,0,9999,1
1708250981588,BGRD 200,029,485639,Cook-Andersen; Heidi Leigh,9999,0,9999,0
1708250981588,BGRD 200,030,485686,Cooke; James Edward,9999,0,9999,0
1708250981588,BGRD 200,031,485688,Cooper; Kimberly Lynn,9999,0,9999,0
1708250981588,BGRD 200,032,485689,Coufal; Nicole Gabriele,9998,0,9999,1
1708250981588,BGRD 200,033,485690,Crotty Alexander; Laura E,9999,0,9999,0
1708250981588,BGRD 200,034,485691,Staff,9999,0,9999,0
1708250981588,BGRD 200,035,485692,De Guglielmo; Giordano,9999,0,9999,0
1708250981588,BGRD 200,036,485693,De Silva; Shermin,9999,0,9999,0
1708250981588,BGRD 200,037,485694,Desai; Arshad,9999,0,9999,0
1708250981588,BGRD 200,038,485695,Dickinson; Alexandra Jazz,9999,0,9999,0
1708250981588,BGRD 200,039,485717,Doherty; Taylor Alan,9998,0,9999,1
1708250981588,BGRD 200,040,485720,Dulawa; Stephanie Carole,9999,0,9999,0
1708250981588,BGRD 200,041,485721,Ecker; Joseph R,9999,0,9999,0
1708250981588,BGRD 200,042,485760,Engle; Dannielle D,9999,0,9999,0
1708250981588,BGRD 200,043,485761,Ernst; Andreas,9998,0,9999,1
1708250981588,BGRD 200,044,485766,Esko; Jeffrey D.,9998,0,9999,1
1708250981588,BGRD 200,045,485905,Evans; Ronald M,9999,0,9999,0
1708250981588,BGRD 200,046,485907,Staff,9999,0,9999,0
1708250981588,BGRD 200,047,485918,Feldstein; Ariel E,9998,0,9999,1
1708250981588,BGRD 200,048,485938,Friedman; Rick Adam,9999,0,9999,0
1708250981588,BGRD 200,049,485986,Furnari; Frank,9999,0,9999,0
1708250981588,BGRD 200,050,486018,Gage; Fred H,9999,0,9999,0
1708250981588,BGRD 200,051,486139,George; Monique Leana,9999,0,9999,0
1708250981588,BGRD 200,052,486140,Ghosh; Pradipta,9998,0,9999,1
1708250981588,BGRD 200,053,486141,Glass; Christopher,9998,0,9999,1
1708250981588,BGRD 200,054,486142,Gleeson; Joseph Gerard,9999,0,9999,0
1708250981588,BGRD 200,055,486143,Golden; Susan S.,9999,0,9999,0
1708250981588,BGRD 200,056,486144,Goldrath; Ananda,9999,0,9999,0
1708250981588,BGRD 200,057,486145,Goren; Alon M,9998,0,9999,1
1708250981588,BGRD 200,058,486146,Gustafsson; Asa Birgitta,9999,0,9999,0
1708250981588,BGRD 200,059,486164,Gutkind; Jorge Silvio,9999,0,9999,0
1708250981588,BGRD 200,060,486203,Hamdoun; Amr,9999,0,9999,0
1708250981588,BGRD 200,061,486204,Hampton; Randolph Y.,9999,0,9999,0
1708250981588,BGRD 200,062,486205,Hao; Nan,9999,0,9999,0
1708250981588,BGRD 200,063,486206,Staff,9999,0,9999,0
1708250981588,BGRD 200,064,486207,Hasty; Jeff M,9999,0,9999,0
1708250981588,BGRD 200,065,486208,Hollern; Daniel Patrick,9999,0,9999,0
1708250981588,BGRD 200,066,486209,Holway; David A.,9997,0,9999,2
1708250981588,BGRD 200,067,486214,Huffaker; Alisa,9998,0,9999,1
1708250981588,BGRD 200,068,486215,Hui; Enfu,9999,0,9999,0
1708250981588,BGRD 200,069,486216,Hwa; Terence T.,9999,0,9999,0
1708250981588,BGRD 200,070,486217,Sebat; Lilia Mikhailovna,9998,0,9999,1
1708250981588,BGRD 200,071,486218,Ideker; Trey,9999,0,9999,0
1708250981588,BGRD 200,072,486219,Jackrel; Sara,9998,0,9999,1
1708250981588,BGRD 200,073,486224,Jiang; Qingfei,9998,0,9999,1
1708250981588,BGRD 200,074,486225,Jin; Yishi,9999,0,9999,0
1708250981588,BGRD 200,075,486226,Joiner; William J.,9999,0,9999,0
1708250981588,BGRD 200,076,486227,Jun; Suckjoon,9999,0,9999,0
1708250981588,BGRD 200,077,486228,Kadonaga; James T,9998,0,9999,1
1708250981588,BGRD 200,078,486229,Kaech; Susan Michelle,9997,0,9999,2
1708250981588,BGRD 200,079,486237,Karin; Michael,9999,0,9999,0
1708250981588,BGRD 200,080,486238,Kleinfeld; David,9999,0,9999,0
1708250981588,BGRD 200,081,486239,Knight; Robin,9999,0,9999,0
1708250981588,BGRD 200,082,486335,Koffler; Yacov,9999,0,9999,0
1708250981588,BGRD 200,083,486336,Komiyama; Takaki,9999,0,9999,0
1708250981588,BGRD 200,084,486337,Kosuri; Pallav,9999,0,9999,0
1708250981588,BGRD 200,085,486353,Kryazhimskiy; Sergey A,9999,0,9999,0
1708250981588,BGRD 200,086,486354,Kurle; Carolyn M.,9999,0,9999,0
1708250981588,BGRD 200,087,486355,Law; Julie A,9999,0,9999,0
1708250981588,BGRD 200,088,486356,Lawson; Mark Andrew,9999,0,9999,0
1708250981588,BGRD 200,089,486357,Lee; Kuo Fen,9999,0,9999,0
1708250981588,BGRD 200,090,486376,Lee; Yun Sok,9999,0,9999,0
1708250981588,BGRD 200,091,486413,Leutgeb; Jill K.,9999,0,9999,0
1708250981588,BGRD 200,092,486414,Leutgeb; Stefan,9998,0,9999,1
1708250981588,BGRD 200,093,486415,Lim; Byungkook,9999,0,9999,0
1708250981588,BGRD 200,094,486419,Lo; Stanley M.,9999,0,9999,0
1708250981588,BGRD 200,095,486420,Looger; Loren Lee,9999,0,9999,0
1708250981588,BGRD 200,096,486422,Lovett-Barron; Matthew Rod,9999,0,9999,0
1708250981588,BGRD 200,097,486423,Lu; Li-Fan,9998,0,9999,1
1708250981588,BGRD 200,098,486424,Lu; Pengzhe,9998,0,9999,1
1708250981588,BGRD 200,099,486425,Lykke-Andersen; Jens,9998,0,9999,1
1708250981588,BGRD 200,100,486426,Lyumkis; Dmitry Evgenievich,9999,0,9999,0
1708250981588,BGRD 200,101,486427,Madigan; Cressida Ariana,9999,0,9999,0
1708250981588,BGRD 200,102,486428,Staff,9999,0,9999,0
1708250981588,BGRD 200,103,486429,Mayfield; Stephen P.,9998,0,9999,1
1708250981588,BGRD 200,104,486430,McDonnell; Lisa Marie,9999,0,9999,0
1708250981588,BGRD 200,105,486620,McHugh; Colleen A,9998,0,9999,1
1708250981588,BGRD 200,106,486621,Meharena; Hiruy Sibhatu,9999,0,9999,0
1708250981588,BGRD 200,107,486622,Staff,9999,0,9999,0
1708250981588,BGRD 200,108,486681,Morris; Gerald P,9999,0,9999,0
1708250981588,BGRD 200,109,486682,Mukamel; Eran A,9998,0,9999,1
1708250981588,BGRD 200,110,486683,Muotri; Alysson,9999,0,9999,0
1708250981588,BGRD 200,111,486684,Muroyama; Andrew David,9999,0,9999,0
1708250981588,BGRD 200,112,486687,Murre; Cornelis,9999,0,9999,0
1708250981588,BGRD 200,113,486691,Neal; Sonya E,9999,0,9999,0
1708250981588,BGRD 200,114,486692,Nieh; James Charles,9998,0,9999,1
1708250981588,BGRD 200,115,486693,Nimmerjahn; Axel,9999,0,9999,0
1708250981588,BGRD 200,116,486694,Nizet; Victor F.,9999,0,9999,0
1708250981588,BGRD 200,117,486695,O'Donoghue; Anthony John,9999,0,9999,0
1708250981588,BGRD 200,118,486706,Oegema; Karen,9999,0,9999,0
1708250981588,BGRD 200,119,486708,O'Shea; Clodagh,9999,0,9999,0
1708250981588,BGRD 200,120,486709,Pantham; Priyadarshini,9999,0,9999,0
1708250981588,BGRD 200,121,486715,Parast; Mana,9999,0,9999,0
1708250981588,BGRD 200,122,486716,Pasquinelli; Amy,9998,0,9999,1
1708250981588,BGRD 200,123,486718,Pekkurnaz Banghart; Gulcin,9999,0,9999,0
1708250981588,BGRD 200,124,486720,Perry; Michael William,9999,0,9999,0
1708250981588,BGRD 200,125,486721,Pfaff; Samuel,9999,0,9999,0
1708250981588,BGRD 200,126,486723,Pogliano; Joseph,9999,0,9999,0
1708250981588,BGRD 200,127,486724,Pogliano; Kit J.,9999,0,9999,0
1708250981588,BGRD 200,128,486727,Pride; David Tevis,9999,0,9999,0
1708250981588,BGRD 200,129,486728,Pruneda-Paz; Jose L.,9999,0,9999,0
1708250981588,BGRD 200,130,486733,Staff,9999,0,9999,0
1708250981588,BGRD 200,131,486734,Rana; Tariq,9999,0,9999,0
1708250981588,BGRD 200,132,486736,Reck-Peterson; Samara L,9999,0,9999,0
1708250981588,BGRD 200,133,486738,Rennison; Diana,9999,0,9999,0
1708250981588,BGRD 200,134,486741,Rifkin; Scott,9999,0,9999,0
1708250981588,BGRD 200,135,486743,Risbrough; Victoria Blythe,9999,0,9999,0
1708250981588,BGRD 200,136,486749,Rissman; Robert Andrew,9999,0,9999,0
1708250981588,BGRD 200,137,486750,Rivera; Fabian Chavez,9999,0,9999,0
1708250981588,BGRD 200,138,486753,Root; Cory Matthew,9999,0,9999,0
1708250981588,BGRD 200,139,486760,Rosenfeld; Michael G,9998,0,9999,1
1708250981588,BGRD 200,140,486763,Russell; Alistair B,9999,0,9999,0
1708250981588,BGRD 200,141,486766,Saier; Milton H.,9999,0,9999,0
1708250981588,BGRD 200,142,486768,Sander; Maike,9999,0,9999,0
1708250981588,BGRD 200,143,486770,Saphire; Erica Ollmann,9999,0,9999,0
1708250981588,BGRD 200,144,486771,Schenk; Simon,9999,0,9999,0
1708250981588,BGRD 200,145,486774,Schoeneberg; Johannes,9999,0,9999,0
1708250981588,BGRD 200,146,486777,Schroeder; Julian I,9998,0,9999,1
1708250981588,BGRD 200,147,486783,Shah; Sameer B,9999,0,9999,0
1708250981588,BGRD 200,148,486784,Shaner; Nathan C.,9999,0,9999,0
1708250981588,BGRD 200,149,486785,Shaw; Reuben,9999,0,9999,0
1708250981588,BGRD 200,150,486786,Sheikh; Farah,9999,0,9999,0
1708250981588,BGRD 200,151,486787,Staff,9999,0,9999,0
1708250981588,BGRD 200,152,486788,Signer; Robert,9999,0,9999,0
1708250981588,BGRD 200,153,486789,Sigurdson; Christina,9999,0,9999,0
1708250981588,BGRD 200,154,486790,Smith; David M.,9999,0,9999,0
1708250981588,BGRD 200,155,486791,Soncin; Francesca,9999,0,9999,0
1708250981588,BGRD 200,156,486792,Steinmetz; Nicole F,9999,0,9999,0
1708250981588,BGRD 200,157,486793,Su; Chih-Ying,9999,0,9999,0
1708250981588,BGRD 200,158,486794,Suel; Gurol Mehmet,9999,0,9999,0
1708250981588,BGRD 200,159,486795,Sun; Xin,9999,0,9999,0
1708250981588,BGRD 200,160,486796,Telese; Francesca,9999,0,9999,0
1708250981588,BGRD 200,161,486797,Thackray; Varykina G.,9999,0,9999,0
1708250981588,BGRD 200,162,486798,Towers; Christina Garlingt,9999,0,9999,0
1708250981588,BGRD 200,163,486799,Traver; David,9999,0,9999,0
1708250981588,BGRD 200,164,486800,Troemel; Emily Ruth,9998,0,9999,1
1708250981588,BGRD 200,165,486801,Tye; Kay M,9999,0,9999,0
1708250981588,BGRD 200,166,486802,Valdez-Jasso; Daniela,9998,0,9999,1
1708250981588,BGRD 200,167,486803,Vijayanand; Pandurangan,9999,0,9999,0
1708250981588,BGRD 200,168,486804,Villa Rodriguez; Elizabeth,9999,0,9999,0
1708250981588,BGRD 200,169,486805,Wahlin; Karl Jonas,9997,0,9999,2
1708250981588,BGRD 200,170,486806,Wang; Jean Yin Jen,9999,0,9999,0
1708250981588,BGRD 200,171,486807,Welsbie; Derek,9999,0,9999,0
1708250981588,BGRD 200,172,486808,Wildonger; Jill Cathleen,9998,0,9999,1
1708250981588,BGRD 200,173,486809,Wilkinson; Miles Frome,9999,0,9999,0
1708250981588,BGRD 200,174,486810,Winzeler; Elizabeth A,9999,0,9999,0
1708250981588,BGRD 200,175,486811,Yaksh; Tony L.,9999,0,9999,0
1708250981588,BGRD 200,176,486812,Yang; Jing,9999,0,9999,0
1708250981588,BGRD 200,177,486813,Staff,9999,0,9999,0
1708250981588,BGRD 200,178,486814,Yeo; Eugene Wei-Ming,9998,0,9999,1
1708250981588,BGRD 200,179,486815,Ying; Wei,9999,0,9999,0
1708250981588,BGRD 200,180,486816,Zarrinpar; Amir,9999,0,9999,0
1708250981588,BGRD 200,181,486817,Zengler; Karsten B,9999,0,9999,0
1708250981588,BGRD 200,182,486818,Zhang; Dong-Er,9999,0,9999,0
1708250981588,BGRD 200,183,486819,Zhao; Yunde,9999,0,9999,0
1708250981588,BGRD 200,184,486820,Zheng; Binhai,9999,0,9999,0
1708250981588,BGRD 200,185,486821,Zheng; Ye,9998,0,9999,1
1708250981588,BGRD 200,186,486822,Zuniga; Elina I,9999,0,9999,0
1708250982119,BGSE 200,A00,424140,Tour; Ella & Petrie; Katherine Lynn,9995,0,9999,4
1708250982662,BGSE 205,A00,424177,Bennett; Eric J,49,0,50,1
1708250982662,BGSE 205,B00,424179,Bennett; Eric J,48,0,50,2
1708250982662,BGSE 205,C00,424182,Bennett; Eric J,47,0,50,3
1708250982662,BGSE 205,D00,424184,Bennett; Eric J,46,0,50,4
1708250982662,BGSE 205,E00,424185,Bennett; Eric J,50,0,50,0
1708250983198,BIBC 100,A01,425401,Corbett; Kevin Daniel,150,0,158,8
1708250983198,BIBC 100,B01,477769,Amaro; Rommie E,156,0,158,2
1708250983743,BIBC 102,A01,425425,Bozinovic; Goran,255,0,256,1
1708250983743,BIBC 102,B01,425440,Hampton; Randolph Y.,250,0,256,6
1708250983743,BIBC 102,C01,486849,Flagg; Matthew Paul,62,0,120,58
1708250984307,BIBC 103,A01,425476,Grossman; Emily N,17,0,24,7
1708250984307,BIBC 103,A02,425509,Grossman; Emily N,21,0,24,3
1708250984307,BIBC 103,A03,425530,Grossman; Emily N,18,0,24,6
1708250984307,BIBC 103,A04,425536,Grossman; Emily N,22,0,24,2
1708250984307,BIBC 103,B01,425538,Boumechache; Miyyada,20,0,24,4
1708250984307,BIBC 103,B02,425539,Boumechache; Miyyada,24,0,24,0
1708250984307,BIBC 103,B03,425548,Boumechache; Miyyada,24,0,24,0
1708250984307,BIBC 103,B04,425549,Boumechache; Miyyada,24,0,24,0
1708250984850,BIBC 120,A01,425592,Coleman; Aaron B.,242,0,256,14
1708250985378,BIBC 194,A00,425609,Ernst; Andreas,21,0,27,6
1708250985378,BIBC 194,B00,477632,Saier; Milton H.,26,0,27,1
1708250985378,BIBC 194,C00,481360,Amaro; Rommie E,23,0,27,4
1708250985378,BIBC 194,D00,486852,Flagg; Matthew Paul,21,0,32,11
1708250985940,BICD 100,A01,470377,Troemel; Emily Ruth,127,0,128,1
1708250985940,BICD 100,A02,470378,Troemel; Emily Ruth,126,0,128,2
1708250985940,BICD 100,B01,470409,Reinagel; Pam,59,0,64,5
1708250985940,BICD 100,B02,470413,Reinagel; Pam,62,0,64,2
1708250985940,BICD 100,B03,470464,Reinagel; Pam,64,0,64,0
1708250985940,BICD 100,B04,470468,Reinagel; Pam,63,0,64,1
1708250985940,BICD 100,C01,470469,Beyhan; Sinem,51,0,64,13
1708250985940,BICD 100,C02,470605,Beyhan; Sinem,58,0,64,6
1708250985940,BICD 100,C03,470606,Beyhan; Sinem,60,0,64,4
1708250985940,BICD 100,C04,470607,Beyhan; Sinem,63,0,64,1
1708250985940,BICD 100,D01,477465,Nguyen; Vu Quang,158,0,160,2
1708250986475,BICD 100R,A01,425674,Smith; Laurie,29,0,34,5
1708250986475,BICD 100R,A02,425675,Smith; Laurie,30,0,34,4
1708250986475,BICD 100R,A03,425676,Smith; Laurie,30,0,34,4
1708250987002,BICD 104,A01,425696,Greenspan; Ralph J.,60,0,64,4
1708250987530,BICD 110,A01,470608,Muroyama; Andrew David,264,0,275,11
1708250987530,BICD 110,B01,425721,Ernst; Andreas,245,0,275,30
1708250988065,BICD 112,A01,458177,Cooper; Kimberly Lynn & Traver; David,10,0,32,22
1708250988065,BICD 112,A02,458180,Cooper; Kimberly Lynn & Traver; David,28,0,32,4
1708250988591,BICD 123,A01,425725,Zhao; Yunde,24,0,32,8
1708250989119,BICD 140,A01,425728,Lu; Li-Fan,227,0,240,13
1708250989645,BICD 158,A01,425730,Bier; Ethan,136,0,145,9
1708250990179,BICD 194,A00,425731,Desai; Arshad & Oegema; Karen,18,0,27,9
1708250990179,BICD 194,B00,481735,Wilhelm; James E.,29,0,32,3
1708250990705,BIEB 121,A00,425732,Butler; Shannon Rhey,21,0,32,11
1708250990705,BIEB 121,B00,425733,Butler; Shannon Rhey,24,0,32,8
1708250991231,BIEB 130,A01,425735,Kurle; Carolyn M.,243,0,295,52
1708250991758,BIEB 146,A01,425737,Petrie; Katherine Lynn,365,0,395,30
1708250992284,BIEB 148,A01,470637,Rose; Noah Hartmann,59,0,63,4
1708250992284,BIEB 148,A02,470638,Rose; Noah Hartmann,61,0,63,2
1708250992818,BIEB 154,A01,458184,Stockwell; Sarah R,29,0,30,1
1708250992818,BIEB 154,A02,458186,Stockwell; Sarah R,29,0,30,1
1708250993344,BIEB 176,A01,425741,De Silva; Shermin,56,0,64,8
1708250993869,BIEB 182,A01,458194,Roy; Kaustuv,25,0,32,7
1708250993869,BIEB 182,A02,458215,Roy; Kaustuv,31,0,32,1
1708250994413,BILD 1,A01,424267,Patrick; Gentry,249,0,250,1
1708250994413,BILD 1,B01,424272,Burg; Michael,231,0,250,19
1708250994413,BILD 1,C01,424293,Pickett; Brooke Elizabeth,245,0,250,5
1708250994413,BILD 1,D01,458292,Gonzalez Gamboa; Ivonne,48,0,50,2
1708250994413,BILD 1,D02,458295,Gonzalez Gamboa; Ivonne,50,0,50,0
1708250994413,BILD 1,D03,458296,Gonzalez Gamboa; Ivonne,50,0,50,0
1708250994413,BILD 1,D04,458297,Gonzalez Gamboa; Ivonne,49,0,50,1
1708250994413,BILD 1,D05,458303,Gonzalez Gamboa; Ivonne,50,0,50,0
1708250994966,BILD 2,A01,458304,Reyes Gonzalez; Catalina,53,0,56,3
1708250994966,BILD 2,A02,458307,Reyes Gonzalez; Catalina,55,0,56,1
1708250994966,BILD 2,A03,458313,Reyes Gonzalez; Catalina,55,0,56,1
1708250994966,BILD 2,A04,458320,Reyes Gonzalez; Catalina,56,0,56,0
1708250994966,BILD 2,B01,458324,Reyes Gonzalez; Catalina,47,0,56,9
1708250994966,BILD 2,B02,458327,Reyes Gonzalez; Catalina,54,0,56,2
1708250994966,BILD 2,B03,458339,Reyes Gonzalez; Catalina,56,0,56,0
1708250994966,BILD 2,B04,458340,Reyes Gonzalez; Catalina,56,0,56,0
1708250994966,BILD 2,C01,458387,Park; Ji Young,44,0,49,5
1708250994966,BILD 2,C02,458544,Park; Ji Young,46,0,49,3
1708250994966,BILD 2,C03,458557,Park; Ji Young,47,0,49,2
1708250994966,BILD 2,C04,458563,Park; Ji Young,46,0,49,3
1708250995517,BILD 3,A01,424312,Hammond; LaTisha Marie,331,0,350,19
1708250995517,BILD 3,B01,470107,Stockwell; Sarah R,66,0,70,4
1708250995517,BILD 3,B02,470110,Stockwell; Sarah R,70,0,70,0
1708250995517,BILD 3,B03,470116,Stockwell; Sarah R,70,0,70,0
1708250995517,BILD 3,B04,470123,Stockwell; Sarah R,67,0,70,3
1708250995517,BILD 3,B05,470150,Stockwell; Sarah R,70,0,70,0
1708250995517,BILD 3,C01,470159,Cooper; Kimberly Lynn,67,0,70,3
1708250995517,BILD 3,C02,470160,Cooper; Kimberly Lynn,69,0,70,1
1708250995517,BILD 3,C03,470164,Cooper; Kimberly Lynn,70,0,70,0
1708250995517,BILD 3,C04,470165,Cooper; Kimberly Lynn,69,0,70,1
1708250995517,BILD 3,C05,470374,Cooper; Kimberly Lynn,68,0,70,2
1708250996061,BILD 4,A01,424318,Staff,22,0,24,2
1708250996061,BILD 4,A02,424324,Staff,24,0,24,0
1708250996061,BILD 4,A03,424325,Staff,24,0,24,0
1708250996061,BILD 4,A04,424326,Staff,22,0,24,2
1708250996061,BILD 4,A05,424327,Staff,24,0,24,0
1708250996061,BILD 4,A06,424330,Staff,24,0,24,0
1708250996061,BILD 4,A07,424331,Staff,24,0,24,0
1708250996061,BILD 4,A08,424342,Staff,24,0,24,0
1708250996061,BILD 4,B01,424462,Pickett; Brooke Elizabeth,23,0,24,1
1708250996061,BILD 4,B02,424466,Pickett; Brooke Elizabeth,24,0,24,0
1708250996061,BILD 4,B03,424469,Pickett; Brooke Elizabeth,23,0,24,1
1708250996061,BILD 4,B04,424470,Pickett; Brooke Elizabeth,22,0,24,2
1708250996061,BILD 4,B05,424700,Pickett; Brooke Elizabeth,23,0,24,1
1708250996061,BILD 4,B06,424723,Pickett; Brooke Elizabeth,24,0,24,0
1708250996061,BILD 4,B07,424730,Pickett; Brooke Elizabeth,24,0,24,0
1708250996061,BILD 4,B08,424929,Pickett; Brooke Elizabeth,22,0,24,2
1708250996061,BILD 4,C01,424947,Gonzalez Gamboa; Ivonne,22,0,24,2
1708250996061,BILD 4,C02,424951,Gonzalez Gamboa; Ivonne,23,0,24,1
1708250996061,BILD 4,C03,424991,Gonzalez Gamboa; Ivonne,23,0,24,1
1708250996061,BILD 4,C04,424993,Gonzalez Gamboa; Ivonne,24,0,24,0
1708250996061,BILD 4,C05,424994,Gonzalez Gamboa; Ivonne,24,0,24,0
1708250996061,BILD 4,C06,425209,Gonzalez Gamboa; Ivonne,24,0,24,0
1708250996061,BILD 4,C07,425233,Gonzalez Gamboa; Ivonne,24,0,24,0
1708250996061,BILD 4,C08,425247,Gonzalez Gamboa; Ivonne,24,0,24,0
1708250996591,BILD 60,A01,425326,Hammond; LaTisha Marie,62,0,64,2
1708250997133,BILD 83,A00,425347,Pogliano; Joseph,25,0,30,5
1708250997660,BILD 87,A00,425368,Saier; Milton H.,20,0,20,0
1708250998247,BIMM 100,A01,425744,Cooper; Andrew Michael,303,0,320,17
1708250998247,BIMM 100,B01,425746,Cooper; Andrew Michael,315,0,320,5
1708250998774,BIMM 101,A01,425748,McDonnell; Lisa Marie,8,0,24,16
1708250998774,BIMM 101,A02,425749,McDonnell; Lisa Marie,23,0,24,1
1708250998774,BIMM 101,B01,425751,Day; Christopher D,22,0,24,2
1708250998774,BIMM 101,B02,425752,Day; Christopher D,24,0,24,0
1708250998774,BIMM 101,B03,425753,Day; Christopher D,22,0,24,2
1708250998774,BIMM 101,B04,425754,Day; Christopher D,24,0,24,0
1708250998774,BIMM 101,C01,425756,Rusert; Jessica Marie,16,0,24,8
1708250998774,BIMM 101,C02,425757,Rusert; Jessica Marie,23,0,24,1
1708250998774,BIMM 101,C03,425758,Rusert; Jessica Marie,23,0,24,1
1708250998774,BIMM 101,C04,425759,Rusert; Jessica Marie,23,0,24,1
1708250999301,BIMM 110,A01,425764,Niwa; Maho,55,0,56,1
1708250999301,BIMM 110,A02,425765,Niwa; Maho,56,0,56,0
1708250999301,BIMM 110,A03,425766,Niwa; Maho,56,0,56,0
1708250999301,BIMM 110,A04,425767,Niwa; Maho,55,0,56,1
1708250999831,BIMM 116R,A01,425771,Golden; Susan S. & Gorman; Michael R.,55,0,72,17
1708250999831,BIMM 116R,A02,425772,Golden; Susan S. & Gorman; Michael R.,53,0,72,19
1708250999831,BIMM 116R,A03,425773,Golden; Susan S. & Gorman; Michael R.,66,0,72,6
1708250999831,BIMM 116R,A04,425774,Golden; Susan S. & Gorman; Michael R.,70,0,72,2
1708251000356,BIMM 118,A01,425779,David; Michael,83,0,96,13
1708251000890,BIMM 120,A01,425792,Pirino; Giorgia,203,0,216,13
1708251000890,BIMM 120,B01,470639,Saier; Milton H.,201,0,216,15
1708251001419,BIMM 121,A01,425830,Gustafson-Brown; Cindy,18,0,24,6
1708251001419,BIMM 121,A02,425831,Gustafson-Brown; Cindy,21,0,24,3
1708251001419,BIMM 121,A03,425832,Gustafson-Brown; Cindy,24,0,24,0
1708251001419,BIMM 121,A04,425833,Gustafson-Brown; Cindy,23,0,24,1
1708251001419,BIMM 121,B01,425835,Pirino; Giorgia,18,0,24,6
1708251001419,BIMM 121,B02,425836,Pirino; Giorgia,24,0,24,0
1708251001419,BIMM 121,C01,425838,Park; Ji Young,6,0,24,18
1708251001419,BIMM 121,C02,425839,Park; Ji Young,20,0,24,4
1708251001948,BIMM 134,A01,425841,Burg; Michael,393,0,416,23
1708251002479,BIMM 143,A01,425843,Grant; Barry J,17,0,40,23
1708251002479,BIMM 143,B01,425845,Bozinovic; Goran,33,0,40,7
1708251003009,BIMM 182,A01,455012,Bafna; Vineet,28,0,50,22
1708251003535,BIMM 194,A00,425847,Rivera; Fabian Chavez,24,0,27,3
1708251003535,BIMM 194,B00,425868,Russell; Alistair B,16,0,27,11
1708251003535,BIMM 194,D00,425870,Wildonger; Jill Cathleen,14,0,27,13
1708251004063,BIOM 202,A00,390710,Corbett; Kevin Daniel,93,0,100,7
1708251004593,BIOM 219,A00,390713,Ross; Camille,0,0,0,7
1708251005121,BIOM 231,A00,455099,Furnari; Frank,0,0,0,0
1708251005121,BIOM 231,B00,455100,Lopez Ramirez; Miguel Alej,0,0,0,0
1708251005651,BIOM 242,A00,390714,Hamilton; Bruce Alan,20,0,20,0
1708251006180,BIOM 246,A00,492784,Gordts; Philip & Varki; Ajit P & Lewis; Amanda Lark & Godula; Kamil & Gagneux; Pascal & Esko; Jeffrey D. & Bode; Lars,0,0,0,0
1708251006707,BIOM 252,A00,390715,Ayyagari; Radha,27,0,28,1
1708251007233,BIOM 254,A00,390718,Corbett; Kevin Daniel,14,0,20,6
1708251007759,BIOM 272,A00,390722,Hangauer; Matthew John,16,0,20,4
1708251008285,BIOM 274,A00,390725,Sun; Bryan Kee-Hong,7,0,15,8
1708251008811,BIOM 283,A00,390728,Komives; Elizabeth A,2,0,2,0
1708251009339,BIOM 285,A00,390730,Gaulton; Kyle J,10,0,20,10
1708251009865,BIOM 295,A00,455083,Brown; Joan Heller,0,0,0,0
1708251010392,BIPN 100,A01,425872,Augustine; Vineet,240,0,245,5
1708251010392,BIPN 100,B01,425874,George; Monique Leana,240,0,245,5
1708251010392,BIPN 100,C01,458640,Maita; Isabella Vincenza,44,0,49,5
1708251010392,BIPN 100,C02,458646,Maita; Isabella Vincenza,48,0,49,1
1708251010392,BIPN 100,C03,458714,Maita; Isabella Vincenza,48,0,49,1
1708251010392,BIPN 100,C04,458716,Maita; Isabella Vincenza,48,0,49,1
1708251010392,BIPN 100,C05,458717,Maita; Isabella Vincenza,46,0,49,3
1708251010922,BIPN 105,A01,425877,Armour; Jon Christopher,12,0,21,9
1708251010922,BIPN 105,A02,425878,Armour; Jon Christopher,21,0,21,0
1708251010922,BIPN 105,A03,425879,Armour; Jon Christopher,10,0,21,11
1708251010922,BIPN 105,A04,425880,Armour; Jon Christopher,20,0,21,1
1708251011453,BIPN 120,A01,425882,Cooke; James Edward,371,0,395,24
1708251011983,BIPN 140,A01,425884,Hibbs; Ryan E.,183,0,192,9
1708251012516,BIPN 144,A01,425886,Zou; Yimin,153,0,158,5
1708251013048,BIPN 145,A01,425888,Maita; Isabella Vincenza,41,0,42,1
1708251013048,BIPN 145,B01,425918,Marino; Marc J,37,0,42,5
1708251013048,BIPN 145,B02,425954,Marino; Marc J,40,0,42,2
1708251013575,BIPN 147,A01,426086,Sejnowski; Terrence J,53,0,64,11
1708251014100,BIPN 152,A01,426112,Halpain; Shelley,97,0,128,31
1708251014630,BIPN 162,A01,426120,Juavinett; Ashley Lauren,17,0,30,13
1708251015156,BIPN 164,A01,455010,Benna; Marcus K & Aljadeff; Johnatan,120,0,120,0
1708251015682,BIPN 194,A00,426122,Glasgow; Stacey Marie,20,0,27,7
1708251016212,BISP 170,A00,426158,French; Kathleen Ann,26,0,30,4
1708251016741,BISP 182,A00,426168,Pogliano; Joseph,9999,0,9999,0
1708251017271,BISP 194,A00,426240,Chisholm; Andrew D.,11,0,27,16
1708251017271,BISP 194,B00,426241,Farley; Emma Kristen,25,0,27,2
1708251017796,BNFO 281,A00,427175,Gaasterland; Theresa,85,0,100,15
1708251018328,BNFO 283,A00,427211,Carter; Hannah Kathryn & Chavez; Alejandro,39,0,50,11
1708251018328,BNFO 283,B00,480483,Amariuta-Bartell; Tiffany & Dorrestein; Pieter,21,0,30,9
1708251018859,BNFO 294,B01,427269,Ross; Camille,47,0,50,3
1708251019414,CAT 3,A01,396994,Glaser; Amelia,15,0,15,0
1708251019414,CAT 3,A02,396995,Glaser; Amelia,15,0,15,0
1708251019414,CAT 3,A03,396996,Glaser; Amelia,7,0,15,8
1708251019414,CAT 3,A04,396997,Glaser; Amelia,12,0,15,3
1708251019414,CAT 3,A05,397004,Glaser; Amelia,15,0,15,0
1708251019414,CAT 3,A06,397039,Glaser; Amelia,11,0,15,4
1708251019414,CAT 3,A07,397040,Glaser; Amelia,13,0,15,2
1708251019414,CAT 3,A08,397084,Glaser; Amelia,15,0,15,0
1708251019414,CAT 3,A09,397269,Glaser; Amelia,13,0,15,2
1708251019414,CAT 3,A10,397270,Glaser; Amelia,0,0,15,15
1708251019414,CAT 3,A11,397271,Glaser; Amelia,9,0,15,6
1708251019414,CAT 3,A12,397272,Glaser; Amelia,12,0,15,3
1708251019414,CAT 3,A13,397273,Glaser; Amelia,15,0,15,0
1708251019414,CAT 3,A14,397274,Glaser; Amelia,14,0,15,1
1708251019414,CAT 3,B01,397276,Porter; Lisa,15,0,15,0
1708251019414,CAT 3,B02,397277,Porter; Lisa,15,0,15,0
1708251019414,CAT 3,B03,397278,Porter; Lisa,14,0,15,1
1708251019414,CAT 3,B04,397279,Porter; Lisa,15,0,15,0
1708251019414,CAT 3,B06,397281,Porter; Lisa,15,0,15,0
1708251019414,CAT 3,B07,397291,Porter; Lisa,15,0,15,0
1708251019414,CAT 3,B09,397293,Porter; Lisa,15,0,15,0
1708251019414,CAT 3,B10,397294,Porter; Lisa,15,0,15,0
1708251019414,CAT 3,B11,397295,Porter; Lisa,12,0,15,3
1708251019414,CAT 3,B12,397296,Porter; Lisa,14,0,15,1
1708251019414,CAT 3,B13,397297,Porter; Lisa,11,0,15,4
1708251019414,CAT 3,B14,397298,Porter; Lisa,15,0,15,0
1708251019414,CAT 3,B15,397299,Porter; Lisa,15,0,15,0
1708251019414,CAT 3,B16,397300,Porter; Lisa,15,0,15,0
1708251019414,CAT 3,C01,397302,Marchisotto; Jennifer Anne,13,0,15,2
1708251019414,CAT 3,C02,397308,Marchisotto; Jennifer Anne,9,0,15,6
1708251019414,CAT 3,C03,397309,Marchisotto; Jennifer Anne,9,0,15,6
1708251019414,CAT 3,C04,397315,Marchisotto; Jennifer Anne,11,0,15,4
1708251019414,CAT 3,C05,397316,Marchisotto; Jennifer Anne,14,0,15,1
1708251019414,CAT 3,C06,397322,Marchisotto; Jennifer Anne,15,0,15,0
1708251019414,CAT 3,C07,397323,Marchisotto; Jennifer Anne,15,0,15,0
1708251019414,CAT 3,C08,397329,Marchisotto; Jennifer Anne,15,0,15,0
1708251019414,CAT 3,C09,397333,Marchisotto; Jennifer Anne,15,0,15,0
1708251019414,CAT 3,C10,397336,Marchisotto; Jennifer Anne,15,0,15,0
1708251019414,CAT 3,C11,397354,Marchisotto; Jennifer Anne,13,0,15,2
1708251019414,CAT 3,C12,397357,Marchisotto; Jennifer Anne,15,0,15,0
1708251019414,CAT 3,C13,397364,Marchisotto; Jennifer Anne,14,0,15,1
1708251019414,CAT 3,C14,397367,Marchisotto; Jennifer Anne,14,0,15,1
1708251019414,CAT 3,C15,397369,Marchisotto; Jennifer Anne,15,0,15,0
1708251019414,CAT 3,C16,397373,Marchisotto; Jennifer Anne,15,0,15,0
1708251019414,CAT 3,C17,397374,Marchisotto; Jennifer Anne,15,0,15,0
1708251019414,CAT 3,C18,397380,Marchisotto; Jennifer Anne,14,0,15,1
1708251019414,CAT 3,D02,397405,Rahimi; Babak,13,0,15,2
1708251019414,CAT 3,D03,397408,Rahimi; Babak,14,0,15,1
1708251019414,CAT 3,D04,397415,Rahimi; Babak,15,0,15,0
1708251019414,CAT 3,D05,397416,Rahimi; Babak,15,0,15,0
1708251019414,CAT 3,D06,397422,Rahimi; Babak,15,0,15,0
1708251019414,CAT 3,D07,397426,Rahimi; Babak,14,0,15,1
1708251019414,CAT 3,D09,397447,Rahimi; Babak,11,0,15,4
1708251019414,CAT 3,D10,397450,Rahimi; Babak,13,0,15,2
1708251019414,CAT 3,D11,397625,Rahimi; Babak,13,0,15,2
1708251019414,CAT 3,D12,397630,Rahimi; Babak,15,0,15,0
1708251019414,CAT 3,D13,397631,Rahimi; Babak,14,0,15,1
1708251019414,CAT 3,D14,397635,Rahimi; Babak,14,0,15,1
1708251019944,CAT 3CE,A01,397642,Bronstein; Phoebe Malan,25,0,25,0
1708251020476,CAT 87,A00,397645,Bronstein; Phoebe Malan,19,0,20,1
1708251021002,CAT 90,A00,480731,Bronstein; Phoebe Malan,20,0,20,0
1708251021530,CAT 124,A01,397662,Knight; Amy,5,0,5,0
1708251021530,CAT 124,A02,397722,Knight; Amy,5,0,5,0
1708251021530,CAT 124,A03,397726,Knight; Amy,5,0,5,0
1708251021530,CAT 124,A04,397829,Knight; Amy,4,0,5,1
1708251022061,CAT 125,001,397832,Popko; Elizabeth Ashley,20,0,20,0
1708251022061,CAT 125,002,397833,Delaville; Romain,20,0,20,0
1708251022061,CAT 125,003,397834,Marchisotto; Jennifer Anne,18,0,20,2
1708251022061,CAT 125,004,397835,Bigham; David Joseph,20,0,20,0
1708251022061,CAT 125,005,397836,Bigham; David Joseph,19,0,20,1
1708251022061,CAT 125,006,397837,Bigham; David Joseph,16,0,20,4
1708251022061,CAT 125,007,397838,Vanderschuit; Maya Alysia,20,0,20,0
1708251022061,CAT 125,008,397839,Vanderschuit; Maya Alysia,20,0,20,0
1708251022061,CAT 125,009,397840,Vanderschuit; Maya Alysia,20,0,20,0
1708251022061,CAT 125,010,397841,Morales; Celeste Georgianna,15,0,16,1
1708251022061,CAT 125,011,397842,Morales; Celeste Georgianna,16,0,16,0
1708251022061,CAT 125,012,397881,Morales; Celeste Georgianna,19,0,20,1
1708251022061,CAT 125,013,397954,Rose; Becca Rae,18,0,20,2
1708251022061,CAT 125,014,397956,Rose; Becca Rae,20,0,20,0
1708251022061,CAT 125,015,397998,Rose; Becca Rae,19,0,20,1
1708251022061,CAT 125,016,397999,Tosun; Adriana,20,0,20,0
1708251022061,CAT 125,017,398001,Tosun; Adriana,20,0,20,0
1708251022061,CAT 125,018,398009,Irwin; Matthew Joseph,19,0,20,1
1708251022061,CAT 125,019,398010,Irwin; Matthew Joseph,18,0,20,2
1708251022061,CAT 125,020,398014,Irwin; Matthew Joseph,20,0,20,0
1708251022589,CAT 125R,A00,398015,Smith; Lauryn Alissa,19,0,20,1
1708251022589,CAT 125R,B00,398016,Smith; Lauryn Alissa,17,0,20,3
1708251022589,CAT 125R,C00,398017,Smith; Lauryn Alissa,19,0,20,1
1708251022589,CAT 125R,D00,398019,Tosun; Adriana,19,0,20,1
1708251022589,CAT 125R,E00,398020,Hyland; Tina Mae,12,0,20,8
1708251022589,CAT 125R,F00,398027,Hyland; Tina Mae,18,0,20,2
1708251022589,CAT 125R,G00,398028,Hyland; Tina Mae,18,0,20,2
1708251023125,CCE 1,A01,396087,Kenley Grounds; Nicole,40,0,40,0
1708251023125,CCE 1,B01,396142,Quijada; David,39,0,40,1
1708251023125,CCE 1,C01,396159,Bigley; Michele Heather,39,0,40,1
1708251023125,CCE 1,D01,396164,Bigley; Michele Heather,40,0,40,0
1708251023125,CCE 1,E01,396166,Lee; Kassandra,40,0,40,0
1708251023125,CCE 1,F01,396168,Lee; Kassandra,40,0,40,0
1708251023125,CCE 1,G01,396170,Staff,40,0,40,0
1708251023125,CCE 1,H01,396172,Staff,40,0,40,0
1708251023656,CENG 101B,A00,392993,Chen; Shaochen,44,0,45,1
1708251024183,CENG 101C,A00,392997,Li; Yanran,148,0,150,2
1708251024715,CENG 113,A00,393000,Chen; Zheng,69,0,70,1
1708251024715,CENG 113,B00,393001,Li; Wan-Lu,69,0,70,1
1708251025247,CENG 124B,A00,393036,Powell; Alyssa & Russ; Benjamin Edward,113,0,120,7
1708251025773,CENG 157,A00,393220,Opatkiewicz; Justin Paul,50,0,57,7
1708251026301,CENG 160,A00,393231,Powell; Alyssa,70,0,80,10
1708251026828,CENG 170,A01,393238,Drews; Aaron,27,0,30,3
1708251027354,CENG 175,A00,393239,Steinmetz; Nicole F,34,0,35,1
1708251027881,CENG 176B,A01,393285,Opatkiewicz; Justin Paul,46,0,52,6
1708251027881,CENG 176B,B01,393629,Zhang; Liangfang,40,0,49,9
1708251028411,CENG 205,A00,393681,Jahed Motlagh; Zeinab,53,0,60,7
1708251028938,CENG 257,A00,393682,Opatkiewicz; Justin Paul,10,0,13,3
1708251029464,CGS 87,A00,489609,Wesling; Megan E.,20,0,20,0
1708251029991,CGS 100B,A00,396181,Whitley; Leila Marie,28,0,30,2
1708251030522,CGS 109,A00,396194,Whitley; Leila Marie,19,0,20,1
1708251031048,CGS 112,A00,396220,Martin Sandino; Amanda Maria Yoland,22,0,25,3
1708251031582,CGS 114,A00,396223,Steelman; Katherine Wallis,14,0,16,2
1708251032109,CGS 116,A00,396295,Staff,19,0,20,1
1708251032634,CGS 117,A00,396306,Martin Sandino; Amanda Maria Yoland,14,0,15,1
1708251033164,CGS 118,A00,396314,Hankins; Joseph D.,28,0,29,1
1708251033690,CGS 128,A00,396366,Whitley; Leila Marie,14,0,15,1
1708251034219,CGS 137,A00,396865,Martin Sandino; Amanda Maria Yoland,16,0,19,3
1708251034744,CGS 150,A00,396901,Taylor-Garcia; Daphne,18,0,18,0
1708251035272,CGS 196B,A00,396904,Lo; Stanley M.,7,0,7,0
1708251035272,CGS 196B,B00,396973,Brenner; Suzanne A,7,0,7,0
1708251035272,CGS 196B,C00,396985,Jones; Makeba,7,0,7,0
1708251035798,CGS 198,001,396987,Anderson; Patrick W.,0,0,0,0
1708251035798,CGS 198,002,396988,Anderson; Patrick W.,0,0,0,0
1708251035798,CGS 198,003,396989,Anderson; Patrick W.,0,0,0,0
1708251035798,CGS 198,004,396990,Anderson; Patrick W.,0,0,0,0
1708251036323,CGS 200,A00,396991,Perez; Roy,0,0,0,3
1708251036853,CHEM 6A,A01,459563,Deshmukh; Lalit,40,0,40,0
1708251036853,CHEM 6A,A02,459564,Deshmukh; Lalit,35,0,40,5
1708251036853,CHEM 6A,A03,459565,Deshmukh; Lalit,31,0,40,9
1708251036853,CHEM 6A,A04,459566,Deshmukh; Lalit,30,0,38,8
1708251036853,CHEM 6A,A05,459567,Deshmukh; Lalit,40,0,40,0
1708251036853,CHEM 6A,A06,459568,Deshmukh; Lalit,37,0,40,3
1708251036853,CHEM 6A,A07,459569,Deshmukh; Lalit,37,0,40,3
1708251036853,CHEM 6A,A08,459570,Deshmukh; Lalit,0,0,0,0
1708251037388,CHEM 6B,A01,467314,Ortony; Julia Helen,39,0,40,1
1708251037388,CHEM 6B,A02,467322,Ortony; Julia Helen,32,0,40,8
1708251037388,CHEM 6B,A03,467323,Ortony; Julia Helen,40,0,40,0
1708251037388,CHEM 6B,A04,467325,Ortony; Julia Helen,31,0,40,9
1708251037388,CHEM 6B,A05,467326,Ortony; Julia Helen,39,0,40,1
1708251037388,CHEM 6B,A06,467346,Ortony; Julia Helen,40,0,40,0
1708251037388,CHEM 6B,B01,467360,Hopkins; Patrycja Anna,35,0,40,5
1708251037388,CHEM 6B,B02,467363,Hopkins; Patrycja Anna,38,0,40,2
1708251037388,CHEM 6B,B03,467364,Hopkins; Patrycja Anna,35,0,40,5
1708251037388,CHEM 6B,B04,467380,Hopkins; Patrycja Anna,40,0,40,0
1708251037388,CHEM 6B,B05,467381,Hopkins; Patrycja Anna,40,0,40,0
1708251037388,CHEM 6B,B06,467382,Hopkins; Patrycja Anna,39,0,40,1
1708251037920,CHEM 6C,A01,468994,Ternansky; Robert J.,39,0,40,1
1708251037920,CHEM 6C,A02,469054,Ternansky; Robert J.,38,0,40,2
1708251037920,CHEM 6C,A03,469065,Ternansky; Robert J.,39,0,40,1
1708251037920,CHEM 6C,A04,469069,Ternansky; Robert J.,40,0,40,0
1708251037920,CHEM 6C,A05,469080,Ternansky; Robert J.,40,0,40,0
1708251037920,CHEM 6C,B01,469318,Ternansky; Robert J.,39,0,40,1
1708251037920,CHEM 6C,B02,469319,Ternansky; Robert J.,40,0,40,0
1708251037920,CHEM 6C,B03,469320,Ternansky; Robert J.,39,0,40,1
1708251037920,CHEM 6C,B04,469321,Ternansky; Robert J.,40,0,40,0
1708251037920,CHEM 6C,B05,469322,Ternansky; Robert J.,40,0,40,0
1708251037920,CHEM 6C,C01,469323,Schurmeier; Kimberly,38,0,40,2
1708251037920,CHEM 6C,C02,469324,Schurmeier; Kimberly,36,0,40,4
1708251037920,CHEM 6C,C03,469325,Schurmeier; Kimberly,38,0,40,2
1708251037920,CHEM 6C,C04,469326,Schurmeier; Kimberly,36,0,40,4
1708251037920,CHEM 6C,C05,469327,Schurmeier; Kimberly,40,0,40,0
1708251037920,CHEM 6C,D01,460183,Schurmeier; Kimberly,39,0,40,1
1708251037920,CHEM 6C,D02,460184,Schurmeier; Kimberly,32,0,40,8
1708251037920,CHEM 6C,D03,460185,Schurmeier; Kimberly,26,0,40,14
1708251037920,CHEM 6C,D04,460186,Schurmeier; Kimberly,38,0,40,2
1708251037920,CHEM 6C,D05,460187,Schurmeier; Kimberly,40,0,40,0
1708251037920,CHEM 6C,E01,460188,Stallings; Dontarie M,24,0,40,16
1708251037920,CHEM 6C,E02,460190,Stallings; Dontarie M,25,0,40,15
1708251037920,CHEM 6C,E03,460191,Stallings; Dontarie M,3,0,20,17
1708251037920,CHEM 6C,E04,460192,Stallings; Dontarie M,36,0,40,4
1708251037920,CHEM 6C,E05,460193,Stallings; Dontarie M,37,0,40,3
1708251038448,CHEM 6CH,A01,459630,Tezcan; Faik,40,0,40,0
1708251038991,CHEM 7L,A01,393998,Jazzar; Rodolphe,0,0,0,3
1708251038991,CHEM 7L,A02,393999,Jazzar; Rodolphe,10,0,24,14
1708251038991,CHEM 7L,A03,394000,Jazzar; Rodolphe,21,0,24,3
1708251038991,CHEM 7L,A04,394001,Jazzar; Rodolphe,22,0,24,2
1708251038991,CHEM 7L,A05,394002,Jazzar; Rodolphe,18,0,24,6
1708251038991,CHEM 7L,A06,394003,Jazzar; Rodolphe,22,0,24,2
1708251038991,CHEM 7L,A07,394004,Jazzar; Rodolphe,18,0,21,3
1708251038991,CHEM 7L,A08,394005,Jazzar; Rodolphe,0,0,0,0
1708251038991,CHEM 7L,A09,394006,Jazzar; Rodolphe,20,0,24,4
1708251038991,CHEM 7L,A10,394007,Jazzar; Rodolphe,24,0,24,0
1708251038991,CHEM 7L,B01,394009,Jazzar; Rodolphe,0,0,0,1
1708251038991,CHEM 7L,B02,394010,Jazzar; Rodolphe,1,0,6,5
1708251038991,CHEM 7L,B03,394011,Jazzar; Rodolphe,15,0,24,9
1708251038991,CHEM 7L,B04,394012,Jazzar; Rodolphe,18,0,21,3
1708251038991,CHEM 7L,B05,394013,Jazzar; Rodolphe,0,0,0,0
1708251038991,CHEM 7L,B06,394014,Jazzar; Rodolphe,15,0,24,9
1708251038991,CHEM 7L,B07,394015,Jazzar; Rodolphe,18,0,24,6
1708251038991,CHEM 7L,B08,394016,Jazzar; Rodolphe,23,0,24,1
1708251038991,CHEM 7L,B09,394017,Jazzar; Rodolphe,24,0,24,0
1708251038991,CHEM 7L,B10,394018,Jazzar; Rodolphe,24,0,24,0
1708251038991,CHEM 7L,C01,394020,Staff,0,0,0,0
1708251038991,CHEM 7L,C02,394021,Staff,21,0,24,3
1708251038991,CHEM 7L,C03,394022,Staff,23,0,24,1
1708251038991,CHEM 7L,C04,394023,Staff,24,0,24,0
1708251038991,CHEM 7L,C05,394024,Staff,0,0,0,0
1708251038991,CHEM 7L,C06,394025,Staff,20,0,24,4
1708251038991,CHEM 7L,C07,394026,Staff,22,0,24,2
1708251038991,CHEM 7L,C08,394027,Staff,23,0,24,1
1708251038991,CHEM 7L,C09,394028,Staff,24,0,24,0
1708251038991,CHEM 7L,C10,394029,Staff,23,0,24,1
1708251039524,CHEM 11,A01,459661,Staff,42,0,44,2
1708251039524,CHEM 11,A02,459664,Staff,44,0,44,0
1708251039524,CHEM 11,A03,459702,Staff,42,0,44,2
1708251039524,CHEM 11,A04,459707,Staff,44,0,44,0
1708251039524,CHEM 11,A05,459708,Staff,43,0,44,1
1708251039524,CHEM 11,A06,459711,Staff,41,0,44,3
1708251040051,CHEM 40A,A01,459576,Albizati; Kim F.,36,0,40,4
1708251040051,CHEM 40A,A02,459577,Albizati; Kim F.,33,0,40,7
1708251040051,CHEM 40A,A03,459578,Albizati; Kim F.,37,0,40,3
1708251040051,CHEM 40A,A04,459579,Albizati; Kim F.,38,0,40,2
1708251040051,CHEM 40A,A05,459580,Albizati; Kim F.,40,0,40,0
1708251040051,CHEM 40A,A06,459581,Albizati; Kim F.,37,0,40,3
1708251040051,CHEM 40A,A07,459582,Albizati; Kim F.,38,0,40,2
1708251040051,CHEM 40A,A08,459588,Albizati; Kim F.,39,0,40,1
1708251040587,CHEM 40B,A01,467442,Weizman; Haim,29,0,40,11
1708251040587,CHEM 40B,A02,467443,Weizman; Haim,33,0,40,7
1708251040587,CHEM 40B,A03,467444,Weizman; Haim,39,0,40,1
1708251040587,CHEM 40B,A04,467445,Weizman; Haim,38,0,40,2
1708251040587,CHEM 40B,A05,467446,Weizman; Haim,39,0,40,1
1708251040587,CHEM 40B,A06,467447,Weizman; Haim,37,0,40,3
1708251040587,CHEM 40B,A07,467448,Weizman; Haim,31,0,40,9
1708251040587,CHEM 40B,A08,467449,Weizman; Haim,40,0,40,0
1708251040587,CHEM 40B,B01,467383,Molinski; Tadeusz,40,0,40,0
1708251040587,CHEM 40B,B02,467384,Molinski; Tadeusz,40,0,40,0
1708251040587,CHEM 40B,B03,467385,Molinski; Tadeusz,40,0,40,0
1708251040587,CHEM 40B,B04,467399,Molinski; Tadeusz,40,0,40,0
1708251040587,CHEM 40B,B05,467400,Molinski; Tadeusz,40,0,40,0
1708251040587,CHEM 40B,B06,467401,Molinski; Tadeusz,40,0,40,0
1708251040587,CHEM 40B,B07,467402,Molinski; Tadeusz,40,0,40,0
1708251040587,CHEM 40B,B08,467404,Molinski; Tadeusz,39,0,40,1
1708251041115,CHEM 41B,A01,459571,Klosterman; Jeremy K,40,0,40,0
1708251041115,CHEM 41B,A02,459572,Klosterman; Jeremy K,36,0,37,1
1708251041115,CHEM 41B,A03,459573,Klosterman; Jeremy K,40,0,40,0
1708251041647,CHEM 41C,A01,459589,Tor; Yitzhak,40,0,40,0
1708251041647,CHEM 41C,A02,459624,Tor; Yitzhak,38,0,40,2
1708251041647,CHEM 41C,A03,459625,Tor; Yitzhak,40,0,40,0
1708251041647,CHEM 41C,A04,459626,Tor; Yitzhak,40,0,40,0
1708251041647,CHEM 41C,A05,459627,Tor; Yitzhak,29,0,29,0
1708251041647,CHEM 41C,A06,459628,Tor; Yitzhak,38,0,40,2
1708251041647,CHEM 41C,A07,459629,Tor; Yitzhak,40,0,40,0
1708251042174,CHEM 43A,A01,394068,Lam; Tin Yiu,12,0,24,12
1708251042174,CHEM 43A,A02,394088,Lam; Tin Yiu,23,0,24,1
1708251042174,CHEM 43A,A03,394092,Lam; Tin Yiu,23,0,24,1
1708251042174,CHEM 43A,A04,394093,Lam; Tin Yiu,21,0,24,3
1708251042174,CHEM 43A,A05,394094,Lam; Tin Yiu,23,0,24,1
1708251042174,CHEM 43A,A06,394096,Lam; Tin Yiu,15,0,24,9
1708251042174,CHEM 43A,A07,394115,Lam; Tin Yiu,20,0,24,4
1708251042174,CHEM 43A,A08,394116,Lam; Tin Yiu,22,0,24,2
1708251042174,CHEM 43A,A09,394117,Lam; Tin Yiu,22,0,24,2
1708251042174,CHEM 43A,A10,394118,Lam; Tin Yiu,20,0,24,4
1708251042174,CHEM 43A,A11,394119,Lam; Tin Yiu,8,0,13,5
1708251042174,CHEM 43A,A12,394120,Lam; Tin Yiu,24,0,24,0
1708251042174,CHEM 43A,A13,394132,Lam; Tin Yiu,24,0,24,0
1708251042174,CHEM 43A,B01,394134,Lam; Tin Yiu,24,0,24,0
1708251042174,CHEM 43A,B02,394135,Lam; Tin Yiu,16,0,24,8
1708251042174,CHEM 43A,B03,394136,Lam; Tin Yiu,13,0,24,11
1708251042174,CHEM 43A,B04,394137,Lam; Tin Yiu,17,0,24,7
1708251042174,CHEM 43A,B05,394138,Lam; Tin Yiu,20,0,24,4
1708251042174,CHEM 43A,B06,394139,Lam; Tin Yiu,19,0,24,5
1708251042174,CHEM 43A,B07,394140,Lam; Tin Yiu,20,0,24,4
1708251042174,CHEM 43A,B08,394141,Lam; Tin Yiu,24,0,24,0
1708251042174,CHEM 43A,B09,394142,Lam; Tin Yiu,20,0,24,4
1708251042174,CHEM 43A,B10,394143,Lam; Tin Yiu,24,0,24,0
1708251042174,CHEM 43A,B11,394145,Lam; Tin Yiu,22,0,24,2
1708251042174,CHEM 43A,B12,394146,Lam; Tin Yiu,23,0,24,1
1708251042701,CHEM 96,A00,394159,Bussey; Thomas J,24,0,25,1
1708251043235,CHEM 100A,A01,394161,Li; Shaowei,16,0,22,6
1708251043235,CHEM 100A,A02,394162,Li; Shaowei,20,0,24,4
1708251043235,CHEM 100A,A03,394163,Li; Shaowei,22,0,24,2
1708251043235,CHEM 100A,A04,394164,Li; Shaowei,24,0,24,0
1708251043235,CHEM 100A,A05,394165,Li; Shaowei,24,0,24,0
1708251043235,CHEM 100A,A06,394166,Li; Shaowei,20,0,22,2
1708251043761,CHEM 100B,A01,394175,Pomeroy; Robert S.,19,0,25,6
1708251044294,CHEM 105A,A01,394177,Young; Mark,31,0,39,8
1708251044294,CHEM 105A,B01,394179,Young; Mark,0,0,0,0
1708251044820,CHEM 108,A01,394181,Staff,14,0,20,6
1708251044820,CHEM 108,A02,394182,Staff,23,0,24,1
1708251044820,CHEM 108,B01,394184,Staff,4,0,20,16
1708251044820,CHEM 108,B02,394185,Staff,23,0,24,1
1708251045345,CHEM 109,A01,394187,Piercy; Marc Anthony,17,0,20,3
1708251045345,CHEM 109,A02,394188,Piercy; Marc Anthony,22,0,24,2
1708251045345,CHEM 109,B01,394193,Piercy; Marc Anthony,12,0,20,8
1708251045345,CHEM 109,B02,394194,Piercy; Marc Anthony,23,0,24,1
1708251045876,CHEM 111,A00,394195,Thiemens; Mark H,97,0,100,3
1708251046404,CHEM 114B,A01,459574,Piercy; Marc Anthony,39,0,45,6
1708251046404,CHEM 114B,A02,459575,Piercy; Marc Anthony,40,0,45,5
1708251046936,CHEM 114C,A01,467286,Komives; Elizabeth A,32,0,44,12
1708251046936,CHEM 114C,A02,467287,Komives; Elizabeth A,42,0,44,2
1708251046936,CHEM 114C,A03,467290,Komives; Elizabeth A,42,0,44,2
1708251046936,CHEM 114C,A04,467295,Komives; Elizabeth A,43,0,44,1
1708251047467,CHEM 114D,A00,394198,Ghosh; Gourisankar,29,0,30,1
1708251047993,CHEM 118,A01,459788,Donoghue; Daniel J.,37,0,40,3
1708251047993,CHEM 118,A02,459800,Donoghue; Daniel J.,37,0,40,3
1708251047993,CHEM 118,A03,459807,Donoghue; Daniel J.,36,0,40,4
1708251047993,CHEM 118,A04,459809,Donoghue; Daniel J.,38,0,40,2
1708251047993,CHEM 118,A05,459811,Donoghue; Daniel J.,37,0,40,3
1708251047993,CHEM 118,A06,459826,Donoghue; Daniel J.,39,0,40,1
1708251048521,CHEM 119,A01,467427,Joseph; Simpson,35,0,40,5
1708251048521,CHEM 119,A02,467441,Joseph; Simpson,0,0,0,0
1708251049048,CHEM 120B,A01,467450,Griffith; Kent,37,0,40,3
1708251049048,CHEM 120B,A02,467451,Griffith; Kent,34,0,40,6
1708251049048,CHEM 120B,A03,467452,Griffith; Kent,35,0,40,5
1708251049574,CHEM 123,A00,394211,Schimpf; Alina M,0,0,0,1
1708251050104,CHEM 125,A00,394217,Tezcan; Faik,18,0,20,2
1708251050629,CHEM 126A,A01,459715,Yong; Haiwang,39,0,40,1
1708251050629,CHEM 126A,A02,459725,Yong; Haiwang,36,0,40,4
1708251051157,CHEM 126B,A01,467405,Tauber; Michael,36,0,40,4
1708251051157,CHEM 126B,A02,467406,Tauber; Michael,39,0,40,1
1708251051157,CHEM 126B,A03,467426,Tauber; Michael,39,0,40,1
1708251051744,CHEM 132,A01,460181,Galperin; Michael,42,0,45,3
1708251051744,CHEM 132,A02,460182,Galperin; Michael,37,0,45,8
1708251052270,CHEM 135,A01,394222,Tauber; Michael,15,0,15,0
1708251052796,CHEM 143B,A01,394229,Klosterman; Jeremy K,16,0,24,8
1708251052796,CHEM 143B,A02,394230,Klosterman; Jeremy K,21,0,24,3
1708251053324,CHEM 156,A00,394231,Romero; Erik Anthony,30,0,30,0
1708251053854,CHEM 157,A00,394232,Tor; Yitzhak,74,0,80,6
1708251054384,CHEM 165,A01,460194,Herzik; Mark Anthony,21,0,25,4
1708251054917,CHEM 167,A01,467296,Deshmukh; Lalit,39,0,40,1
1708251054917,CHEM 167,A02,467297,Deshmukh; Lalit,33,0,40,7
1708251054917,CHEM 167,A03,467298,Deshmukh; Lalit,37,0,40,3
1708251054917,CHEM 167,A04,467312,Deshmukh; Lalit,37,0,40,3
1708251055444,CHEM 173,A00,394284,Young; Mark,48,0,50,2
1708251055970,CHEM 174,A01,455015,Pomeroy; Robert S.,45,0,50,5
1708251056501,CHEM 186,A00,477716,Paesani; Francesco & Gilson; Michael K.,6,0,12,6
1708251057033,CHEM 188,A00,394294,Bussey; Thomas J,19,0,20,1
1708251057558,CHEM 214,A00,394336,Ghosh; Gourisankar,12,0,20,8
1708251058084,CHEM 217,A00,394341,Joseph; Simpson,25,0,30,5
1708251058621,CHEM 221,A00,394425,Taylor; Susan S.,10,0,20,10
1708251059147,CHEM 225,A00,394429,Tezcan; Faik,4,0,10,6
1708251059673,CHEM 227,A00,394430,Schimpf; Alina M,26,0,30,4
1708251060201,CHEM 229,A00,394431,Stauber; Julia Megan,13,0,20,7
1708251060727,CHEM 235,A01,394433,Tauber; Michael,20,0,20,0
1708251061258,CHEM 236,A00,394434,Kummel; Andrew C,14,0,15,1
1708251061786,CHEM 241,A00,394435,Pokorski; Jonathan Kyle,14,0,15,1
1708251062312,CHEM 250,A00,394436,Weizman; Haim,0,0,0,16
1708251062839,CHEM 256,A00,394437,Romero; Erik Anthony,15,0,20,5
1708251063365,CHEM 257,A00,394438,Tor; Yitzhak,23,0,30,7
1708251063891,CHEM 265,A01,460195,Herzik; Mark Anthony,13,0,20,7
1708251064417,CHEM 273,A00,394440,Young; Mark,13,0,20,7
1708251064945,CHEM 276,A00,394441,Mc Culloch; Andrew Douglas & Amaro; Rommie E,0,0,0,0
1708251065473,CHEM 283,A00,394443,Komives; Elizabeth A,2,0,4,2
1708251065999,CHEM 286,A00,477693,Paesani; Francesco & Gilson; Michael K.,26,0,34,8
1708251066525,CHEM 291,A00,394446,Komives; Elizabeth A,20,0,20,0
1708251067053,CHEM 294,A00,394447,Romero; Erik Anthony,50,0,50,0
1708251067580,CHIN 10CD,A01,394453,Liu; Mingming,17,0,17,0
1708251067580,CHIN 10CD,A02,394457,Liu; Mingming,18,0,18,0
1708251068108,CHIN 10CM,A01,394465,Chen; Pei-Chia,11,0,12,1
1708251068108,CHIN 10CM,A02,394466,Chen; Pei-Chia,12,0,12,0
1708251068108,CHIN 10CM,B01,394468,Liu; Mingming,11,0,13,2
1708251068108,CHIN 10CM,B02,394469,Liu; Mingming,13,0,13,0
1708251068636,CHIN 10CN,A01,394581,Xu; Li,14,0,14,0
1708251068636,CHIN 10CN,A02,394582,Xu; Li,14,0,14,0
1708251068636,CHIN 10CN,B01,394585,Xu; Li,14,0,14,0
1708251068636,CHIN 10CN,B02,394586,Xu; Li,13,0,14,1
1708251069166,CHIN 20CD,A01,394591,Wang; Xiao,11,0,12,1
1708251069166,CHIN 20CD,A02,394592,Wang; Xiao,11,0,12,1
1708251069700,CHIN 20CN,A01,394597,Anderson; Qin-Hong,7,0,8,1
1708251069700,CHIN 20CN,A02,394599,Anderson; Qin-Hong,8,0,8,0
1708251069700,CHIN 20CN,B01,394601,Anderson; Qin-Hong,14,0,15,1
1708251070226,CHIN 100CM,A00,394602,Anderson; Qin-Hong,19,0,20,1
1708251070756,CHIN 100CN,A00,394603,Chen; Pei-Chia,24,0,24,0
1708251071282,CHIN 169B,A00,394623,Wang; Xiao,19,0,20,1
1708251071809,CLAS 87,A00,394669,Herbst; Matthew,19,0,20,1
1708251072340,CLAS 121R,A01,394671,Herbst; Matthew,11,0,12,1
1708251072340,CLAS 121R,B01,486854,Herbst; Matthew,8,0,8,0
1708251072869,CLIN 294C,A00,476856,Wierenga; Christina E & Banks; Sarah Jane,20,0,20,0
1708251073402,CLIN 296,001,476768,Brookman; Lauren Irene,94,0,100,6
1708251073402,CLIN 296,002,476855,Brookman; Lauren Irene,10,0,10,0
1708251073929,CLRE 238R,A00,394675,Mehta; Ravindra L.,9998,0,9999,1
1708251074456,CLRE 254,A00,394678,Vaida; Florin,9999,0,9999,0
1708251074982,CLRE 256,A00,394685,Morris; Sheldon,9999,0,9999,0
1708251075514,CLRE 258,A00,394692,Mehta; Ravindra L.,9999,0,9999,0
1708251076041,CLRE 260,A00,394693,Cuomo; Raphael Eduardo,9999,0,9999,0
1708251076570,CLRE 264,A00,394696,Mehta; Ravindra L.,9999,0,9999,0
1708251077096,CLRE 267,A00,394703,Vaida; Florin,9999,0,9999,0
1708251077622,CLRE 297,001,394705,Cuomo; Raphael Eduardo,9999,0,9999,0
1708251078154,CMM 246,A00,492783,Gordts; Philip & Varki; Ajit P & Lewis; Amanda Lark & Godula; Kamil & Gagneux; Pascal & Esko; Jeffrey D. & Bode; Lars,9,0,10,1
1708251078684,CMM 250,A00,492943,Willert; Karl Heinrich,31,0,40,9
1708251079211,COGR 200B,A00,395746,Jack; Caroline Sarah,2,0,5,3
1708251079742,COGR 225B,A00,395750,Serlin; David,1,0,5,4
1708251080267,COGR 225C,A00,395753,Gates; Kelly,1,0,5,4
1708251080793,COGR 275,A00,395943,Goldfarb; Brian,6,0,10,4
1708251080793,COGR 275,B00,396046,Fattal; Alexander Leor,4,0,10,6
1708251080793,COGR 275,C00,396047,Kidman; Shawna F,4,0,10,6
1708251081323,COGR 280,A00,396048,Ahn; Patricia Jeehyun,6,0,10,4
1708251081851,COGS 1,A01,407484,Boyle; Mary E. T.,52,0,60,8
1708251081851,COGS 1,A02,407498,Boyle; Mary E. T.,54,0,60,6
1708251081851,COGS 1,A03,407504,Boyle; Mary E. T.,59,0,60,1
1708251081851,COGS 1,A04,407512,Boyle; Mary E. T.,57,0,60,3
1708251081851,COGS 1,A05,407513,Boyle; Mary E. T.,60,0,60,0
1708251081851,COGS 1,A06,407514,Boyle; Mary E. T.,58,0,60,2
1708251081851,COGS 1,A07,407515,Boyle; Mary E. T.,57,0,57,0
1708251082382,COGS 9,A01,407520,Shannon; Kyle Michael,54,0,60,6
1708251082382,COGS 9,A02,407521,Shannon; Kyle Michael,60,0,60,0
1708251082382,COGS 9,A03,407522,Shannon; Kyle Michael,59,0,60,1
1708251082382,COGS 9,A04,407524,Shannon; Kyle Michael,57,0,60,3
1708251082382,COGS 9,A05,407525,Shannon; Kyle Michael,59,0,60,1
1708251082910,COGS 10,A01,407527,Morgan; Eric,45,0,50,5
1708251082910,COGS 10,A02,407530,Morgan; Eric,46,0,50,4
1708251082910,COGS 10,A03,407531,Morgan; Eric,46,0,50,4
1708251082910,COGS 10,A04,407532,Morgan; Eric,47,0,50,3
1708251082910,COGS 10,A05,407534,Morgan; Eric,47,0,50,3
1708251082910,COGS 10,A06,407539,Morgan; Eric,50,0,50,0
1708251082910,COGS 10,A07,407628,Morgan; Eric,50,0,50,0
1708251083436,COGS 11,A01,407699,Boroditsky; Lera,179,0,180,1
1708251083968,COGS 12,A00,407702,Boroditsky; Lera,75,0,75,0
1708251084500,COGS 14A,A01,407706,Barrera; Steven James,51,0,57,6
1708251084500,COGS 14A,A02,407707,Barrera; Steven James,54,0,57,3
1708251084500,COGS 14A,A03,407712,Barrera; Steven James,0,0,0,1
1708251084500,COGS 14A,A04,407715,Barrera; Steven James,57,0,57,0
1708251084500,COGS 14A,A05,407717,Barrera; Steven James,55,0,56,1
1708251084500,COGS 14A,A06,407718,Barrera; Steven James,52,0,55,3
1708251084500,COGS 14A,A07,407720,Barrera; Steven James,49,0,55,6
1708251085032,COGS 14B,A01,407723,Hoffman; Drew Ellen,52,0,57,5
1708251085032,COGS 14B,A02,407726,Hoffman; Drew Ellen,48,0,55,7
1708251085032,COGS 14B,A03,407727,Hoffman; Drew Ellen,52,0,55,3
1708251085032,COGS 14B,A04,407729,Hoffman; Drew Ellen,52,0,55,3
1708251085032,COGS 14B,A05,407730,Hoffman; Drew Ellen,50,0,55,5
1708251085564,COGS 17,A01,407733,Johnson; Christine M.,50,0,50,0
1708251085564,COGS 17,A02,407734,Johnson; Christine M.,48,0,50,2
1708251085564,COGS 17,A03,407735,Johnson; Christine M.,46,0,50,4
1708251085564,COGS 17,A04,407740,Johnson; Christine M.,47,0,50,3
1708251085564,COGS 17,A05,407745,Johnson; Christine M.,48,0,50,2
1708251085564,COGS 17,A06,407824,Johnson; Christine M.,48,0,50,2
1708251085564,COGS 17,A07,407878,Johnson; Christine M.,50,0,55,5
1708251085564,COGS 17,A08,408015,Johnson; Christine M.,52,0,55,3
1708251086101,COGS 18,A01,408118,Ellis; Shannon Elizabeth,27,0,35,8
1708251086101,COGS 18,A02,408119,Ellis; Shannon Elizabeth,31,0,35,4
1708251086101,COGS 18,A03,408120,Ellis; Shannon Elizabeth,23,0,35,12
1708251086101,COGS 18,A04,408136,Ellis; Shannon Elizabeth,33,0,35,2
1708251086101,COGS 18,A05,408141,Ellis; Shannon Elizabeth,35,0,35,0
1708251086101,COGS 18,A06,408143,Ellis; Shannon Elizabeth,34,0,35,1
1708251086101,COGS 18,A07,408144,Ellis; Shannon Elizabeth,35,0,35,0
1708251086101,COGS 18,A08,408145,Ellis; Shannon Elizabeth,34,0,35,1
1708251086101,COGS 18,A09,408146,Ellis; Shannon Elizabeth,35,0,35,0
1708251086101,COGS 18,B01,408148,Ellis; Shannon Elizabeth,30,0,32,2
1708251086101,COGS 18,B02,408149,Ellis; Shannon Elizabeth,26,0,32,6
1708251086101,COGS 18,B03,408151,Ellis; Shannon Elizabeth,27,0,33,6
1708251086101,COGS 18,B04,408154,Ellis; Shannon Elizabeth,32,0,33,1
1708251086101,COGS 18,B05,408163,Ellis; Shannon Elizabeth,29,0,33,4
1708251086101,COGS 18,B06,408176,Ellis; Shannon Elizabeth,33,0,33,0
1708251086101,COGS 18,B07,408177,Ellis; Shannon Elizabeth,31,0,33,2
1708251086101,COGS 18,B08,408178,Ellis; Shannon Elizabeth,32,0,33,1
1708251086101,COGS 18,B09,408195,Ellis; Shannon Elizabeth,31,0,33,2
1708251086627,COGS 87,A00,408196,Deak; Gedeon O.,20,0,20,0
1708251086627,COGS 87,B00,479478,Fleischer; Jason G,20,0,20,0
1708251087152,COGS 100,A01,408262,Allen; Michael Gordon,54,0,56,2
1708251087152,COGS 100,A02,408263,Allen; Michael Gordon,52,0,56,4
1708251087152,COGS 100,A03,408264,Allen; Michael Gordon,55,0,56,1
1708251087152,COGS 100,A04,408265,Allen; Michael Gordon,56,0,56,0
1708251087152,COGS 100,A05,408266,Allen; Michael Gordon,56,0,56,0
1708251087152,COGS 100,A06,408349,Allen; Michael Gordon,55,0,56,1
1708251087683,COGS 101A,A01,408352,Morgan; Eric,60,0,60,0
1708251087683,COGS 101A,A02,408353,Morgan; Eric,58,0,60,2
1708251087683,COGS 101A,A03,408354,Morgan; Eric,57,0,60,3
1708251087683,COGS 101A,A04,408355,Morgan; Eric,59,0,60,1
1708251088214,COGS 101B,A01,408373,Barrera; Steven James,47,0,50,3
1708251088214,COGS 101B,A02,408380,Barrera; Steven James,46,0,50,4
1708251088214,COGS 101B,A03,408384,Barrera; Steven James,38,0,50,12
1708251088214,COGS 101B,A04,408385,Barrera; Steven James,37,0,50,13
1708251088742,COGS 101C,A01,408387,Trott; Sean Thomas,48,0,50,2
1708251088742,COGS 101C,A02,408388,Trott; Sean Thomas,43,0,50,7
1708251088742,COGS 101C,A03,408389,Trott; Sean Thomas,45,0,50,5
1708251089268,COGS 107A,A01,408396,Boyle; Mary E. T.,54,0,56,2
1708251089268,COGS 107A,A02,408397,Boyle; Mary E. T.,54,0,56,2
1708251089268,COGS 107A,A03,408399,Boyle; Mary E. T.,51,0,56,5
1708251089268,COGS 107A,A04,408409,Boyle; Mary E. T.,50,0,56,6
1708251089268,COGS 107A,A05,408410,Boyle; Mary E. T.,51,0,56,5
1708251089268,COGS 107A,A06,408411,Boyle; Mary E. T.,55,0,56,1
1708251089801,COGS 107B,A01,408413,Mooshagian; Eric Frederick,46,0,50,4
1708251089801,COGS 107B,A02,408414,Mooshagian; Eric Frederick,43,0,50,7
1708251089801,COGS 107B,A03,408428,Mooshagian; Eric Frederick,43,0,50,7
1708251089801,COGS 107B,A04,408434,Mooshagian; Eric Frederick,46,0,50,4
1708251089801,COGS 107B,A05,408435,Mooshagian; Eric Frederick,50,0,50,0
1708251089801,COGS 107B,A06,408446,Mooshagian; Eric Frederick,49,0,50,1
1708251090325,COGS 107C,A01,408500,Chiba; Andrea,51,0,60,9
1708251090325,COGS 107C,A02,408519,Chiba; Andrea,55,0,60,5
1708251090325,COGS 107C,A03,408524,Chiba; Andrea,56,0,60,4
1708251090857,COGS 108,A01,408532,Fleischer; Jason G,45,0,60,15
1708251090857,COGS 108,A02,408543,Fleischer; Jason G,58,0,60,2
1708251090857,COGS 108,A03,408544,Fleischer; Jason G,59,0,60,1
1708251090857,COGS 108,A04,408552,Fleischer; Jason G,32,0,60,28
1708251090857,COGS 108,A05,408554,Fleischer; Jason G,47,0,60,13
1708251090857,COGS 108,A06,408574,Fleischer; Jason G,43,0,60,17
1708251090857,COGS 108,A07,408576,Fleischer; Jason G,56,0,60,4
1708251091390,COGS 112,A01,408682,Hoffman; Drew Ellen,33,0,50,17
1708251091390,COGS 112,A02,408683,Hoffman; Drew Ellen,38,0,50,12
1708251091390,COGS 112,A03,408684,Hoffman; Drew Ellen,48,0,60,12
1708251091920,COGS 122,A01,408695,Dow; Steven P,21,0,50,29
1708251092449,COGS 125,A00,408697,Klemmer; Scott R,36,0,50,14
1708251092976,COGS 126,A01,408787,Hollan; James D.,44,0,50,6
1708251093502,COGS 138,A01,408866,Khosla; Meenakshi,71,0,75,4
1708251094034,COGS 142,A01,408868,Rossano; Federico,49,0,50,1
1708251094559,COGS 144,A01,408950,Rossano; Federico,48,0,50,2
1708251095085,COGS 155,A01,408993,Staff,49,0,50,1
1708251095616,COGS 157,A00,408994,Creel; Sarah,0,0,0,0
1708251096142,COGS 160,A00,409031,Deak; Gedeon O.,20,0,20,0
1708251096672,COGS 175,A01,409035,Rill; Bryan,67,0,75,8
1708251097198,COGS 178,A00,409274,Jernigan; Terry Lynne,68,0,70,2
1708251097724,COGS 179,A00,409278,Staff,40,0,40,0
1708251098254,COGS 184,A01,409317,Johnson; Christine M.,42,0,50,8
1708251098782,COGS 185,A01,409476,Tu; Zhuowen,33,0,50,17
1708251098782,COGS 185,A02,409525,Tu; Zhuowen,45,0,50,5
1708251099308,COGS 188,A01,409527,Fleischer; Jason G,44,0,75,31
1708251099838,COGS 190C,001,409528,Chiba; Andrea,9999,0,9999,0
1708251099838,COGS 190C,002,409530,Fleischer; Jason G,9999,0,9999,0
1708251099838,COGS 190C,003,409531,Boyle; Mary E. T.,9999,0,9999,0
1708251099838,COGS 190C,004,409532,Nitz; Douglas A.,9999,0,9999,0
1708251099838,COGS 190C,005,409535,Rangel; Lara M,9999,0,9999,0
1708251099838,COGS 190C,006,409536,Rossano; Federico,9999,0,9999,0
1708251099838,COGS 190C,007,409537,Deak; Gedeon O.,9999,0,9999,0
1708251099838,COGS 190C,008,409538,Trott; Sean Thomas,9999,0,9999,0
1708251099838,COGS 190C,009,409540,Creel; Sarah,9999,0,9999,0
1708251099838,COGS 190C,010,409541,Voytek; Bradley Thomas,9999,0,9999,0
1708251099838,COGS 190C,011,409542,Greene; Deanna Jacquelyn,9999,0,9999,0
1708251099838,COGS 190C,012,409543,Ellis; Shannon Elizabeth,9999,0,9999,0
1708251099838,COGS 190C,013,409546,Kirsh; David Joel,9999,0,9999,0
1708251100364,COGS 190D,A00,409547,Voytek; Bradley Thomas,20,0,20,0
1708251100893,COGS 194,A00,409548,Hill; Seth J,9999,0,9999,0
1708251101420,COGS 200,A01,406697,Creel; Sarah,0,0,0,0
1708251101945,COGS 205,A00,406698,Chiba; Andrea,20,0,20,0
1708251102473,COGS 209,A00,406699,Mukamel; Eran A,41,0,68,27
1708251103001,COGS 210C,001,406700,Kirsh; David Joel,9999,0,9999,0
1708251103001,COGS 210C,002,406701,Greene; Deanna Jacquelyn,9998,0,9999,1
1708251103001,COGS 210C,003,406702,Xia; Haijun,9999,0,9999,0
1708251103001,COGS 210C,004,406703,Nitz; Douglas A.,9998,0,9999,1
1708251103001,COGS 210C,005,406710,Hollan; James D.,9999,0,9999,0
1708251103001,COGS 210C,006,406713,De Sa; Virginia,9999,0,9999,0
1708251103001,COGS 210C,007,406714,Rossano; Federico,9999,0,9999,0
1708251103001,COGS 210C,008,406740,Kiyonaga; Anastasia,9999,0,9999,0
1708251103001,COGS 210C,009,406745,Guo; Philip J,9998,0,9999,1
1708251103001,COGS 210C,010,406746,Dow; Steven P,9999,0,9999,0
1708251103001,COGS 210C,011,406747,Bergen; Benjamin,9999,0,9999,0
1708251103001,COGS 210C,012,406758,Coulson; Seana M,9999,0,9999,0
1708251103531,COGS 211C,A00,406763,Coulson; Seana M,17,0,20,3
1708251104057,COGS 229,A00,406788,Hollan; James D. & Xia; Haijun,4,0,10,6
1708251104586,COGS 238,A00,406789,Bergen; Benjamin,17,0,20,3
1708251105172,COGS 278,A00,406794,Jernigan; Terry Lynne,18,0,20,2
1708251105701,COMM 10,A01,394711,Schmidt; Thomas Rainer,20,0,24,4
1708251105701,COMM 10,A02,394714,Schmidt; Thomas Rainer,24,0,24,0
1708251105701,COMM 10,A03,394716,Schmidt; Thomas Rainer,24,0,24,0
1708251105701,COMM 10,A04,394717,Schmidt; Thomas Rainer,22,0,24,2
1708251105701,COMM 10,A05,394731,Schmidt; Thomas Rainer,24,0,24,0
1708251105701,COMM 10,A06,394733,Schmidt; Thomas Rainer,24,0,24,0
1708251105701,COMM 10,A07,394740,Schmidt; Thomas Rainer,24,0,24,0
1708251105701,COMM 10,A08,394741,Schmidt; Thomas Rainer,24,0,24,0
1708251105701,COMM 10,A09,394751,Schmidt; Thomas Rainer,23,0,24,1
1708251105701,COMM 10,A10,394779,Schmidt; Thomas Rainer,24,0,24,0
1708251105701,COMM 10,A11,394809,Schmidt; Thomas Rainer,24,0,24,0
1708251105701,COMM 10,A12,394811,Schmidt; Thomas Rainer,24,0,24,0
1708251105701,COMM 10,A13,394818,Schmidt; Thomas Rainer,24,0,24,0
1708251105701,COMM 10,A14,394825,Schmidt; Thomas Rainer,23,0,24,1
1708251105701,COMM 10,A15,394828,Schmidt; Thomas Rainer,24,0,24,0
1708251105701,COMM 10,A16,394829,Schmidt; Thomas Rainer,0,0,0,0
1708251105701,COMM 10,A17,486828,Schmidt; Thomas Rainer,20,0,21,1
1708251106248,COMM 20,A01,394834,McKenna; Denise,69,0,70,1
1708251106792,COMM 80,A01,394849,Campbell; Robert Harold,120,0,120,0
1708251107318,COMM 100C,A01,394957,Kidman; Shawna F,24,0,25,1
1708251107318,COMM 100C,A02,394972,Kidman; Shawna F,25,0,25,0
1708251107318,COMM 100C,A03,394977,Kidman; Shawna F,22,0,25,3
1708251107318,COMM 100C,A04,394981,Kidman; Shawna F,25,0,25,0
1708251107318,COMM 100C,A05,394985,Kidman; Shawna F,24,0,25,1
1708251107318,COMM 100C,A06,394989,Kidman; Shawna F,23,0,25,2
1708251107318,COMM 100C,A07,394993,Kidman; Shawna F,24,0,25,1
1708251107318,COMM 100C,A08,394997,Kidman; Shawna F,23,0,25,2
1708251107318,COMM 100C,A09,394999,Kidman; Shawna F,25,0,25,0
1708251107318,COMM 100C,A10,395018,Kidman; Shawna F,25,0,25,0
1708251107318,COMM 100C,A11,395041,Kidman; Shawna F,24,0,25,1
1708251107318,COMM 100C,A12,395080,Kidman; Shawna F,24,0,25,1
1708251107849,COMM 101,A01,395135,Halm; Gavin Patrick,15,0,15,0
1708251107849,COMM 101,A02,395252,Halm; Gavin Patrick,15,0,15,0
1708251107849,COMM 101,A03,395253,Halm; Gavin Patrick,15,0,15,0
1708251107849,COMM 101,A04,395263,Halm; Gavin Patrick,15,0,15,0
1708251108375,COMM 101D,A00,395264,Martinico; Daniel J,13,0,16,3
1708251108905,COMM 101K,A00,395266,Ahn; Patricia Jeehyun,16,0,18,2
1708251109431,COMM 101N,A00,395267,Martinico; Daniel J,16,0,16,0
1708251109958,COMM 102C,A01,395270,Campion; Camille E,5,0,6,1
1708251109958,COMM 102C,A02,395271,Campion; Camille E,6,0,6,0
1708251109958,COMM 102C,A03,395272,Campion; Camille E,5,0,6,1
1708251110489,COMM 102M,A01,395285,Davis; Zeinabu I.,9,0,10,1
1708251110489,COMM 102M,A02,395288,Davis; Zeinabu I.,8,0,10,2
1708251111015,COMM 103D,A00,395343,Gates; Kelly,34,0,35,1
1708251111545,COMM 107,A00,395461,Serlin; David,33,0,35,2
1708251112074,COMM 109D,A00,395462,Halm; Gavin Patrick,72,0,75,3
1708251112599,COMM 110G,A00,395481,Whitworth-Smith; Andrew C,32,0,35,3
1708251113126,COMM 110M,A00,395482,Harb; Anthony Joseph,34,0,35,1
1708251113655,COMM 111A,A00,487217,Pavon Aramburu; Maria Laur,34,0,35,1
1708251114182,COMM 113T,A00,395516,Fields; Gary,35,0,35,0
1708251114711,COMM 114A,A00,395517,Zilberg; Elana,32,0,35,3
1708251115237,COMM 114B,A00,395523,Zilberg; Elana,19,0,20,1
1708251115763,COMM 114E,A00,487218,Pavon Aramburu; Maria Laur,34,0,35,1
1708251116292,COMM 114W,A00,395524,Walkover; Lillian B,17,0,18,1
1708251116817,COMM 126,A00,479341,Staff,26,0,30,4
1708251117343,COMM 132,A00,481491,Rojo Solis; Juan Jose,0,0,0,0
1708251117869,COMM 134,A00,395578,Abuelhiga; Soraya Jill,28,0,30,2
1708251118398,COMM 143,A00,395579,Rojo Solis; Juan Jose,28,0,30,2
1708251118923,COMM 146,A00,395584,Jack; Caroline Sarah,29,0,30,1
1708251119450,COMM 168,A00,395592,Harb; Anthony Joseph,29,0,30,1
1708251119979,COMM 170,A00,395608,Pavon Aramburu; Maria Laur,30,0,30,0
1708251120505,COMM 173,A00,395609,Alac; Morana,29,0,30,1
1708251121035,COMM 174,A00,395679,Alac; Morana,30,0,30,0
1708251121561,COMM 190,A00,395682,Abuelhiga; Soraya Jill,19,0,23,4
1708251121561,COMM 190,B00,395696,Staff,21,0,23,2
1708251121561,COMM 190,C00,395697,Fattal; Alexander Leor,22,0,23,1
1708251122090,CSE 8A,A50,459200,Miranda; Gregory Joseph,34,0,35,1
1708251122090,CSE 8A,A51,459205,Miranda; Gregory Joseph,34,0,35,1
1708251122090,CSE 8A,A52,459206,Miranda; Gregory Joseph,34,0,35,1
1708251122090,CSE 8A,A53,459212,Miranda; Gregory Joseph,34,0,35,1
1708251122090,CSE 8A,A54,459213,Miranda; Gregory Joseph,34,0,35,1
1708251122090,CSE 8A,A55,459232,Miranda; Gregory Joseph,34,0,35,1
1708251122620,CSE 11,A01,470735,Ochoa; Benjamin Lawrence,180,0,195,15
1708251123152,CSE 12,A01,470744,Cao; Yingjun,189,0,200,11
1708251123152,CSE 12,B01,470752,Miranda; Gregory Joseph,71,0,100,29
1708251123152,CSE 12,B02,470760,Miranda; Gregory Joseph,93,0,100,7
1708251123700,CSE 15L,A01,410174,Solares; Edwin A,6,0,10,4
1708251123700,CSE 15L,B01,410215,Solares; Edwin A,7,0,10,3
1708251123700,CSE 15L,C01,410305,Solares; Edwin A,3,0,10,7
1708251123700,CSE 15L,D01,410400,Solares; Edwin A,1,0,10,9
1708251124225,CSE 20,A01,470765,Minnes Kemp; Mor Mia,145,0,150,5
1708251124753,CSE 21,A01,470776,Jones; Miles E,68,0,73,5
1708251124753,CSE 21,A02,482889,Jones; Miles E,68,0,72,4
1708251125294,CSE 29,A01,494014,Soosai Raj; Adalbert Geral,48,0,50,2
1708251125294,CSE 29,A02,494016,Soosai Raj; Adalbert Geral,40,0,50,10
1708251125294,CSE 29,B01,494018,Shalev; Aaron D,16,0,20,4
1708251125828,CSE 30,A01,470784,Cao; Yingjun,141,0,150,9
1708251125828,CSE 30,B01,467469,Muller; P Keith,98,0,120,22
1708251126355,CSE 87,A00,410528,Moshiri; Niema,20,0,20,0
1708251126881,CSE 90,A00,486885,Minnes Kemp; Mor Mia,0,0,0,0
1708251127408,CSE 91,A00,486872,Minnes Kemp; Mor Mia,0,0,0,0
1708251127408,CSE 91,B00,486873,Minnes Kemp; Mor Mia,0,0,0,0
1708251127933,CSE 95,A00,410529,Minnes Kemp; Mor Mia,50,0,50,0
1708251128461,CSE 100,A01,470792,Sahoo; Debashis,54,0,70,16
1708251128987,CSE 100R,A01,410556,Moshiri; Niema,1,0,40,39
1708251129519,CSE 101,A01,470797,Jones; Miles E,14,0,44,30
1708251129519,CSE 101,A02,482892,Jones; Miles E,32,0,43,11
1708251130049,CSE 105,A01,470800,Micciancio; Daniele,85,0,98,13
1708251130593,CSE 107,A01,467479,Bellare; Mihir,141,0,146,5
1708251131118,CSE 109,A01,459538,Shang; Jingbo,0,0,25,25
1708251131667,CSE 110,A50,459395,Powell; Thomas Allan,49,0,50,1
1708251131667,CSE 110,A51,459512,Powell; Thomas Allan,37,0,50,13
1708251131667,CSE 110,A52,459513,Powell; Thomas Allan,46,0,50,4
1708251131667,CSE 110,A53,459514,Powell; Thomas Allan,48,0,50,2
1708251131667,CSE 110,A54,459515,Powell; Thomas Allan,47,0,50,3
1708251131667,CSE 110,A55,459516,Powell; Thomas Allan,45,0,50,5
1708251131667,CSE 110,A56,459517,Powell; Thomas Allan,47,0,48,1
1708251132209,CSE 112,A50,459518,Powell; Thomas Allan,132,0,146,14
1708251132738,CSE 120,A01,470808,Zhou; Yuan-Yuan,167,0,200,33
1708251133267,CSE 125,A00,410564,Voelker; Geoffrey M.,30,0,30,0
1708251133793,CSE 127,A01,467484,Fernandes; Earlence T,175,0,196,21
1708251134324,CSE 130,A01,467485,Polikarpova; Nadezhda,176,0,192,16
1708251134854,CSE 131,A01,459522,Ding; Yufei,36,0,50,14
1708251135380,CSE 132B,A01,470816,Deutsch; Alin Bernard,60,0,70,10
1708251135906,CSE 140,A01,410606,Orailoglu; Alex,99,0,100,1
1708251135906,CSE 140,B01,410622,Eldon; John,130,0,146,16
1708251136452,CSE 140L,A01,410655,Orailoglu; Alex,98,0,100,2
1708251136452,CSE 140L,B01,410658,Eldon; John,123,0,146,23
1708251136983,CSE 141,A01,467486,Zhao; Jishen,173,0,196,23
1708251137509,CSE 141L,A01,410685,Eldon; John,162,0,196,34
1708251138036,CSE 145,A01,410713,Kastner; Ryan Charles,25,0,25,0
1708251138562,CSE 150B,A01,470824,Gao; Sicun,310,0,362,52
1708251139091,CSE 156,A01,467487,Nakashole; Ndapandula,139,0,192,53
1708251139618,CSE 165,A01,410757,Weibel; Nadir & Schulze; Jurgen P.,40,0,50,10
1708251140148,CSE 168,A01,410759,Ramamoorthi; Ravi,24,0,25,1
1708251140148,CSE 168,A02,410761,Ramamoorthi; Ravi,24,0,25,1
1708251140677,CSE 175,A01,410764,Kumar; Rakesh,48,0,50,2
1708251141203,CSE 182,A01,455011,Bafna; Vineet,47,0,50,3
1708251141736,CSE 185,A01,410895,Gymrek; Melissa Ann,41,0,57,16
1708251141736,CSE 185,A02,479240,Gymrek; Melissa Ann,53,0,58,5
1708251142264,CSE 190,A00,410982,Grier; Daniel T,48,0,50,2
1708251142264,CSE 190,B00,410983,Riek; Laurel D,50,0,50,0
1708251142264,CSE 190,C00,410984,Staff,36,0,50,14
1708251142264,CSE 190,D00,481666,Saha; Barna & Impagliazzo; Russell,27,0,28,1
1708251142790,CSE 203A,A00,410985,Saha; Barna & Impagliazzo; Russell,0,0,0,0
1708251143323,CSE 209A,A00,410986,Grier; Daniel T,0,0,0,0
1708251143849,CSE 209B,A00,410987,Bellare; Mihir,0,0,0,0
1708251145390,CSE 217,A01,459553,Weibel; Nadir,0,0,0,0
1708251145920,CSE 218,A00,410989,Griswold; William G.,0,0,0,0
1708251146446,CSE 219,A00,410990,Hollan; James D. & Xia; Haijun,0,0,0,0
1708251146977,CSE 224,A01,470832,Snoeren; Alex C.,0,0,0,0
1708251147508,CSE 229A,A00,410993,Shalev; Aaron D,0,0,0,0
1708251148037,CSE 229C,A00,410994,Fernandes; Earlence T,0,0,0,0
1708251148563,CSE 231,A01,467488,Jhala; Ranjit,0,0,0,0
1708251149088,CSE 233,A00,410996,Vianu; Victor Dan,0,0,0,0
1708251149615,CSE 237D,A00,410998,Kastner; Ryan Charles,0,0,0,0
1708251150142,CSE 239A,A00,410999,Vianu; Victor Dan,0,0,0,0
1708251150667,CSE 239B,A00,411000,Coblenz; Michael J,0,0,0,0
1708251151192,CSE 240A,A00,411001,Chin; Bryan W.,0,0,0,0
1708251151721,CSE 252D,A00,411004,Chandraker; Manmohan Krishna,0,0,0,0
1708251152246,CSE 256,A00,411005,Nakashole; Ndapandula,0,0,0,0
1708251152780,CSE 260,A01,467491,Chin; Bryan W.,0,0,0,0
1708251153310,CSE 276B,A00,411007,Riek; Laurel D,0,0,0,0
1708251153837,CSE 276F,A01,459554,Su; Hao,0,0,0,0
1708251154370,CSE 283,A00,411009,Bafna; Vineet & Zhong; Sheng,0,0,0,0
1708251154915,CSE 290,A00,411010,Gao; Sicun,0,0,0,0
1708251154915,CSE 290,B00,411011,Chern; Albert Ren-Haur,0,0,0,0
1708251154915,CSE 290,C00,411012,Swanson; Steven James,0,0,0,0
1708251154915,CSE 290,E00,411013,Su; Hao,0,0,0,0
1708251154915,CSE 290,F00,411014,Riek; Laurel D,0,0,0,0
1708251154915,CSE 290,G00,411015,Gymrek; Melissa Ann,0,0,0,0
1708251154915,CSE 290,H00,479239,Dasgupta; Sanjoy & Gymrek; Melissa Ann,0,0,0,0
1708251154915,CSE 290,I00,481669,Bafna; Vineet,0,0,0,0
1708251154915,CSE 290,J00,494949,Paturi; Ramamohan,0,0,0,0
1708251155461,CSE 291,A00,411016,Li; Tzumao,0,0,0,0
1708251155461,CSE 291,B00,411017,Heninger; Nadia A,0,0,0,0
1708251155461,CSE 291,C00,411114,Chern; Albert Ren-Haur,0,0,0,0
1708251155461,CSE 291,D00,411115,Zhang; Yiying,0,0,0,0
1708251155461,CSE 291,E00,411116,Cheng; Chung Kuan,0,0,0,0
1708251155461,CSE 291,G00,411118,Lerner; Sorin,0,0,0,0
1708251155461,CSE 291,I00,481509,Shang; Jingbo,0,0,0,0
1708251155461,CSE 291,J00,494844,Savage; Stefan & Stefan; Deian,50,0,50,0
1708251156053,CSE 293,001,487239,Bafna; Vineet,9999,0,9999,0
1708251156053,CSE 293,002,487240,Bellare; Mihir,9999,0,9999,0
1708251156053,CSE 293,003,487241,Berg-Kirkpatrick; Taylor D,9999,0,9999,0
1708251156053,CSE 293,004,487242,Chandraker; Manmohan Krishna,9999,0,9999,0
1708251156053,CSE 293,005,487243,Cheng; Chung Kuan,9999,0,9999,0
1708251156053,CSE 293,006,487244,Christensen; Henrik I,9999,0,9999,0
1708251156053,CSE 293,007,487245,Coblenz; Michael J,9999,0,9999,0
1708251156053,CSE 293,008,487363,Cottrell; Garrison W,9999,0,9999,0
1708251156053,CSE 293,009,487366,Deutsch; Alin Bernard,9999,0,9999,0
1708251156053,CSE 293,010,487433,Esmaeilzadeh; Hadi,9999,0,9999,0
1708251156053,CSE 293,011,487434,Freund; Yoav,9999,0,9999,0
1708251156053,CSE 293,012,487455,Griswold; William G.,9999,0,9999,0
1708251156053,CSE 293,013,487469,Gymrek; Melissa Ann,9999,0,9999,0
1708251156053,CSE 293,014,487470,Heninger; Nadia A,9999,0,9999,0
1708251156053,CSE 293,015,487471,Impagliazzo; Russell,9999,0,9999,0
1708251156053,CSE 293,016,487472,Jhala; Ranjit,9999,0,9999,0
1708251156053,CSE 293,017,487473,Kahng; Andrew Byun,9999,0,9999,0
1708251156053,CSE 293,018,487474,Kane; Daniel Mertz,9999,0,9999,0
1708251156053,CSE 293,019,487475,Kriegman; David J,9999,0,9999,0
1708251156053,CSE 293,020,487476,Kumar; Arun Kumar,9999,0,9999,0
1708251156053,CSE 293,021,487477,Lerner; Sorin,9999,0,9999,0
1708251156053,CSE 293,022,487478,Lovett; Shachar,9999,0,9999,0
1708251156053,CSE 293,023,487520,McAuley; Julian John,9999,0,9999,0
1708251156053,CSE 293,024,487522,Micciancio; Daniele,9999,0,9999,0
1708251156053,CSE 293,025,487577,Orailoglu; Alex,9999,0,9999,0
1708251156053,CSE 293,026,487586,Pannuto; Patrick William,9999,0,9999,0
1708251156053,CSE 293,027,487598,Paturi; Ramamohan,9999,0,9999,0
1708251156053,CSE 293,028,487604,Polikarpova; Nadezhda,9999,0,9999,0
1708251156053,CSE 293,029,487609,Politz; Joseph Gibbs,9999,0,9999,0
1708251156053,CSE 293,030,487642,Porter; George M,9999,0,9999,0
1708251156053,CSE 293,031,487665,Porter; Leonard Emerson,9999,0,9999,0
1708251156053,CSE 293,032,487689,Ramamoorthi; Ravi,9999,0,9999,0
1708251156053,CSE 293,033,487698,Riek; Laurel D,9999,0,9999,0
1708251156053,CSE 293,034,487712,Sahoo; Debashis,9999,0,9999,0
1708251156053,CSE 293,035,487721,Saul; Lawrence,9999,0,9999,0
1708251156053,CSE 293,036,487735,Savage; Stefan,9999,0,9999,0
1708251156053,CSE 293,037,487744,Schulze; Jurgen P.,9999,0,9999,0
1708251156053,CSE 293,038,487758,Snoeren; Alex C.,9999,0,9999,0
1708251156053,CSE 293,039,487767,Shang; Jingbo,9999,0,9999,0
1708251156053,CSE 293,040,487790,Stefan; Deian,9999,0,9999,0
1708251156053,CSE 293,041,487817,Su; Hao,9999,0,9999,0
1708251156053,CSE 293,042,487827,Swanson; Steven James,9999,0,9999,0
1708251156053,CSE 293,043,487830,Tullsen; Dean Michael,9999,0,9999,0
1708251156053,CSE 293,044,487837,Vaccaro; Kristen Marie,9999,0,9999,0
1708251156053,CSE 293,045,487838,Voelker; Geoffrey M.,9999,0,9999,0
1708251156053,CSE 293,046,487842,Zhao; Jishen,9999,0,9999,0
1708251156053,CSE 293,047,487847,Zhou; Yuan-Yuan,9999,0,9999,0
1708251156053,CSE 293,048,487852,Gao; Sicun,9999,0,9999,0
1708251156053,CSE 293,049,487853,Weibel; Nadir,9999,0,9999,0
1708251156053,CSE 293,050,487854,Gupta; Rajesh K.,9999,0,9999,0
1708251156053,CSE 293,051,487855,Soosai Raj; Adalbert Geral,9999,0,9999,0
1708251156053,CSE 293,052,494373,Zhang; Hao,9999,0,9999,0
1708251156583,CSE 294,A00,411124,Voelker; Geoffrey M.,15,0,15,0
1708251157110,CSS 100,A01,396053,Trott; Sean Thomas,43,0,50,7
1708251157642,CSS 120,A01,479237,Mignozzetti; Umberto,47,0,50,3
1708251157642,CSS 120,A02,479238,Mignozzetti; Umberto,50,0,50,0
1708251158172,CSS 209,A00,396054,Styler; William Francis,21,0,35,14
1708251158698,CSS 296,001,396055,Mignozzetti; Umberto,0,0,0,1
1708251158698,CSS 296,002,396056,Styler; William Francis,0,0,0,1
1708251158698,CSS 296,003,396057,Broz; James Lawrence,0,0,0,2
1708251158698,CSS 296,004,396058,Elliott; Graham,0,0,0,5
1708251158698,CSS 296,005,396059,Sun; Feiyang,0,0,0,0
1708251158698,CSS 296,006,396060,Dewaard; Andrew Michael,0,0,0,0
1708251159225,DDPM 210,A00,400652,Ma; Joseph David,36,0,36,0
1708251159810,DDPM 211,A00,400653,Ma; Joseph David,36,0,36,0
1708251160336,DDPM 214,A00,400720,Ma; Joseph David,36,0,36,0
1708251160862,DERM 296,001,464131,Staff,50,0,50,0
1708251160862,DERM 296,002,464178,Staff,50,0,50,0
1708251160862,DERM 296,003,464181,Staff,50,0,50,0
1708251161402,DOC 3,A01,399409,Strom; Megan C.,0,0,0,0
1708251161402,DOC 3,A02,399414,Strom; Megan C.,0,0,0,0
1708251161402,DOC 3,A03,399432,Strom; Megan C.,0,0,0,0
1708251161402,DOC 3,A04,399461,Strom; Megan C.,0,0,0,0
1708251161402,DOC 3,A05,399470,Strom; Megan C.,0,0,0,0
1708251161402,DOC 3,A06,399476,Strom; Megan C.,0,0,0,0
1708251161402,DOC 3,A07,399547,Strom; Megan C.,0,0,0,0
1708251161402,DOC 3,A08,399548,Strom; Megan C.,0,0,0,0
1708251161402,DOC 3,A09,399675,Strom; Megan C.,0,0,0,0
1708251161402,DOC 3,A10,399687,Strom; Megan C.,0,0,0,0
1708251161402,DOC 3,A11,399704,Strom; Megan C.,0,0,0,0
1708251161402,DOC 3,A12,399707,Strom; Megan C.,0,0,0,0
1708251161402,DOC 3,A13,399714,Strom; Megan C.,0,0,0,0
1708251161402,DOC 3,A14,399721,Strom; Megan C.,0,0,0,0
1708251161402,DOC 3,A15,399765,Strom; Megan C.,0,0,0,0
1708251161402,DOC 3,A16,399766,Strom; Megan C.,0,0,0,0
1708251161402,DOC 3,B01,399786,Strom; Megan C.,0,0,0,0
1708251161402,DOC 3,B02,399787,Strom; Megan C.,0,0,0,0
1708251161402,DOC 3,B03,399788,Strom; Megan C.,0,0,0,0
1708251161402,DOC 3,B04,399845,Strom; Megan C.,0,0,0,0
1708251161402,DOC 3,B05,399846,Strom; Megan C.,0,0,0,0
1708251161402,DOC 3,B06,399895,Strom; Megan C.,0,0,0,0
1708251161402,DOC 3,B07,399916,Strom; Megan C.,0,0,0,0
1708251161402,DOC 3,B08,400073,Strom; Megan C.,0,0,0,0
1708251161402,DOC 3,B09,400074,Strom; Megan C.,0,0,0,0
1708251161402,DOC 3,B10,400076,Strom; Megan C.,0,0,0,0
1708251161402,DOC 3,B11,400077,Strom; Megan C.,0,0,0,0
1708251161402,DOC 3,B12,400078,Strom; Megan C.,0,0,0,0
1708251161402,DOC 3,B13,400079,Strom; Megan C.,0,0,0,0
1708251161402,DOC 3,B14,400080,Strom; Megan C.,0,0,0,0
1708251161402,DOC 3,B15,400081,Strom; Megan C.,0,0,0,0
1708251161402,DOC 3,B16,400082,Strom; Megan C.,0,0,0,0
1708251161402,DOC 3,C01,400084,Chapman; Dillon,0,0,0,0
1708251161402,DOC 3,C02,400085,Chapman; Dillon,0,0,0,0
1708251161402,DOC 3,C03,400086,Chapman; Dillon,0,0,0,0
1708251161402,DOC 3,C04,400087,Chapman; Dillon,0,0,0,0
1708251161402,DOC 3,C05,400113,Chapman; Dillon,0,0,0,0
1708251161402,DOC 3,C06,400114,Chapman; Dillon,0,0,0,0
1708251161402,DOC 3,C07,400117,Chapman; Dillon,0,0,0,0
1708251161402,DOC 3,C08,400118,Chapman; Dillon,0,0,0,0
1708251161402,DOC 3,C09,400119,Chapman; Dillon,0,0,0,0
1708251161402,DOC 3,C10,400121,Chapman; Dillon,0,0,0,0
1708251161402,DOC 3,C11,400122,Chapman; Dillon,0,0,0,0
1708251161402,DOC 3,C12,400126,Chapman; Dillon,0,0,0,0
1708251161402,DOC 3,C13,400157,Chapman; Dillon,0,0,0,0
1708251161402,DOC 3,C14,400240,Chapman; Dillon,0,0,0,0
1708251161402,DOC 3,C15,400241,Chapman; Dillon,0,0,0,0
1708251161402,DOC 3,C16,400242,Chapman; Dillon,0,0,0,0
1708251161402,DOC 3,D01,400253,Chapman; Dillon,0,0,0,0
1708251161402,DOC 3,D02,400294,Chapman; Dillon,0,0,0,0
1708251161402,DOC 3,D03,400295,Chapman; Dillon,0,0,0,0
1708251161402,DOC 3,D04,400430,Chapman; Dillon,0,0,0,0
1708251161402,DOC 3,D05,400438,Chapman; Dillon,0,0,0,0
1708251161402,DOC 3,D06,400439,Chapman; Dillon,0,0,0,0
1708251161402,DOC 3,D07,400441,Chapman; Dillon,0,0,0,0
1708251161402,DOC 3,D08,400442,Chapman; Dillon,0,0,0,0
1708251161402,DOC 3,D09,400443,Chapman; Dillon,0,0,0,0
1708251161402,DOC 3,D10,400445,Chapman; Dillon,0,0,0,0
1708251161402,DOC 3,D11,400446,Chapman; Dillon,0,0,0,0
1708251161402,DOC 3,D12,400447,Chapman; Dillon,0,0,0,0
1708251161402,DOC 3,D13,400448,Chapman; Dillon,0,0,0,0
1708251161402,DOC 3,D14,400646,Chapman; Dillon,0,0,0,0
1708251161402,DOC 3,D15,400647,Chapman; Dillon,0,0,0,0
1708251161402,DOC 3,D16,400648,Chapman; Dillon,0,0,0,0
1708251161932,DOC 100D,A00,400649,Pass; Natalye Joann,22,0,25,3
1708251161932,DOC 100D,B00,400650,Pass; Natalye Joann,25,0,25,0
1708251162462,DSC 10,A01,398041,Tiefenbruck; Janine LoBue,142,0,147,5
1708251162462,DSC 10,B01,398180,Tiefenbruck; Janine LoBue,144,0,147,3
1708251162462,DSC 10,C01,398400,Tiefenbruck; Janine LoBue,143,0,147,4
1708251162992,DSC 20,A01,398415,Langlois; Marina,200,0,200,0
1708251163524,DSC 30,A01,398436,Langlois; Marina,156,0,158,2
1708251163524,DSC 30,B01,398439,Langlois; Marina,144,0,150,6
1708251164055,DSC 40A,A01,398441,Rampure; Suraj,123,0,125,2
1708251164055,DSC 40A,B01,398443,Rampure; Suraj,125,0,125,0
1708251164584,DSC 40B,A01,398445,Staff,150,0,150,0
1708251165110,DSC 80,A01,398470,Lau; Samuel Ethan,70,0,70,0
1708251165110,DSC 80,B01,398541,Lau; Samuel Ethan,68,0,70,2
1708251165636,DSC 95,A01,398650,Rampure; Suraj,50,0,50,0
1708251166162,DSC 100,A01,398683,Salimi; Babak,147,0,150,3
1708251166688,DSC 102,A01,398708,Jin; Haojian,145,0,150,5
1708251167216,DSC 106,A01,398711,Wilber; Jared Dane,146,0,149,3
1708251167745,DSC 140A,A01,398724,Eldridge; Justin Matthew,98,0,100,2
1708251167745,DSC 140A,B01,479346,Ustun; Tevfik Berk,50,0,50,0
1708251168270,DSC 140B,A01,398726,Weng; Tsui-Wei (lily),144,0,150,6
1708251168807,DSC 190,A01,398738,Silberman; Jack,20,0,20,0
1708251168807,DSC 190,B01,479475,Ustun; Tevfik Berk,29,0,30,1
1708251168807,DSC 190,C01,481341,Rahman; Tauhidur,50,0,50,0
1708251169333,DSC 197,001,494360,Eldridge; Justin Matthew,9999,0,9999,0
1708251169862,DSC 214,A00,477322,Staff,21,0,60,39
1708251170388,DSC 231,A01,398863,Gupta; Rajesh K.,60,0,60,0
1708251170917,DSC 232R,A01,487133,Solares; Edwin A,39,0,60,21
1708251171448,DSC 240,A00,398957,Belkin; Mikhail,74,0,90,16
1708251172504,DSC 243,A00,398958,Ma; Yian,59,0,60,1
1708251173035,DSC 245,A00,398959,Huang; Biwei,41,0,60,19
1708251173561,DSC 253,A00,398960,Shang; Jingbo,0,0,30,30
1708251174086,DSC 258R,A01,398962,Shang; Jingbo,43,0,60,17
1708251174616,DSC 267R,A01,398964,Staff,56,0,60,4
1708251175145,DSC 291,A00,398965,Belkin; Mikhail,90,0,90,0
1708251175145,DSC 291,B00,398966,Weng; Tsui-Wei (lily),90,0,90,0
1708251175145,DSC 291,C00,398997,Staff,60,0,60,0
1708251175145,DSC 291,D00,398998,Zhang; Hao,40,0,40,0
1708251175145,DSC 291,E00,477386,Staff,50,0,50,0
1708251175671,DSC 293,A00,477388,Ustun; Tevfik Berk,9989,0,9999,10
1708251176197,DSC 295,A00,480826,Danks; David J,30,0,40,10
1708251176723,DSE 220,A00,398034,Dasgupta; Sanjoy,20,0,20,0
1708251177253,DSE 230,A00,398035,Nguyen; Mai Huong,20,0,20,0
1708251177779,DSE 260B,A00,398037,Altintas De Callaf; Ilkay,20,0,20,0
1708251178305,DSGN 1,A01,408210,Klemmer; Scott R,46,0,50,4
1708251178305,DSGN 1,A02,408245,Klemmer; Scott R,47,0,50,3
1708251178835,DSGN 119,A00,407467,Hollan; James D. & Xia; Haijun,76,0,90,14
1708251179364,DSGN 160,A00,494371,Aronoff-Spencer; Eliah Sea,15,0,20,5
1708251179893,DSGN 219,A00,474323,Hollan; James D. & Xia; Haijun,15,0,15,0
1708251180419,ECE 5,A01,428645,Morris; Karcher William,21,0,24,3
1708251180419,ECE 5,A02,428646,Morris; Karcher William,24,0,24,0
1708251180419,ECE 5,A03,428647,Morris; Karcher William,24,0,24,0
1708251180419,ECE 5,A04,428648,Morris; Karcher William,24,0,24,0
1708251180944,ECE 15,A01,428650,Sahay; Rajeev,119,0,120,1
1708251181469,ECE 16,A01,428652,Wang; Edward Jay,22,0,30,8
1708251181999,ECE 17,A01,428654,Sahay; Rajeev,48,0,60,12
1708251182525,ECE 25,A50,428657,Dey; Sujit,30,0,30,0
1708251182525,ECE 25,A51,428658,Dey; Sujit,30,0,30,0
1708251183059,ECE 30,A50,428674,Mir Arabbaygi; Siavash,28,0,30,2
1708251183059,ECE 30,A51,428675,Mir Arabbaygi; Siavash,28,0,30,2
1708251183059,ECE 30,A52,428676,Mir Arabbaygi; Siavash,28,0,30,2
1708251183059,ECE 30,A53,428679,Mir Arabbaygi; Siavash,29,0,30,1
1708251183059,ECE 30,A54,428680,Mir Arabbaygi; Siavash,30,0,30,0
1708251183586,ECE 35,A50,428684,Taur; Yuan,29,0,30,1
1708251183586,ECE 35,A51,428685,Taur; Yuan,30,0,30,0
1708251183586,ECE 35,A52,428686,Taur; Yuan,30,0,30,0
1708251183586,ECE 35,A53,428687,Taur; Yuan,29,0,30,1
1708251184113,ECE 45,A01,428689,Zeger; Kenneth A.,137,0,150,13
1708251184647,ECE 65,A50,428701,Baghdadchi; Saharnaz,28,0,30,2
1708251184647,ECE 65,A51,428742,Baghdadchi; Saharnaz,29,0,30,1
1708251184647,ECE 65,A52,428743,Baghdadchi; Saharnaz,30,0,30,0
1708251184647,ECE 65,A53,428754,Baghdadchi; Saharnaz,26,0,30,4
1708251184647,ECE 65,A54,428796,Baghdadchi; Saharnaz,30,0,30,0
1708251184647,ECE 65,A55,428797,Baghdadchi; Saharnaz,29,0,30,1
1708251184647,ECE 65,A56,428803,Baghdadchi; Saharnaz,30,0,30,0
1708251185174,ECE 100,A01,428978,Baghdadchi; Saharnaz,29,0,30,1
1708251185174,ECE 100,A02,428988,Baghdadchi; Saharnaz,30,0,30,0
1708251185174,ECE 100,A03,428989,Baghdadchi; Saharnaz,29,0,30,1
1708251185174,ECE 100,A04,429008,Baghdadchi; Saharnaz,29,0,30,1
1708251185705,ECE 101,A01,429017,Bharadia; Dinesh,57,0,60,3
1708251185705,ECE 101,A02,429019,Bharadia; Dinesh,60,0,60,0
1708251186230,ECE 103,A01,429027,Kuzum; Duygu,74,0,75,1
1708251186756,ECE 107,A01,429055,Fullerton; Eric E,73,0,75,2
1708251187282,ECE 108,A01,429068,Kang; Mingu,53,0,60,7
1708251187812,ECE 109,A01,429085,Orlitsky; Alon,98,0,100,2
1708251187812,ECE 109,A02,429098,Orlitsky; Alon,96,0,100,4
1708251188339,ECE 111,A01,429132,Turakhia; Yatish Girish,173,0,180,7
1708251188865,ECE 115,A01,429314,Yip; Michael,22,0,26,4
1708251189396,ECE 123,A01,429327,Sievenpiper; Daniel F.,56,0,60,4
1708251189923,ECE 125B,A50,429397,Esmaili; Gholamreza,23,0,24,1
1708251189923,ECE 125B,A51,429627,Esmaili; Gholamreza,23,0,24,1
1708251190454,ECE 134,A00,429630,Ng; Tse Nga,50,0,50,0
1708251190981,ECE 136L,A01,429634,Dayeh; Shadi Ahmad,3,0,5,2
1708251190981,ECE 136L,A02,429636,Dayeh; Shadi Ahmad,3,0,5,2
1708251190981,ECE 136L,A03,429637,Dayeh; Shadi Ahmad,5,0,5,0
1708251190981,ECE 136L,A04,429641,Dayeh; Shadi Ahmad,5,0,5,0
1708251191511,ECE 139,A00,429642,Nomura; Kenji,17,0,20,3
1708251192039,ECE 140B,A01,455349,Khoshabeh; Ramsin & Gessner; Richard K.,19,0,24,5
1708251192039,ECE 140B,A02,455351,Khoshabeh; Ramsin & Gessner; Richard K.,23,0,24,1
1708251192039,ECE 140B,A03,455354,Khoshabeh; Ramsin & Gessner; Richard K.,21,0,22,1
1708251192565,ECE 141B,A01,455355,Gessner; Richard K.,48,0,50,2
1708251193091,ECE 148,A01,492803,Silberman; Jack,0,0,0,0
1708251193622,ECE 153,A01,429655,Naghizadeh Ardabili; Parin,94,0,100,6
1708251194148,ECE 157A,A01,429657,Bharadia; Dinesh,22,0,25,3
1708251194675,ECE 158B,A01,429659,Zhang; Xinyu,14,0,20,6
1708251195207,ECE 161C,A00,429660,Cosman; Pamela C.,58,0,60,2
1708251195733,ECE 163,A00,429664,Hsueh; Tzu-Chien,95,0,100,5
1708251196266,ECE 165,A51,429672,Mercier; Patrick Philip,20,0,30,10
1708251196266,ECE 165,A52,429673,Mercier; Patrick Philip,22,0,30,8
1708251196266,ECE 165,A53,429674,Mercier; Patrick Philip,30,0,30,0
1708251196266,ECE 165,A54,429675,Mercier; Patrick Philip,30,0,30,0
1708251196792,ECE 171A,A01,429813,Zheng; Yang,96,0,100,4
1708251197318,ECE 175B,A01,429886,Xie; Pengtao,72,0,75,3
1708251197844,ECE 183,A01,430023,Mookherjea; Shayan,26,0,30,4
1708251198374,ECE 185,A01,430025,Papen; George C.,19,0,20,1
1708251198913,ECE 191,A00,430039,Zhang; Xinyu,30,0,30,0
1708251199440,ECE 196,A00,430040,Morris; Karcher William,18,0,24,6
1708251199440,ECE 196,B00,430045,Morris; Karcher William,23,0,24,1
1708251199969,ECE 198,001,430052,Nguyen; Truong Quang,9999,0,9999,0
1708251200511,ECE 200,001,438659,Atanasov; Nikolay A.,9999,0,9999,0
1708251200511,ECE 200,002,438660,Bharadia; Dinesh,9999,0,9999,0
1708251200511,ECE 200,003,438668,Cheng; Chung Kuan,9999,0,9999,0
1708251200511,ECE 200,004,438845,Cosman; Pamela C.,9999,0,9999,0
1708251200511,ECE 200,005,438846,Dayeh; Shadi Ahmad,9999,0,9999,0
1708251200511,ECE 200,006,438847,Fainman; Yeshaiahu,9999,0,9999,0
1708251200511,ECE 200,007,438848,Ford; Joseph Earl,9999,0,9999,0
1708251200511,ECE 200,008,438849,Franceschetti; Massimo,9999,0,9999,0
1708251200511,ECE 200,009,438850,Fullerton; Eric E,9999,0,9999,0
1708251200511,ECE 200,010,438851,Galton; Ian A,9999,0,9999,0
1708251200511,ECE 200,011,438852,Gilja; Vikash,9999,0,9999,0
1708251200511,ECE 200,012,438853,Hall; Drew A.,9999,0,9999,0
1708251200511,ECE 200,013,438854,Hsueh; Tzu-Chien,9999,0,9999,0
1708251200511,ECE 200,014,438855,Javidi; Tara,9999,0,9999,0
1708251200511,ECE 200,015,438865,Kahng; Andrew Byun,9999,0,9999,0
1708251200511,ECE 200,016,438866,Kim; Young-Han,9999,0,9999,0
1708251200511,ECE 200,017,438876,Koushanfar; Farinaz,9999,0,9999,0
1708251200511,ECE 200,018,438877,Kuzum; Duygu,9999,0,9999,0
1708251200511,ECE 200,019,438934,Le; Hanh-Phuc,9999,0,9999,0
1708251200511,ECE 200,020,438954,Lin; Bill,9999,0,9999,0
1708251200511,ECE 200,021,438955,Liu; Zhaowei,9999,0,9999,0
1708251200511,ECE 200,022,438957,Lo; Yu-Hwa,9999,0,9999,0
1708251200511,ECE 200,023,439086,Lomakin; Vitaliy,9999,0,9999,0
1708251200511,ECE 200,024,439087,Mercier; Patrick Philip,9999,0,9999,0
1708251200511,ECE 200,025,439088,Meyer; Florian,9999,0,9999,0
1708251200511,ECE 200,026,439090,Milstein; Laurence B.,9999,0,9999,0
1708251200511,ECE 200,027,439208,Mir Arabbaygi; Siavash,9999,0,9999,0
1708251200511,ECE 200,028,439209,Mookherjea; Shayan,9999,0,9999,0
1708251200511,ECE 200,029,439210,Morris; Karcher William,9999,0,9999,0
1708251200511,ECE 200,030,439211,Ng; Tse Nga,9999,0,9999,0
1708251200511,ECE 200,031,439219,Nguyen; Truong Quang,9999,0,9999,0
1708251200511,ECE 200,032,439220,Nomura; Kenji,9999,0,9999,0
1708251200511,ECE 200,033,439221,Orlitsky; Alon,9999,0,9999,0
1708251200511,ECE 200,034,439222,Pal; Piya,9999,0,9999,0
1708251200511,ECE 200,035,439223,Papen; George C.,9999,0,9999,0
1708251200511,ECE 200,036,439224,Radic; Stojan,9999,0,9999,0
1708251200511,ECE 200,037,439225,Rao; Bhaskar D.,9999,0,9999,0
1708251200511,ECE 200,038,439227,Rao; Ramesh R,9999,0,9999,0
1708251200511,ECE 200,039,439231,Rebeiz; Gabriel,9999,0,9999,0
1708251200511,ECE 200,040,439232,Sanford; John R,9999,0,9999,0
1708251200511,ECE 200,041,439302,Siegel; Paul H.,9999,0,9999,0
1708251200511,ECE 200,042,439303,Sievenpiper; Daniel F.,9999,0,9999,0
1708251200511,ECE 200,043,439305,Sworder; David D.,9999,0,9999,0
1708251200511,ECE 200,044,439306,Taur; Yuan,9999,0,9999,0
1708251200511,ECE 200,045,439419,Touri; Behrouz,9999,0,9999,0
1708251200511,ECE 200,046,439425,Trivedi; Mohan M.,9999,0,9999,0
1708251200511,ECE 200,047,439538,Vasconcelos; Nuno,9999,0,9999,0
1708251200511,ECE 200,048,439546,Wang; Xiaolong,9999,0,9999,0
1708251200511,ECE 200,049,439549,Xie; Pengtao,9999,0,9999,0
1708251200511,ECE 200,050,439551,Yip; Michael,9999,0,9999,0
1708251200511,ECE 200,051,439553,Zeger; Kenneth A.,9999,0,9999,0
1708251200511,ECE 200,052,439554,Zhang; Xinyu,9999,0,9999,0
1708251200511,ECE 200,053,439555,Zheng; Yang,9999,0,9999,0
1708251200511,ECE 200,054,439557,Turakhia; Yatish Girish,9999,0,9999,0
1708251200511,ECE 200,055,439558,Kang; Mingu,9999,0,9999,0
1708251200511,ECE 200,056,439560,Shi; Yuanyuan,9999,0,9999,0
1708251200511,ECE 200,057,439564,Wang; Edward Jay,9999,0,9999,0
1708251200511,ECE 200,058,439565,Antipa; Nicholas A,9999,0,9999,0
1708251200511,ECE 200,059,439566,Zheng; Yang,9999,0,9999,0
1708251200511,ECE 200,060,492991,Yu; Paul K L,9999,0,9999,0
1708251200511,ECE 200,061,492992,Ndao; Abdoulaye,9999,0,9999,0
1708251200511,ECE 200,062,493019,Naghizadeh Ardabili; Parin,9999,0,9999,0
1708251200511,ECE 200,063,493033,Sahay; Rajeev,9999,0,9999,0
1708251201037,ECE 208,A00,430053,Mir Arabbaygi; Siavash,0,0,0,0
1708251201568,ECE 212CN,A00,430054,Liu; Zhaowei,0,0,0,0
1708251202093,ECE 222C,A00,430055,Lomakin; Vitaliy,0,0,0,0
1708251202624,ECE 227,A00,430057,Franceschetti; Massimo,0,0,0,0
1708251203152,ECE 228,A00,430078,Shi; Yuanyuan,0,0,0,0
1708251203677,ECE 230C,A00,430079,Yu; Paul K L,0,0,0,0
1708251204204,ECE 235,A00,430081,Taur; Yuan,0,0,0,0
1708251204734,ECE 236B,A00,430082,Lo; Yu-Hwa,0,0,0,0
1708251205261,ECE 240C,A00,430083,Mookherjea; Shayan,0,0,0,0
1708251205788,ECE 250,A00,430115,Touri; Behrouz,0,0,0,0
1708251206314,ECE 251B,A00,430166,Vasconcelos; Manuela,0,0,0,0
1708251206844,ECE 258B,A00,430167,Milstein; Laurence B.,0,0,0,0
1708251207369,ECE 260C,A00,430168,Eldon; John,0,0,0,0
1708251207894,ECE 264B,A00,430169,Galton; Ian A,0,0,0,0
1708251208424,ECE 265B,A00,430170,Gudem; Prasad S.S.,0,0,0,0
1708251208952,ECE 266,A01,430273,Hall; Drew A.,0,0,0,0
1708251209479,ECE 271C,A00,430283,Vasconcelos; Nuno,0,0,0,0
1708251210009,ECE 272A,A01,430340,Poveda Fonseca; Jorge,0,0,0,0
1708251210535,ECE 273,A00,430352,Wang; Jun-Kun,0,0,0,0
1708251211062,ECE 276B,A00,430353,Atanasov; Nikolay A.,0,0,0,0
1708251211592,ECE 284,A00,430385,Wang; Edward,0,0,0,0
1708251212121,ECE 285,A00,430386,Wang; Xiaolong,0,0,0,0
1708251212121,ECE 285,B00,430387,Antipa; Nicholas A,0,0,0,0
1708251212649,ECON 1,A01,409576,Crane; Meredith Helen,87,0,100,13
1708251212649,ECON 1,A02,409577,Crane; Meredith Helen,96,0,100,4
1708251212649,ECON 1,A03,409578,Crane; Meredith Helen,97,0,100,3
1708251213229,ECON 2,A01,409580,Candido; Maria Teresa,70,0,75,5
1708251213756,ECON 3,A01,409582,Crane; Meredith Helen,109,0,120,11
1708251213756,ECON 3,A02,409583,Crane; Meredith Helen,114,0,115,1
1708251213756,ECON 3,A03,409584,Crane; Meredith Helen,110,0,115,5
1708251214282,ECON 4,A01,409586,Levkoff; Steven B.,88,0,92,4
1708251214282,ECON 4,A02,409587,Levkoff; Steven B.,89,0,90,1
1708251214816,ECON 5,A01,409589,Dai; Yinlin,53,0,58,5
1708251214816,ECON 5,A02,409590,Dai; Yinlin,56,0,58,2
1708251214816,ECON 5,A03,409591,Dai; Yinlin,54,0,54,0
1708251214816,ECON 5,A04,409593,Dai; Yinlin,55,0,55,0
1708251214816,ECON 5,B01,409595,Dai; Yinlin,57,0,58,1
1708251214816,ECON 5,B02,409596,Dai; Yinlin,49,0,49,0
1708251214816,ECON 5,B03,409597,Dai; Yinlin,59,0,59,0
1708251214816,ECON 5,B04,409598,Dai; Yinlin,55,0,55,0
1708251214816,ECON 5,C01,487209,Staff,40,0,45,5
1708251215351,ECON 100A,A01,409600,Famulari; Melissa,94,0,100,6
1708251215351,ECON 100A,A02,409601,Famulari; Melissa,98,0,100,2
1708251215351,ECON 100A,A03,409604,Famulari; Melissa,98,0,100,2
1708251215351,ECON 100A,B01,409610,Famulari; Melissa,76,0,80,4
1708251215876,ECON 100AH,A00,409612,Famulari; Melissa,19,0,20,1
1708251216409,ECON 100B,A01,409614,Grigoryan; Aram,109,0,120,11
1708251216409,ECON 100B,A02,409616,Grigoryan; Aram,117,0,120,3
1708251216409,ECON 100B,B01,409626,Grigoryan; Aram,47,0,50,3
1708251216409,ECON 100B,B02,409627,Grigoryan; Aram,49,0,50,1
1708251216935,ECON 100C,A01,409629,Levkoff; Steven B.,144,0,146,2
1708251216935,ECON 100C,B01,409632,Levkoff; Steven B.,143,0,146,3
1708251217465,ECON 106,A00,409633,Bowen; T. Renee,90,0,90,0
1708251217990,ECON 109T,A00,409634,Trevino; Isabel,18,0,20,2
1708251218515,ECON 110A,A01,409637,Staff,68,0,75,7
1708251219041,ECON 110B,A01,409663,Herreno Lopera; Juan,119,0,125,6
1708251219041,ECON 110B,A02,409682,Herreno Lopera; Juan,125,0,125,0
1708251219041,ECON 110B,B01,409734,Herreno Lopera; Juan,99,0,100,1
1708251219570,ECON 120A,A01,409739,Candido; Maria Teresa,84,0,90,6
1708251219570,ECON 120A,A02,409740,Candido; Maria Teresa,87,0,90,3
1708251219570,ECON 120A,B01,409742,Candido; Maria Teresa,85,0,90,5
1708251219570,ECON 120A,B02,409743,Candido; Maria Teresa,90,0,90,0
1708251220099,ECON 120B,A01,409748,Ma; Xinwei,128,0,130,2
1708251220099,ECON 120B,A02,409754,Ma; Xinwei,128,0,130,2
1708251220099,ECON 120B,B01,409756,Ma; Xinwei,25,0,40,15
1708251220643,ECON 120C,A01,409758,Sun; Yixiao,141,0,146,5
1708251220643,ECON 120C,B01,409762,Sun; Yixiao,144,0,146,2
1708251221170,ECON 129,A00,409763,Eckert; Fabian Paul,44,0,50,6
1708251221696,ECON 134,A00,409764,Gelber; Alexander Michael,45,0,50,5
1708251221696,ECON 134,B00,409765,Gelber; Alexander Michael,49,0,50,1
1708251222225,ECON 137,A00,409766,Niehaus; Paul,19,0,20,1
1708251222757,ECON 142,A00,409767,Trevino; Isabel,39,0,40,1
1708251222757,ECON 142,B00,409768,Trevino; Isabel,38,0,40,2
1708251223288,ECON 164,A00,409771,Muralidharan; Karthik,118,0,120,2
1708251223816,ECON 172A,A01,409773,Newhouse; Herbert S,67,0,75,8
1708251224342,ECON 172B,A01,409775,Newhouse; Herbert S,74,0,75,1
1708251224342,ECON 172B,B01,409777,Newhouse; Herbert S,71,0,75,4
1708251225401,ECON 191A,A00,409780,Cullen; Julie,20,0,20,0
1708251225929,ECON 200C,A00,409782,Du; Songzi,34,0,35,1
1708251226459,ECON 210C,A00,409784,Herreno Lopera; Juan & Wieland; Johannes Friedrich,35,0,35,0
1708251226986,ECON 220C,A00,409785,Sun; Yixiao,35,0,35,0
1708251227518,ECON 220F,A00,409786,Carson; Richard T,27,0,30,3
1708251228048,ECON 221,A00,409787,Zhu; Ying,25,0,25,0
1708251228575,ECON 241,A00,409788,Muralidharan; Karthik,18,0,20,2
1708251229102,ECON 243,A00,409789,Niehaus; Paul,18,0,20,2
1708251229627,ECON 248,A00,409790,Eckert; Fabian Paul,18,0,20,2
1708251230157,ECON 250C,A00,409791,Arnold; David Hall & Betts; Julian,25,0,25,0
1708251230682,ECON 268,A00,409792,Jacobsen; Mark,24,0,25,1
1708251231209,ECON 281,A00,409793,Meckel; Katherine Hunter,19,0,20,1
1708251231209,ECON 281,B00,409794,Herreno Lopera; Juan & Wieland; Johannes Friedrich,19,0,20,1
1708251231209,ECON 281,C00,477854,Herreno Lopera; Juan & Wieland; Johannes Friedrich,18,0,20,2
1708251231738,ECON 285,A00,409795,Eckert; Fabian Paul,20,0,20,0
1708251232266,ECON 286,A00,409796,Ma; Xinwei,15,0,15,0
1708251232266,ECON 286,B00,409797,Hamilton; James D.,15,0,15,0
1708251232266,ECON 286,C00,409798,Grigoryan; Aram,15,0,15,0
1708251232266,ECON 286,D00,409799,Niehaus; Paul,15,0,15,0
1708251232795,ECON 296,A00,409800,Eckert; Fabian Paul,20,0,20,0
1708251233326,EDS 31,A00,409801,Bussey; Thomas J,9,0,10,1
1708251233857,EDS 38,A01,409803,Chung; Luz Marina,25,0,25,0
1708251234385,EDS 39,A01,409805,Heinzman; Erica M.,24,0,25,1
1708251234912,EDS 102,A01,409807,Ambo; Theresa Jean,37,0,45,8
1708251235441,EDS 110R,A01,409809,Staff,42,0,50,8
1708251235441,EDS 110R,B01,481358,Staff,20,0,20,0
1708251235966,EDS 111,A00,479044,Wishard Guerra; Alison G.,56,0,60,4
1708251236493,EDS 117,A01,409818,Jones; Gabrielle Anastasia,21,0,23,2
1708251236493,EDS 117,A02,409819,Jones; Gabrielle Anastasia,23,0,23,0
1708251236493,EDS 117,A03,409820,Jones; Gabrielle Anastasia,22,0,23,1
1708251236493,EDS 117,A04,409821,Jones; Gabrielle Anastasia,21,0,21,0
1708251237018,EDS 118,A00,409828,Warstadt; Melissa Fawn,46,0,50,4
1708251237550,EDS 123,A00,409831,Bussey; Thomas J,10,0,10,0
1708251238076,EDS 124AR,A00,419352,Simon; Elizabeth A,82,0,100,18
1708251238076,EDS 124AR,B00,419377,Simon; Elizabeth A,97,0,100,3
1708251238076,EDS 124AR,C00,481485,Simon; Elizabeth A,25,0,25,0
1708251238076,EDS 124AR,D00,481490,Simon; Elizabeth A,25,0,25,0
1708251238607,EDS 124BR,A00,409838,Eguchi; Emi,52,0,75,23
1708251238607,EDS 124BR,B00,481363,Eguchi; Emi,25,0,25,0
1708251239134,EDS 125,A00,409839,Aragon; Maria Jose,48,0,50,2
1708251239660,EDS 126,A01,409843,Jones; Makeba,19,0,25,6
1708251239660,EDS 126,A02,409844,Jones; Makeba,25,0,25,0
1708251239660,EDS 126,A03,409846,Jones; Makeba,25,0,25,0
1708251239660,EDS 126,A04,409847,Jones; Makeba,25,0,25,0
1708251240184,EDS 128B,A01,409851,Pappas; Elizabeth,49,0,50,1
1708251240712,EDS 129C,A01,409906,Millstone; Rachel Diana,44,0,50,6
1708251241238,EDS 130,A01,409954,Mendez; Kathrina Mendoza,14,0,15,1
1708251241238,EDS 130,A02,409955,Mendez; Kathrina Mendoza,24,0,25,1
1708251241238,EDS 130,A03,409956,Mendez; Kathrina Mendoza,20,0,20,0
1708251241767,EDS 133,A01,409961,Bintliff; Amy S.V.,15,0,20,5
1708251241767,EDS 133,A02,409962,Bintliff; Amy S.V.,20,0,20,0
1708251241767,EDS 133,A03,489636,Bintliff; Amy S.V.,15,0,15,0
1708251242295,EDS 136,A01,409964,Chung; Luz Marina,30,0,30,0
1708251242295,EDS 136,A02,409977,Chung; Luz Marina,30,0,30,0
1708251242822,EDS 139,A00,479197,Millstone; Rachel Diana,42,0,50,8
1708251242822,EDS 139,B00,479198,Pappas; Elizabeth,49,0,50,1
1708251242822,EDS 139,C00,479199,Mendez; Kathrina Mendoza,58,0,60,2
1708251242822,EDS 139,D00,479200,Bintliff; Amy S.V.,56,0,60,4
1708251242822,EDS 139,E00,479201,Chung; Luz Marina,59,0,60,1
1708251242822,EDS 139,F00,479202,Bintliff; Amy S.V.,15,0,15,0
1708251242822,EDS 139,G00,479203,Mamas; Christoforos,27,0,30,3
1708251242822,EDS 139,H00,493997,Choi; Bailey Miyeon,28,0,30,2
1708251243352,EDS 141,A00,409979,Mamas; Christoforos,38,0,40,2
1708251243879,EDS 145,A01,409989,Choi; Bailey Miyeon,13,0,15,2
1708251243879,EDS 145,A02,409990,Choi; Bailey Miyeon,15,0,15,0
1708251244406,EDS 180,A00,409991,Chapman; Thandeka K,30,0,30,0
1708251244406,EDS 180,B00,409992,Ambo; Theresa Jean,24,0,25,1
1708251244406,EDS 180,C00,409993,Jones; Gabrielle Anastasia,20,0,20,0
1708251244406,EDS 180,D00,409994,Phuong; Andrew,24,0,24,0
1708251244932,EDS 198,001,487216,Eguchi; Emi,20,0,20,0
1708251245461,EDS 205B,A00,409995,Staff,40,0,45,5
1708251245461,EDS 205B,B00,409997,Staff,42,0,45,3
1708251245989,EDS 232,A00,409999,Hopkins; Megan Beth,9,0,12,3
1708251246514,EDS 255,A00,410001,Phuong; Andrew,14,0,15,1
1708251247040,EDS 257,A00,410003,Datnow; Amanda Lee,14,0,15,1
1708251247570,EDS 282,A00,479192,Daly; Alan J.,16,0,16,0
1708251248096,EDS 287B,A00,479193,Daly; Alan J.,16,0,16,0
1708251248622,EDS 288A,A00,410005,Staff,18,0,18,0
1708251249148,EDS 288C,A00,410007,Staff,18,0,18,0
1708251249677,EDS 289B,A01,410009,Daly; Alan J.,18,0,18,0
1708251250203,EDS 290,A00,410010,Black; Alison Michelle,30,0,30,0
1708251250203,EDS 290,B00,410012,Choi; Bailey Miyeon,29,0,30,1
1708251250203,EDS 290,C00,479205,Heinzman; Erica M.,0,0,0,0
1708251250729,EDS 291B,A01,479195,Daly; Alan J.,16,0,16,0
1708251251255,EDS 293B,A01,410016,Staff,18,0,18,0
1708251251783,EDS 294B,A00,479196,Burrell; Sade Renee,16,0,16,0
1708251252324,EDS 296,001,478927,Ambo; Theresa Jean,0,0,0,0
1708251252324,EDS 296,002,478935,Aragon; Maria Jose,0,0,0,1
1708251252324,EDS 296,003,478936,Chapman; Thandeka K,0,0,0,0
1708251252324,EDS 296,004,478942,Bintliff; Amy S.V.,0,0,0,0
1708251252324,EDS 296,005,478943,Clarke; Sherice Nicole,0,0,0,0
1708251252324,EDS 296,006,478967,Cohen; Shana R,0,0,0,1
1708251252324,EDS 296,007,478968,Datnow; Amanda Lee,0,0,0,0
1708251252324,EDS 296,008,478969,Daly; Alan J.,0,0,0,0
1708251252324,EDS 296,009,478970,Eguchi; Emi,0,0,0,0
1708251252324,EDS 296,010,478971,Fine; Sarah,0,0,0,0
1708251252324,EDS 296,011,478972,Jones; Gabrielle Anastasia,0,0,0,0
1708251252324,EDS 296,012,479020,Jones; Makeba,0,0,0,0
1708251252324,EDS 296,013,479021,Halter; Christopher P.,0,0,0,0
1708251252324,EDS 296,014,479027,Hofstetter; Carolyn,0,0,0,0
1708251252324,EDS 296,015,479028,Hopkins; Megan Beth,0,0,0,0
1708251252324,EDS 296,016,479034,Mamas; Christoforos,0,0,0,0
1708251252324,EDS 296,017,479035,Pollock; Mica,0,0,0,0
1708251252324,EDS 296,018,479036,Wishard Guerra; Alison G.,0,0,0,0
1708251252324,EDS 296,019,494549,Phuong; Andrew,0,0,0,0
1708251252851,EMED 296,001,464428,Singh; Sukhdeep,49,0,50,1
1708251252851,EMED 296,002,464438,Subramony; Rachna,49,0,50,1
1708251252851,EMED 296,003,464490,Staff,50,0,50,0
1708251253378,ENG 10,A00,399006,Evdokimenko; Ekaterina,30,0,30,0
1708251253905,ENG 100D,A00,399084,Ngo; Anh-Thu T.,33,0,50,17
1708251254431,ENG 100DR,A00,479230,Ngo; Anh-Thu T.,29,0,40,11
1708251254965,ENG 100L,A00,399163,Kleissl; Jan,6,0,6,0
1708251254965,ENG 100L,B00,399217,Bratton; Maryann,8,0,8,0
1708251254965,ENG 100L,C00,399218,Yu; Paul K L,8,0,8,0
1708251254965,ENG 100L,D00,399257,Bratton; Maryann,6,0,6,0
1708251254965,ENG 100L,E00,399258,de Oliveira; Mauricio,9,0,10,1
1708251254965,ENG 100L,F00,399314,Bratton; Maryann,7,0,7,0
1708251254965,ENG 100L,G00,399394,Boyle; Mary E. T.,14,0,15,1
1708251255494,ENVR 102,A00,400777,Daly; Heather Marie,19,0,20,1
1708251255494,ENVR 102,B00,400778,Montejo; Carolina,24,0,25,1
1708251255494,ENVR 102,C00,400791,Staff,23,0,25,2
1708251256020,ENVR 140,A01,400813,Siapno; Jacqueline A,12,0,15,3
1708251256020,ENVR 140,A02,400870,Siapno; Jacqueline A,15,0,15,0
1708251256020,ENVR 140,A03,400889,Siapno; Jacqueline A,15,0,15,0
1708251256020,ENVR 140,A04,400890,Siapno; Jacqueline A,15,0,15,0
1708251256546,ENVR 144,A01,400929,Herbst; Matthew,20,0,20,0
1708251257071,ERC 20,A00,400722,Evans; Ivan T,30,0,30,0
1708251257598,ESYS 103,A01,400931,Lerner; Amy M,32,0,34,2
1708251257598,ESYS 103,A02,400934,Lerner; Amy M,34,0,34,0
1708251257598,ESYS 103,A03,400938,Lerner; Amy M,28,0,34,6
1708251257598,ESYS 103,A04,400939,Lerner; Amy M,33,0,34,1
1708251257598,ESYS 103,A05,400940,Lerner; Amy M,34,0,34,0
1708251257598,ESYS 103,A06,400941,Lerner; Amy M,33,0,34,1
1708251258128,ESYS 187C,A01,400945,Hetherington; Elizabeth Dorsey,28,0,40,12
1708251258128,ESYS 187C,A02,400946,Hetherington; Elizabeth Dorsey,39,0,40,1
1708251258660,ETHN 3R,A01,400948,Streeby; Shelley,21,0,25,4
1708251258660,ETHN 3R,A02,401220,Streeby; Shelley,24,0,25,1
1708251258660,ETHN 3R,A03,401231,Streeby; Shelley,22,0,25,3
1708251258660,ETHN 3R,A04,401236,Streeby; Shelley,23,0,25,2
1708251258660,ETHN 3R,A05,401241,Streeby; Shelley,21,0,25,4
1708251258660,ETHN 3R,A06,401311,Streeby; Shelley,21,0,25,4
1708251258660,ETHN 3R,A07,401318,Streeby; Shelley,25,0,25,0
1708251258660,ETHN 3R,A08,401319,Streeby; Shelley,25,0,25,0
1708251258660,ETHN 3R,A09,401397,Streeby; Shelley,25,0,25,0
1708251258660,ETHN 3R,A10,401398,Streeby; Shelley,25,0,25,0
1708251258660,ETHN 3R,A11,401399,Streeby; Shelley,24,0,25,1
1708251258660,ETHN 3R,A12,401518,Streeby; Shelley,25,0,25,0
1708251258660,ETHN 3R,A13,401551,Streeby; Shelley,24,0,25,1
1708251258660,ETHN 3R,A14,401552,Streeby; Shelley,23,0,25,2
1708251259186,ETHN 30,A01,401554,Fuste; Jose Ignacio,24,0,25,1
1708251259186,ETHN 30,A02,401555,Fuste; Jose Ignacio,25,0,25,0
1708251259186,ETHN 30,A03,401556,Fuste; Jose Ignacio,25,0,25,0
1708251259186,ETHN 30,A04,401557,Fuste; Jose Ignacio,25,0,25,0
1708251259712,ETHN 100C,A00,401558,Museus; Samuel David,36,0,40,4
1708251260242,ETHN 101TV,A01,401560,Marez; Curtis F.,21,0,25,4
1708251260242,ETHN 101TV,A02,401564,Marez; Curtis F.,25,0,25,0
1708251260767,ETHN 108,A00,401584,Hankins; Sarah E.,25,0,29,4
1708251261293,ETHN 113A,A00,401657,Werner; Bradley T.,15,0,15,0
1708251261820,ETHN 114B,A00,401724,Frank; Ross H.,19,0,20,1
1708251262350,ETHN 120D,A01,401848,Alvarez; Luis A,8,0,10,2
1708251262350,ETHN 120D,A02,401853,Alvarez; Luis A,10,0,10,0
1708251262876,ETHN 125R,A00,401858,Sasaki; Christen T,39,0,50,11
1708251263408,ETHN 126,A00,401865,Tran; Ly Thi Hai,39,0,40,1
1708251263934,ETHN 127,A00,401866,Martin Sandino; Amanda Maria Yoland,24,0,25,1
1708251264460,ETHN 137,A00,401867,Martin Sandino; Amanda Maria Yoland,19,0,19,0
1708251264990,ETHN 139,A00,401992,Perreira; Christopher Michael,25,0,25,0
1708251265518,ETHN 143,A00,402059,Marez; Curtis F.,39,0,40,1
1708251266046,ETHN 144M,A00,402060,Jolivette; Andrew J,62,0,65,3
1708251266628,ETHN 150,A00,402158,Taylor-Garcia; Daphne,16,0,18,2
1708251267152,ETHN 153,A00,402160,Martinez-Matsuda; Veronica,24,0,25,1
1708251267678,ETHN 179,A00,402165,Richards; Stephanie F,23,0,25,2
1708251268208,ETHN 183,A00,402217,Steelman; Katherine Wallis,16,0,16,0
1708251268735,ETHN 186,A00,402313,Perez; Roy,15,0,15,0
1708251269267,ETHN 189,A00,479226,Museus; Samuel David,29,0,30,1
1708251269794,ETHN 196H,A00,402314,Espiritu; Yen,0,0,0,0
1708251269794,ETHN 196H,B00,402325,Perreira; Christopher Michael,0,0,0,0
1708251269794,ETHN 196H,C00,402344,Perez; Roy,0,0,0,0
1708251269794,ETHN 196H,D00,402345,Streeby; Shelley,0,0,0,0
1708251269794,ETHN 196H,E00,402346,Taylor-Garcia; Daphne,0,0,0,0
1708251270319,ETHN 200C,A00,402358,Fuste; Jose Ignacio,19,0,20,1
1708251270845,ETHN 230,A00,402359,Streeby; Shelley,16,0,20,4
1708251271372,ETHN 291,A00,402363,Perreira; Christopher Michael,16,0,20,4
1708251271900,EXPR 100,A00,477778,Staff,9999,0,9999,0
1708251272426,EXPR 105,A00,477779,Staff,9999,0,9999,0
1708251272953,EXPR 201,A00,477780,Staff,9999,0,9999,0
1708251273483,EXPR 205,A00,477781,Staff,9999,0,9999,0
1708251274014,FILM 87,A00,402794,Rahimi; Babak,19,0,20,1
1708251274014,FILM 87,B00,402796,Rahimi; Babak,20,0,20,0
1708251274014,FILM 87,C00,402821,Havis; Allan,19,0,20,1
1708251274541,FMPH 95,A00,481734,Larsen; Britta Ann,0,0,0,2
1708251275067,FMPH 101,A00,404648,Tan; Gene Brian,31,0,40,9
1708251275597,FMPH 102,A01,404692,Rana; Brinda Kanti,25,0,28,3
1708251275597,FMPH 102,A02,404714,Rana; Brinda Kanti,28,0,28,0
1708251275597,FMPH 102,B01,404739,Rana; Brinda Kanti,26,0,28,2
1708251275597,FMPH 102,B02,404746,Rana; Brinda Kanti,28,0,28,0
1708251276123,FMPH 110,A00,404747,Campbell; Chadwick Karl,52,0,55,3
1708251276123,FMPH 110,B00,404789,Zoumas-Morse; Christine E.,24,0,30,6
1708251276650,FMPH 120,A00,404792,Nguyen-Grozavu; France T.,48,0,60,12
1708251277183,FMPH 130,A00,404859,Gould; Carlos Francisco,49,0,55,6
1708251277183,FMPH 130,B00,479047,Ciborowski; Haley Minae,52,0,55,3
1708251277708,FMPH 155,A00,404864,Fielding-Miller; Rebecca,65,0,65,0
1708251278233,FMPH 161,A00,404865,Zoumas-Morse; Christine E.,27,0,35,8
1708251278761,FMPH 191,A00,404866,Eikey; Elizabeth Victoria,35,0,35,0
1708251279296,FMPH 194,A00,404938,Larsen; Britta Ann,0,0,0,0
1708251279296,FMPH 194,B00,404939,Marquez; Becky,0,0,0,0
1708251279296,FMPH 194,C00,404949,Nguyen-Grozavu; France T.,0,0,0,0
1708251279296,FMPH 194,D00,404950,Stone; Matthew David,0,0,0,0
1708251279296,FMPH 194,E00,404958,White; Anne Elizabeth Clar,0,0,0,0
1708251279296,FMPH 194,F00,404969,Zoumas-Morse; Christine E.,0,0,0,0
1708251279823,FMPH 223,A00,404977,Vaida; Florin,7,0,26,19
1708251280350,FMPH 225,A00,404978,Zou; Jingjing,0,0,0,0
1708251280879,FMPH 291,A00,404992,Salem; Rany Mansour,15,0,15,0
1708251280879,FMPH 291,C00,405005,Schwartzman; Armin,0,0,0,11
1708251280879,FMPH 291,D00,479113,Shadyab; Aladdin Hassan,0,0,0,0
1708251280879,FMPH 291,E00,479114,Shadyab; Aladdin Hassan,0,0,0,0
1708251280879,FMPH 291,F00,479115,Wynn; Adriane Michelle,0,0,0,3
1708251280879,FMPH 291,G00,479116,Xu; Ronghui,0,0,0,10
1708251280879,FMPH 291,H00,479119,Vaida; Florin,0,0,0,2
1708251281409,FPM 258C,A00,405129,Chen; Brian Hwa-Yang,11,0,15,4
1708251281936,FPM 259C,A00,405130,Nguyen; Annie Lu & Araneta; Maria Rosario Gorrez,4,0,5,1
1708251282466,FPM 278,A00,405131,Strong; David R,13,0,15,2
1708251282992,FPM 280C,A01,405133,Banegas; Matthew Patrick,10,0,10,0
1708251283519,FPM 296,001,464651,Johnson; Michelle Lee,49,0,50,1
1708251283519,FPM 296,002,464652,Staff,50,0,50,0
1708251283519,FPM 296,003,464653,Staff,50,0,50,0
1708251284045,FPM 297,001,479175,Vaida; Florin,9999,0,9999,0
1708251284045,FPM 297,002,494007,Strong; David R,9999,0,9999,0
1708251284045,FPM 297,003,494364,Bazzi; Angela Robertson,9999,0,9999,0
1708251284571,GLBH 20,A00,405134,Elwardani; Nile Regina,143,0,146,3
1708251285099,GLBH 100,A00,405135,Bhavsar; Radhika,68,0,70,2
1708251285099,GLBH 100,B00,477773,Villarino; Margarita,39,0,44,5
1708251285099,GLBH 100,C00,477855,Jenkins; Janis A.,20,0,20,0
1708251285099,GLBH 100,D00,481337,Mishra; Jyoti,40,0,40,0
1708251285625,GLBH 101,A00,405136,Sloane; Julia Kathryn,40,0,40,0
1708251286154,GLBH 107,A00,405137,Wilson; Brenda K,63,0,70,7
1708251286691,GLBH 111,A01,486865,Burgos; Jose L.,0,0,0,0
1708251286691,GLBH 111,B01,486867,Burgos; Jose L.,0,0,0,0
1708251287217,GLBH 114W,A00,405138,Walkover; Lillian B,17,0,17,0
1708251287745,GLBH 118,A00,405140,Wilson; Brenda K,31,0,32,1
1708251288271,GLBH 147,A00,405141,Stewart; Alexander B,40,0,40,0
1708251288800,GLBH 148,A00,405142,Olivas Hernandez; Olga Lid,93,0,100,7
1708251289327,GLBH 150B,A00,486855,Sanchez; Giselle,0,0,0,0
1708251289857,GLBH 181,A00,405154,Burgos; Jose L.,211,0,216,5
1708251290384,GLBH 215,A00,479241,Walkover; Lillian B,18,0,18,0
1708251290911,GLBH 260,A00,480722,Elwardani; Nile Regina,18,0,18,0
1708251291435,GSS 20,A00,405155,Siapno; Jacqueline A,25,0,30,5
1708251291961,GSS 25,A00,405156,Batarseh; Amanda Alicia,24,0,30,6
1708251292494,HDS 1,A01,405160,Reese; Clarissa Jane,25,0,25,0
1708251292494,HDS 1,A02,405168,Reese; Clarissa Jane,25,0,25,0
1708251292494,HDS 1,A03,405169,Reese; Clarissa Jane,22,0,25,3
1708251292494,HDS 1,A04,405170,Reese; Clarissa Jane,24,0,25,1
1708251292494,HDS 1,A05,405171,Reese; Clarissa Jane,23,0,25,2
1708251292494,HDS 1,A06,405172,Reese; Clarissa Jane,24,0,25,1
1708251292494,HDS 1,A07,405173,Reese; Clarissa Jane,24,0,25,1
1708251293023,HDS 60,A01,405175,Warstadt; Melissa Fawn,34,0,35,1
1708251293023,HDS 60,A02,405176,Warstadt; Melissa Fawn,33,0,35,2
1708251293550,HDS 95,A00,405177,Staff,38,0,40,2
1708251294076,HDS 120,A00,405178,Staff,0,0,0,0
1708251294607,HDS 122,A00,405179,Rodriguez; Victoria Calip,64,0,75,11
1708251295136,HDS 150,A00,405180,Staff,20,0,20,0
1708251295136,HDS 150,B00,405181,Staff,20,0,20,0
1708251295136,HDS 150,C00,405182,Staff,20,0,20,0
1708251295662,HDS 181,A01,405185,Bjorklund; Peter,30,0,30,0
1708251296192,HDS 191,A01,405187,Reese; Clarissa Jane,40,0,40,0
1708251296192,HDS 191,B01,405194,Staff,25,0,25,0
1708251296720,HIAF 113,A00,403736,Prestholdt; Jeremy,74,0,75,1
1708251297243,HIAF 114,A00,403738,Gyamfi; Bright,49,0,50,1
1708251297770,HIEA 132,A00,403740,Kletzer; Benjamin Nathan,25,0,30,5
1708251298300,HIEA 154,A00,403741,Henry; Todd A.,62,0,64,2
1708251298827,HIEU 139,A00,403742,Strasser; Ulrike,52,0,56,4
1708251299357,HIEU 171,A00,403743,Hansen; Jan Eric,62,0,64,2
1708251299883,HIEU 176,A00,403744,Hertz; Deborah,14,0,15,1
1708251300414,HIEU 183,A00,403800,Gallant; Thomas W.,15,0,15,0
1708251300942,HIEU 276,A00,403862,Hertz; Deborah,0,0,0,0
1708251301471,HIGL 127,A00,403802,Ivey; James Alexander,56,0,56,0
1708251301998,HIGR 201,A00,494372,Pineda De Avila; Nydia,9,0,10,1
1708251302523,HIGR 205,A00,403863,Strasser; Ulrike,11,0,15,4
1708251303053,HIGR 217C,A00,403864,Lu; Weijing,9,0,10,1
1708251303579,HIGR 239,A00,403865,Serlin; David,4,0,5,1
1708251304106,HIGR 240,A00,403875,Gates; Kelly,2,0,5,3
1708251304637,HILA 101,A00,403818,LeNeave; Kimiko Nicole,62,0,64,2
1708251305169,HILA 119,A00,403819,Kozameh; Sara J,47,0,50,3
1708251305695,HILA 144,A00,403821,Kozameh; Sara J,50,0,50,0
1708251306220,HILD 2C,A01,402843,Hendrickson; Gerald M.,31,0,32,1
1708251306220,HILD 2C,A02,403030,Hendrickson; Gerald M.,31,0,32,1
1708251306220,HILD 2C,A03,403042,Hendrickson; Gerald M.,32,0,32,0
1708251306220,HILD 2C,A04,403048,Hendrickson; Gerald M.,30,0,32,2
1708251306220,HILD 2C,A05,403049,Hendrickson; Gerald M.,32,0,32,0
1708251306220,HILD 2C,A06,403098,Hendrickson; Gerald M.,32,0,32,0
1708251306746,HILD 7C,A01,403501,Bermudez; Rosie Cano,27,0,32,5
1708251306746,HILD 7C,A02,403513,Bermudez; Rosie Cano,30,0,32,2
1708251306746,HILD 7C,A03,403570,Bermudez; Rosie Cano,32,0,32,0
1708251306746,HILD 7C,A04,403572,Bermudez; Rosie Cano,32,0,32,0
1708251306746,HILD 7C,A05,403587,Bermudez; Rosie Cano,32,0,32,0
1708251306746,HILD 7C,A06,403588,Bermudez; Rosie Cano,32,0,32,0
1708251306746,HILD 7C,A07,403589,Bermudez; Rosie Cano,29,0,32,3
1708251306746,HILD 7C,A08,403590,Bermudez; Rosie Cano,32,0,32,0
1708251306746,HILD 7C,A09,403601,Bermudez; Rosie Cano,30,0,32,2
1708251306746,HILD 7C,A10,403602,Bermudez; Rosie Cano,32,0,32,0
1708251306746,HILD 7C,A11,403603,Bermudez; Rosie Cano,32,0,32,0
1708251306746,HILD 7C,A12,403604,Bermudez; Rosie Cano,32,0,32,0
1708251307274,HILD 12,A01,403607,Henry; Todd A.,32,0,32,0
1708251307274,HILD 12,A02,403608,Henry; Todd A.,31,0,32,1
1708251307274,HILD 12,A03,403609,Henry; Todd A.,32,0,32,0
1708251307274,HILD 12,A04,403699,Henry; Todd A.,32,0,32,0
1708251307274,HILD 12,A05,403700,Henry; Todd A.,32,0,32,0
1708251307274,HILD 12,A06,403701,Henry; Todd A.,32,0,32,0
1708251307800,HILD 30,A01,403703,Soleiman; Matthew Teymour,29,0,32,3
1708251307800,HILD 30,A02,403704,Soleiman; Matthew Teymour,30,0,32,2
1708251308328,HINE 118,A00,403822,Kayali; Hasan,50,0,50,0
1708251308856,HISC 119,A00,403823,Golan; Tal,26,0,30,4
1708251309383,HISC 123,A00,403839,Pineda De Avila; Nydia,45,0,50,5
1708251309915,HITO 87,A00,403707,Patterson; Patrick H.,15,0,15,0
1708251309915,HITO 87,B00,403709,Patterson; Patrick H.,15,0,15,0
1708251309915,HITO 87,C00,403735,Schneewind; Sarah,15,0,15,0
1708251310441,HITO 100,B00,403841,Klann; Mary Cameron,24,0,25,1
1708251310969,HITO 170,A00,403842,Watts; Edward J.,8,0,10,2
1708251311494,HITO 193,A00,455333,Hill; Seth J,0,0,0,0
1708251312020,HIUS 114A,A00,403843,Lewandoski; Julia Mavis,52,0,56,4
1708251312552,HIUS 120D,A01,403854,Alvarez; Luis A,8,0,10,2
1708251312552,HIUS 120D,A02,403855,Alvarez; Luis A,10,0,10,0
1708251313079,HIUS 136,A00,403857,Martinez-Matsuda; Veronica,21,0,25,4
1708251313612,HIUS 144,A00,403858,Martinez-Matsuda; Veronica,55,0,56,1
1708251313612,HIUS 144,B00,403859,Vandevelde; Kenneth Joseph,54,0,56,2
1708251313612,HIUS 144,C00,403860,Klann; Mary Cameron,52,0,56,4
1708251313612,HIUS 144,D00,403861,Lewandoski; Julia Mavis,55,0,56,1
1708251314162,HUM 2,A01,422723,Watts; Edward J.,16,0,16,0
1708251314162,HUM 2,A02,422735,Watts; Edward J.,15,0,16,1
1708251314162,HUM 2,A03,422736,Watts; Edward J.,15,0,16,1
1708251314162,HUM 2,A04,422737,Watts; Edward J.,16,0,16,0
1708251314162,HUM 2,A05,422738,Watts; Edward J.,15,0,16,1
1708251314162,HUM 2,A06,422760,Watts; Edward J.,15,0,16,1
1708251314162,HUM 2,A07,422778,Watts; Edward J.,16,0,16,0
1708251314162,HUM 2,A08,422793,Watts; Edward J.,16,0,16,0
1708251314162,HUM 2,A09,422794,Watts; Edward J.,16,0,16,0
1708251314162,HUM 2,A10,422795,Watts; Edward J.,16,0,16,0
1708251314162,HUM 2,B01,422805,Markman; Kristina,13,0,16,3
1708251314162,HUM 2,B02,422806,Markman; Kristina,14,0,16,2
1708251314162,HUM 2,B03,422807,Markman; Kristina,14,0,16,2
1708251314162,HUM 2,B04,422808,Markman; Kristina,16,0,16,0
1708251314162,HUM 2,B05,422809,Markman; Kristina,16,0,16,0
1708251314162,HUM 2,B06,422842,Markman; Kristina,16,0,16,0
1708251314162,HUM 2,B07,422843,Markman; Kristina,15,0,16,1
1708251314162,HUM 2,B08,422848,Markman; Kristina,16,0,16,0
1708251314162,HUM 2,B09,422850,Markman; Kristina,15,0,16,1
1708251314162,HUM 2,B10,422851,Markman; Kristina,12,0,16,4
1708251314162,HUM 2,B11,422852,Markman; Kristina,15,0,16,1
1708251314162,HUM 2,B12,422853,Markman; Kristina,16,0,16,0
1708251314162,HUM 2,C01,422855,Rodriguez; Bretton Sigfred,15,0,16,1
1708251314162,HUM 2,C02,422856,Rodriguez; Bretton Sigfred,16,0,16,0
1708251314162,HUM 2,C03,422859,Rodriguez; Bretton Sigfred,15,0,16,1
1708251314162,HUM 2,C04,423106,Rodriguez; Bretton Sigfred,12,0,16,4
1708251314162,HUM 2,C05,423107,Rodriguez; Bretton Sigfred,15,0,16,1
1708251314162,HUM 2,C06,423108,Rodriguez; Bretton Sigfred,14,0,16,2
1708251314162,HUM 2,C07,423109,Rodriguez; Bretton Sigfred,15,0,16,1
1708251314162,HUM 2,C08,423110,Rodriguez; Bretton Sigfred,15,0,16,1
1708251314162,HUM 2,C09,423133,Rodriguez; Bretton Sigfred,14,0,16,2
1708251314162,HUM 2,C10,423134,Rodriguez; Bretton Sigfred,14,0,16,2
1708251314162,HUM 2,C11,423135,Rodriguez; Bretton Sigfred,16,0,16,0
1708251314162,HUM 2,C12,423136,Rodriguez; Bretton Sigfred,15,0,16,1
1708251314162,HUM 2,C13,423137,Rodriguez; Bretton Sigfred,16,0,16,0
1708251314162,HUM 2,C14,423138,Rodriguez; Bretton Sigfred,16,0,16,0
1708251314162,HUM 2,D01,423140,West; Geoffrey Scott,13,0,16,3
1708251314162,HUM 2,D02,423141,West; Geoffrey Scott,15,0,16,1
1708251314162,HUM 2,D03,423142,West; Geoffrey Scott,15,0,16,1
1708251314162,HUM 2,D04,423143,West; Geoffrey Scott,14,0,16,2
1708251314162,HUM 2,D05,423144,West; Geoffrey Scott,16,0,16,0
1708251314162,HUM 2,D06,423145,West; Geoffrey Scott,16,0,16,0
1708251314162,HUM 2,D07,423146,West; Geoffrey Scott,16,0,16,0
1708251314162,HUM 2,D08,423158,West; Geoffrey Scott,16,0,16,0
1708251314162,HUM 2,D09,423169,West; Geoffrey Scott,16,0,16,0
1708251314162,HUM 2,D10,423174,West; Geoffrey Scott,16,0,16,0
1708251314162,HUM 2,D11,423175,West; Geoffrey Scott,16,0,16,0
1708251314162,HUM 2,D12,423179,West; Geoffrey Scott,15,0,16,1
1708251314162,HUM 2,D13,423188,West; Geoffrey Scott,15,0,16,1
1708251314162,HUM 2,D14,423204,West; Geoffrey Scott,16,0,16,0
1708251314691,HUM 5,A01,423221,Lyon; Antony J.,26,0,30,4
1708251314691,HUM 5,A02,423232,Lyon; Antony J.,24,0,30,6
1708251314691,HUM 5,A03,423237,Lyon; Antony J.,18,0,30,12
1708251314691,HUM 5,A04,423240,Lyon; Antony J.,25,0,30,5
1708251314691,HUM 5,A05,423242,Lyon; Antony J.,28,0,30,2
1708251314691,HUM 5,A06,423244,Lyon; Antony J.,23,0,30,7
1708251314691,HUM 5,A07,423247,Lyon; Antony J.,27,0,30,3
1708251314691,HUM 5,A08,423254,Lyon; Antony J.,27,0,30,3
1708251314691,HUM 5,B01,423286,Patterson; Patrick H.,28,0,30,2
1708251314691,HUM 5,B02,423291,Patterson; Patrick H.,29,0,30,1
1708251314691,HUM 5,B03,423294,Patterson; Patrick H.,28,0,30,2
1708251314691,HUM 5,B04,423297,Patterson; Patrick H.,29,0,30,1
1708251314691,HUM 5,B05,423313,Patterson; Patrick H.,30,0,30,0
1708251314691,HUM 5,B06,423318,Patterson; Patrick H.,30,0,30,0
1708251314691,HUM 5,B07,423362,Patterson; Patrick H.,29,0,30,1
1708251314691,HUM 5,B08,423363,Patterson; Patrick H.,29,0,30,1
1708251314691,HUM 5,C01,423365,Caldwell; Michael Alan,23,0,30,7
1708251314691,HUM 5,C02,423474,Caldwell; Michael Alan,24,0,30,6
1708251314691,HUM 5,C03,423528,Caldwell; Michael Alan,30,0,30,0
1708251314691,HUM 5,C04,423529,Caldwell; Michael Alan,27,0,30,3
1708251314691,HUM 5,C05,423545,Caldwell; Michael Alan,30,0,30,0
1708251314691,HUM 5,C06,423546,Caldwell; Michael Alan,30,0,30,0
1708251314691,HUM 5,C07,423547,Caldwell; Michael Alan,29,0,30,1
1708251314691,HUM 5,C08,423548,Caldwell; Michael Alan,28,0,30,2
1708251315218,INTL 101,A01,404350,Day; Joel Keith,23,0,25,2
1708251315218,INTL 101,A02,404356,Day; Joel Keith,25,0,25,0
1708251315218,INTL 101,A03,404357,Day; Joel Keith,24,0,25,1
1708251315218,INTL 101,A04,404360,Day; Joel Keith,25,0,25,0
1708251315749,INTL 102,A01,404375,Fisk; David Lee,25,0,25,0
1708251315749,INTL 102,A02,404376,Fisk; David Lee,22,0,25,3
1708251315749,INTL 102,A03,404377,Fisk; David Lee,20,0,25,5
1708251315749,INTL 102,A04,404381,Fisk; David Lee,25,0,25,0
1708251316280,INTL 190,A00,404396,Samphantharak; Krislert,24,0,25,1
1708251316280,INTL 190,B00,404402,McIntosh; Justin Daniel,24,0,25,1
1708251316280,INTL 190,C00,404403,Vos; Stacie N.,24,0,25,1
1708251316280,INTL 190,D00,404404,Nadkarni; Vidya,24,0,25,1
1708251316280,INTL 190,E00,404407,Scott; Jeffrey F,25,0,25,0
1708251316280,INTL 190,F00,404409,Auerbach; Bradford C,25,0,25,0
1708251316280,INTL 190,G00,404442,Auerbach; Bradford C,25,0,25,0
1708251316280,INTL 190,H00,404465,Segui; Alan S,25,0,25,0
1708251316280,INTL 190,I00,404481,Segui; Alan S,25,0,25,0
1708251316835,JAPN 10C,A01,403881,Iwamoto; Naoki,15,0,15,0
1708251316835,JAPN 10C,B01,403884,McKee; Mayumi Mochizuki,15,0,15,0
1708251316835,JAPN 10C,C01,403887,Sato; Kyoko,10,0,10,0
1708251316835,JAPN 10C,C02,403888,Sato; Kyoko,10,0,10,0
1708251316835,JAPN 10C,D01,403890,Inada; Minori,8,0,10,2
1708251316835,JAPN 10C,D02,403891,Inada; Minori,10,0,10,0
1708251316835,JAPN 10C,E01,403893,Sato; Kyoko,10,0,10,0
1708251316835,JAPN 10C,E02,403894,Sato; Kyoko,10,0,10,0
1708251316835,JAPN 10C,F01,403896,McKee; Mayumi Mochizuki,10,0,10,0
1708251316835,JAPN 10C,F02,403897,McKee; Mayumi Mochizuki,10,0,10,0
1708251316835,JAPN 10C,G01,403899,Homma; Kunihiko,10,0,10,0
1708251316835,JAPN 10C,G02,403900,Homma; Kunihiko,10,0,10,0
1708251316835,JAPN 10C,H01,403902,Maruyama; Rie,10,0,10,0
1708251316835,JAPN 10C,H02,403903,Maruyama; Rie,9,0,10,1
1708251316835,JAPN 10C,I01,403905,Inada; Minori,10,0,10,0
1708251316835,JAPN 10C,I02,403906,Inada; Minori,9,0,10,1
1708251316835,JAPN 10C,J01,403915,Iwamoto; Naoki,10,0,10,0
1708251316835,JAPN 10C,J02,403916,Iwamoto; Naoki,9,0,10,1
1708251316835,JAPN 10C,K01,403918,Ross; Kayoko F,10,0,10,0
1708251316835,JAPN 10C,K02,403928,Ross; Kayoko F,10,0,10,0
1708251316835,JAPN 10C,L01,403935,Homma; Kunihiko,9,0,10,1
1708251316835,JAPN 10C,L02,403936,Homma; Kunihiko,10,0,10,0
1708251316835,JAPN 10C,M02,403939,Kamioka; Sachiko,13,0,15,2
1708251316835,JAPN 10C,N01,479041,Iwamoto; Naoki,15,0,15,0
1708251317361,JAPN 10CR,A01,403982,Inada; Minori,12,0,12,0
1708251317361,JAPN 10CR,A02,403983,Inada; Minori,12,0,12,0
1708251317890,JAPN 20C,A01,403988,Homma; Kunihiko,10,0,12,2
1708251317890,JAPN 20C,B02,404029,Kamioka; Sachiko,10,0,12,2
1708251317890,JAPN 20C,C01,404033,Takeda; Izumi,8,0,12,4
1708251317890,JAPN 20C,D02,404114,Kamioka; Sachiko,11,0,12,1
1708251317890,JAPN 20C,E01,404135,Simpson; Junko Tokuda,12,0,12,0
1708251318424,JAPN 130C,A01,404144,Maruyama; Rie,9,0,9,0
1708251318424,JAPN 130C,A02,404145,Maruyama; Rie,9,0,9,0
1708251318424,JAPN 130C,B01,404147,Simpson; Junko Tokuda,8,0,9,1
1708251318424,JAPN 130C,B02,404148,Simpson; Junko Tokuda,9,0,9,0
1708251318952,JAPN 135C,A00,404176,Ross; Kayoko F,16,0,16,0
1708251318952,JAPN 135C,B00,404253,Takeda; Izumi,14,0,16,2
1708251319478,JAPN 140C,A00,404255,Sato; Kyoko,18,0,20,2
1708251320078,JAPN 150C,A00,404258,McKee; Mayumi Mochizuki,14,0,14,0
1708251320606,JAPN 190,A00,404260,Miyao; Daisuke,17,0,20,3
1708251321131,JAPN 196B,001,487237,Turner; Christena L.,9999,0,9999,0
1708251321664,JWSP 3,A01,404485,Shuster; Alana,20,0,20,0
1708251322195,LATI 10,A01,405201,Kennemore; Amy Michelle,27,0,30,3
1708251322195,LATI 10,A02,405202,Kennemore; Amy Michelle,27,0,30,3
1708251322195,LATI 10,A03,405208,Kennemore; Amy Michelle,28,0,30,2
1708251322723,LATI 50,A01,405214,Kokinis; Troy Andreas,34,0,35,1
1708251322723,LATI 50,A02,405215,Kokinis; Troy Andreas,34,0,35,1
1708251323249,LATI 130,A01,482880,Alvarez; Camila Huerta,29,0,30,1
1708251323778,LATI 160,A01,477482,Kokinis; Troy Andreas,30,0,30,0
1708251324303,LATI 180,A00,405221,Kennemore; Amy Michelle,28,0,30,2
1708251324303,LATI 180,B00,405222,Mostajo; Lorena,30,0,30,0
1708251324829,LIAB 1C,A00,405278,Saab; Dima,13,0,14,1
1708251324829,LIAB 1C,B00,405279,Saab; Dima,11,0,14,3
1708251325355,LIAB 1CX,A00,405281,Akjeje; Abdelhak,19,0,20,1
1708251325355,LIAB 1CX,B00,405291,Akjeje; Abdelhak,20,0,20,0
1708251325889,LIAB 1F,A00,482814,El Cheddadi; Youniss,14,0,14,0
1708251326416,LIDS 19,001,492979,Goodall; Grant Todd,9999,0,9999,0
1708251326416,LIDS 19,002,492980,Goodall; Grant Todd,9999,0,9999,0
1708251326416,LIDS 19,003,492981,Goodall; Grant Todd,9999,0,9999,0
1708251326416,LIDS 19,004,492982,Goodall; Grant Todd,9999,0,9999,0
1708251326416,LIDS 19,005,492983,Goodall; Grant Todd,9999,0,9999,0
1708251326416,LIDS 19,006,492984,Goodall; Grant Todd,9999,0,9999,0
1708251326416,LIDS 19,007,492985,Goodall; Grant Todd,9999,0,9999,0
1708251326416,LIDS 19,008,492986,Goodall; Grant Todd,9999,0,9999,0
1708251326416,LIDS 19,009,492987,Goodall; Grant Todd,9999,0,9999,0
1708251326416,LIDS 19,010,492988,Goodall; Grant Todd,9999,0,9999,0
1708251326416,LIDS 19,011,492989,Goodall; Grant Todd,9999,0,9999,0
1708251326416,LIDS 19,012,492990,Goodall; Grant Todd,9999,0,9999,0
1708251326947,LIFR 1A,A00,405299,Van Moer; Vinciane G,13,0,14,1
1708251326947,LIFR 1A,B00,405300,Van Moer; Vinciane G,13,0,14,1
1708251326947,LIFR 1A,C00,405301,Van Moer; Vinciane G,13,0,14,1
1708251326947,LIFR 1A,D00,405307,Van Moer; Vinciane G,14,0,14,0
1708251327478,LIFR 1AX,A00,405308,Van Moer; Vinciane G,27,0,28,1
1708251327478,LIFR 1AX,B00,405309,Van Moer; Vinciane G,27,0,28,1
1708251328004,LIFR 1C,A00,405310,Van Moer; Vinciane G,14,0,14,0
1708251328004,LIFR 1C,B00,405311,Van Moer; Vinciane G,12,0,14,2
1708251328004,LIFR 1C,C00,405325,Van Moer; Vinciane G,13,0,14,1
1708251328004,LIFR 1C,D00,405326,Van Moer; Vinciane G,11,0,14,3
1708251328533,LIFR 1CX,A00,405332,Van Moer; Vinciane G,25,0,28,3
1708251328533,LIFR 1CX,B00,405333,Van Moer; Vinciane G,27,0,28,1
1708251329060,LIFR 1D,A00,405334,Van Moer; Vinciane G,13,0,14,1
1708251329060,LIFR 1D,B00,405335,Van Moer; Vinciane G,13,0,14,1
1708251329060,LIFR 1D,C00,405336,Van Moer; Vinciane G,13,0,14,1
1708251329060,LIFR 1D,D00,405337,Van Moer; Vinciane G,13,0,14,1
1708251329588,LIFR 1DX,A00,405338,Van Moer; Vinciane G,25,0,28,3
1708251329588,LIFR 1DX,B00,405394,Van Moer; Vinciane G,27,0,28,1
1708251330112,LIFR 11,001,405395,Goodall; Grant Todd,999,0,999,0
1708251330642,LIGM 1C,A00,405398,Fischer-Grunski; Eva K,12,0,14,2
1708251330642,LIGM 1C,B00,405400,Fischer-Grunski; Eva K,13,0,14,1
1708251330642,LIGM 1C,C00,405403,Fischer-Grunski; Eva K,13,0,14,1
1708251330642,LIGM 1C,D00,405404,Fischer-Grunski; Eva K,13,0,14,1
1708251331169,LIGM 1CX,A00,405407,Fischer-Grunski; Eva K,27,0,28,1
1708251331169,LIGM 1CX,B00,405408,Fischer-Grunski; Eva K,26,0,28,2
1708251331699,LIGM 11,001,405464,Goodall; Grant Todd,999,0,999,0
1708251332225,LIGN 8,A00,411133,McIntosh; Justin Daniel,232,0,240,8
1708251332751,LIGN 17,A00,411141,Kehler; Andrew Scott,287,0,300,13
1708251333280,LIGN 101,A01,411144,Staff,28,0,30,2
1708251333280,LIGN 101,A02,411147,Staff,29,0,30,1
1708251333280,LIGN 101,A03,411154,Staff,27,0,30,3
1708251333280,LIGN 101,A04,411163,Staff,29,0,30,1
1708251333807,LIGN 120,A01,411165,Ackerman; Farrell,28,0,30,2
1708251333807,LIGN 120,A02,411177,Ackerman; Farrell,23,0,27,4
1708251334339,LIGN 130,A01,411223,Staff,29,0,30,1
1708251334339,LIGN 130,A02,411231,Staff,30,0,30,0
1708251334339,LIGN 130,A03,411232,Staff,29,0,30,1
1708251334869,LIGN 141,A00,411276,Rose; Sharon,37,0,40,3
1708251335400,LIGN 144,A00,411277,Lott; Margaret S.,22,0,24,2
1708251335925,LIGN 148,A00,411278,Mayberry; Rachel,71,0,75,4
1708251336455,LIGN 165,A00,411279,Bergen; Leon,41,0,70,29
1708251336988,LIGN 168,A01,411281,Styler; William Francis,65,0,70,5
1708251337514,LIGN 175,A00,482816,Rodriguez Aispuro; Alejandro,35,0,40,5
1708251338040,LIGN 230,A00,411293,Caponigro; Ivano,19,0,20,1
1708251338569,LIGN 238,A00,411308,Bergen; Benjamin,20,0,20,0
1708251339097,LIGN 252,A00,411309,Bergen; Leon,28,0,30,2
1708251339623,LIGN 256,A00,411310,Nakashole; Ndapandula,0,0,5,5
1708251340152,LIGN 272,A00,482887,Kluender; Robert,10,0,10,0
1708251340684,LIHL 112P,A00,405228,Pagkalinawan; Leticia Cant,27,0,28,1
1708251341210,LIHL 114P,A00,405229,Nguyen; Hoan Thi,26,0,28,2
1708251341742,LIHL 117P,A00,405256,Sadegholvad; Elham,27,0,28,1
1708251342269,LIHL 118,A00,405257,Chen; Areana Yen,28,0,28,0
1708251342796,LIHL 124P,A00,405262,Nguyen; Hoan Thi,28,0,28,0
1708251343326,LIHL 132P,A00,405263,Pagkalinawan; Leticia Cant,28,0,28,0
1708251343852,LIHL 134P,A00,405269,Nguyen; Hoan Thi,28,0,28,0
1708251344378,LIHL 138,A00,405270,Chen; Areana Yen,27,0,28,1
1708251344909,LIIT 1C,A00,405465,Carnelos; Chiara,12,0,14,2
1708251344909,LIIT 1C,B00,405466,Carnelos; Chiara,14,0,14,0
1708251345435,LIIT 1CX,A00,405594,Carnelos; Chiara,28,0,28,0
1708251345962,LIPO 1C,A00,405595,Paladini; Denise,13,0,14,1
1708251345962,LIPO 1C,B00,405596,Paladini; Denise,14,0,14,0
1708251346490,LIPO 1CX,A00,405597,De Abreu; Cassia,28,0,28,0
1708251347016,LISL 1A,C00,405600,Lott; Margaret S.,13,0,14,1
1708251347016,LISL 1A,D00,405601,Lott; Margaret S.,10,0,14,4
1708251347016,LISL 1A,E00,405602,Lott; Margaret S.,13,0,14,1
1708251347016,LISL 1A,F00,405603,Lott; Margaret S.,13,0,14,1
1708251347543,LISL 1AR,A00,480605,Lott; Margaret S.,13,0,15,2
1708251347543,LISL 1AR,B00,480606,Lott; Margaret S.,14,0,15,1
1708251348069,LISL 1AX,A00,405754,Lott; Margaret S.,26,0,28,2
1708251348069,LISL 1AX,B00,405755,Lott; Margaret S.,23,0,28,5
1708251348601,LISL 1C,A00,405776,Lott; Margaret S.,13,0,14,1
1708251348601,LISL 1C,B00,405779,Lott; Margaret S.,14,0,14,0
1708251348601,LISL 1C,C00,405785,Lott; Margaret S.,14,0,14,0
1708251348601,LISL 1C,D00,405787,Lott; Margaret S.,9,0,14,5
1708251348601,LISL 1C,E00,405827,Lott; Margaret S.,12,0,14,2
1708251348601,LISL 1C,F00,405830,Lott; Margaret S.,13,0,14,1
1708251349127,LISL 1CX,A00,405844,Lott; Margaret S.,25,0,28,3
1708251349127,LISL 1CX,B00,405848,Lott; Margaret S.,25,0,28,3
1708251349127,LISL 1CX,C00,405849,Lott; Margaret S.,28,0,28,0
1708251349652,LISL 1D,A00,405850,Lott; Margaret S.,8,0,14,6
1708251349652,LISL 1D,B00,405851,Lott; Margaret S.,13,0,14,1
1708251349652,LISL 1D,C00,405852,Lott; Margaret S.,10,0,14,4
1708251350182,LISL 1DX,A00,405854,Lott; Margaret S.,17,0,22,5
1708251350182,LISL 1DX,B00,405855,Lott; Margaret S.,18,0,22,4
1708251350709,LISP 1A,001,405856,Munoz Sanchez; Alicia,11,0,14,3
1708251350709,LISP 1A,002,405857,Munoz Sanchez; Alicia,13,0,14,1
1708251350709,LISP 1A,003,405858,Munoz Sanchez; Alicia,14,0,14,0
1708251350709,LISP 1A,004,405861,Munoz Sanchez; Alicia,14,0,14,0
1708251351238,LISP 1AX,001,405862,Munoz Sanchez; Alicia,28,0,28,0
1708251351238,LISP 1AX,002,405863,Munoz Sanchez; Alicia,25,0,28,3
1708251351765,LISP 1C,001,405864,Munoz Sanchez; Alicia,13,0,14,1
1708251351765,LISP 1C,002,405865,Munoz Sanchez; Alicia,12,0,14,2
1708251351765,LISP 1C,003,405879,Munoz Sanchez; Alicia,12,0,14,2
1708251351765,LISP 1C,004,405880,Munoz Sanchez; Alicia,13,0,14,1
1708251351765,LISP 1C,005,405881,Munoz Sanchez; Alicia,12,0,14,2
1708251351765,LISP 1C,006,405882,Munoz Sanchez; Alicia,12,0,14,2
1708251351765,LISP 1C,007,405904,Munoz Sanchez; Alicia,14,0,14,0
1708251351765,LISP 1C,008,405905,Munoz Sanchez; Alicia,14,0,14,0
1708251351765,LISP 1C,009,405908,Munoz Sanchez; Alicia,14,0,14,0
1708251351765,LISP 1C,010,405917,Munoz Sanchez; Alicia,13,0,14,1
1708251352292,LISP 1CX,001,405922,Munoz Sanchez; Alicia,24,0,28,4
1708251352292,LISP 1CX,002,405990,Munoz Sanchez; Alicia,26,0,28,2
1708251352292,LISP 1CX,003,406007,Munoz Sanchez; Alicia,27,0,28,1
1708251352292,LISP 1CX,004,406008,Munoz Sanchez; Alicia,25,0,28,3
1708251352292,LISP 1CX,005,406015,Munoz Sanchez; Alicia,26,0,28,2
1708251352825,LISP 1D,001,406016,Munoz Sanchez; Alicia,12,0,14,2
1708251352825,LISP 1D,002,406017,Munoz Sanchez; Alicia,13,0,14,1
1708251352825,LISP 1D,003,406018,Munoz Sanchez; Alicia,14,0,14,0
1708251352825,LISP 1D,004,406019,Munoz Sanchez; Alicia,11,0,14,3
1708251352825,LISP 1D,005,406020,Munoz Sanchez; Alicia,13,0,14,1
1708251352825,LISP 1D,006,406021,Munoz Sanchez; Alicia,10,0,14,4
1708251352825,LISP 1D,007,406022,Munoz Sanchez; Alicia,12,0,14,2
1708251352825,LISP 1D,008,406023,Munoz Sanchez; Alicia,13,0,14,1
1708251352825,LISP 1D,009,406024,Munoz Sanchez; Alicia,11,0,14,3
1708251352825,LISP 1D,010,406025,Munoz Sanchez; Alicia,12,0,14,2
1708251352825,LISP 1D,011,406026,Munoz Sanchez; Alicia,13,0,14,1
1708251352825,LISP 1D,012,406027,Munoz Sanchez; Alicia,13,0,14,1
1708251352825,LISP 1D,013,406028,Munoz Sanchez; Alicia,12,0,14,2
1708251352825,LISP 1D,014,406029,Munoz Sanchez; Alicia,12,0,14,2
1708251352825,LISP 1D,015,406030,Munoz Sanchez; Alicia,10,0,14,4
1708251352825,LISP 1D,016,406031,Munoz Sanchez; Alicia,14,0,14,0
1708251352825,LISP 1D,017,406032,Munoz Sanchez; Alicia,14,0,14,0
1708251352825,LISP 1D,018,406033,Munoz Sanchez; Alicia,12,0,14,2
1708251352825,LISP 1D,019,406034,Munoz Sanchez; Alicia,13,0,14,1
1708251352825,LISP 1D,020,406035,Munoz Sanchez; Alicia,14,0,14,0
1708251352825,LISP 1D,021,406036,Munoz Sanchez; Alicia,13,0,14,1
1708251352825,LISP 1D,022,406037,Munoz Sanchez; Alicia,14,0,14,0
1708251352825,LISP 1D,023,406038,Munoz Sanchez; Alicia,14,0,14,0
1708251352825,LISP 1D,024,406039,Munoz Sanchez; Alicia,13,0,14,1
1708251353360,LISP 1DX,001,406040,Munoz Sanchez; Alicia,28,0,28,0
1708251353360,LISP 1DX,002,406041,Munoz Sanchez; Alicia,27,0,28,1
1708251353360,LISP 1DX,003,406127,Munoz Sanchez; Alicia,24,0,28,4
1708251353360,LISP 1DX,004,406128,Munoz Sanchez; Alicia,17,0,28,11
1708251353360,LISP 1DX,005,406418,Munoz Sanchez; Alicia,24,0,28,4
1708251353360,LISP 1DX,006,406536,Munoz Sanchez; Alicia,27,0,28,1
1708251353360,LISP 1DX,007,406561,Munoz Sanchez; Alicia,23,0,28,5
1708251353360,LISP 1DX,008,406576,Munoz Sanchez; Alicia,25,0,28,3
1708251353360,LISP 1DX,009,406679,Munoz Sanchez; Alicia,28,0,28,0
1708251353360,LISP 1DX,010,406691,Munoz Sanchez; Alicia,26,0,28,2
1708251353360,LISP 1DX,011,406692,Munoz Sanchez; Alicia,28,0,28,0
1708251353360,LISP 1DX,012,406693,Munoz Sanchez; Alicia,28,0,28,0
1708251353886,LISP 17,001,406694,Munoz Sanchez; Alicia,18,0,20,2
1708251354415,LISP 18,001,406695,Munoz Sanchez; Alicia,20,0,20,0
1708251354941,LTAM 105,A00,412520,Ruiz; Ariana,28,0,40,12
1708251355467,LTCH 101,A00,479214,Zhu; Ping,39,0,40,1
1708251355993,LTCS 87,A00,492906,Nguyen; Hoang Tan,20,0,20,0
1708251355993,LTCS 87,B00,492907,Nguyen; Hoang Tan,20,0,20,0
1708251356525,LTCS 150,A00,412543,Liao; Ping H,39,0,40,1
1708251357052,LTCS 225,A00,412819,Mendoza; Andrea,14,0,15,1
1708251357579,LTCS 250,A00,412821,Lee; Jin-Kyung,15,0,15,0
1708251358107,LTEA 110B,A00,412548,Liao; Ping H,60,0,60,0
1708251358634,LTEA 120A,A00,479216,Zhu; Ping,36,0,40,4
1708251359165,LTEA 120C,A00,412552,Fiss; Geraldine Anna,295,0,300,5
1708251359691,LTEA 132,A00,412561,Mendoza; Andrea,51,0,60,9
1708251360254,LTEA 141,A00,412565,Lee; Jin-Kyung,37,0,40,3
1708251360795,LTEN 23,A01,411317,Vijay; Ameeth Varma,24,0,25,1
1708251360795,LTEN 23,A02,411318,Vijay; Ameeth Varma,24,0,25,1
1708251360795,LTEN 23,A03,411371,Vijay; Ameeth Varma,25,0,25,0
1708251360795,LTEN 23,A04,411375,Vijay; Ameeth Varma,24,0,25,1
1708251361323,LTEN 28,A01,411632,Blanco; John D,25,0,25,0
1708251361323,LTEN 28,A02,411697,Blanco; John D,25,0,25,0
1708251361323,LTEN 28,A03,411698,Blanco; John D,25,0,25,0
1708251361323,LTEN 28,A04,411709,Blanco; John D,25,0,25,0
1708251361323,LTEN 28,A05,411719,Blanco; John D,25,0,25,0
1708251361323,LTEN 28,A06,411744,Blanco; John D,25,0,25,0
1708251361323,LTEN 28,A07,411780,Blanco; John D,25,0,25,0
1708251361323,LTEN 28,A08,411820,Blanco; John D,25,0,25,0
1708251361856,LTEN 110,A00,486891,Vitkus; Daniel J.,38,0,40,2
1708251362382,LTEN 144,A00,412570,Vijay; Ameeth Varma,39,0,40,1
1708251362913,LTEN 180,A00,412581,Perreira; Christopher Michael,18,0,25,7
1708251363439,LTEN 181,A00,412582,Mukherjee; Silpa,55,0,60,5
1708251363965,LTEN 245,A00,412824,Johnson; Sara E.,13,0,15,2
1708251364495,LTEN 259,A00,412825,Streeby; Shelley,13,0,15,2
1708251365020,LTEU 111,A00,412588,Kontje; Todd Curtis,38,0,40,2
1708251365547,LTEU 140,A00,480172,De Marchi Gherini; Adriana,36,0,37,1
1708251366080,LTEU 141,A00,412592,Cohen; Alain J. J.,40,0,40,0
1708251366615,LTFR 2A,A01,411996,Ploye; Catherine,25,0,25,0
1708251367141,LTFR 2C,A00,411997,Ploye; Catherine,24,0,25,1
1708251367669,LTFR 142,A00,412597,Zhiri; Oumelbanine,20,0,20,0
1708251368195,LTGK 3,A00,412001,Murray; Kourtney Kristine,30,0,30,0
1708251368721,LTGM 2C,A00,412002,Fischer-Grunski; Eva K,25,0,25,0
1708251369255,LTKO 1C,A01,412029,Cho; Hye Jin,24,0,25,1
1708251369255,LTKO 1C,B01,412164,Cho; Hye Jin,23,0,25,2
1708251369255,LTKO 1C,C01,412168,Cho; Hye Jin,25,0,25,0
1708251369255,LTKO 1C,D01,412353,Yim; Nancy,24,0,25,1
1708251369255,LTKO 1C,E01,412372,Yim; Nancy,25,0,25,0
1708251369781,LTKO 2C,A01,412374,Yim; Nancy,21,0,25,4
1708251370308,LTKO 130P,A00,412601,Lee; Jeyseon,25,0,25,0
1708251370839,LTKO 135,A00,412606,Lee; Jeyseon,25,0,25,0
1708251371369,LTLA 3,A00,412375,Murray; Kourtney Kristine,36,0,40,4
1708251371896,LTRU 1C,A01,412491,Wells; Patricia Rebecca,24,0,25,1
1708251372424,LTRU 104A,A01,412614,Wells; Patricia Rebecca,20,0,20,0
1708251372951,LTSP 2A,A01,412493,Lampell; Toni,24,0,25,1
1708251373547,LTSP 2B,A01,412497,Lampell; Toni,22,0,25,3
1708251373547,LTSP 2B,B01,479218,Lampell; Toni,24,0,25,1
1708251374073,LTSP 2C,A01,412499,Mastromartino; Alexandra L,23,0,25,2
1708251374604,LTSP 2D,A00,412500,Dominguez; Noelia,24,0,25,1
1708251375130,LTSP 2E,A00,412501,Mastromartino; Alexandra L,24,0,25,1
1708251375130,LTSP 2E,B00,412502,Mastromartino; Alexandra L,25,0,25,0
1708251375659,LTSP 87,A00,479212,Bessett; Ryan Matthew,20,0,20,0
1708251376186,LTSP 100B,A00,412619,Dominguez; Noelia,25,0,25,0
1708251376186,LTSP 100B,B00,412623,Dominguez; Noelia,24,0,25,1
1708251376712,LTSP 116,A00,412628,Blanco; John D,28,0,30,2
1708251377238,LTSP 135A,A00,412631,Parra; Max,27,0,30,3
1708251377765,LTSP 174,A00,479213,Staff,28,0,30,2
1708251378291,LTTH 115,A00,412632,Kontje; Todd Curtis,35,0,40,5
1708251378821,LTTH 210C,A00,412826,Batarseh; Amanda Alicia,14,0,15,1
1708251379346,LTTH 255,A00,412827,Ali; Mohammad Kazim,13,0,15,2
1708251379877,LTTH 260,A00,412828,Kim; Joo Ok,30,0,30,0
1708251380402,LTWL 19C,A00,412503,Kelting; Edward William,40,0,40,0
1708251380929,LTWL 101,A00,412633,Kelting; Edward William,39,0,40,1
1708251381455,LTWL 114,A00,412656,Fiss; Geraldine Anna,60,0,60,0
1708251381984,LTWL 123,A00,412674,Lampert-Weissig; Lisa,31,0,40,9
1708251382514,LTWL 172,A00,412729,De Marchi Gherini; Adriana,37,0,40,3
1708251383040,LTWL 183,A00,412731,Cohen; Alain J. J.,38,0,40,2
1708251383571,LTWL 184,A00,479219,Mukherjee; Silpa,38,0,40,2
1708251384098,LTWL 194A,A00,489635,Vijay; Ameeth Varma,27,0,31,4
1708251384629,LTWR 8A,A01,412505,Springer; Anna Joy,24,0,25,1
1708251384629,LTWR 8A,A02,412506,Springer; Anna Joy,24,0,25,1
1708251384629,LTWR 8A,A03,412507,Springer; Anna Joy,25,0,25,0
1708251384629,LTWR 8A,A04,412508,Springer; Anna Joy,23,0,25,2
1708251385155,LTWR 8C,A01,412511,Forbes; Camille,23,0,25,2
1708251385155,LTWR 8C,A02,412512,Forbes; Camille,25,0,25,0
1708251385155,LTWR 8C,A03,412514,Forbes; Camille,25,0,25,0
1708251385155,LTWR 8C,A04,412519,Forbes; Camille,24,0,25,1
1708251385682,LTWR 100,A00,412734,Forbes; Camille,7,0,15,8
1708251386211,LTWR 113,A00,412816,Carroll; Amy Sara,28,0,30,2
1708251386741,LTWR 114,A00,412817,Springer; Anna Joy,23,0,30,7
1708251387268,LTWR 126,A00,412818,Hoang; Lily Kim,25,0,30,5
1708251387795,LTWR 215,A00,412880,Carroll; Amy Sara,19,0,20,1
1708251388325,MAE 3,A01,435606,Qi; Huihui,16,0,20,4
1708251388325,MAE 3,A02,435607,Qi; Huihui,15,0,20,5
1708251388325,MAE 3,A03,435608,Qi; Huihui,19,0,20,1
1708251388325,MAE 3,B01,435618,Delson; Nathan Joseph & Mullin; Jennifer S,20,0,20,0
1708251388325,MAE 3,B02,435626,Delson; Nathan Joseph & Mullin; Jennifer S,20,0,20,0
1708251388325,MAE 3,B03,435666,Delson; Nathan Joseph & Mullin; Jennifer S,20,0,20,0
1708251388325,MAE 3,B04,435679,Delson; Nathan Joseph & Mullin; Jennifer S,20,0,20,0
1708251388325,MAE 3,B05,494545,Delson; Nathan Joseph & Mullin; Jennifer S,20,0,20,0
1708251388853,MAE 8,A01,435688,Pham; Hieu Tan,197,0,200,3
1708251389380,MAE 30B,A00,435689,Lubarda; Marko,128,0,130,2
1708251389380,MAE 30B,B00,435701,Ghazinejad; Maziar,117,0,130,13
1708251389908,MAE 101B,A00,435702,Saintillan; David,146,0,150,4
1708251389908,MAE 101B,B00,435703,Nomura; Keiko K.,138,0,146,8
1708251390455,MAE 101C,A00,435704,Sadeghizadeh; Zahra,53,0,65,12
1708251390983,MAE 101D,A00,435705,Chen; Renkun,14,0,20,6
1708251391513,MAE 105,A00,435706,Becker; Janet Maria,115,0,120,5
1708251392040,MAE 107,A00,435707,Lindsey; Stephanie,48,0,50,2
1708251392040,MAE 107,B00,435708,Davidson; Michael R,55,0,60,5
1708251392569,MAE 119,A00,435710,Hidalgo-Gonzalez; Patricia,100,0,120,20
1708251393097,MAE 120,A00,435722,Arefiev; Alexey,49,0,65,16
1708251393624,MAE 125,A00,435723,Kleissl; Jan,60,0,65,5
1708251394172,MAE 131A,A00,435724,Qi; Huihui,119,0,125,6
1708251394172,MAE 131A,B00,435725,Meyers; Marc,123,0,125,2
1708251394703,MAE 143B,A00,435726,Morimoto; Tania,114,0,120,6
1708251394703,MAE 143B,B00,435727,Herbert; Sylvia Lee,117,0,120,3
1708251394703,MAE 143B,C00,435728,Diagne; Mamadou Lamine,108,0,120,12
1708251395229,MAE 145,A00,435729,Martinez; Sonia,41,0,60,19
1708251395755,MAE 148,A01,492802,Silberman; Jack,14,0,24,10
1708251396280,MAE 150,A00,435730,Pham; Hieu Tan,52,0,60,8
1708251396806,MAE 152,A00,435731,Llewellyn Smith; Stefan G.,14,0,14,0
1708251396806,MAE 152,B00,435747,Llewellyn Smith; Stefan G.,12,0,14,2
1708251396806,MAE 152,C00,435748,Llewellyn Smith; Stefan G.,12,0,14,2
1708251396806,MAE 152,D00,435749,Llewellyn Smith; Stefan G.,8,0,14,6
1708251396806,MAE 152,E00,435750,Llewellyn Smith; Stefan G.,13,0,14,1
1708251397334,MAE 155B,A01,435752,Hwang; John T,36,0,50,14
1708251397334,MAE 155B,B01,435768,Anderson; Mark Ronald,27,0,50,23
1708251397334,MAE 155B,C01,494006,Saha; Abhishek,0,0,0,0
1708251397866,MAE 156B,A01,435770,Tustaniwskyj; Jerry I,33,0,40,7
1708251397866,MAE 156B,B01,435772,Ghazinejad; Maziar,35,0,40,5
1708251397866,MAE 156B,C01,435774,Delson; Nathan Joseph,38,0,40,2
1708251397866,MAE 156B,D01,435776,Saha; Abhishek,31,0,40,9
1708251398395,MAE 166,A00,435777,Fullerton; Eric E,44,0,50,6
1708251398921,MAE 170,A01,435779,Lubarda; Marko,30,0,32,2
1708251398921,MAE 170,A02,435780,Lubarda; Marko,27,0,32,5
1708251398921,MAE 170,A03,435781,Lubarda; Marko,32,0,32,0
1708251398921,MAE 170,A04,435782,Lubarda; Marko,31,0,32,1
1708251398921,MAE 170,A05,435783,Lubarda; Marko,29,0,32,3
1708251398921,MAE 170,A06,435784,Lubarda; Marko,30,0,32,2
1708251398921,MAE 170,B01,435786,Evdokimenko; Ekaterina,23,0,24,1
1708251398921,MAE 170,B02,435787,Evdokimenko; Ekaterina,20,0,24,4
1708251398921,MAE 170,B03,435788,Evdokimenko; Ekaterina,23,0,24,1
1708251398921,MAE 170,B04,435789,Evdokimenko; Ekaterina,23,0,24,1
1708251398921,MAE 170,B05,435790,Evdokimenko; Ekaterina,19,0,24,5
1708251398921,MAE 170,B06,435791,Evdokimenko; Ekaterina,23,0,24,1
1708251399447,MAE 180,A00,479477,Sadeghizadeh; Zahra,55,0,60,5
1708251399973,MAE 184,A00,435792,Anderson; Mark Ronald,7,0,50,43
1708251400505,MAE 190,A00,435793,Beg; Farhat N.,17,0,20,3
1708251400505,MAE 190,B00,479209,Gerardo; Hortense Flotilde,12,0,15,3
1708251401032,MAE 202,A00,435794,Bandaru; Prabhakar,32,0,70,38
1708251401560,MAE 205,A00,435804,Hwang; John T & Tynan; George Robert & Seshadri; Kalyanasundaram & Rangamani; Padmini & Bandaru; Prabhakar,9990,0,9999,9
1708251402086,MAE 207,A00,435805,Beg; Farhat N.,9,0,10,1
1708251402086,MAE 207,B00,435815,Campbell; Edward Michael,6,0,10,4
1708251402086,MAE 207,C00,477499,Gerardo; Hortense Flotilde,6,0,30,24
1708251402611,MAE 209,A00,435816,Scholtes Acevedo; Claire,25,0,30,5
1708251403136,MAE 210C,A00,435817,Becker; Janet Maria,22,0,30,8
1708251403663,MAE 211,A00,435818,Seshadri; Kalyanasundaram,20,0,30,10
1708251404193,MAE 214A,A00,435819,Sarkar; Sutanu,27,0,35,8
1708251404720,MAE 217C,A00,435820,Marinoni; Alessandro,10,0,10,0
1708251405244,MAE 221C,A00,435821,Seshadri; Kalyanasundaram,9,0,15,6
1708251405786,MAE 221D,A00,435822,Poulikakos; Lisa Voula,23,0,30,7
1708251406315,MAE 224A,A00,435823,Pawlak; Geno Ronald,5,0,10,5
1708251406844,MAE 227,A00,435824,Hidalgo-Gonzalez; Patricia,21,0,35,14
1708251407387,MAE 231A,A00,435825,Boechler; Nicholas Sebastia,14,0,30,16
1708251407927,MAE 240,A00,435826,Rosengren; Aaron,19,0,30,11
1708251408454,MAE 242,A00,435827,Martinez; Sonia,0,0,45,45
1708251408979,MAE 249,A00,435842,Tolley; Michael Thomas,0,0,35,35
1708251409507,MAE 253,A00,435891,Staff,24,0,25,1
1708251410032,MAE 256,A00,435949,Coimbra; Carlos F.,6,0,10,4
1708251410560,MAE 263,A00,435987,Rangamani; Padmini,10,0,10,0
1708251411087,MAE 266,A00,435988,Evdokimenko; Ekaterina,7,0,30,23
1708251411614,MAE 271C,A00,435990,Arzt; Eduard,10,0,10,0
1708251412140,MAE 281B,A00,435991,Cortes; Jorge,9,0,25,16
1708251412670,MAE 288A,A00,435998,McEneaney; William Michael,6,0,40,34
1708251413196,MAE 288B,A00,435999,Bitmead; Robert R.,41,0,45,4
1708251413722,MAE 290C,A00,436008,Schmidt; Oliver,26,0,30,4
1708251414250,MAE 294C,A01,436010,Young; William Roy,19,0,20,1
1708251414786,MATH 2,A01,431271,Staff,31,0,35,4
1708251414786,MATH 2,B01,431273,Staff,29,0,35,6
1708251414786,MATH 2,C01,431275,Staff,31,0,35,4
1708251415312,MATH 3C,A01,431277,Safii; Soheil,12,0,15,3
1708251415312,MATH 3C,A02,431278,Safii; Soheil,12,0,15,3
1708251415312,MATH 3C,A03,431279,Safii; Soheil,12,0,15,3
1708251415312,MATH 3C,A04,431280,Safii; Soheil,15,0,15,0
1708251415312,MATH 3C,A05,431281,Safii; Soheil,14,0,15,1
1708251415312,MATH 3C,A06,431282,Safii; Soheil,15,0,15,0
1708251415855,MATH 10A,A01,431284,Bowers; Adam R.,20,0,30,10
1708251415855,MATH 10A,A02,431285,Bowers; Adam R.,18,0,30,12
1708251415855,MATH 10A,A03,431369,Bowers; Adam R.,28,0,30,2
1708251415855,MATH 10A,A04,431395,Bowers; Adam R.,27,0,30,3
1708251415855,MATH 10A,A05,431450,Bowers; Adam R.,28,0,30,2
1708251415855,MATH 10A,A06,431508,Bowers; Adam R.,30,0,30,0
1708251415855,MATH 10A,B01,431572,Kowalenko; Ethan J,24,0,30,6
1708251415855,MATH 10A,B02,431573,Kowalenko; Ethan J,29,0,30,1
1708251415855,MATH 10A,B03,431574,Kowalenko; Ethan J,30,0,30,0
1708251415855,MATH 10A,B04,431576,Kowalenko; Ethan J,30,0,30,0
1708251415855,MATH 10A,B05,431577,Kowalenko; Ethan J,30,0,30,0
1708251415855,MATH 10A,B06,431583,Kowalenko; Ethan J,30,0,30,0
1708251416415,MATH 10B,A01,431595,Habib; Yousaf,29,0,36,7
1708251416415,MATH 10B,A02,431597,Habib; Yousaf,35,0,36,1
1708251416415,MATH 10B,A03,431669,Habib; Yousaf,37,0,37,0
1708251416415,MATH 10B,A04,431670,Habib; Yousaf,36,0,37,1
1708251416415,MATH 10B,A05,431671,Habib; Yousaf,70,0,70,0
1708251416415,MATH 10B,B01,431673,Habib; Yousaf,25,0,33,8
1708251416415,MATH 10B,B02,431712,Habib; Yousaf,33,0,33,0
1708251416415,MATH 10B,B03,431713,Habib; Yousaf,33,0,33,0
1708251416415,MATH 10B,B04,431714,Habib; Yousaf,33,0,33,0
1708251416415,MATH 10B,B05,431715,Habib; Yousaf,60,0,60,0
1708251416415,MATH 10B,C01,431717,Bach; Quang Tran,57,0,60,3
1708251416415,MATH 10B,C02,431718,Bach; Quang Tran,18,0,34,16
1708251416415,MATH 10B,C03,431719,Bach; Quang Tran,34,0,34,0
1708251416415,MATH 10B,C04,431720,Bach; Quang Tran,33,0,34,1
1708251416415,MATH 10B,C05,431721,Bach; Quang Tran,32,0,34,2
1708251416415,MATH 10B,D01,431723,Staff,28,0,34,6
1708251416415,MATH 10B,D02,431724,Staff,34,0,34,0
1708251416415,MATH 10B,D03,431725,Staff,34,0,34,0
1708251416415,MATH 10B,D04,431726,Staff,34,0,34,0
1708251416415,MATH 10B,D05,431727,Staff,57,0,60,3
1708251416941,MATH 10C,A01,431741,Staff,94,0,96,2
1708251416941,MATH 10C,A02,431742,Staff,39,0,40,1
1708251416941,MATH 10C,B01,431744,Staff,95,0,96,1
1708251416941,MATH 10C,B02,431746,Staff,27,0,40,13
1708251416941,MATH 10C,C01,431748,Pardo Guerra; Sebastian,30,0,40,10
1708251416941,MATH 10C,C02,431885,Pardo Guerra; Sebastian,40,0,40,0
1708251416941,MATH 10C,C03,431895,Pardo Guerra; Sebastian,32,0,33,1
1708251416941,MATH 10C,C04,431896,Pardo Guerra; Sebastian,32,0,32,0
1708251417467,MATH 11,A01,431933,Rava; Denise,82,0,100,18
1708251417467,MATH 11,A02,431960,Rava; Denise,66,0,70,4
1708251417467,MATH 11,A03,431971,Rava; Denise,39,0,40,1
1708251417467,MATH 11,B01,432053,Staff,99,0,100,1
1708251417467,MATH 11,B02,432064,Staff,37,0,45,8
1708251417467,MATH 11,B03,432073,Staff,44,0,45,1
1708251418010,MATH 18,A01,432082,Mackall; Eoin Travis,65,0,70,5
1708251418010,MATH 18,A02,432086,Mackall; Eoin Travis,68,0,70,2
1708251418010,MATH 18,B01,432089,Suk; Andrew Hoon,39,0,40,1
1708251418010,MATH 18,B02,432090,Suk; Andrew Hoon,35,0,40,5
1708251418010,MATH 18,B03,432091,Suk; Andrew Hoon,33,0,40,7
1708251418010,MATH 18,B04,432092,Suk; Andrew Hoon,30,0,40,10
1708251418010,MATH 18,B05,432093,Suk; Andrew Hoon,34,0,35,1
1708251418010,MATH 18,B06,432094,Suk; Andrew Hoon,33,0,35,2
1708251418010,MATH 18,B07,432095,Suk; Andrew Hoon,98,0,100,2
1708251418010,MATH 18,B08,432096,Suk; Andrew Hoon,100,0,100,0
1708251418010,MATH 18,B09,432097,Suk; Andrew Hoon,98,0,100,2
1708251418010,MATH 18,B10,432098,Suk; Andrew Hoon,69,0,70,1
1708251418537,MATH 20A,A01,432101,Briones; Jor-el Thomas Caparas,30,0,40,10
1708251418537,MATH 20A,A02,432102,Briones; Jor-el Thomas Caparas,98,0,100,2
1708251418537,MATH 20A,B01,432104,Briones; Jor-el Thomas Caparas,99,0,100,1
1708251418537,MATH 20A,B02,432105,Briones; Jor-el Thomas Caparas,40,0,40,0
1708251419068,MATH 20B,A01,432107,Quarfoot; David James,33,0,35,2
1708251419068,MATH 20B,A02,432108,Quarfoot; David James,18,0,35,17
1708251419068,MATH 20B,A03,432109,Quarfoot; David James,32,0,35,3
1708251419068,MATH 20B,A04,432110,Quarfoot; David James,34,0,35,1
1708251419068,MATH 20B,A05,432331,Quarfoot; David James,26,0,32,6
1708251419068,MATH 20B,A06,432411,Quarfoot; David James,31,0,32,1
1708251419068,MATH 20B,B01,432413,Mackall; Eoin Travis,62,0,65,3
1708251419068,MATH 20B,B02,432443,Mackall; Eoin Travis,65,0,65,0
1708251419068,MATH 20B,B03,432444,Mackall; Eoin Travis,60,0,60,0
1708251419068,MATH 20B,B04,432471,Mackall; Eoin Travis,60,0,60,0
1708251419613,MATH 20C,A01,432473,Ohm; Ko Woon,26,0,38,12
1708251419613,MATH 20C,A02,432474,Ohm; Ko Woon,36,0,38,2
1708251419613,MATH 20C,A03,432475,Ohm; Ko Woon,34,0,37,3
1708251419613,MATH 20C,A04,432546,Ohm; Ko Woon,36,0,37,1
1708251419613,MATH 20C,A05,432550,Ohm; Ko Woon,88,0,90,2
1708251419613,MATH 20C,B01,432568,Ohm; Ko Woon,43,0,45,2
1708251419613,MATH 20C,B02,432594,Ohm; Ko Woon,40,0,45,5
1708251419613,MATH 20C,B03,432609,Ohm; Ko Woon,85,0,90,5
1708251419613,MATH 20C,C01,432613,Cheng; Hsiao-Bing,67,0,70,3
1708251419613,MATH 20C,C02,432614,Cheng; Hsiao-Bing,68,0,70,2
1708251419613,MATH 20C,C03,432615,Cheng; Hsiao-Bing,70,0,70,0
1708251419613,MATH 20C,D01,432617,Cheng; Hsiao-Bing,69,0,70,1
1708251419613,MATH 20C,D02,432618,Cheng; Hsiao-Bing,68,0,70,2
1708251419613,MATH 20C,D03,432619,Cheng; Hsiao-Bing,70,0,70,0
1708251420161,MATH 20D,A01,432622,Hammock; Frances H,58,0,60,2
1708251420161,MATH 20D,A02,432623,Hammock; Frances H,58,0,60,2
1708251420161,MATH 20D,A03,432658,Hammock; Frances H,35,0,35,0
1708251420161,MATH 20D,A04,432660,Hammock; Frances H,35,0,35,0
1708251420161,MATH 20D,B01,432702,Hammock; Frances H,66,0,70,4
1708251420161,MATH 20D,B02,432703,Hammock; Frances H,70,0,70,0
1708251420161,MATH 20D,B03,432766,Hammock; Frances H,30,0,30,0
1708251420161,MATH 20D,B04,432782,Hammock; Frances H,20,0,30,10
1708251420161,MATH 20D,C01,432811,Sheng; Hongyi,60,0,60,0
1708251420161,MATH 20D,C02,432931,Sheng; Hongyi,60,0,60,0
1708251420161,MATH 20D,C03,432945,Sheng; Hongyi,28,0,30,2
1708251420161,MATH 20D,C04,432949,Sheng; Hongyi,30,0,30,0
1708251420688,MATH 20E,A01,433007,Eggers; John Dietrich,70,0,80,10
1708251420688,MATH 20E,A02,433070,Eggers; John Dietrich,77,0,80,3
1708251420688,MATH 20E,A03,433079,Eggers; John Dietrich,32,0,35,3
1708251420688,MATH 20E,B01,433092,Staff,86,0,90,4
1708251420688,MATH 20E,B02,433093,Staff,90,0,90,0
1708251420688,MATH 20E,C01,433237,Bach; Quang Tran,52,0,60,8
1708251420688,MATH 20E,C02,433238,Bach; Quang Tran,69,0,70,1
1708251420688,MATH 20E,C03,433239,Bach; Quang Tran,70,0,70,0
1708251421213,MATH 31CH,A01,433241,Rabin; Jeffrey Mark,35,0,35,0
1708251421745,MATH 95,A00,433242,Stevens; Laura Jeanne,30,0,30,0
1708251422287,MATH 100C,A01,433244,Pollack; Aaron,31,0,35,4
1708251422287,MATH 100C,A02,433245,Pollack; Aaron,35,0,35,0
1708251422828,MATH 102,A01,433298,Ophir; Amit,29,0,30,1
1708251422828,MATH 102,A02,433369,Ophir; Amit,30,0,30,0
1708251422828,MATH 102,A03,433373,Ophir; Amit,30,0,30,0
1708251422828,MATH 102,A04,433374,Ophir; Amit,29,0,30,1
1708251422828,MATH 102,B01,433572,Zhang; Ming,28,0,30,2
1708251422828,MATH 102,B02,433732,Zhang; Ming,30,0,30,0
1708251422828,MATH 102,B03,433733,Zhang; Ming,30,0,30,0
1708251422828,MATH 102,B04,433734,Zhang; Ming,29,0,30,1
1708251423374,MATH 103B,A01,433793,Lu; Yunze,23,0,30,7
1708251423374,MATH 103B,A02,433795,Lu; Yunze,30,0,30,0
1708251423374,MATH 103B,A03,433830,Lu; Yunze,28,0,30,2
1708251423374,MATH 103B,B01,433845,Lahiri; Aranya,24,0,30,6
1708251423374,MATH 103B,B02,433846,Lahiri; Aranya,28,0,30,2
1708251423374,MATH 103B,B03,433847,Lahiri; Aranya,27,0,30,3
1708251423918,MATH 109,A01,433849,Aycock; Jon Merrill,6,0,10,4
1708251423918,MATH 109,A02,433850,Aycock; Jon Merrill,9,0,10,1
1708251423918,MATH 109,B01,433852,Klevdal; Christian Sleek,10,0,10,0
1708251423918,MATH 109,B02,433859,Klevdal; Christian Sleek,10,0,10,0
1708251423918,MATH 109,C01,433861,Treuer; John N,5,0,10,5
1708251423918,MATH 109,C02,433862,Treuer; John N,10,0,10,0
1708251423918,MATH 109,D01,433864,Treuer; John N,8,0,10,2
1708251423918,MATH 109,D02,433865,Treuer; John N,8,0,10,2
1708251423918,MATH 109,E01,433868,Sheng; Hongyi,10,0,10,0
1708251423918,MATH 109,E02,433869,Sheng; Hongyi,19,0,20,1
1708251424447,MATH 110,A01,433871,Pillai; Mohandas K,24,0,35,11
1708251424447,MATH 110,A02,433872,Pillai; Mohandas K,33,0,35,2
1708251424974,MATH 112B,A01,480683,Komarova; Natalia,27,0,27,0
1708251425501,MATH 120B,A01,433885,Xiao; Ming,32,0,35,3
1708251425501,MATH 120B,A02,433886,Xiao; Ming,34,0,35,1
1708251426031,MATH 121B,A01,433888,Stevens; Laura Jeanne,29,0,30,1
1708251426557,MATH 140B,A01,433890,Seward; Brandon M.,31,0,35,4
1708251426557,MATH 140B,A02,433891,Seward; Brandon M.,35,0,35,0
1708251427157,MATH 140C,A01,433895,Spolaor; Luca,32,0,35,3
1708251427157,MATH 140C,A02,433896,Spolaor; Luca,35,0,35,0
1708251427684,MATH 142B,A01,433966,Eggers; John Dietrich,25,0,35,10
1708251427684,MATH 142B,A02,434063,Eggers; John Dietrich,32,0,35,3
1708251427684,MATH 142B,B01,434071,Sanchez; Anthony,32,0,35,3
1708251427684,MATH 142B,B02,434083,Sanchez; Anthony,34,0,35,1
1708251427684,MATH 142B,C01,434094,Kunnawalkam Elayavalli; Sr,31,0,35,4
1708251427684,MATH 142B,C02,434095,Kunnawalkam Elayavalli; Sr,34,0,35,1
1708251428209,MATH 144,A01,434097,Cloninger; Alexander,30,0,30,0
1708251428740,MATH 150B,A01,434104,Parise; Davide,33,0,35,2
1708251429265,MATH 152,A01,434107,Grier; Daniel T,20,0,40,20
1708251429793,MATH 154,A01,434109,Wesley; William J,31,0,35,4
1708251429793,MATH 154,A02,434119,Wesley; William J,35,0,35,0
1708251429793,MATH 154,A03,434120,Wesley; William J,35,0,35,0
1708251429793,MATH 154,A04,434121,Wesley; William J,34,0,35,1
1708251429793,MATH 154,B01,434126,Aliabadi Sr.; Mohsen,26,0,35,9
1708251429793,MATH 154,B02,434127,Aliabadi Sr.; Mohsen,34,0,35,1
1708251429793,MATH 154,B03,434138,Aliabadi Sr.; Mohsen,35,0,35,0
1708251429793,MATH 154,B04,434139,Aliabadi Sr.; Mohsen,35,0,35,0
1708251430323,MATH 163,A01,434144,Bowers; Adam R.,0,0,5,5
1708251430850,MATH 170A,A01,434148,Nag; Panchali,36,0,36,0
1708251430850,MATH 170A,A02,434149,Nag; Panchali,36,0,36,0
1708251430850,MATH 170A,A03,434150,Nag; Panchali,36,0,37,1
1708251430850,MATH 170A,A04,434151,Nag; Panchali,36,0,36,0
1708251431379,MATH 170B,A01,434155,Huang; Lei,31,0,35,4
1708251431379,MATH 170B,A02,434160,Huang; Lei,35,0,35,0
1708251431379,MATH 170B,A03,434161,Huang; Lei,35,0,35,0
1708251431379,MATH 170B,A04,434162,Huang; Lei,35,0,35,0
1708251431905,MATH 170C,A01,434176,Leok; Melvin,30,0,35,5
1708251431905,MATH 170C,A02,434300,Leok; Melvin,34,0,35,1
1708251432431,MATH 171B,A01,434576,Nie; Jiawang,24,0,35,11
1708251432431,MATH 171B,A02,434583,Nie; Jiawang,35,0,35,0
1708251432431,MATH 171B,A03,434584,Nie; Jiawang,35,0,35,0
1708251432431,MATH 171B,A04,434609,Nie; Jiawang,35,0,35,0
1708251432973,MATH 180A,A01,434638,Gartland; Christopher John,29,0,30,1
1708251432973,MATH 180A,A02,434821,Gartland; Christopher John,28,0,30,2
1708251432973,MATH 180A,A03,434833,Gartland; Christopher John,24,0,30,6
1708251432973,MATH 180A,A04,434839,Gartland; Christopher John,30,0,30,0
1708251432973,MATH 180A,A05,434843,Gartland; Christopher John,30,0,30,0
1708251432973,MATH 180A,A06,434895,Gartland; Christopher John,30,0,30,0
1708251433498,MATH 180B,A01,435085,Gartland; Christopher John,30,0,35,5
1708251433498,MATH 180B,A02,435086,Gartland; Christopher John,35,0,35,0
1708251433498,MATH 180B,A03,435087,Gartland; Christopher John,34,0,35,1
1708251433498,MATH 180B,A04,435088,Gartland; Christopher John,35,0,35,0
1708251434026,MATH 180C,A01,435090,Carfagnini; Marco,29,0,35,6
1708251434026,MATH 180C,A02,435091,Carfagnini; Marco,35,0,35,0
1708251434026,MATH 180C,A03,435092,Carfagnini; Marco,32,0,35,3
1708251434026,MATH 180C,A04,435113,Carfagnini; Marco,35,0,35,0
1708251434553,MATH 181A,A01,435279,Zhang; Danna,30,0,35,5
1708251434553,MATH 181A,A02,435300,Zhang; Danna,35,0,35,0
1708251434553,MATH 181A,A03,435301,Zhang; Danna,21,0,35,14
1708251434553,MATH 181A,A04,435302,Zhang; Danna,31,0,35,4
1708251435078,MATH 181B,A01,435315,Rava; Denise,33,0,35,2
1708251435078,MATH 181B,A02,435316,Rava; Denise,32,0,35,3
1708251435078,MATH 181B,A03,435317,Rava; Denise,33,0,35,2
1708251435078,MATH 181B,A04,435318,Rava; Denise,35,0,35,0
1708251435623,MATH 183,A01,435320,Quarfoot; David James,26,0,35,9
1708251435623,MATH 183,A02,435321,Quarfoot; David James,35,0,35,0
1708251435623,MATH 183,A03,435322,Quarfoot; David James,32,0,35,3
1708251435623,MATH 183,A04,435323,Quarfoot; David James,34,0,35,1
1708251435623,MATH 183,A05,435327,Quarfoot; David James,34,0,35,1
1708251435623,MATH 183,A06,435329,Quarfoot; David James,33,0,35,2
1708251436150,MATH 184,A01,435337,Verstraete; Jacques Allan,32,0,35,3
1708251436150,MATH 184,A02,435338,Verstraete; Jacques Allan,35,0,35,0
1708251436150,MATH 184,A03,435339,Verstraete; Jacques Allan,34,0,35,1
1708251436150,MATH 184,A04,435347,Verstraete; Jacques Allan,30,0,35,5
1708251436692,MATH 185,A01,435432,Arias-Castro; Ery,15,0,30,15
1708251436692,MATH 185,A02,435436,Arias-Castro; Ery,30,0,30,0
1708251436692,MATH 185,A03,435437,Arias-Castro; Ery,30,0,30,0
1708251436692,MATH 185,A04,435438,Arias-Castro; Ery,30,0,30,0
1708251437222,MATH 187A,A01,435443,Agrawal; Shishir,15,0,30,15
1708251437222,MATH 187A,A02,435444,Agrawal; Shishir,30,0,30,0
1708251437222,MATH 187A,A03,435503,Agrawal; Shishir,28,0,30,2
1708251437222,MATH 187A,A04,435507,Agrawal; Shishir,30,0,30,0
1708251437222,MATH 187A,A05,435554,Agrawal; Shishir,22,0,30,8
1708251437222,MATH 187A,A06,435558,Agrawal; Shishir,28,0,30,2
1708251437749,MATH 187B,A01,435570,Bucur; Alina Ioana,24,0,35,11
1708251437749,MATH 187B,A02,435571,Bucur; Alina Ioana,35,0,35,0
1708251438279,MATH 188,A01,435573,Kunnawalkam Elayavalli; Sr,35,0,35,0
1708251438806,MATH 189,A01,435577,Vishwanath; Siddharth,0,0,10,10
1708251438806,MATH 189,A02,435594,Vishwanath; Siddharth,0,0,10,10
1708251438806,MATH 189,A03,435595,Vishwanath; Siddharth,0,0,10,10
1708251438806,MATH 189,A04,435596,Vishwanath; Siddharth,0,0,10,10
1708251438806,MATH 189,A05,480706,Vishwanath; Siddharth,2,0,10,8
1708251438806,MATH 189,A06,481362,Vishwanath; Siddharth,6,0,10,4
1708251439336,MATH 200C,A00,430388,Bucur; Alina Ioana,15,0,15,0
1708251439862,MATH 202C,A00,430389,Rhoades; Brendon Patrick,15,0,15,0
1708251440388,MATH 203C,A00,430390,Izadi; Elham,15,0,15,0
1708251440934,MATH 204C,A00,430391,Sorensen; Claus M,15,0,15,0
1708251441459,MATH 208,A00,430392,Izadi; Elham,8,0,10,2
1708251441987,MATH 209,A00,430393,Pollack; Aaron,10,0,10,0
1708251442513,MATH 211A,A00,430394,Salehi Golsefidy; Alireza,10,0,10,0
1708251443040,MATH 211B,A00,430395,Seward; Brandon M.,10,0,10,0
1708251443569,MATH 212B,A01,480692,Komarova; Natalia,5,0,5,0
1708251444094,MATH 216C,A00,430429,Saab; Rayan,13,0,15,2
1708251444622,MATH 217,A00,430430,Li; Bo,13,0,15,2
1708251445150,MATH 218,A00,430431,Li; Bo,8,0,10,2
1708251445676,MATH 220C,A00,430432,Xiao; Ming,15,0,15,0
1708251446202,MATH 240C,A00,430433,Ebenfelt; Peter F,14,0,15,1
1708251446729,MATH 241B,A00,430434,Ioana; Adrian,14,0,15,1
1708251447254,MATH 243,A00,430435,Kunnawalkam Elayavalli; Sr,9,0,10,1
1708251447782,MATH 248,A00,430436,Bejenaru; Ioan,9,0,10,1
1708251448309,MATH 251C,A00,430437,Wenzl; Hans G,15,0,15,0
1708251448835,MATH 258,A00,430438,Spolaor; Luca,10,0,10,0
1708251449364,MATH 261C,A00,430439,Manners; Frederick,14,0,15,1
1708251449893,MATH 262A,A00,430440,Warnke; Lutz Peter,14,0,15,1
1708251450419,MATH 268,A00,430441,Buss; Samuel R,10,0,10,0
1708251450948,MATH 269,A00,430442,Rhoades; Brendon Patrick & Warnke; Lutz Peter,10,0,10,0
1708251451473,MATH 270C,A00,430445,Cheng; Li-Tien,15,0,15,0
1708251451998,MATH 273B,A00,430452,Zhu; Yuhua,15,0,15,0
1708251452528,MATH 276,A00,430458,Mc Culloch; Andrew Douglas & Amaro; Rommie E,0,0,0,0
1708251453059,MATH 277A,A00,430464,Dumitriu; Ioana,14,0,15,1
1708251453602,MATH 278A,A00,430470,Cheng; Li-Tien,9,0,10,1
1708251454129,MATH 278B,A00,430471,Cloninger; Alexander,10,0,10,0
1708251454653,MATH 278C,A00,430472,Nie; Jiawang,9,0,10,1
1708251455179,MATH 280C,A00,430485,Schweinsberg; Jason,13,0,15,2
1708251455721,MATH 281C,A00,430496,Arias-Castro; Ery,8,0,15,7
1708251456247,MATH 284,A00,430503,Xu; Ronghui,11,0,15,4
1708251456773,MATH 287C,A00,430520,Zhang; Danna,14,0,15,1
1708251457303,MATH 288,A00,430527,Carfagnini; Marco,9,0,10,1
1708251457830,MATH 289A,A00,430541,Novak; Jonathan I,14,0,15,1
1708251458357,MATH 290C,A00,430548,Roberts; Justin Deritter,13,0,15,2
1708251458883,MATH 292,A00,430660,Lu; Yunze,10,0,10,0
1708251459411,MATH 294,A00,430678,Fitzsimmons; Patrick J,11,0,15,4
1708251459938,MATH 295,A00,430692,Bejenaru; Ioan,15,0,15,0
1708251460466,MATH 297,001,430721,Gamst; Anthony Collins,0,0,0,0
1708251460994,MATS 200,A00,414457,Graeve; Olivia A,9995,0,9999,4
1708251461521,MATS 201C,A00,414465,Arzt; Eduard,38,0,50,12
1708251462049,MATS 236,A00,414466,Staff,17,0,20,3
1708251462580,MATS 252,A00,414467,Evdokimenko; Ekaterina,42,0,45,3
1708251463105,MATS 261B,A00,414468,Qiao; Yu,17,0,25,8
1708251463633,MATS 295,A00,414469,Graeve; Olivia A,9999,0,9999,0
1708251463633,MATS 295,B00,478858,Kummel; Andrew C,9999,0,9999,0
1708251464166,MCWP 40,001,414476,Montejo; Carolina,19,0,20,1
1708251464166,MCWP 40,004,414480,Wastal; Carrie King,13,0,15,2
1708251464166,MCWP 40,005,414481,Wastal; Carrie King,10,0,15,5
1708251464166,MCWP 40,006,414482,Wastal; Carrie King,12,0,15,3
1708251464166,MCWP 40,007,414483,Wastal; Carrie King,13,0,15,2
1708251464166,MCWP 40,008,414484,Wastal; Carrie King,15,0,15,0
1708251464166,MCWP 40,009,414487,Wastal; Carrie King,12,0,15,3
1708251464166,MCWP 40,014,414505,Staff,20,0,20,0
1708251464166,MCWP 40,015,494362,Wastal; Carrie King,14,0,15,1
1708251464742,MCWP 50,002,414534,Bartulis; Jason Michael,20,0,20,0
1708251464742,MCWP 50,003,414536,Bartulis; Jason Michael,20,0,20,0
1708251464742,MCWP 50,004,414538,Krone; Jarret,16,0,20,4
1708251464742,MCWP 50,005,414539,Krone; Jarret,19,0,20,1
1708251464742,MCWP 50,006,414540,Smith; Haydee Marie,16,0,20,4
1708251464742,MCWP 50,007,414544,Compas; Sean Matthew,14,0,20,6
1708251464742,MCWP 50,008,414549,Redela; Pamela Morgan,20,0,20,0
1708251464742,MCWP 50,011,414557,Carter; Andrea L,16,0,20,4
1708251464742,MCWP 50,012,414592,Silva; Kelly B,20,0,20,0
1708251464742,MCWP 50,013,414593,Silva; Kelly B,19,0,20,1
1708251464742,MCWP 50,014,414594,Carter; Andrea L,20,0,20,0
1708251464742,MCWP 50,016,414596,Morshed; Michael James,14,0,20,6
1708251464742,MCWP 50,017,414598,Morshed; Michael James,17,0,20,3
1708251464742,MCWP 50,019,414601,Redela; Pamela Morgan,17,0,20,3
1708251464742,MCWP 50,020,414606,Carter; Jennifer A,20,0,20,0
1708251464742,MCWP 50,021,414607,Carter; Jennifer A,19,0,20,1
1708251464742,MCWP 50,022,414649,Compas; Sean Matthew,11,0,20,9
1708251464742,MCWP 50,023,414650,Smith; Haydee Marie,20,0,20,0
1708251464742,MCWP 50,024,414651,Nies; Laurie Elizabeth,19,0,20,1
1708251464742,MCWP 50,025,414655,Nies; Laurie Elizabeth,18,0,20,2
1708251464742,MCWP 50,026,414656,Pham; Vincent Minhduc,19,0,20,1
1708251464742,MCWP 50,027,414657,Pham; Vincent Minhduc,20,0,20,0
1708251464742,MCWP 50,028,414668,Morshed; Michael James,16,0,20,4
1708251464742,MCWP 50,029,414669,Morshed; Michael James,19,0,20,1
1708251465270,MCWP 50R,A00,486838,Miller; Elizabeth Deen,19,0,20,1
1708251465270,MCWP 50R,B00,486843,Miller; Elizabeth Deen,16,0,20,4
1708251465270,MCWP 50R,C00,486844,Miller; Elizabeth Deen,19,0,20,1
1708251465796,MCWP 125,A00,414670,Wilson; Marion E.,20,0,20,0
1708251465796,MCWP 125,B00,414674,Guillen; Melinda,20,0,20,0
1708251465796,MCWP 125,C00,414678,Guillen; Melinda,20,0,20,0
1708251465796,MCWP 125,D00,414682,Guillen; Melinda,20,0,20,0
1708251466324,MED 231,A00,476440,Hurst; Samantha,7,0,7,0
1708251466851,MED 246,A00,492785,Gordts; Philip & Varki; Ajit P & Lewis; Amanda Lark & Godula; Kamil & Gagneux; Pascal & Esko; Jeffrey D. & Bode; Lars,10,0,10,0
1708251467377,MED 262,A00,492942,Koola; Jejo David,28,0,30,2
1708251467903,MED 267,A01,492789,Hogarth; Michael Andrew,25,0,30,5
1708251468435,MED 275,A00,464684,Liu; George Yenhsi,10,0,10,0
1708251468961,MED 276,A00,492786,Sitapati; Amy,23,0,25,2
1708251469492,MED 278,A00,492787,Carter; Hannah Kathryn & Mesirov; Jill P. & Curtius; Kathleen Mary,20,0,20,0
1708251470022,MED 296,001,464685,Chi; Neil C.,48,0,50,2
1708251470022,MED 296,002,464686,Hong; Kimberly N,49,0,50,1
1708251470022,MED 296,003,464687,Staff,50,0,50,0
1708251470549,MGT 3,A00,442429,Wagner; Timothy Ryan,95,0,98,3
1708251471093,MGT 4,A01,442443,Levkoff; Steven B.,0,0,5,5
1708251471093,MGT 4,A02,442444,Levkoff; Steven B.,4,0,5,1
1708251471620,MGT 5,A00,442446,Molloie Jr.; William H,184,0,196,12
1708251472145,MGT 12,A00,442447,Lindenberger; Wade Douglas,83,0,100,17
1708251472145,MGT 12,B00,442448,Lindenberger; Wade Douglas,72,0,100,28
1708251472145,MGT 12,C00,442449,Pecore; Joseph P.,88,0,100,12
1708251472672,MGT 16,A00,442452,Buchanan; Harold G,97,0,100,3
1708251472672,MGT 16,B00,442459,Buchanan; Harold G,92,0,100,8
1708251472672,MGT 16,C00,442461,Campbell; Robert Harold,113,0,120,7
1708251472672,MGT 16,D00,442475,Campbell; Robert Harold,118,0,120,2
1708251473236,MGT 18,A00,442477,McKay; Michael J,98,0,98,0
1708251473236,MGT 18,B00,442491,McKay; Michael J,96,0,98,2
1708251473236,MGT 18,C00,442493,McKay; Michael J,98,0,98,0
1708251473236,MGT 18,D00,442503,Chamberlain; Travis Dean,98,0,98,0
1708251473762,MGT 45,A00,442508,Pecore; Joseph P.,146,0,150,4
1708251473762,MGT 45,B00,442510,Pecore; Joseph P.,142,0,150,8
1708251474285,MGT 71,A00,442524,Lee; Hyun Seok,77,0,98,21
1708251474814,MGT 71R,A00,442526,Phiroz; Zal Navroze,77,0,98,21
1708251475340,MGT 100,A00,442541,Wilbur; Kenneth C,82,0,98,16
1708251475340,MGT 100,B00,442542,Wilbur; Kenneth C,89,0,98,9
1708251475884,MGT 103,A00,442543,Eberhard; Craig A,98,0,98,0
1708251475884,MGT 103,B00,442544,Eberhard; Craig A,95,0,98,3
1708251475884,MGT 103,C00,442545,Ehrich; Kristine R,90,0,98,8
1708251475884,MGT 103,D00,442547,Ehrich; Kristine R,96,0,98,2
1708251475884,MGT 103,E00,442548,Ehrich; Kristine R,97,0,98,1
1708251475884,MGT 103,F00,442549,Demill; Burritt,92,0,98,6
1708251475884,MGT 103,G00,442550,Bates; Kenneth Walter,97,0,98,1
1708251476414,MGT 105,A00,442558,Bates; Kenneth Walter,86,0,98,12
1708251476940,MGT 106,A00,442560,Eberhard; Craig A,95,0,98,3
1708251477466,MGT 109,A00,442574,Campbell; Colin Leslie,90,0,98,8
1708251477996,MGT 112,A00,442576,Somasundaram; Tyagarajan,96,0,98,2
1708251477996,MGT 112,B00,442590,Somasundaram; Tyagarajan,94,0,98,4
1708251477996,MGT 112,C00,442592,Zimmermann; Carsten,87,0,98,11
1708251478527,MGT 119,A00,442602,Staff,97,0,98,1
1708251478527,MGT 119,B00,442603,Anderson; Jon Marcus,96,0,98,2
1708251479053,MGT 121B,A00,442606,Klaas; Jeffrey David,94,0,98,4
1708251479579,MGT 128R,A00,442607,Krishnan; Viswanathan,84,0,98,14
1708251480123,MGT 131A,A00,442608,Houskeeper; Robert,148,0,150,2
1708251480702,MGT 131B,A00,442609,Houskeeper; Robert,100,0,100,0
1708251481228,MGT 132,A00,442610,Blakley; Bruce,97,0,98,1
1708251481758,MGT 137,A00,442611,Lindenberger; Wade Douglas,86,0,98,12
1708251482286,MGT 147,A00,442612,Anderson; John Charles,32,0,40,8
1708251482812,MGT 151R,A00,442613,Phiroz; Zal Navroze,92,0,98,6
1708251483340,MGT 153,A00,442650,Perols; Johan Lars,55,0,80,25
1708251483866,MGT 162,A00,442652,Demill; Burritt,81,0,98,17
1708251483866,MGT 162,B00,442654,Demill; Burritt,88,0,98,10
1708251483866,MGT 162,C00,442776,Staff,95,0,98,3
1708251483866,MGT 162,D00,442778,Staff,96,0,98,2
1708251484392,MGT 164,A00,442780,McKay; Mary A,97,0,98,1
1708251484392,MGT 164,B00,442849,McKay; Mary A,96,0,98,2
1708251484392,MGT 164,C00,442917,McKay; Mary A,97,0,98,1
1708251484392,MGT 164,D00,442949,Meyer; Alison Bloomfield,90,0,98,8
1708251484925,MGT 166,A00,443017,Moran; Cathleen L.,95,0,98,3
1708251484925,MGT 166,B00,443045,Moran; Cathleen L.,97,0,98,1
1708251484925,MGT 166,C00,443046,Moran; Cathleen L.,98,0,98,0
1708251485453,MGT 167,A00,443047,Klaas; Jeffrey David,93,0,98,5
1708251485981,MGT 171R,A00,443048,Phiroz; Zal Navroze,86,0,98,12
1708251486509,MGT 172,A00,443049,Hedges; Kathleen & Royal; Rebecca,116,0,120,4
1708251486509,MGT 172,B00,443050,Hedges; Kathleen,95,0,98,3
1708251486509,MGT 172,C00,443051,Zimmermann; Carsten,96,0,98,2
1708251487035,MGT 173,A00,443052,Hayes; Sherry Lorine,92,0,100,8
1708251487560,MGT 175,A00,443053,Gopal; Christopher S.,98,0,98,0
1708251488090,MGT 180,A00,443055,Bliss; Barbara Ann,139,0,150,11
1708251488090,MGT 180,B00,443069,Bliss; Barbara Ann,145,0,150,5
1708251488619,MGT 181,A00,443120,Buchanan; Harold G,147,0,150,3
1708251489149,MGT 183,A00,443121,Banerjee; Snehal,88,0,98,10
1708251489681,MGT 185,A00,443122,Dunn; Louis Jean,90,0,98,8
1708251490207,MGT 187,A00,443133,Dunn; Louis Jean,95,0,100,5
1708251490734,MGT 189,A00,443134,Avenancio-Leon; Carlos,98,0,98,0
1708251491263,MGT 227,A00,479242,Serra Garcia; Marta,19,0,20,1
1708251491790,MGT 259,A00,443135,Oveis; Christopher S,19,0,20,1
1708251492318,MGT 296,001,481416,Gneezy; Ayelet,3,0,3,0
1708251492318,MGT 296,002,481420,Amir; On,3,0,3,0
1708251492318,MGT 296,003,481466,Amir; On & Karmarkar; Uma R,3,0,3,0
1708251492318,MGT 296,004,481468,Liu; Jun,3,0,3,0
1708251492318,MGT 296,005,481469,Misra; Kanishka,3,0,3,0
1708251492318,MGT 296,006,481470,Erat; Sanjiv,3,0,3,0
1708251492318,MGT 296,007,481473,Timmermann; Allan,3,0,3,0
1708251492318,MGT 296,008,481474,Smith; Pamela Karen,3,0,3,0
1708251492318,MGT 296,009,481477,Zhang; Zhe,3,0,3,0
1708251492318,MGT 296,010,481478,Oveis; Christopher S,3,0,3,0
1708251492318,MGT 296,011,481479,Amir; On & Gneezy; Ayelet,3,0,3,0
1708251492318,MGT 296,012,481481,Wilbur; Kenneth C,3,0,3,0
1708251492854,MMW 13,A01,412918,Chang; Edmond Yi-Teh,15,0,16,1
1708251492854,MMW 13,A02,412928,Chang; Edmond Yi-Teh,16,0,16,0
1708251492854,MMW 13,A03,413017,Chang; Edmond Yi-Teh,16,0,16,0
1708251492854,MMW 13,A04,413018,Chang; Edmond Yi-Teh,16,0,16,0
1708251492854,MMW 13,A05,413019,Chang; Edmond Yi-Teh,15,0,16,1
1708251492854,MMW 13,A06,413020,Chang; Edmond Yi-Teh,16,0,16,0
1708251492854,MMW 13,A07,413021,Chang; Edmond Yi-Teh,15,0,16,1
1708251492854,MMW 13,A08,413023,Chang; Edmond Yi-Teh,16,0,16,0
1708251492854,MMW 13,A09,413024,Chang; Edmond Yi-Teh,16,0,16,0
1708251492854,MMW 13,A10,413025,Chang; Edmond Yi-Teh,16,0,16,0
1708251492854,MMW 13,A11,413026,Chang; Edmond Yi-Teh,16,0,16,0
1708251492854,MMW 13,A12,413027,Chang; Edmond Yi-Teh,16,0,16,0
1708251492854,MMW 13,A13,413028,Chang; Edmond Yi-Teh,0,0,0,0
1708251492854,MMW 13,A14,413029,Chang; Edmond Yi-Teh,0,0,0,0
1708251492854,MMW 13,A15,413030,Chang; Edmond Yi-Teh,14,0,16,2
1708251492854,MMW 13,A16,413031,Chang; Edmond Yi-Teh,15,0,16,1
1708251492854,MMW 13,A17,413032,Chang; Edmond Yi-Teh,16,0,16,0
1708251492854,MMW 13,A18,413034,Chang; Edmond Yi-Teh,14,0,16,2
1708251492854,MMW 13,A19,413035,Chang; Edmond Yi-Teh,16,0,16,0
1708251492854,MMW 13,A20,413036,Chang; Edmond Yi-Teh,16,0,16,0
1708251492854,MMW 13,A21,413037,Chang; Edmond Yi-Teh,0,0,0,0
1708251492854,MMW 13,A22,413038,Chang; Edmond Yi-Teh,0,0,0,0
1708251492854,MMW 13,B01,413290,Zhiri; Oumelbanine,15,0,16,1
1708251492854,MMW 13,B02,413291,Zhiri; Oumelbanine,15,0,16,1
1708251492854,MMW 13,B03,413308,Zhiri; Oumelbanine,14,0,16,2
1708251492854,MMW 13,B04,413322,Zhiri; Oumelbanine,14,0,16,2
1708251492854,MMW 13,B05,413343,Zhiri; Oumelbanine,12,0,16,4
1708251492854,MMW 13,B06,413344,Zhiri; Oumelbanine,14,0,16,2
1708251492854,MMW 13,B07,413524,Zhiri; Oumelbanine,16,0,16,0
1708251492854,MMW 13,B08,413584,Zhiri; Oumelbanine,16,0,16,0
1708251492854,MMW 13,B09,413588,Zhiri; Oumelbanine,15,0,16,1
1708251492854,MMW 13,B10,413590,Zhiri; Oumelbanine,16,0,16,0
1708251492854,MMW 13,B11,413779,Zhiri; Oumelbanine,12,0,16,4
1708251492854,MMW 13,B12,413780,Zhiri; Oumelbanine,9,0,16,7
1708251492854,MMW 13,B13,413781,Zhiri; Oumelbanine,0,0,0,0
1708251492854,MMW 13,B14,413782,Zhiri; Oumelbanine,0,0,0,0
1708251492854,MMW 13,B15,413808,Zhiri; Oumelbanine,16,0,16,0
1708251492854,MMW 13,B16,413815,Zhiri; Oumelbanine,15,0,16,1
1708251492854,MMW 13,B17,413816,Zhiri; Oumelbanine,15,0,16,1
1708251492854,MMW 13,B18,413817,Zhiri; Oumelbanine,12,0,16,4
1708251492854,MMW 13,B19,413822,Zhiri; Oumelbanine,16,0,16,0
1708251492854,MMW 13,B20,413823,Zhiri; Oumelbanine,14,0,16,2
1708251492854,MMW 13,B21,413825,Zhiri; Oumelbanine,0,0,0,0
1708251492854,MMW 13,B22,413826,Zhiri; Oumelbanine,0,0,0,0
1708251492854,MMW 13,B23,413827,Zhiri; Oumelbanine,16,0,16,0
1708251492854,MMW 13,B24,413834,Zhiri; Oumelbanine,15,0,16,1
1708251492854,MMW 13,C01,413859,Vitkus; Daniel J.,16,0,16,0
1708251492854,MMW 13,C02,413860,Vitkus; Daniel J.,16,0,16,0
1708251492854,MMW 13,C04,413868,Vitkus; Daniel J.,0,0,0,0
1708251492854,MMW 13,C05,413869,Vitkus; Daniel J.,16,0,16,0
1708251492854,MMW 13,C06,413871,Vitkus; Daniel J.,16,0,16,0
1708251492854,MMW 13,C07,413886,Vitkus; Daniel J.,16,0,16,0
1708251492854,MMW 13,C08,413908,Vitkus; Daniel J.,16,0,16,0
1708251492854,MMW 13,C09,413930,Vitkus; Daniel J.,16,0,16,0
1708251492854,MMW 13,C10,413952,Vitkus; Daniel J.,15,0,16,1
1708251492854,MMW 13,C11,413972,Vitkus; Daniel J.,16,0,16,0
1708251492854,MMW 13,C12,413991,Vitkus; Daniel J.,16,0,16,0
1708251492854,MMW 13,C13,414007,Vitkus; Daniel J.,0,0,0,0
1708251492854,MMW 13,C14,414017,Vitkus; Daniel J.,0,0,0,0
1708251492854,MMW 13,C15,414030,Vitkus; Daniel J.,16,0,16,0
1708251492854,MMW 13,C16,414032,Vitkus; Daniel J.,16,0,16,0
1708251492854,MMW 13,C17,414033,Vitkus; Daniel J.,15,0,16,1
1708251492854,MMW 13,C18,414034,Vitkus; Daniel J.,16,0,16,0
1708251492854,MMW 13,C19,414041,Vitkus; Daniel J.,16,0,16,0
1708251492854,MMW 13,C20,414056,Vitkus; Daniel J.,16,0,16,0
1708251492854,MMW 13,C21,414057,Vitkus; Daniel J.,15,0,16,1
1708251492854,MMW 13,C22,414059,Vitkus; Daniel J.,16,0,16,0
1708251493384,MMW 15,A01,414065,Chang; Edmond Yi-Teh,28,0,28,0
1708251493384,MMW 15,A02,414067,Chang; Edmond Yi-Teh,27,0,28,1
1708251493384,MMW 15,A03,414092,Chang; Edmond Yi-Teh,26,0,28,2
1708251493384,MMW 15,A04,414104,Chang; Edmond Yi-Teh,28,0,28,0
1708251493384,MMW 15,A05,414121,Chang; Edmond Yi-Teh,0,0,0,0
1708251493384,MMW 15,A06,414122,Chang; Edmond Yi-Teh,0,0,0,0
1708251493384,MMW 15,A07,414123,Chang; Edmond Yi-Teh,27,0,28,1
1708251493384,MMW 15,A08,414124,Chang; Edmond Yi-Teh,28,0,28,0
1708251493384,MMW 15,A09,414125,Chang; Edmond Yi-Teh,0,0,0,0
1708251493384,MMW 15,A10,414130,Chang; Edmond Yi-Teh,0,0,0,0
1708251493384,MMW 15,B01,414132,Radcliff; Pamela B.,27,0,28,1
1708251493384,MMW 15,B02,414134,Radcliff; Pamela B.,27,0,28,1
1708251493384,MMW 15,B03,414135,Radcliff; Pamela B.,26,0,28,2
1708251493384,MMW 15,B04,414136,Radcliff; Pamela B.,27,0,28,1
1708251493384,MMW 15,B05,414137,Radcliff; Pamela B.,28,0,28,0
1708251493384,MMW 15,B06,414138,Radcliff; Pamela B.,27,0,28,1
1708251493384,MMW 15,B07,414140,Radcliff; Pamela B.,26,0,28,2
1708251493384,MMW 15,B08,414141,Radcliff; Pamela B.,28,0,28,0
1708251493384,MMW 15,C01,414143,Prestholdt; Jeremy,0,0,0,0
1708251493384,MMW 15,C02,414144,Prestholdt; Jeremy,0,0,0,0
1708251493384,MMW 15,C03,414145,Prestholdt; Jeremy,24,0,28,4
1708251493384,MMW 15,C04,414147,Prestholdt; Jeremy,17,0,28,11
1708251493384,MMW 15,C05,414148,Prestholdt; Jeremy,28,0,28,0
1708251493384,MMW 15,C06,414149,Prestholdt; Jeremy,26,0,28,2
1708251493384,MMW 15,C07,414152,Prestholdt; Jeremy,25,0,28,3
1708251493384,MMW 15,C08,414153,Prestholdt; Jeremy,23,0,28,5
1708251493913,MSED 295,A00,477850,Rabin; Jeffrey Mark,5,0,5,0
1708251493913,MSED 295,B00,477852,Lo; Stanley M.,5,0,5,0
1708251494438,MSED 296C,A00,477853,Staff,14,0,15,1
1708251494964,MUS 1C,A01,416488,Ishov; Alexander Alexandrovich,24,0,25,1
1708251494964,MUS 1C,A02,416502,Ishov; Alexander Alexandrovich,25,0,25,0
1708251494964,MUS 1C,A03,416519,Ishov; Alexander Alexandrovich,25,0,25,0
1708251494964,MUS 1C,A04,416520,Ishov; Alexander Alexandrovich,25,0,25,0
1708251494964,MUS 1C,A05,416521,Ishov; Alexander Alexandrovich,25,0,25,0
1708251495496,MUS 2C,A01,416523,Richards; Stephanie F,30,0,30,0
1708251496023,MUS 2CK,A00,416524,Ohnishi; Takae,15,0,15,0
1708251496023,MUS 2CK,B00,416547,Ohnishi; Takae,15,0,15,0
1708251496549,MUS 2JK,A00,416548,Kenyatta; Kamau,15,0,15,0
1708251497076,MUS 4,A01,416562,Staff,25,0,25,0
1708251497076,MUS 4,A02,416634,Staff,24,0,25,1
1708251497076,MUS 4,A03,416644,Staff,25,0,25,0
1708251497076,MUS 4,A04,416659,Staff,24,0,25,1
1708251497076,MUS 4,A05,416667,Staff,25,0,25,0
1708251497076,MUS 4,A06,416757,Staff,25,0,25,0
1708251497076,MUS 4,A07,416830,Staff,25,0,25,0
1708251497076,MUS 4,A08,416953,Staff,23,0,25,2
1708251497076,MUS 4,A09,417005,Staff,25,0,25,0
1708251497076,MUS 4,A10,417007,Staff,24,0,25,1
1708251497607,MUS 7,A01,417048,Staff,23,0,24,1
1708251497607,MUS 7,A02,417102,Staff,23,0,24,1
1708251497607,MUS 7,A03,417103,Staff,23,0,24,1
1708251497607,MUS 7,A04,417114,Staff,22,0,24,2
1708251498134,MUS 8,A01,417119,Staff,14,0,20,6
1708251498134,MUS 8,A02,417163,Staff,16,0,20,4
1708251498134,MUS 8,A03,417164,Staff,16,0,20,4
1708251498134,MUS 8,A04,417165,Staff,17,0,20,3
1708251498134,MUS 8,A05,417194,Staff,18,0,20,2
1708251498134,MUS 8,A06,417198,Staff,20,0,20,0
1708251498669,MUS 11,A01,417201,Terrazas Perez; Wilfrido D,21,0,25,4
1708251498669,MUS 11,A02,417219,Terrazas Perez; Wilfrido D,23,0,25,2
1708251498669,MUS 11,A03,417220,Terrazas Perez; Wilfrido D,25,0,25,0
1708251498669,MUS 11,A04,417222,Terrazas Perez; Wilfrido D,25,0,25,0
1708251498669,MUS 11,A05,417223,Terrazas Perez; Wilfrido D,24,0,25,1
1708251498669,MUS 11,A06,417295,Terrazas Perez; Wilfrido D,23,0,25,2
1708251498669,MUS 11,A07,417297,Terrazas Perez; Wilfrido D,24,0,25,1
1708251498669,MUS 11,A08,417298,Terrazas Perez; Wilfrido D,25,0,25,0
1708251499200,MUS 12,A01,417300,Guy; Nancy,25,0,25,0
1708251499200,MUS 12,A02,417301,Guy; Nancy,25,0,25,0
1708251499200,MUS 12,A03,417302,Guy; Nancy,25,0,25,0
1708251499200,MUS 12,A04,417303,Guy; Nancy,25,0,25,0
1708251499727,MUS 13,A01,417305,Leslie Santana; Myrta,25,0,25,0
1708251499727,MUS 13,A02,417306,Leslie Santana; Myrta,25,0,25,0
1708251499727,MUS 13,A03,417307,Leslie Santana; Myrta,25,0,25,0
1708251499727,MUS 13,A04,417308,Leslie Santana; Myrta,25,0,25,0
1708251500258,MUS 15,A01,417327,Schaffer; Max Benjamin,18,0,20,2
1708251500258,MUS 15,A02,417331,Schaffer; Max Benjamin,19,0,20,1
1708251500258,MUS 15,A03,417358,Schaffer; Max Benjamin,19,0,20,1
1708251500258,MUS 15,A04,417359,Schaffer; Max Benjamin,17,0,20,3
1708251500258,MUS 15,A05,417360,Schaffer; Max Benjamin,20,0,20,0
1708251500258,MUS 15,A06,417370,Schaffer; Max Benjamin,20,0,20,0
1708251500258,MUS 15,A07,417371,Schaffer; Max Benjamin,17,0,20,3
1708251500258,MUS 15,A08,417372,Schaffer; Max Benjamin,18,0,20,2
1708251500258,MUS 15,A09,417378,Schaffer; Max Benjamin,19,0,20,1
1708251500258,MUS 15,A10,417379,Schaffer; Max Benjamin,19,0,20,1
1708251500791,MUS 17,A01,417381,Staff,22,0,25,3
1708251500791,MUS 17,A02,417406,Staff,24,0,25,1
1708251500791,MUS 17,A03,417420,Staff,24,0,25,1
1708251500791,MUS 17,A04,417594,Staff,24,0,25,1
1708251500791,MUS 17,A05,417595,Staff,25,0,25,0
1708251500791,MUS 17,A06,417605,Staff,21,0,25,4
1708251500791,MUS 17,A07,417606,Staff,25,0,25,0
1708251500791,MUS 17,A08,417627,Staff,25,0,25,0
1708251500791,MUS 17,A09,417628,Staff,21,0,25,4
1708251500791,MUS 17,A10,417629,Staff,24,0,25,1
1708251500791,MUS 17,A11,417630,Staff,25,0,25,0
1708251500791,MUS 17,A12,417631,Staff,24,0,25,1
1708251500791,MUS 17,A13,417632,Staff,25,0,25,0
1708251500791,MUS 17,A14,417633,Staff,25,0,25,0
1708251501316,MUS 32,001,418855,Dresser; Mark Stuart,10,0,10,0
1708251501316,MUS 32,002,418856,Kenyatta; Kamau,9,0,10,1
1708251501316,MUS 32,003,418864,Curtis; Charles Rector,10,0,10,0
1708251501316,MUS 32,004,418865,Carlstrom; Mitchell Kraig,9,0,10,1
1708251501316,MUS 32,005,418868,Terrazas Perez; Wilfrido D,10,0,10,0
1708251501316,MUS 32,006,418869,Ohnishi; Takae,10,0,10,0
1708251501316,MUS 32,007,418872,Burr; Anthony I,10,0,10,0
1708251501316,MUS 32,008,418873,Carlson; Erik Norman,10,0,10,0
1708251501316,MUS 32,009,418874,Blair; Kyle Adam,10,0,10,0
1708251501316,MUS 32,010,418875,Richards; Stephanie F,10,0,10,0
1708251501845,MUS 32V,A00,417634,Narucki; Susan M,10,0,10,0
1708251501845,MUS 32V,B00,417635,Staff,10,0,10,0
1708251502370,MUS 32VM,A00,417636,Staff,15,0,15,0
1708251502902,MUS 33C,A00,417637,Taylor; Alexander Lawther,20,0,20,0
1708251503428,MUS 43,A00,417647,Burr; Anthony I,83,0,90,7
1708251503957,MUS 95D,A00,417919,Staff,40,0,40,0
1708251504483,MUS 95E,A00,417933,Henson; Matthew Alexander,55,0,55,0
1708251505009,MUS 95G,A00,417935,Anderson; Kenneth,387,0,395,8
1708251505009,MUS 95G,B00,417937,Anderson; Kenneth,394,0,395,1
1708251505537,MUS 95JC,A00,417939,Kenyatta; Kamau,30,0,30,0
1708251506063,MUS 95L,A00,417940,Jones; Michael David,50,0,50,0
1708251506588,MUS 95W,A00,417946,Seshadri; Kartik,29,0,30,1
1708251506588,MUS 95W,B00,417948,Seshadri; Kartik,30,0,30,0
1708251507116,MUS 101C,A01,417951,Burr; Anthony I,33,0,35,2
1708251507643,MUS 103C,A00,417952,Davis; Anthony Curtis,14,0,15,1
1708251508169,MUS 103F,A00,417959,Obermueller; Karola,1,0,1,0
1708251508699,MUS 113,A00,418015,Narucki; Susan M,13,0,15,2
1708251509225,MUS 120C,A01,418032,Leslie Santana; Myrta,25,0,25,0
1708251509754,MUS 127,A00,418037,Richards; Stephanie F,92,0,100,8
1708251510284,MUS 130,A00,418047,Ohnishi; Takae,30,0,30,0
1708251510810,MUS 131,A00,418065,Roberts; Matana,30,0,30,0
1708251511340,MUS 132,001,418883,Dresser; Mark Stuart,10,0,10,0
1708251511340,MUS 132,002,418885,Kenyatta; Kamau,10,0,10,0
1708251511340,MUS 132,003,418886,Curtis; Charles Rector,10,0,10,0
1708251511340,MUS 132,004,418887,Carlstrom; Mitchell Kraig,10,0,10,0
1708251511340,MUS 132,005,418888,Jones; Michael David,10,0,10,0
1708251511340,MUS 132,006,418889,Terrazas Perez; Wilfrido D,10,0,10,0
1708251511340,MUS 132,007,418893,Ohnishi; Takae,10,0,10,0
1708251511340,MUS 132,008,418894,Burr; Anthony I,10,0,10,0
1708251511340,MUS 132,009,418896,Carlson; Erik Norman,10,0,10,0
1708251511340,MUS 132,010,418900,Blair; Kyle Adam,10,0,10,0
1708251511340,MUS 132,011,418932,Richards; Stephanie F,10,0,10,0
1708251511340,MUS 132,012,418933,Nourai; Keyarash,10,0,10,0
1708251511866,MUS 132R,A00,418067,Burr; Anthony I,5,0,5,0
1708251511866,MUS 132R,B00,418078,Jones; Michael David,5,0,5,0
1708251512391,MUS 132V,A00,418092,Narucki; Susan M,15,0,15,0
1708251512391,MUS 132V,B00,418096,Staff,15,0,15,0
1708251512920,MUS 134,A00,418098,Staff,40,0,40,0
1708251513447,MUS 137C,A00,418109,Kenyatta; Kamau,25,0,25,0
1708251513979,MUS 143,A00,418123,Burr; Anthony I,33,0,40,7
1708251514505,MUS 150,A00,418127,Davis; Anthony Curtis,28,0,30,2
1708251515031,MUS 151,A00,418129,Hankins; Sarah E.,20,0,30,10
1708251515562,MUS 160B,A00,418172,Staff,11,0,15,4
1708251515562,MUS 160B,B00,418175,Dubnov; Shlomo,14,0,15,1
1708251516087,MUS 172,A01,418178,Staff,36,0,40,4
1708251516614,MUS 174C,A00,418179,Erbe; Tom,24,0,27,3
1708251517140,MUS 175,A00,418247,Smyth; Tamara R.,28,0,30,2
1708251517665,MUS 177,A00,418265,Erbe; Tom,11,0,15,4
1708251518194,MUS 201A,A00,418267,Narucki; Susan M,15,0,15,0
1708251518194,MUS 201A,B00,418268,Dresser; Mark Stuart,13,0,15,2
1708251518725,MUS 203C,A00,418269,Lou; Michelle Siulai,15,0,15,0
1708251519253,MUS 203D,A00,418272,Davis; Anthony Curtis,4,0,5,1
1708251519253,MUS 203D,B00,418275,Obermueller; Karola,5,0,5,0
1708251519253,MUS 203D,C00,418277,Liang; Lei,5,0,5,0
1708251519253,MUS 203D,D00,418323,Lou; Michelle Siulai,5,0,5,0
1708251519781,MUS 204,A00,418324,Obermueller; Karola,24,0,25,1
1708251520308,MUS 205,A00,418325,Cimini; Amy Marie,22,0,25,3
1708251520834,MUS 206,A00,418326,Liang; Lei,13,0,15,2
1708251520834,MUS 206,B00,418327,Roberts; Matana,13,0,15,2
1708251521361,MUS 215C,A00,418328,Cimini; Amy Marie,14,0,15,1
1708251521889,MUS 232,001,418937,Dresser; Mark Stuart,9,0,10,1
1708251521889,MUS 232,002,418969,Kenyatta; Kamau,10,0,10,0
1708251521889,MUS 232,003,418971,Curtis; Charles Rector,10,0,10,0
1708251521889,MUS 232,004,418974,Terrazas Perez; Wilfrido D,10,0,10,0
1708251521889,MUS 232,005,418979,Ohnishi; Takae,10,0,10,0
1708251521889,MUS 232,006,418980,Burr; Anthony I,10,0,10,0
1708251521889,MUS 232,007,418981,Carlson; Erik Norman,10,0,10,0
1708251521889,MUS 232,008,418982,Richards; Stephanie F,10,0,10,0
1708251521889,MUS 232,009,418985,Narucki; Susan M,10,0,10,0
1708251522418,MUS 234,A00,418329,Staff,15,0,15,0
1708251522948,MUS 245,A00,418330,Carlson; Erik Norman,14,0,15,1
1708251523474,MUS 267,A00,418331,Erbe; Tom,15,0,15,0
1708251524002,MUS 270B,A00,418332,Staff,15,0,15,0
1708251524528,MUS 270D,A00,479231,Smyth; Tamara R.,15,0,15,0
1708251525059,NANO 103,A00,414714,Jahed Motlagh; Zeinab,40,0,40,0
1708251525586,NANO 108,A00,414740,Lubarda; Vlado,70,0,70,0
1708251526116,NANO 112,A01,414825,Vazquez Mena; Oscar,70,0,70,0
1708251526643,NANO 115L,A01,414830,Yang; Kesong,37,0,38,1
1708251526643,NANO 115L,B01,414832,Xu; Sheng,35,0,38,3
1708251527169,NANO 120B,A01,414835,Vecchio; Kenneth S,33,0,35,2
1708251527169,NANO 120B,B01,414841,Fenning; David,30,0,35,5
1708251527699,NANO 156,A00,414843,Fullerton; Eric E,24,0,30,6
1708251528228,NANO 158,A00,414844,Luo; Jian,29,0,30,1
1708251528754,NANO 175,A00,414850,Steinmetz; Nicole F,30,0,35,5
1708251529280,NANO 200,A00,414852,Jahed Motlagh; Zeinab,118,0,120,2
1708251529807,NANO 241,A00,414854,Pokorski; Jonathan Kyle,18,0,25,7
1708251530336,NANO 262,A00,414858,Wang; Joseph,50,0,50,0
1708251530862,NANO 271,A00,414862,Cubukcu; Ertugrul,22,0,25,3
1708251531388,NANO 272,A00,414877,Xu; Sheng,42,0,50,8
1708251531914,NANO 279,A00,414878,Liu; Ping,32,0,40,8
1708251532447,NANO 282,A00,414879,Steinmetz; Nicole F,30,0,30,0
1708251532976,NEU 200C,A00,455013,Staff,0,0,0,1
1708251533502,NEU 276,A01,479489,Staff,35,0,36,1
1708251534086,NEU 277,A00,479492,Risbrough; Victoria Blythe,0,0,0,0
1708251534611,NEU 296,001,464921,Evans; Sean Jeffrey,48,0,50,2
1708251534611,NEU 296,002,464922,Staff,50,0,50,0
1708251534611,NEU 296,003,464925,Staff,50,0,50,0
1708251535139,NEUG 221,A00,479490,Zheng; Binhai,15,0,15,0
1708251535669,NEUG 280,A00,479491,Chen; Xu,0,0,0,0
1708251536195,NEUG 296,A00,479493,Bloodgood; Brenda Laurie,9998,0,9999,1
1708251536722,OPTH 296,001,465054,Baxter; Sally Liu,49,0,50,1
1708251536722,OPTH 296,002,465068,Afshari; Natalie,49,0,50,1
1708251536722,OPTH 296,003,465074,Staff,50,0,50,0
1708251537247,ORTH 296,A00,465104,Staff,50,0,50,0
1708251537247,ORTH 296,001,465111,Staff,50,0,50,0
1708251537247,ORTH 296,002,465120,Staff,50,0,50,0
1708251537773,PATH 224,A01,494386,Ross; Camille,11,0,12,1
1708251538303,PATH 296,001,465373,Calcutt; Nigel A,49,0,50,1
1708251538303,PATH 296,002,465374,Staff,50,0,50,0
1708251538303,PATH 296,003,465375,Staff,50,0,50,0
1708251538830,PEDS 296,001,465527,Weiss; Katherine Jean,49,0,50,1
1708251538830,PEDS 296,002,465528,Staff,50,0,50,0
1708251538830,PEDS 296,003,465529,Staff,50,0,50,0
1708251539357,PH 196BH,A01,405158,Binkin; Nancy Jeanne,20,0,20,0
1708251539887,PHAR 219,A00,415016,Ross; Camille,1,0,1,0
1708251540413,PHAR 231,A00,415017,Furnari; Frank,20,0,20,0
1708251540413,PHAR 231,B00,415018,Lopez Ramirez; Miguel Alej,20,0,20,0
1708251540941,PHAR 276,A00,415020,Mc Culloch; Andrew Douglas & Amaro; Rommie E,1,0,1,0
1708251541466,PHAR 295,A00,415022,Brown; Joan Heller,15,0,15,0
1708251541992,PHIL 1,A00,415023,Harrell; Maralee Mae,58,0,60,2
1708251542520,PHIL 10,A01,415026,Grush; Rick Scott,40,0,44,4
1708251542520,PHIL 10,A02,415028,Grush; Rick Scott,42,0,44,2
1708251542520,PHIL 10,A03,415029,Grush; Rick Scott,0,0,0,0
1708251542520,PHIL 10,A04,415031,Grush; Rick Scott,0,0,0,0
1708251542520,PHIL 10,A05,415113,Grush; Rick Scott,43,0,44,1
1708251542520,PHIL 10,A06,415114,Grush; Rick Scott,43,0,44,1
1708251542520,PHIL 10,A07,415116,Grush; Rick Scott,44,0,44,0
1708251542520,PHIL 10,A08,415118,Grush; Rick Scott,43,0,44,1
1708251543048,PHIL 12,A01,415120,McKenzie; Kerry V.,28,0,30,2
1708251543048,PHIL 12,A02,415136,McKenzie; Kerry V.,30,0,30,0
1708251543048,PHIL 12,A03,415137,McKenzie; Kerry V.,27,0,30,3
1708251543048,PHIL 12,A04,415142,McKenzie; Kerry V.,30,0,30,0
1708251543581,PHIL 13,A01,415165,Brink; David O.,25,0,25,0
1708251543581,PHIL 13,A02,415179,Brink; David O.,22,0,25,3
1708251543581,PHIL 13,A03,415185,Brink; David O.,24,0,25,1
1708251543581,PHIL 13,A04,415201,Brink; David O.,25,0,25,0
1708251543581,PHIL 13,A05,415204,Brink; David O.,25,0,25,0
1708251543581,PHIL 13,A06,415220,Brink; David O.,25,0,25,0
1708251544107,PHIL 15,A01,415250,Fulkerson; Matthew Todd,26,0,30,4
1708251544107,PHIL 15,A02,415281,Fulkerson; Matthew Todd,29,0,30,1
1708251544639,PHIL 27,A01,415293,Brandt; Reuven A,20,0,25,5
1708251544639,PHIL 27,A02,415296,Brandt; Reuven A,0,0,0,0
1708251544639,PHIL 27,A03,415332,Brandt; Reuven A,22,0,25,3
1708251544639,PHIL 27,A04,415333,Brandt; Reuven A,22,0,25,3
1708251544639,PHIL 27,A05,415342,Brandt; Reuven A,20,0,25,5
1708251544639,PHIL 27,A06,415384,Brandt; Reuven A,24,0,25,1
1708251544639,PHIL 27,A07,415385,Brandt; Reuven A,25,0,25,0
1708251544639,PHIL 27,A08,415391,Brandt; Reuven A,0,0,0,0
1708251544639,PHIL 27,A09,415406,Brandt; Reuven A,0,0,0,0
1708251544639,PHIL 27,A10,415407,Brandt; Reuven A,0,0,0,0
1708251545170,PHIL 28,A01,415412,Lamey; Andy M.,24,0,25,1
1708251545170,PHIL 28,A02,415470,Lamey; Andy M.,20,0,25,5
1708251545170,PHIL 28,A03,415474,Lamey; Andy M.,0,0,0,0
1708251545170,PHIL 28,A04,415475,Lamey; Andy M.,22,0,25,3
1708251545170,PHIL 28,A05,415487,Lamey; Andy M.,24,0,25,1
1708251545170,PHIL 28,A06,415506,Lamey; Andy M.,21,0,25,4
1708251545170,PHIL 28,A07,415507,Lamey; Andy M.,25,0,25,0
1708251545170,PHIL 28,A08,415508,Lamey; Andy M.,24,0,25,1
1708251545170,PHIL 28,A09,415509,Lamey; Andy M.,25,0,25,0
1708251545170,PHIL 28,A10,415510,Lamey; Andy M.,0,0,0,0
1708251545696,PHIL 33,A01,415521,Hardimon; Michael O.,35,0,35,0
1708251545696,PHIL 33,A02,415522,Hardimon; Michael O.,35,0,35,0
1708251546224,PHIL 60,A00,415523,Marechal; Patricia,55,0,60,5
1708251546750,PHIL 102,A00,415524,Johnson; Monte,37,0,40,3
1708251547276,PHIL 106,A00,415544,Watkins; Eric,40,0,40,0
1708251547805,PHIL 112,A00,415545,Watkins; Eric,34,0,40,6
1708251548333,PHIL 115,A00,415548,Nelkin; Dana Kay,20,0,20,0
1708251548859,PHIL 120,A00,415549,Carr; Jennifer Rose,64,0,65,1
1708251549387,PHIL 134,A00,415552,Carr; Jennifer Rose,40,0,40,0
1708251549913,PHIL 150,A00,415553,Cohen; Jonathan David,38,0,40,2
1708251550441,PHIL 171,A00,415561,Brink; David O.,39,0,40,1
1708251550970,PHIL 172,A00,415563,Lamey; Andy M.,40,0,40,0
1708251551501,PHIL 174,A01,415576,Danks; David J,21,0,25,4
1708251551501,PHIL 174,A02,415582,Danks; David J,22,0,25,3
1708251551501,PHIL 174,A03,415583,Danks; David J,24,0,25,1
1708251551501,PHIL 174,A04,415584,Danks; David J,25,0,25,0
1708251552043,PHIL 175,A00,415585,Shields; Christopher John,40,0,40,0
1708251552572,PHIL 181,A00,415601,Tolley; Clinton,34,0,40,6
1708251553096,PHIL 209B,A00,415655,Serlin; David,4,0,5,1
1708251553621,PHIL 209C,A00,415658,Gates; Kelly,5,0,5,0
1708251554149,PHIL 210,A00,415659,Marechal; Patricia,20,0,20,0
1708251554673,PHIL 230,A00,415661,Grush; Rick Scott,20,0,20,0
1708251555204,PHIL 232,A00,415662,Sher; Gila,20,0,20,0
1708251555729,PHIL 260,A00,415675,Bazargan-Forward; Saba,20,0,20,0
1708251556257,PHIL 277,A00,479176,Tolley; Clinton,9,0,10,1
1708251556784,PHIL 285,A00,415685,Kovaka; Karenc,20,0,20,0
1708251557312,PHIL 287,A00,415697,Marechal; Patricia,5,0,5,0
1708251557841,PHIL 290,001,415701,Nelkin; Dana Kay,9999,0,9999,0
1708251557841,PHIL 290,002,415721,Bazargan-Forward; Saba,9999,0,9999,0
1708251557841,PHIL 290,003,415731,Brandt; Reuven A,9999,0,9999,0
1708251557841,PHIL 290,004,415743,Brink; David O.,9999,0,9999,0
1708251557841,PHIL 290,005,415747,Callender; Craig Adam,9999,0,9999,0
1708251557841,PHIL 290,006,415779,Carr; Jennifer Rose,9999,0,9999,0
1708251557841,PHIL 290,007,415780,Cartwright; Nancy D.,9999,0,9999,0
1708251557841,PHIL 290,008,415781,Cohen; Jonathan David,9999,0,9999,0
1708251557841,PHIL 290,009,415782,Danks; David J,9999,0,9999,0
1708251557841,PHIL 290,010,415783,Fulkerson; Matthew Todd,9999,0,9999,0
1708251557841,PHIL 290,011,415784,Grush; Rick Scott,9999,0,9999,0
1708251557841,PHIL 290,012,415785,Hardimon; Michael O.,9999,0,9999,0
1708251557841,PHIL 290,013,415786,Harrell; Maralee Mae,9999,0,9999,0
1708251557841,PHIL 290,014,415787,Johnson; Monte,9999,0,9999,0
1708251557841,PHIL 290,015,415788,Kovaka; Karenc,9999,0,9999,0
1708251557841,PHIL 290,016,415789,Lamey; Andy M.,9999,0,9999,0
1708251557841,PHIL 290,017,415790,Marechal; Patricia,9999,0,9999,0
1708251557841,PHIL 290,018,415791,McKenzie; Kerry V.,9999,0,9999,0
1708251557841,PHIL 290,019,415792,Rickless; Samuel Charles,9999,0,9999,0
1708251557841,PHIL 290,020,415793,Sher; Gila,9999,0,9999,0
1708251557841,PHIL 290,021,415794,Shields; Christopher John,9999,0,9999,0
1708251557841,PHIL 290,022,415805,Tolley; Clinton,9999,0,9999,0
1708251557841,PHIL 290,023,415806,Vargas; Manuel Rogelio,9999,0,9999,0
1708251557841,PHIL 290,024,415807,Watkins; Eric,9999,0,9999,0
1708251557841,PHIL 290,025,415815,Chen; Keming,9999,0,9999,0
1708251558370,PHIL 295,001,415816,Bazargan-Forward; Saba,9999,0,9999,0
1708251558370,PHIL 295,002,415857,Brandt; Reuven A,9999,0,9999,0
1708251558370,PHIL 295,003,415858,Brink; David O.,9999,0,9999,0
1708251558370,PHIL 295,004,415877,Callender; Craig Adam,9999,0,9999,0
1708251558370,PHIL 295,005,415878,Carr; Jennifer Rose,9999,0,9999,0
1708251558370,PHIL 295,006,415884,Cartwright; Nancy D.,9999,0,9999,0
1708251558370,PHIL 295,007,415885,Chen; Keming,9999,0,9999,0
1708251558370,PHIL 295,008,415891,Cohen; Jonathan David,9999,0,9999,0
1708251558370,PHIL 295,009,415892,Danks; David J,9999,0,9999,0
1708251558370,PHIL 295,010,415937,Fulkerson; Matthew Todd,9999,0,9999,0
1708251558370,PHIL 295,011,415940,Grush; Rick Scott,9999,0,9999,0
1708251558370,PHIL 295,012,415945,Hardimon; Michael O.,9999,0,9999,0
1708251558370,PHIL 295,013,415946,Harrell; Maralee Mae,9999,0,9999,0
1708251558370,PHIL 295,014,415953,Johnson; Monte,9999,0,9999,0
1708251558370,PHIL 295,015,415954,Kovaka; Karenc,9999,0,9999,0
1708251558370,PHIL 295,016,415957,Lamey; Andy M.,9999,0,9999,0
1708251558370,PHIL 295,017,415958,Marechal; Patricia,9999,0,9999,0
1708251558370,PHIL 295,018,415959,McKenzie; Kerry V.,9999,0,9999,0
1708251558370,PHIL 295,019,415960,Nelkin; Dana Kay,9999,0,9999,0
1708251558370,PHIL 295,020,415961,Rickless; Samuel Charles,9999,0,9999,0
1708251558370,PHIL 295,021,415987,Sher; Gila,9999,0,9999,0
1708251558370,PHIL 295,022,416027,Shields; Christopher John,9999,0,9999,0
1708251558370,PHIL 295,023,416030,Tolley; Clinton,9999,0,9999,0
1708251558370,PHIL 295,024,416033,Vargas; Manuel Rogelio,9999,0,9999,0
1708251558370,PHIL 295,025,416034,Watkins; Eric,9999,0,9999,0
1708251558901,PHYA 224,A00,442106,Sandstrom; Karin Marie,30,0,30,0
1708251559427,PHYS 1A,A00,441607,Gilbert; Dylan Paul,346,0,362,16
1708251559958,PHYS 1AL,001,441608,Arlett; Jessica Lynn & Yagil; Avi,30,0,30,0
1708251559958,PHYS 1AL,002,441609,Arlett; Jessica Lynn & Yagil; Avi,28,0,30,2
1708251559958,PHYS 1AL,003,441610,Arlett; Jessica Lynn & Yagil; Avi,26,0,30,4
1708251559958,PHYS 1AL,004,441611,Arlett; Jessica Lynn & Yagil; Avi,29,0,30,1
1708251559958,PHYS 1AL,005,441612,Arlett; Jessica Lynn & Yagil; Avi,28,0,30,2
1708251559958,PHYS 1AL,006,441616,Arlett; Jessica Lynn & Yagil; Avi,28,0,30,2
1708251559958,PHYS 1AL,007,441618,Arlett; Jessica Lynn & Yagil; Avi,26,0,30,4
1708251559958,PHYS 1AL,008,441620,Arlett; Jessica Lynn & Yagil; Avi,29,0,30,1
1708251559958,PHYS 1AL,009,441623,Arlett; Jessica Lynn & Yagil; Avi,29,0,30,1
1708251559958,PHYS 1AL,010,441625,Arlett; Jessica Lynn & Yagil; Avi,29,0,30,1
1708251559958,PHYS 1AL,011,441626,Arlett; Jessica Lynn & Yagil; Avi,29,0,30,1
1708251559958,PHYS 1AL,012,441627,Arlett; Jessica Lynn & Yagil; Avi,29,0,30,1
1708251560485,PHYS 1B,A00,441630,Groisman; Alexander,351,0,362,11
1708251561012,PHYS 1BL,001,441632,Arlett; Jessica Lynn & Yagil; Avi,28,0,30,2
1708251561012,PHYS 1BL,002,441634,Arlett; Jessica Lynn & Yagil; Avi,29,0,30,1
1708251561012,PHYS 1BL,003,441636,Arlett; Jessica Lynn & Yagil; Avi,29,0,30,1
1708251561012,PHYS 1BL,004,441637,Arlett; Jessica Lynn & Yagil; Avi,29,0,30,1
1708251561012,PHYS 1BL,005,441639,Arlett; Jessica Lynn & Yagil; Avi,29,0,30,1
1708251561012,PHYS 1BL,006,441641,Arlett; Jessica Lynn & Yagil; Avi,26,0,30,4
1708251561012,PHYS 1BL,007,441642,Arlett; Jessica Lynn & Yagil; Avi,23,0,30,7
1708251561012,PHYS 1BL,008,441643,Arlett; Jessica Lynn & Yagil; Avi,30,0,30,0
1708251561012,PHYS 1BL,009,441646,Arlett; Jessica Lynn & Yagil; Avi,29,0,30,1
1708251561012,PHYS 1BL,010,441648,Arlett; Jessica Lynn & Yagil; Avi,29,0,30,1
1708251561012,PHYS 1BL,011,441652,Arlett; Jessica Lynn & Yagil; Avi,29,0,30,1
1708251561012,PHYS 1BL,012,441654,Arlett; Jessica Lynn & Yagil; Avi,30,0,30,0
1708251561540,PHYS 1C,A00,441658,Popmintchev; Tenio,587,0,600,13
1708251561540,PHYS 1C,B00,441662,Popmintchev; Tenio,558,0,600,42
1708251562101,PHYS 1CL,001,441664,Arlett; Jessica Lynn & Yagil; Avi,29,0,30,1
1708251562101,PHYS 1CL,002,441665,Arlett; Jessica Lynn & Yagil; Avi,27,0,30,3
1708251562101,PHYS 1CL,003,441666,Arlett; Jessica Lynn & Yagil; Avi,25,0,30,5
1708251562101,PHYS 1CL,004,441667,Arlett; Jessica Lynn & Yagil; Avi,30,0,30,0
1708251562101,PHYS 1CL,005,441668,Arlett; Jessica Lynn & Yagil; Avi,28,0,30,2
1708251562101,PHYS 1CL,006,441669,Arlett; Jessica Lynn & Yagil; Avi,25,0,30,5
1708251562101,PHYS 1CL,007,441671,Arlett; Jessica Lynn & Yagil; Avi,27,0,30,3
1708251562101,PHYS 1CL,008,441673,Arlett; Jessica Lynn & Yagil; Avi,30,0,30,0
1708251562101,PHYS 1CL,009,441674,Arlett; Jessica Lynn & Yagil; Avi,26,0,30,4
1708251562101,PHYS 1CL,010,441676,Arlett; Jessica Lynn & Yagil; Avi,30,0,30,0
1708251562101,PHYS 1CL,011,441677,Arlett; Jessica Lynn & Yagil; Avi,30,0,30,0
1708251562101,PHYS 1CL,012,441683,Arlett; Jessica Lynn & Yagil; Avi,30,0,30,0
1708251562101,PHYS 1CL,013,441685,Arlett; Jessica Lynn & Yagil; Avi,28,0,30,2
1708251562101,PHYS 1CL,014,441687,Arlett; Jessica Lynn & Yagil; Avi,30,0,30,0
1708251562101,PHYS 1CL,015,441689,Arlett; Jessica Lynn & Yagil; Avi,17,0,30,13
1708251562101,PHYS 1CL,016,441692,Arlett; Jessica Lynn & Yagil; Avi,29,0,30,1
1708251562101,PHYS 1CL,017,441696,Arlett; Jessica Lynn & Yagil; Avi,24,0,30,6
1708251562101,PHYS 1CL,018,441698,Arlett; Jessica Lynn & Yagil; Avi,25,0,30,5
1708251562101,PHYS 1CL,019,441702,Arlett; Jessica Lynn & Yagil; Avi,25,0,30,5
1708251562101,PHYS 1CL,020,441705,Arlett; Jessica Lynn & Yagil; Avi,29,0,30,1
1708251562101,PHYS 1CL,021,441706,Arlett; Jessica Lynn & Yagil; Avi,30,0,30,0
1708251562101,PHYS 1CL,022,441707,Arlett; Jessica Lynn & Yagil; Avi,30,0,30,0
1708251562101,PHYS 1CL,023,441708,Arlett; Jessica Lynn & Yagil; Avi,27,0,30,3
1708251562101,PHYS 1CL,024,441710,Arlett; Jessica Lynn & Yagil; Avi,29,0,30,1
1708251562101,PHYS 1CL,025,441711,Arlett; Jessica Lynn & Yagil; Avi,28,0,30,2
1708251562101,PHYS 1CL,026,441712,Arlett; Jessica Lynn & Yagil; Avi,29,0,30,1
1708251562101,PHYS 1CL,027,441713,Arlett; Jessica Lynn & Yagil; Avi,26,0,30,4
1708251562101,PHYS 1CL,028,441714,Arlett; Jessica Lynn & Yagil; Avi,29,0,30,1
1708251562101,PHYS 1CL,029,441715,Arlett; Jessica Lynn & Yagil; Avi,25,0,30,5
1708251562101,PHYS 1CL,030,441717,Arlett; Jessica Lynn & Yagil; Avi,29,0,30,1
1708251562101,PHYS 1CL,031,441718,Arlett; Jessica Lynn & Yagil; Avi,27,0,30,3
1708251562101,PHYS 1CL,032,441721,Arlett; Jessica Lynn & Yagil; Avi,30,0,30,0
1708251562101,PHYS 1CL,033,441724,Arlett; Jessica Lynn & Yagil; Avi,28,0,30,2
1708251562101,PHYS 1CL,034,441726,Arlett; Jessica Lynn & Yagil; Avi,29,0,30,1
1708251562101,PHYS 1CL,035,441728,Arlett; Jessica Lynn & Yagil; Avi,29,0,30,1
1708251562101,PHYS 1CL,036,441729,Arlett; Jessica Lynn & Yagil; Avi,30,0,30,0
1708251562101,PHYS 1CL,037,441730,Arlett; Jessica Lynn & Yagil; Avi,27,0,30,3
1708251562101,PHYS 1CL,038,441732,Arlett; Jessica Lynn & Yagil; Avi,29,0,30,1
1708251562101,PHYS 1CL,039,441733,Arlett; Jessica Lynn & Yagil; Avi,27,0,30,3
1708251562101,PHYS 1CL,040,441734,Arlett; Jessica Lynn & Yagil; Avi,30,0,30,0
1708251562101,PHYS 1CL,041,441735,Arlett; Jessica Lynn & Yagil; Avi,29,0,30,1
1708251562101,PHYS 1CL,042,441766,Arlett; Jessica Lynn & Yagil; Avi,30,0,30,0
1708251562101,PHYS 1CL,043,441768,Arlett; Jessica Lynn & Yagil; Avi,29,0,30,1
1708251562101,PHYS 1CL,044,441770,Arlett; Jessica Lynn & Yagil; Avi,30,0,30,0
1708251562644,PHYS 2A,A01,460308,Bal; Gurleen K,28,0,30,2
1708251562644,PHYS 2A,A02,460320,Bal; Gurleen K,30,0,30,0
1708251562644,PHYS 2A,A03,460321,Bal; Gurleen K,29,0,30,1
1708251562644,PHYS 2A,A04,460325,Bal; Gurleen K,28,0,30,2
1708251562644,PHYS 2A,A05,460326,Bal; Gurleen K,29,0,30,1
1708251562644,PHYS 2A,A06,460327,Bal; Gurleen K,30,0,30,0
1708251562644,PHYS 2A,A07,460495,Bal; Gurleen K,28,0,30,2
1708251562644,PHYS 2A,A08,460535,Bal; Gurleen K,27,0,30,3
1708251562644,PHYS 2A,A09,460536,Bal; Gurleen K,30,0,30,0
1708251562644,PHYS 2A,A10,460537,Bal; Gurleen K,30,0,30,0
1708251562644,PHYS 2A,A11,460538,Bal; Gurleen K,30,0,30,0
1708251562644,PHYS 2A,A12,460539,Bal; Gurleen K,30,0,30,0
1708251563208,PHYS 2B,A01,460620,Barreiro Guerrero; Julio,30,0,30,0
1708251563208,PHYS 2B,A02,460625,Barreiro Guerrero; Julio,30,0,30,0
1708251563208,PHYS 2B,A03,460626,Barreiro Guerrero; Julio,29,0,30,1
1708251563208,PHYS 2B,A04,460716,Barreiro Guerrero; Julio,26,0,30,4
1708251563208,PHYS 2B,A05,460756,Barreiro Guerrero; Julio,29,0,30,1
1708251563208,PHYS 2B,A06,460837,Barreiro Guerrero; Julio,30,0,30,0
1708251563208,PHYS 2B,A07,460865,Barreiro Guerrero; Julio,30,0,30,0
1708251563208,PHYS 2B,A08,460866,Barreiro Guerrero; Julio,30,0,30,0
1708251563208,PHYS 2B,A09,460867,Barreiro Guerrero; Julio,29,0,30,1
1708251563208,PHYS 2B,A10,460868,Barreiro Guerrero; Julio,30,0,30,0
1708251563208,PHYS 2B,A11,460869,Barreiro Guerrero; Julio,30,0,30,0
1708251563208,PHYS 2B,A12,460874,Barreiro Guerrero; Julio,30,0,30,0
1708251563208,PHYS 2B,B01,469381,Barreiro Guerrero; Julio,30,0,30,0
1708251563208,PHYS 2B,B02,469382,Barreiro Guerrero; Julio,29,0,30,1
1708251563208,PHYS 2B,B03,469402,Barreiro Guerrero; Julio,27,0,30,3
1708251563208,PHYS 2B,B04,469403,Barreiro Guerrero; Julio,28,0,30,2
1708251563208,PHYS 2B,B05,469442,Barreiro Guerrero; Julio,30,0,30,0
1708251563208,PHYS 2B,B06,469449,Barreiro Guerrero; Julio,30,0,30,0
1708251563208,PHYS 2B,B07,469450,Barreiro Guerrero; Julio,29,0,30,1
1708251563208,PHYS 2B,B08,469451,Barreiro Guerrero; Julio,30,0,30,0
1708251563208,PHYS 2B,B09,469457,Barreiro Guerrero; Julio,29,0,30,1
1708251563208,PHYS 2B,B10,469460,Barreiro Guerrero; Julio,30,0,30,0
1708251563208,PHYS 2B,B11,469468,Barreiro Guerrero; Julio,30,0,30,0
1708251563208,PHYS 2B,B12,469475,Barreiro Guerrero; Julio,30,0,30,0
1708251563769,PHYS 2BL,A01,441779,Meyertholen; Andrew D.,21,0,24,3
1708251563769,PHYS 2BL,A02,441780,Meyertholen; Andrew D.,17,0,24,7
1708251563769,PHYS 2BL,A03,441781,Meyertholen; Andrew D.,20,0,24,4
1708251563769,PHYS 2BL,A04,441782,Meyertholen; Andrew D.,21,0,24,3
1708251563769,PHYS 2BL,A05,441784,Meyertholen; Andrew D.,23,0,24,1
1708251563769,PHYS 2BL,A06,441786,Meyertholen; Andrew D.,23,0,24,1
1708251563769,PHYS 2BL,A07,441788,Meyertholen; Andrew D.,23,0,24,1
1708251563769,PHYS 2BL,A08,441790,Meyertholen; Andrew D.,24,0,24,0
1708251563769,PHYS 2BL,A09,441792,Meyertholen; Andrew D.,24,0,24,0
1708251563769,PHYS 2BL,A10,441794,Meyertholen; Andrew D.,23,0,24,1
1708251563769,PHYS 2BL,A11,441796,Meyertholen; Andrew D.,22,0,24,2
1708251563769,PHYS 2BL,A12,441798,Meyertholen; Andrew D.,24,0,24,0
1708251563769,PHYS 2BL,A13,441800,Meyertholen; Andrew D.,24,0,24,0
1708251563769,PHYS 2BL,A14,441802,Meyertholen; Andrew D.,24,0,24,0
1708251563769,PHYS 2BL,A15,441804,Meyertholen; Andrew D.,23,0,24,1
1708251564315,PHYS 2C,A01,460540,Tan; Tzer Han,30,0,30,0
1708251564315,PHYS 2C,A02,460541,Tan; Tzer Han,28,0,30,2
1708251564315,PHYS 2C,A03,460542,Tan; Tzer Han,28,0,30,2
1708251564315,PHYS 2C,A04,460543,Tan; Tzer Han,28,0,30,2
1708251564315,PHYS 2C,A05,460544,Tan; Tzer Han,28,0,30,2
1708251564315,PHYS 2C,A06,460545,Tan; Tzer Han,29,0,30,1
1708251564315,PHYS 2C,A07,460553,Tan; Tzer Han,30,0,30,0
1708251564315,PHYS 2C,A08,460561,Tan; Tzer Han,30,0,30,0
1708251564315,PHYS 2C,A09,460562,Tan; Tzer Han,28,0,30,2
1708251564315,PHYS 2C,A10,460563,Tan; Tzer Han,29,0,30,1
1708251564315,PHYS 2C,A11,460567,Tan; Tzer Han,30,0,30,0
1708251564315,PHYS 2C,A12,460568,Tan; Tzer Han,28,0,30,2
1708251564858,PHYS 2CL,A01,441809,Ni; Kaixuan,25,0,28,3
1708251564858,PHYS 2CL,A02,441811,Ni; Kaixuan,27,0,28,1
1708251564858,PHYS 2CL,A03,441814,Ni; Kaixuan,23,0,28,5
1708251564858,PHYS 2CL,A04,441817,Ni; Kaixuan,28,0,28,0
1708251564858,PHYS 2CL,A05,441819,Ni; Kaixuan,26,0,28,2
1708251564858,PHYS 2CL,A06,441820,Ni; Kaixuan,27,0,28,1
1708251565404,PHYS 2D,A01,460569,Sharma; Vivek A.,24,0,25,1
1708251565404,PHYS 2D,A02,460574,Sharma; Vivek A.,24,0,25,1
1708251565404,PHYS 2D,A03,460575,Sharma; Vivek A.,25,0,25,0
1708251566969,PHYS 4B,A01,441829,Grinstein; Benjamin,34,0,38,4
1708251566969,PHYS 4B,A02,441831,Grinstein; Benjamin,30,0,32,2
1708251566969,PHYS 4B,A03,441832,Grinstein; Benjamin,30,0,30,0
1708251566969,PHYS 4B,A04,441833,Grinstein; Benjamin,30,0,30,0
1708251567515,PHYS 4E,A01,441907,Frano Pereira; Alex M,33,0,34,1
1708251567515,PHYS 4E,A02,441958,Frano Pereira; Alex M,34,0,34,0
1708251568042,PHYS 10,A01,441971,Burgasser; Adam Jonathan,118,0,120,2
1708251568569,PHYS 13,A01,441974,Wright; Shelley Adams,61,0,65,4
1708251569097,PHYS 87,A00,486898,Grinstein; Benjamin,19,0,20,1
1708251569625,PHYS 100C,A01,441978,Averitt; Richard Douglas,58,0,60,2
1708251570150,PHYS 105B,A01,441985,Green; Daniel Richard,37,0,40,3
1708251570676,PHYS 120,A01,441995,Arnold; Kam S,40,0,44,4
1708251570676,PHYS 120,A02,442011,Arnold; Kam S,41,0,44,3
1708251571206,PHYS 130A,A01,442032,Parker; Daniel E,74,0,75,1
1708251571733,PHYS 130B,A01,442056,Branson; James G,47,0,50,3
1708251572266,PHYS 139,A00,442057,Jun; Suckjoon,30,0,30,0
1708251572266,PHYS 139,B00,442059,Duarte; Javier Mauricio & Li; Aobo,42,0,50,8
1708251572794,PHYS 140A,A01,442065,Shotwell; Brian,49,0,50,1
1708251573321,PHYS 152B,A01,442067,Hirsch; Jorge Eduardo,16,0,20,4
1708251573850,PHYS 154,A01,442069,Jenkins; Elizabeth,29,0,30,1
1708251574380,PHYS 162,A01,442096,Keating; Brian,64,0,65,1
1708251574907,PHYS 170,A01,486870,Oh; Seungeun,39,0,40,1
1708251575436,PHYS 177,A00,442103,Dudko; Olga,20,0,20,0
1708251575961,PHYS 203B,A01,442132,Fogler; Michael M.,20,0,20,0
1708251576491,PHYS 210A,A01,442143,Hwa; Terence T.,20,0,20,0
1708251577017,PHYS 212C,A01,442200,Chivukula; Raja S,18,0,20,2
1708251577543,PHYS 215C,A00,442201,Intriligator; Kenneth Arthur,19,0,20,1
1708251578069,PHYS 225C,A01,442203,Flauger; Raphael M,19,0,20,1
1708251578595,PHYS 227,A00,442204,Tytler; David Robert,29,0,30,1
1708251579125,PHYS 230,A01,442206,McGreevy; John A.,20,0,20,0
1708251579656,PHYS 239,A00,442207,Goldenfeld; Nigel,20,0,20,0
1708251579656,PHYS 239,B00,442208,Duarte; Javier Mauricio & Li; Aobo,5,0,5,0
1708251580187,PHYS 244,A01,442280,Norman; Michael L,12,0,20,8
1708251580713,PHYS 250,A00,442300,Fogler; Michael M.,50,0,50,0
1708251581239,PHYS 251,A00,442307,Grinstein; Benjamin,20,0,20,0
1708251581768,PHYS 252,A00,442348,Diamond; Patrick H,10,0,10,0
1708251582292,PHYS 253,A00,442349,Theissen; Christopher Alexander,30,0,30,0
1708251582819,PHYS 254,A00,442352,Hwa; Terence T.,30,0,30,0
1708251583348,PHYS 255,A00,442423,Hwa; Terence T.,30,0,30,0
1708251583874,PHYS 258,A00,442426,Theissen; Christopher Alexander,30,0,30,0
1708251584400,PHYS 260,A00,442427,Frano Pereira; Alex M,50,0,50,0
1708251584931,PHYS 277,A00,442428,Dudko; Olga,20,0,20,0
1708251585464,POLI 5D,A01,419010,Dai; Yinlin,5,0,7,2
1708251585464,POLI 5D,A02,419020,Dai; Yinlin,7,0,7,0
1708251585464,POLI 5D,A03,419022,Dai; Yinlin,4,0,6,2
1708251585464,POLI 5D,A04,419040,Dai; Yinlin,5,0,5,0
1708251585464,POLI 5D,B01,419065,Dai; Yinlin,7,0,7,0
1708251585464,POLI 5D,B02,419068,Dai; Yinlin,7,0,7,0
1708251585464,POLI 5D,B03,419069,Dai; Yinlin,6,0,6,0
1708251585464,POLI 5D,B04,419070,Dai; Yinlin,5,0,5,0
1708251585464,POLI 5D,C01,487211,Staff,3,0,5,2
1708251586007,POLI 11D,A01,419072,Desposato; Scott,32,0,34,2
1708251586007,POLI 11D,A02,419073,Desposato; Scott,33,0,34,1
1708251586007,POLI 11D,A03,419082,Desposato; Scott,32,0,34,2
1708251586007,POLI 11D,A04,419123,Desposato; Scott,34,0,34,0
1708251586007,POLI 11D,A05,419124,Desposato; Scott,34,0,34,0
1708251586007,POLI 11D,A06,419125,Desposato; Scott,34,0,34,0
1708251586554,POLI 12D,A01,419127,Gartzke; Erik,29,0,34,5
1708251586554,POLI 12D,A02,419128,Gartzke; Erik,34,0,34,0
1708251586554,POLI 12D,A03,419129,Gartzke; Erik,34,0,34,0
1708251586554,POLI 12D,A04,419130,Gartzke; Erik,34,0,34,0
1708251586554,POLI 12D,A05,419131,Gartzke; Erik,32,0,34,2
1708251586554,POLI 12D,A06,419168,Gartzke; Erik,34,0,34,0
1708251587098,POLI 13DR,A01,477733,Draper; Matthew William,28,0,34,6
1708251587098,POLI 13DR,A02,477734,Draper; Matthew William,32,0,34,2
1708251587098,POLI 13DR,A03,477736,Draper; Matthew William,33,0,34,1
1708251587098,POLI 13DR,A04,477737,Draper; Matthew William,32,0,34,2
1708251587098,POLI 13DR,A05,477739,Draper; Matthew William,31,0,34,3
1708251587098,POLI 13DR,A06,477740,Draper; Matthew William,34,0,34,0
1708251587628,POLI 30D,A01,419179,Desposato; Scott,19,0,28,9
1708251587628,POLI 30D,A02,419180,Desposato; Scott,25,0,28,3
1708251587628,POLI 30D,A03,419181,Desposato; Scott,27,0,28,1
1708251587628,POLI 30D,A04,419182,Desposato; Scott,28,0,28,0
1708251587628,POLI 30D,A05,419187,Desposato; Scott,24,0,28,4
1708251587628,POLI 30D,A06,419189,Desposato; Scott,28,0,28,0
1708251588171,POLI 100E,A00,419191,Pitcher; Kennedy Anell,105,0,115,10
1708251588752,POLI 104P,A00,419192,Orfield; Michael Bennett,183,0,196,13
1708251589278,POLI 104U,A00,419193,Nichter; Maysa,88,0,115,27
1708251589808,POLI 108,A00,419194,Adida; Claire,293,0,295,2
1708251590336,POLI 110C,A00,419195,Soon; Valerie,47,0,50,3
1708251590866,POLI 120D,A00,419207,Hansen; Jan Eric,48,0,50,2
1708251591393,POLI 124A,A00,419209,Fortunato; David,48,0,50,2
1708251591924,POLI 131CR,A00,419211,Hoston; Germaine,41,0,50,9
1708251591924,POLI 131CR,B00,481592,Hoston; Germaine,10,0,10,0
1708251592451,POLI 136A,A00,419212,Roeder; Philip G,111,0,115,4
1708251592986,POLI 140D,A00,419213,Wong; Tak Kei,183,0,192,9
1708251593513,POLI 142D,A00,419214,Gartzke; Erik,227,0,230,3
1708251594042,POLI 145C,A00,419222,Fisk; David Lee,101,0,115,14
1708251594568,POLI 150A,A00,419225,Wong; Tak Kei,216,0,230,14
1708251595096,POLI 170A,A00,419226,Skillman; Rachel Diane,115,0,115,0
1708251595623,POLI 179,A00,419238,Staff,95,0,104,9
1708251596153,POLI 194,A00,455332,Hill; Seth J,0,0,0,0
1708251596680,POLI 194SD,A00,419248,Nichter; Maysa,999,0,999,0
1708251597208,POLI 197SD,001,419258,Nichter; Maysa,999,0,999,0
1708251597735,POLI 203B,A00,419265,Slantchev; Branislav,21,0,25,4
1708251598264,POLI 214R,A00,419275,Hoston; Germaine,23,0,25,2
1708251598791,POLI 219,A00,419289,Soon; Valerie,24,0,25,1
1708251599316,POLI 220A,A00,419299,Ferree; Karen E,21,0,25,4
1708251599845,POLI 233,A00,419333,Adida; Claire,23,0,25,2
1708251600374,POLI 243,A00,479118,Joseph; Michael F,23,0,25,2
1708251600902,POLI 251,A00,419334,Ban; Pamela M,23,0,25,2
1708251601430,POLI 257,A00,419335,Hill; Seth J,25,0,25,0
1708251601957,POLI 273,A00,419336,Mignozzetti; Umberto,16,0,25,9
1708251602485,POLI 280,A00,419337,Hafner-Burton; Emilie,18,0,25,7
1708251603014,POLI 281,A00,419338,Ban; Pamela M,21,0,25,4
1708251603538,POLI 282,A00,419339,Ferree; Karen E,19,0,25,6
1708251604065,POLI 283,A00,419340,Naoi; Megumi,23,0,25,2
1708251604596,POLI 285,A00,419341,Ingham; Sean,25,0,25,0
1708251605125,POLI 286,A00,419342,Mignozzetti; Umberto,23,0,25,2
1708251605653,POLI 288,A00,479174,Fowler; James,13,0,15,2
1708251606178,PSY 296,001,465760,Besterman; Aaron David,49,0,50,1
1708251606178,PSY 296,002,465765,Eyler; Lisa T.,49,0,50,1
1708251606178,PSY 296,003,465767,Patel; Ekta Himanshu,49,0,50,1
1708251606704,PSYC 3R,A00,419378,Pilegard; Celeste Cristine,314,0,325,11
1708251607237,PSYC 7,A00,419384,Powell; Lindsey Jane,288,0,295,7
1708251607769,PSYC 60,A01,460208,Lowe; Angela Beth,31,0,35,4
1708251607769,PSYC 60,A02,460209,Lowe; Angela Beth,28,0,35,7
1708251607769,PSYC 60,A03,460210,Lowe; Angela Beth,35,0,35,0
1708251607769,PSYC 60,A04,460211,Lowe; Angela Beth,33,0,35,2
1708251607769,PSYC 60,A05,460212,Lowe; Angela Beth,34,0,35,1
1708251607769,PSYC 60,A06,460213,Lowe; Angela Beth,35,0,35,0
1708251607769,PSYC 60,A07,460214,Lowe; Angela Beth,33,0,35,2
1708251607769,PSYC 60,B01,460215,Rose; Fred E.,35,0,35,0
1708251607769,PSYC 60,B02,460216,Rose; Fred E.,35,0,35,0
1708251607769,PSYC 60,B03,460218,Rose; Fred E.,35,0,35,0
1708251607769,PSYC 60,B04,460219,Rose; Fred E.,35,0,35,0
1708251607769,PSYC 60,B05,460220,Rose; Fred E.,32,0,35,3
1708251607769,PSYC 60,B06,460221,Rose; Fred E.,35,0,35,0
1708251607769,PSYC 60,B07,460222,Rose; Fred E.,35,0,35,0
1708251608297,PSYC 70,A01,460223,Pilegard; Celeste Cristine,29,0,35,6
1708251608297,PSYC 70,A02,460224,Pilegard; Celeste Cristine,32,0,35,3
1708251608297,PSYC 70,A03,460225,Pilegard; Celeste Cristine,34,0,35,1
1708251608297,PSYC 70,A04,460266,Pilegard; Celeste Cristine,33,0,35,2
1708251608297,PSYC 70,A05,460267,Pilegard; Celeste Cristine,35,0,35,0
1708251608297,PSYC 70,A06,460277,Pilegard; Celeste Cristine,34,0,35,1
1708251608828,PSYC 71,A01,419620,Staff,19,0,21,2
1708251608828,PSYC 71,A02,419662,Staff,20,0,21,1
1708251608828,PSYC 71,B01,419682,Geller; Emma Harlan,24,0,25,1
1708251608828,PSYC 71,B02,419732,Geller; Emma Harlan,26,0,26,0
1708251609358,PSYC 88,A00,419733,Dobkins; Karen R.,47,0,65,18
1708251609884,PSYC 100,A00,419734,Chapman; Eddie Nathaniel,388,0,410,22
1708251610414,PSYC 101,A00,419735,Walker; Caren Michelle,272,0,295,23
1708251610946,PSYC 102,A00,419779,Moranton; Nirelia Melbina-,292,0,295,3
1708251611472,PSYC 104,A00,419880,Fine; Rachel,267,0,295,28
1708251612004,PSYC 105,A00,419946,Lowe; Angela Beth,276,0,295,19
1708251612529,PSYC 111B,A01,419948,Geller; Emma Harlan,35,0,35,0
1708251613055,PSYC 116C,A01,420046,Lang; Ariel,25,0,25,0
1708251613582,PSYC 117,A01,420092,Bajic; Daniel Andrew,25,0,25,0
1708251614110,PSYC 118,A01,420095,Miller; Cory T.,37,0,45,8
1708251614640,PSYC 124,A00,420096,Chapman; Eddie Nathaniel,381,0,410,29
1708251615168,PSYC 127,A00,420097,Dickenson; Janna Alene,14,0,20,6
1708251615696,PSYC 132,A00,420121,Staff,114,0,120,6
1708251616223,PSYC 133R,A01,420172,Golden; Susan S. & Gorman; Michael R.,10,0,16,6
1708251616223,PSYC 133R,A02,420173,Golden; Susan S. & Gorman; Michael R.,16,0,16,0
1708251616223,PSYC 133R,A03,420175,Golden; Susan S. & Gorman; Michael R.,16,0,16,0
1708251616223,PSYC 133R,A04,420249,Golden; Susan S. & Gorman; Michael R.,13,0,16,3
1708251616749,PSYC 134,A00,420311,Kaye; Walter H.,296,0,300,4
1708251617279,PSYC 137,A00,420312,Lin; Chujun,292,0,295,3
1708251617807,PSYC 144,A00,420313,Wixted; John T,287,0,295,8
1708251618332,PSYC 147,A00,420315,Wong; Lauren Hitomi,120,0,146,26
1708251618860,PSYC 164,A00,420328,Kaplan; Paul,259,0,295,36
1708251619387,PSYC 172,A00,420336,Dickenson; Janna Alene,294,0,300,6
1708251619917,PSYC 178,A00,420337,Glaser; Dale,131,0,146,15
1708251620446,PSYC 179,A00,420338,Lacefield; Katharine I,256,0,328,72
1708251620973,PSYC 181,A00,420339,Anagnostaras; Stephan,333,0,350,17
1708251621499,PSYC 184,A00,420367,Wilson; Brent M,275,0,295,20
1708251622025,PSYC 188,A00,420368,Lacefield; Katharine I,234,0,300,66
1708251622552,PSYC 190,A00,420378,Barner; David A.,374,0,395,21
1708251623087,PSYC 193,B00,420626,Brashier; Nadia Marie,215,0,216,1
1708251623087,PSYC 193,C00,420643,Gremel; Christina M,33,0,35,2
1708251623616,PSYC 193L,A01,420817,Brown; Sandra A,65,0,65,0
1708251623616,PSYC 193L,B01,420830,Staff,26,0,30,4
1708251623616,PSYC 193L,C01,420832,Staff,49,0,49,0
1708251623616,PSYC 193L,D01,420834,Staff,27,0,30,3
1708251623616,PSYC 193L,E01,493996,Aron; Adam,24,0,24,0
1708251624142,PSYC 194C,A01,420905,Heyman; Gail D.,1,0,1,0
1708251624668,PSYC 205,A00,420906,Harris; Christine Renee,17,0,20,3
1708251625196,PSYC 218,A00,420907,Brady; Timothy Francis,11,0,20,9
1708251625722,PSYC 224,A00,420908,Gremel; Christina M,30,0,30,0
1708251626252,PSYC 242,A00,421469,Walker; Caren Michelle,27,0,30,3
1708251626782,PSYC 247,A00,421473,Walker; Caren Michelle,14,0,20,6
1708251627308,PSYC 270C,A00,421554,Dobkins; Karen R.,13,0,20,7
1708251627839,PSYC 272,A00,421561,Gentner; Tim,20,0,20,0
1708251628365,PSYC 274,A00,421564,McCullough; Michael E,29,0,30,1
1708251628893,PSYC 275,A00,421620,Staff,23,0,30,7
1708251629421,PSYC 276,A00,421622,McCullough; Michael E,14,0,20,6
1708251629947,PSYC 280,A00,421623,Serences; John Thomas,76,0,85,9
1708251630478,PSYC 296,001,421667,Anagnostaras; Stephan,9999,0,9999,0
1708251630478,PSYC 296,002,421773,Aron; Adam,9999,0,9999,0
1708251630478,PSYC 296,003,421794,Mukku; Dhananjaya,9999,0,9999,0
1708251630478,PSYC 296,004,421795,Barner; David A.,9998,0,9999,1
1708251630478,PSYC 296,005,421796,Schachner; Adena,9999,0,9999,0
1708251630478,PSYC 296,006,421797,Brown; Sandra A,9999,0,9999,0
1708251630478,PSYC 296,007,421798,Chapman; Eddie Nathaniel,9999,0,9999,0
1708251630478,PSYC 296,008,421799,Dickenson; Janna Alene,9999,0,9999,0
1708251630478,PSYC 296,009,421800,Dobkins; Karen R.,9998,0,9999,1
1708251630478,PSYC 296,010,421801,Fan; Judith Ellen,9999,0,9999,0
1708251630478,PSYC 296,011,421803,Ferreira; Victor,9999,0,9999,0
1708251630478,PSYC 296,012,421814,Geller; Emma Harlan,9998,0,9999,1
1708251630478,PSYC 296,013,422102,Gentner; Tim,9999,0,9999,0
1708251630478,PSYC 296,014,422103,Gorman; Michael R.,9999,0,9999,0
1708251630478,PSYC 296,015,422104,Gremel; Christina M,9999,0,9999,0
1708251630478,PSYC 296,016,422106,Harris; Christine Renee,9999,0,9999,0
1708251630478,PSYC 296,017,422107,Heyman; Gail D.,9999,0,9999,0
1708251630478,PSYC 296,018,422108,McCullough; Michael E,9999,0,9999,0
1708251630478,PSYC 296,019,422109,Mc Kenzie; Craig R.M.,9999,0,9999,0
1708251630478,PSYC 296,020,422122,Miller; Cory T.,9999,0,9999,0
1708251630478,PSYC 296,021,422123,Pashler; Harold E,9999,0,9999,0
1708251630478,PSYC 296,022,422124,Pilegard; Celeste Cristine,9999,0,9999,0
1708251630478,PSYC 296,023,422125,Powell; Lindsey Jane,9999,0,9999,0
1708251630478,PSYC 296,025,422127,Rickard; Timothy C.,9998,0,9999,1
1708251630478,PSYC 296,026,422128,Serences; John Thomas,9998,0,9999,1
1708251630478,PSYC 296,027,422130,Walker; Caren Michelle,9998,0,9999,1
1708251630478,PSYC 296,028,422132,Winkielman; Piotr,9999,0,9999,0
1708251630478,PSYC 296,029,422134,Wixted; John T,9996,0,9999,3
1708251630478,PSYC 296,030,422146,Brady; Timothy Francis,9998,0,9999,1
1708251630478,PSYC 296,031,422154,Carver; Leslie J.,9999,0,9999,0
1708251630478,PSYC 296,032,422161,Lin; Chujun,9999,0,9999,0
1708251630478,PSYC 296,033,422169,Brashier; Nadia Marie,9998,0,9999,1
1708251630478,PSYC 296,034,422177,Oesch; Nicholas W,9999,0,9999,0
1708251631044,RAD 296,001,465795,Staff,50,0,50,0
1708251631044,RAD 296,002,465796,Staff,50,0,50,0
1708251631044,RAD 296,003,465797,Staff,50,0,50,0
1708251631569,RELI 150,A00,419353,Rahimi; Babak,37,0,40,3
1708251632097,REV 87,A00,422721,Lyon; Antony J.,19,0,20,1
1708251632622,RMAS 296,001,465827,Murphy; James D,49,0,50,1
1708251632622,RMAS 296,002,465828,Staff,50,0,50,0
1708251632622,RMAS 296,003,465831,Staff,50,0,50,0
1708251633148,RMED 296,001,466791,Staff,50,0,50,0
1708251633148,RMED 296,002,466792,Staff,50,0,50,0
1708251633148,RMED 296,003,466793,Staff,50,0,50,0
1708251633675,SE 3,A01,446938,Van Den Einde; Yael Dahlia,50,0,52,2
1708251633675,SE 3,A02,446942,Van Den Einde; Yael Dahlia,49,0,52,3
1708251633675,SE 3,A03,446948,Van Den Einde; Yael Dahlia,52,0,53,1
1708251633675,SE 3,A04,446965,Van Den Einde; Yael Dahlia,53,0,53,0
1708251634202,SE 9,A01,447015,Kuester; Falko,30,0,34,4
1708251634202,SE 9,A02,447017,Kuester; Falko,33,0,33,0
1708251634202,SE 9,A03,447022,Kuester; Falko,31,0,33,2
1708251634731,SE 101B,A01,447040,Kosmatka; John B,55,0,56,1
1708251635256,SE 105,A01,447042,Qiao; Yu,118,0,120,2
1708251635789,SE 110A,A01,467467,Asaro; Robert J,56,0,56,0
1708251636318,SE 110B,A00,447045,Zhu; Qiang,122,0,125,3
1708251636845,SE 130B,A01,447049,Chadha; Mayank,92,0,100,8
1708251637373,SE 131A,A01,447059,Krysl; Petr,102,0,110,8
1708251637899,SE 132,A01,447078,Chen; Jiun-Shyan,48,0,50,2
1708251638426,SE 140B,A01,447086,Restrepo; Jose,29,0,34,5
1708251638426,SE 140B,A02,447123,Restrepo; Jose,21,0,33,12
1708251638426,SE 140B,A03,447124,Restrepo; Jose,30,0,33,3
1708251638957,SE 143B,A01,447133,Tehrani; Mehran,11,0,15,4
1708251638957,SE 143B,A02,447134,Tehrani; Mehran,12,0,15,3
1708251639482,SE 150A,A01,447136,Uang; Chia-Ming,94,0,100,6
1708251640009,SE 150B,A01,447214,Morrison; Machel Leigh,49,0,50,1
1708251640536,SE 151B,A00,447215,Shing; P. Benson,71,0,75,4
1708251641062,SE 160B,A01,467468,Kim; Hyunsun Alicia,91,0,100,9
1708251641591,SE 165,A00,447238,Farrar; Charles R.,9,0,10,1
1708251642178,SE 184,A00,447253,Hutchinson; Tara,20,0,20,0
1708251642708,SE 202,A00,447392,Kosmatka; John B,25,0,30,5
1708251643239,SE 204,A00,447482,Todd; Michael,12,0,20,8
1708251643769,SE 206,A00,447483,Conte; Joel P,30,0,30,0
1708251644296,SE 213,A00,447499,Palermo; Alessandro,17,0,30,13
1708251644822,SE 215,A00,447500,Zhu; Qiang,34,0,45,11
1708251645348,SE 222,A00,447507,Elgamal; Ahmed,30,0,30,0
1708251645877,SE 227,A00,447576,Hutchinson; Tara,20,0,25,5
1708251646406,SE 244,A00,447577,Elgamal; Ahmed,29,0,30,1
1708251646931,SE 247,A00,447580,Hutchinson; Tara,0,0,5,5
1708251647461,SE 251B,A00,447612,Qiao; Yu,15,0,25,10
1708251647989,SE 253B,A00,447613,Kim; Hyonny,28,0,30,2
1708251648514,SE 260B,A00,447614,Kim; Hyunsun Alicia,10,0,10,0
1708251649044,SE 265,A00,447615,Farrar; Charles R.,20,0,25,5
1708251649570,SE 266,A00,447616,Loh; Chin Hsiung,23,0,25,2
1708251650622,SE 280,A00,447650,Krysl; Petr,22,0,25,3
1708251651146,SE 281,A01,447658,Kuester; Falko,12,0,30,18
1708251651673,SE 290,A00,447659,Qiao; Yu,78,0,100,22
1708251652214,SE 296,001,447666,Asaro; Robert J,9999,0,9999,0
1708251652214,SE 296,002,447669,Chen; Jiun-Shyan,9999,0,9999,0
1708251652214,SE 296,003,447689,Conte; Joel P,9999,0,9999,0
1708251652214,SE 296,004,447690,Elgamal; Ahmed,9999,0,9999,0
1708251652214,SE 296,005,447728,Hutchinson; Tara,9999,0,9999,0
1708251652214,SE 296,006,447733,Jandaghi Semnani; Shabnam,9999,0,9999,0
1708251652214,SE 296,007,447734,Kim; Hyonny,9999,0,9999,0
1708251652214,SE 296,008,447737,Kim; Hyunsun Alicia,9999,0,9999,0
1708251652214,SE 296,009,447738,Kosmatka; John B,9999,0,9999,0
1708251652214,SE 296,010,447739,Krysl; Petr,9999,0,9999,0
1708251652214,SE 296,011,447740,Kuester; Falko,9999,0,9999,0
1708251652214,SE 296,012,447741,Lanza Di Scalea; Francesco,9999,0,9999,0
1708251652214,SE 296,013,447742,Loh; Kenneth J. H.,9999,0,9999,0
1708251652214,SE 296,014,447745,McCartney; John Scott,9999,0,9999,0
1708251652214,SE 296,015,447747,Morrison; Machel Leigh,9999,0,9999,0
1708251652214,SE 296,016,447749,Mosqueda; Gilberto,9999,0,9999,0
1708251652214,SE 296,017,447874,Qiao; Yu,9999,0,9999,0
1708251652214,SE 296,018,447875,Restrepo; Jose,9999,0,9999,0
1708251652214,SE 296,019,447886,Shing; P. Benson,9999,0,9999,0
1708251652214,SE 296,020,447887,Todd; Michael,9999,0,9999,0
1708251652214,SE 296,021,447888,Tomac; Ingrid,9999,0,9999,0
1708251652214,SE 296,022,447889,Tsampras; Georgios,9999,0,9999,0
1708251652214,SE 296,023,447890,Uang; Chia-Ming,9999,0,9999,0
1708251652214,SE 296,024,447931,Van Den Einde; Yael Dahlia,9999,0,9999,0
1708251652214,SE 296,025,447932,Zhu; Qiang,9999,0,9999,0
1708251652214,SE 296,026,448007,Tehrani; Mehran,9999,0,9999,0
1708251652214,SE 296,027,448008,Palermo; Alessandro,9999,0,9999,0
1708251652214,SE 296,028,492941,Farrar; Charles R.,9998,0,9999,1
1708251652740,SIO 10,A00,446025,Borsa; Adrian Antal,573,0,590,17
1708251653267,SIO 16,A00,446031,Gee; Jeffrey S,119,0,120,1
1708251653799,SIO 50,A01,446057,Cook; Geoffrey W,19,0,22,3
1708251653799,SIO 50,A02,446058,Cook; Geoffrey W,21,0,22,1
1708251654325,SIO 75,A00,446060,Norris; Richard D.,32,0,35,3
1708251654859,SIO 87,A00,479215,Feddersen; Falk & Morzfeld; Matthias,20,0,20,0
1708251654859,SIO 87,B00,489613,Cook; Geoffrey W,19,0,20,1
1708251654859,SIO 87,C00,489620,Cook; Geoffrey W,20,0,20,0
1708251655387,SIO 90,A00,446061,Staff,61,0,70,9
1708251655913,SIO 113,A01,446064,May; David Alexander,27,0,30,3
1708251656972,SIO 128,A00,446115,Bartlett; Douglas H,110,0,120,10
1708251657498,SIO 135,A01,446153,Fricker; Helen A.,16,0,17,1
1708251657498,SIO 135,A02,446156,Fricker; Helen A.,14,0,18,4
1708251658026,SIO 136,A01,446159,Kacev; David & Wegner; Nicholas Craig & Bartlett; Douglas H,31,0,33,2
1708251658026,SIO 136,A02,446160,Kacev; David & Wegner; Nicholas Craig & Bartlett; Douglas H,33,0,33,0
1708251658556,SIO 139,A00,446164,Kacev; David,66,0,70,4
1708251659083,SIO 141,A01,446173,Pomeroy; Robert S.,11,0,12,1
1708251659608,SIO 143,A01,446175,Andersson; Andreas Jerry,20,0,30,10
1708251660141,SIO 145,A01,446181,Choy; Carolyn Anela,6,0,18,12
1708251660671,SIO 152,A01,446184,Van Allen; Emily Joyce,8,0,10,2
1708251660671,SIO 152,A02,479204,Van Allen; Emily Joyce,10,0,10,0
1708251661205,SIO 153,A01,446188,Capaldi; Tomas,24,0,26,2
1708251661731,SIO 160,A00,446189,Stegman; David,21,0,25,4
1708251662327,SIO 164,A00,446193,Staff,27,0,35,8
1708251662855,SIO 173,A00,446194,Lutsko; Nicholas J.,28,0,30,2
1708251663382,SIO 174,A00,446197,Aluwihare; Lihini & Russell; Lynn M.,26,0,30,4
1708251663908,SIO 181,A01,446200,Tresguerres; Martin,18,0,25,7
1708251663908,SIO 181,A02,446201,Tresguerres; Martin,23,0,25,2
1708251663908,SIO 181,A03,446209,Tresguerres; Martin,24,0,25,1
1708251663908,SIO 181,A04,446211,Tresguerres; Martin,24,0,25,1
1708251663908,SIO 181,A05,446223,Tresguerres; Martin,24,0,25,1
1708251663908,SIO 181,A06,446236,Tresguerres; Martin,24,0,25,1
1708251664439,SIO 192,A00,479211,Gerwick; William Henry,20,0,20,0
1708251664968,SIO 194,A00,455340,Hill; Seth J,0,0,0,0
1708251665497,SIOB 262,A00,446243,Gerwick; William Henry,23,0,25,2
1708251666026,SIOB 269,A00,446244,Staff,19,0,20,1
1708251666553,SIOB 270,A01,446261,Allen; Andrew Ellis & Petrik; Colleen Mary,18,0,20,2
1708251667080,SIOB 278,A00,446273,Arcila; Dahiana K,13,0,15,2
1708251667080,SIOB 278,B00,481742,Aburto Oropeza; Marco Octavio,18,0,20,2
1708251667609,SIOB 279,A00,446286,Franks; Peter,31,0,35,4
1708251668138,SIOB 291,A00,446292,Hechinger; Ryan F.,20,0,20,0
1708251668666,SIOB 296,A00,446293,Mongiardino Koch; Nicolas,16,0,20,4
1708251669196,SIOB 297,A00,446294,Allen; Eric,66,0,70,4
1708251669723,SIOC 202B,A00,446312,Stramski; Dariusz & Gabriel; Anne Alice-Agnes,17,0,20,3
1708251670255,SIOC 203C,A01,446314,Young; William Roy,5,0,5,0
1708251670782,SIOC 207C,A00,492798,Vasconcelos; Manuela,5,0,5,0
1708251671313,SIOC 208,A00,446315,Merrifield; Mark A,16,0,20,4
1708251671839,SIOC 209,A00,478924,Werner; Bradley T.,11,0,15,4
1708251671839,SIOC 209,B00,479224,Watson-Parris; Duncan,15,0,25,10
1708251671839,SIOC 209,C00,480739,Ricke; Katharine L,24,0,24,0
1708251672366,SIOC 212B,A01,446324,Cessi; Paola,40,0,40,0
1708251672896,SIOC 217C,A00,446325,Lutsko; Nicholas J.,25,0,25,0
1708251673425,SIOC 220,A00,446326,Rudnick; Daniel Lars,13,0,15,2
1708251673952,SIOC 224,A00,446327,Eisenman; Ian,20,0,25,5
1708251674484,SIOC 228,A00,446328,Shi; Yuanyuan,1,0,10,9
1708251675010,SIOC 235,A00,446342,Xie; Shang-Ping,14,0,15,1
1708251675536,SIOC 251,A00,446343,Evan; Amato Tomas,19,0,20,1
1708251676062,SIOG 200B,A00,446344,Gabriel; Anne Alice-Agnes,9,0,10,1
1708251676589,SIOG 221,A00,446354,Parnell-Turner; Ross Ernes,29,0,30,1
1708251677119,SIOG 227B,A00,446355,Laske; Gabi & Shearer; Peter M,19,0,20,1
1708251677645,SIOG 228,A00,446356,Van Allen; Emily Joyce,7,0,20,13
1708251678173,SIOG 230,A00,446359,Constable; Catherine G,25,0,25,0
1708251678698,SIOG 232,A00,446360,Constable; Catherine G & Constable; Steven C,37,0,40,3
1708251679224,SIOG 234,A00,446361,Sandwell; David T,15,0,15,0
1708251679755,SIOG 236,A01,477658,Fricker; Helen A.,5,0,5,0
1708251679755,SIOG 236,A02,477685,Fricker; Helen A.,3,0,5,2
1708251680282,SIOG 239,A00,446362,Gabriel; Anne Alice-Agnes,19,0,20,1
1708251680282,SIOG 239,B00,481507,May; David Alexander,6,0,6,0
1708251680282,SIOG 239,C00,486863,Fialko; Yuri A.,15,0,15,0
1708251680811,SIOG 268,A00,446364,Barbeau; Katherine,12,0,15,3
1708251681336,SOCE 194,A00,455341,Hill; Seth J,0,0,0,0
1708251681864,SOCG 204,A00,446551,Ng; Kwai,0,0,8,8
1708251682390,SOCG 206,A00,446552,Alvarez; Camila Huerta,4,0,8,4
1708251682916,SOCG 214,A00,446553,Raudenbush; Danielle,3,0,8,5
1708251683444,SOCG 255B,A00,446602,Serlin; David,2,0,5,3
1708251683973,SOCG 255C,A00,446813,Gates; Kelly,3,0,5,2
1708251684500,SOCG 290,A00,446910,Thorpe; Charles Robert,0,0,10,10
1708251684500,SOCG 290,B00,446911,Goldman; Harvey Stern,1,0,10,9
1708251684500,SOCG 290,C00,446914,Lampland; Martha,5,0,10,5
1708251685027,SOCI 2,A01,446373,Rogers; Julia Ellen,28,0,30,2
1708251685027,SOCI 2,A02,446374,Rogers; Julia Ellen,29,0,30,1
1708251685027,SOCI 2,A03,446382,Rogers; Julia Ellen,29,0,30,1
1708251685027,SOCI 2,A04,446384,Rogers; Julia Ellen,30,0,30,0
1708251685027,SOCI 2,A05,446389,Rogers; Julia Ellen,30,0,30,0
1708251685027,SOCI 2,A06,446393,Rogers; Julia Ellen,29,0,30,1
1708251685554,SOCI 20,A01,446396,Calderon-Zaks; Michael Aar,33,0,34,1
1708251685554,SOCI 20,A02,446409,Calderon-Zaks; Michael Aar,34,0,34,0
1708251686086,SOCI 40,A01,446417,Raudenbush; Danielle,30,0,32,2
1708251686086,SOCI 40,A02,446419,Raudenbush; Danielle,31,0,32,1
1708251686086,SOCI 40,A03,446434,Raudenbush; Danielle,31,0,32,1
1708251686086,SOCI 40,A04,446436,Raudenbush; Danielle,28,0,32,4
1708251686086,SOCI 40,A05,446441,Raudenbush; Danielle,29,0,32,3
1708251686086,SOCI 40,A06,446445,Raudenbush; Danielle,32,0,32,0
1708251686612,SOCI 60,A01,446461,Sutton; April Marie,30,0,32,2
1708251686612,SOCI 60,A02,446468,Sutton; April Marie,30,0,32,2
1708251686612,SOCI 60,A03,446469,Sutton; April Marie,26,0,32,6
1708251686612,SOCI 60,A04,446471,Sutton; April Marie,31,0,32,1
1708251687137,SOCI 100,A01,446480,Payne; Christine Anna,28,0,30,2
1708251687137,SOCI 100,A02,446491,Payne; Christine Anna,29,0,30,1
1708251687137,SOCI 100,A03,446492,Payne; Christine Anna,28,0,30,2
1708251687137,SOCI 100,A04,446493,Payne; Christine Anna,27,0,30,3
1708251687663,SOCI 103M,A00,481672,Kilpatrick; Kevin,27,0,28,1
1708251688189,SOCI 104,A00,446494,Turner; Christena L.,28,0,30,2
1708251688718,SOCI 104Q,A00,446495,Rogers; Julia Ellen,27,0,30,3
1708251689245,SOCI 106,A00,446496,Payne; Christine Anna,25,0,30,5
1708251689776,SOCI 107,A00,446497,Staff,30,0,30,0
1708251690301,SOCI 109,A00,446498,Rona-Tas; Akos,20,0,25,5
1708251690828,SOCI 111,A00,446499,Ribas Norris; Janet Vanesa,54,0,56,2
1708251691356,SOCI 114,A00,446500,Lampland; Martha,73,0,75,2
1708251691884,SOCI 117,A01,446502,Jones; Gabrielle Anastasia,14,0,17,3
1708251691884,SOCI 117,A02,446516,Jones; Gabrielle Anastasia,17,0,17,0
1708251691884,SOCI 117,A03,458787,Jones; Gabrielle Anastasia,17,0,17,0
1708251691884,SOCI 117,A04,458835,Jones; Gabrielle Anastasia,19,0,19,0
1708251692412,SOCI 120T,A00,446518,Staff,56,0,56,0
1708251692940,SOCI 123,A00,446519,Staff,79,0,80,1
1708251693466,SOCI 125,A00,487186,Calderon-Zaks; Michael Aar,55,0,56,1
1708251693998,SOCI 126,A01,446532,Jones; Makeba,15,0,15,0
1708251693998,SOCI 126,A02,446533,Jones; Makeba,15,0,15,0
1708251693998,SOCI 126,A03,458839,Jones; Makeba,15,0,15,0
1708251693998,SOCI 126,A04,458840,Jones; Makeba,15,0,15,0
1708251694524,SOCI 133,A00,446534,Calderon-Zaks; Michael Aar,53,0,56,3
1708251695050,SOCI 135,A00,486886,Ruiz; Jonathan Joseph,55,0,56,1
1708251695649,SOCI 136,A00,486887,Ruiz; Jonathan Joseph,56,0,56,0
1708251696178,SOCI 139,A00,446535,Ribas Norris; Janet Vanesa,78,0,80,2
1708251696724,SOCI 140J,A00,446537,Estefan; Michel,75,0,100,25
1708251697254,SOCI 142,A00,477639,Crofts; Christine,43,0,50,7
1708251697783,SOCI 146,A00,446538,Summers; Valerie R.,113,0,120,7
1708251698312,SOCI 151,A00,446540,Goldman; Harvey Stern,56,0,56,0
1708251698840,SOCI 156,A00,446541,Ostovany; Khashayar,55,0,56,1
1708251699367,SOCI 157,A00,446542,Jules-Rosette; Bennetta W.,28,0,28,0
1708251699913,SOCI 159,A00,494493,Estefan; Michel,93,0,96,3
1708251700443,SOCI 161,A00,477638,Staff,45,0,45,0
1708251700974,SOCI 162,A00,477642,Staff,54,0,55,1
1708251701501,SOCI 165,A00,446543,Rona-Tas; Akos,49,0,56,7
1708251702028,SOCI 171,A00,446544,Thorpe; Charles Robert,56,0,56,0
1708251702554,SOCI 173,A00,482888,Crofts; Christine,92,0,100,8
1708251703081,SOCI 180,A00,446545,Ostovany; Khashayar,55,0,56,1
1708251703611,SOCI 183,A00,446546,Sutton; April Marie,43,0,45,2
1708251704139,SOCI 185,A00,494495,Staff,30,0,30,0
1708251704670,SOCI 188D,A00,446549,Kokinis; Troy Andreas,24,0,25,1
1708251705195,SOCI 198RA,001,446550,Ng; Kwai,30,0,30,0
1708251705721,SOMC 224C,A00,466928,Bhakta; Savita Ganapathi,160,0,160,0
1708251706250,SOMC 229,A00,466925,Hoang; Mai Phuong,160,0,160,0
1708251706776,SOMC 240,A00,466937,Coyne; Christopher John,150,0,150,0
1708251707303,SOMC 242,A00,466931,Kline; Ahnika Sarah,160,0,160,0
1708251707843,SOMC 244,A00,466939,Mandel; Jess,150,0,150,0
1708251708371,SOMC 245C,A01,466935,Noel; Geoffroy Pierre Jean,160,0,160,0
1708251708901,SOMC 246C,A00,487163,Eyler; Lisa T.,160,0,160,0
1708251709430,SOMC 247C,A50,466950,Calcutt; Nigel A,160,0,160,0
1708251709961,SOMC 248C,A00,466936,Joshi; Weena Erin,160,0,160,0
1708251710488,SOMC 255C,A00,466951,Allison; Matthew,160,0,160,0
1708251711013,SPPH 161R,A01,476600,Chambers; Christina D,99,0,100,1
1708251711543,SPPH 263B,A01,460901,Hook; Vivian Yuan-Ho,25,0,25,0
1708251712068,SPPS 200A,A00,460907,Luli; Alex J,99,0,99,0
1708251712594,SPPS 200B,A00,460928,Luli; Alex J,99,0,99,0
1708251713120,SPPS 200C,A00,460934,Luli; Alex J,95,0,99,4
1708251713648,SPPS 203,A00,460955,Painter; Nathan A.,83,0,99,16
1708251714174,SPPS 205,A01,460978,Bandeira; Nuno Filipe Cabrita,64,0,80,16
1708251714702,SPPS 209,A00,460979,Bounthavong; Mark,94,0,99,5
1708251715231,SPPS 210,001,460980,Gustafsson; Asa Birgitta,99,0,99,0
1708251715757,SPPS 211A,A00,460987,Ferguson; Fleur,85,0,99,14
1708251716285,SPPS 211B,A00,460991,Ferguson; Fleur,96,0,99,3
1708251716811,SPPS 211C,A00,460992,Ferguson; Fleur,95,0,99,4
1708251717336,SPPS 211D,A00,460993,Tsunoda; Shirley M.,99,0,99,0
1708251717861,SPPS 212C,A01,460995,Saunders; Ila Maewal,95,0,99,4
1708251718385,SPPS 213C,A00,460996,Awdishu; Linda,95,0,99,4
1708251718914,SPPS 218B,A00,460997,Mandyam; Chitra,95,0,99,4
1708251719439,SPPS 225,A01,460999,Reed; Chantal,83,0,99,16
1708251719982,SPPS 236,A00,461000,Reid; Erin G.,96,0,99,3
1708251720507,SPPS 237,A00,461002,Mimoto; Mizuho Stacy,96,0,99,3
1708251721036,SPPS 238,A00,461041,Beyhan; Sinem,96,0,99,3
1708251721561,SPPS 241,A01,461122,Tsunoda; Shirley M.,83,0,99,16
1708251722086,SPPS 249,A00,461123,Brandl; Katharina,96,0,99,3
1708251722614,SPPS 250,A00,461126,Tsunoda; Shirley M.,45,0,50,5
1708251723140,SPPS 251,A00,461127,Chen; Timothy,99,0,99,0
1708251723668,SPPS 252,A00,461128,Abdul-Mutakabbir; Jacinda,74,0,80,6
1708251724194,SPPS 254,A00,481670,Shapiro; Desiree Nicolette,77,0,80,3
1708251724724,SPPS 261,A00,461129,Chambers; Christina D,93,0,99,6
1708251725253,SPPS 278,A00,459983,Fricovsky; Eduardo Santiago,98,0,99,1
1708251725778,SPPS 280,A00,461259,Fricovsky; Eduardo Santiago,19,0,20,1
1708251726302,SPPS 283,A00,461283,Tsunoda; Shirley M.,96,0,99,3
1708251726828,SURG 261,A00,466973,Staff,50,0,50,0
1708251727358,SURG 296,001,467004,Agha Hosseini; Ava,49,0,50,1
1708251727358,SURG 296,002,467005,Hinchcliff; Katharine Moss,49,0,50,1
1708251727358,SURG 296,003,467006,Eliceiri; Brian,49,0,50,1
1708251727915,SYN 1,001,448577,Bishop; Graham,19,0,20,1
1708251727915,SYN 1,002,448578,Iatarola; Briana Marie,19,0,20,1
1708251727915,SYN 1,003,448579,Browne; Emily,20,0,20,0
1708251727915,SYN 1,004,448580,Vega; Adrian,20,0,20,0
1708251727915,SYN 1,005,448581,Browne; Emily,20,0,20,0
1708251727915,SYN 1,006,448582,Rock; Martin,20,0,20,0
1708251727915,SYN 1,007,448583,Rock; Martin,20,0,20,0
1708251727915,SYN 1,008,448584,Iatarola; Briana Marie,19,0,20,1
1708251727915,SYN 1,009,448585,Bishop; Graham,20,0,20,0
1708251727915,SYN 1,010,448586,Bishop; Graham,20,0,20,0
1708251727915,SYN 1,011,448587,Gladstein; Jill M,15,0,15,0
1708251727915,SYN 1,012,448588,Meyer; Leslie Rose,20,0,20,0
1708251727915,SYN 1,013,448589,Rosenberg; Ryan Glenn,20,0,20,0
1708251727915,SYN 1,014,448627,Rosenberg; Ryan Glenn,19,0,20,1
1708251727915,SYN 1,015,448630,Atkinson; Arthur Laird,20,0,20,0
1708251727915,SYN 1,016,448651,Hom; Kirstyn Courtney,20,0,20,0
1708251727915,SYN 1,017,448652,Difruscio; Mark,20,0,20,0
1708251727915,SYN 1,018,448669,Hom; Kirstyn Courtney,20,0,20,0
1708251727915,SYN 1,019,448674,Hom; Kirstyn Courtney,18,0,20,2
1708251727915,SYN 1,020,448675,Atkinson; Arthur Laird,20,0,20,0
1708251727915,SYN 1,021,448678,Gladstein; Jill M,15,0,15,0
1708251727915,SYN 1,022,448682,Iatarola; Briana Marie,20,0,20,0
1708251727915,SYN 1,023,448691,Birberick; Brittany Celest,20,0,20,0
1708251727915,SYN 1,024,448751,Birberick; Brittany Celest,20,0,20,0
1708251727915,SYN 1,027,448766,Deavenport; James Cary,19,0,20,1
1708251727915,SYN 1,028,448767,Meyer; Leslie Rose,20,0,20,0
1708251727915,SYN 1,029,448775,Tawater; Hanna Jean,20,0,20,0
1708251727915,SYN 1,030,448777,Tawater; Hanna Jean,20,0,20,0
1708251727915,SYN 1,031,448792,Deavenport; James Cary,20,0,20,0
1708251727915,SYN 1,032,480169,Tawater; Hanna Jean,18,0,20,2
1708251728445,SYN 1R,001,448793,Difruscio; Mark,20,0,20,0
1708251728445,SYN 1R,004,449146,Difruscio; Mark,20,0,20,0
1708251728996,SYN 100,A01,449148,Staff,11,0,15,4
1708251728996,SYN 100,A02,449149,Staff,15,0,15,0
1708251728996,SYN 100,B01,449164,Gladstein; Jill M,0,0,0,0
1708251728996,SYN 100,B02,449166,Gladstein; Jill M,0,0,0,1
1708251728996,SYN 100,C01,449244,Staff,7,0,15,8
1708251728996,SYN 100,C02,449274,Staff,13,0,15,2
1708251728996,SYN 100,D01,449278,Staff,20,0,20,0
1708251728996,SYN 100,D02,449279,Staff,20,0,20,0
1708251728996,SYN 100,E01,449281,Rock; Martin,9,0,15,6
1708251728996,SYN 100,E02,449282,Rock; Martin,14,0,15,1
1708251728996,SYN 100,F01,449304,Browne; Emily,12,0,15,3
1708251728996,SYN 100,F02,449306,Browne; Emily,14,0,15,1
1708251728996,SYN 100,I01,449390,Gormally; Brenna,0,0,0,0
1708251728996,SYN 100,I02,449391,Gormally; Brenna,0,0,0,0
1708251728996,SYN 100,J01,449401,Atkinson; Arthur Laird,11,0,15,4
1708251728996,SYN 100,J02,449402,Atkinson; Arthur Laird,14,0,15,1
1708251728996,SYN 100,K01,449404,Deavenport; James Cary,11,0,15,4
1708251728996,SYN 100,K02,449405,Deavenport; James Cary,14,0,15,1
1708251728996,SYN 100,L01,449408,Rosenberg; Ryan Glenn,10,0,15,5
1708251728996,SYN 100,L02,449420,Rosenberg; Ryan Glenn,15,0,15,0
1708251729521,SYN 150,001,450016,Vega; Adrian,19,0,19,0
1708251729521,SYN 150,003,450031,Birberick; Brittany Celest,20,0,20,0
1708251730051,SYN 150R,001,494950,Vega; Adrian,20,0,20,0
1708251730576,SYN 198,001,494388,Staff,9999,0,9999,0
1708251731127,TDAC 1,A00,450042,Walsh; Kim C.,14,0,20,6
1708251731127,TDAC 1,B00,450043,Walsh; Kim C.,11,0,20,9
1708251731127,TDAC 1,C00,450044,Walsh; Kim C.,15,0,20,5
1708251731127,TDAC 1,D00,486830,Basso; Beatrice,20,0,20,0
1708251731127,TDAC 1,E00,492912,Walsh; Kim C.,15,0,20,5
1708251731127,TDAC 1,F00,492936,Walsh; Kim C.,18,0,20,2
1708251731652,TDAC 101,A00,450895,Celik; Aysan Karagasli,18,0,20,2
1708251732183,TDAC 102,A00,450904,Walsh; Kim C.,20,0,20,0
1708251732183,TDAC 102,B00,450916,Harting; Carla Kelso,20,0,20,0
1708251732708,TDAC 108,A00,450917,Buescher; Stephen W.,18,0,20,2
1708251733236,TDAC 109,A00,450924,Blair; Kyle Adam,20,0,20,0
1708251733762,TDAC 122,A00,451025,Perry; Lamar,30,0,30,0
1708251733762,TDAC 122,B00,480845,Perry; Lamar,30,0,30,0
1708251734293,TDAC 123,A00,451026,Buescher; Stephen W.,30,0,30,0
1708251734293,TDAC 123,B00,451028,Celik; Aysan Karagasli,30,0,30,0
1708251734293,TDAC 123,C00,480851,Perry; Lamar,30,0,30,0
1708251734821,TDDE 101,A00,451030,Guirguis; Mark C,18,0,20,2
1708251735347,TDDE 112,A00,451032,Staff,20,0,20,0
1708251735872,TDDE 130,A00,451033,Guirguis; Mark C,19,0,20,1
1708251736399,TDDE 132,A00,451034,Guirguis; Mark C,20,0,20,0
1708251736925,TDDE 169A,A00,481304,Petrovich; Victoria A.,19,0,20,1
1708251737454,TDDM 1,A00,450045,Weinberg; Sadie,27,0,30,3
1708251737980,TDDM 101,A00,451067,Staff,29,0,30,1
1708251738509,TDDR 101,A00,451068,Powell; Lora,29,0,34,5
1708251739039,TDDR 102,A00,451069,Powell; Lora,19,0,20,1
1708251739563,TDDR 111,A00,451070,Castro; Robert Jess,15,0,16,1
1708251739563,TDDR 111,B00,451071,Castro; Robert Jess,15,0,16,1
1708251740088,TDDR 190,A00,451073,Perry; Lamar,1,0,1,0
1708251740623,TDGE 1,A01,450047,Salovey; Todd,20,0,20,0
1708251740623,TDGE 1,A02,450048,Salovey; Todd,20,0,20,0
1708251740623,TDGE 1,A03,450085,Salovey; Todd,18,0,20,2
1708251740623,TDGE 1,A04,450093,Salovey; Todd,20,0,20,0
1708251740623,TDGE 1,A05,450096,Salovey; Todd,19,0,20,1
1708251740623,TDGE 1,A06,450132,Salovey; Todd,16,0,20,4
1708251741169,TDGE 25,A00,450236,Harting; Carla Kelso,12,0,20,8
1708251741169,TDGE 25,B00,450240,Harting; Carla Kelso,16,0,20,4
1708251741169,TDGE 25,C00,450243,Harting; Carla Kelso,14,0,20,6
1708251741169,TDGE 25,D00,450388,Harting; Carla Kelso,16,0,20,4
1708251741711,TDGE 100,A01,451098,Salovey; Todd,24,0,25,1
1708251741711,TDGE 100,A02,451099,Salovey; Todd,24,0,25,1
1708251742237,TDGE 124,A00,451122,Fulton; Julia,168,0,200,32
1708251742766,TDGE 125,A00,480853,Havis; Allan,197,0,200,3
1708251742766,TDGE 125,B00,480886,Staff,216,0,220,4
1708251743292,TDGE 133,A00,481097,Brill; Robert L.,20,0,20,0
1708251743834,TDGE 196B,A00,493144,Barricelli; Marc Alexander,1,0,1,0
1708251743834,TDGE 196B,B00,493148,Buescher; Stephen W.,2,0,2,0
1708251743834,TDGE 196B,C00,493151,Burelle; Julie Sara Veronique,1,0,1,0
1708251743834,TDGE 196B,D00,493189,Castro; Robert Jess,2,0,2,0
1708251743834,TDGE 196B,E00,493190,Guirguis; Mark C,1,0,1,0
1708251743834,TDGE 196B,F00,493240,Iizuka; Naomi Hisako,1,0,1,0
1708251743834,TDGE 196B,G00,493241,Perry; Lamar,1,0,1,0
1708251743834,TDGE 196B,H00,493249,Powell; Lora,1,0,1,0
1708251743834,TDGE 196B,I00,493296,Stein; Deborah Isobel,6,0,6,0
1708251744362,TDGR 213C,A00,451385,Buescher; Stephen W.,10,0,10,0
1708251744890,TDGR 220A,A00,451386,Barricelli; Marc Alexander,10,0,10,0
1708251745414,TDGR 239,A00,451387,Blair; Kyle Adam,10,0,10,0
1708251745943,TDGR 240,A00,481306,Portes; Elizabeth Marie,5,0,5,0
1708251746468,TDGR 245,A00,451388,Perry; Lamar,7,0,7,0
1708251746993,TDGR 250,A00,451395,Iizuka; Naomi Hisako,8,0,10,2
1708251747521,TDGR 251,A00,451397,Iizuka; Naomi Hisako,9,0,10,1
1708251747521,TDGR 251,B00,451398,Stein; Deborah Isobel,9,0,10,1
1708251748046,TDGR 257B,A00,451399,Finch; Michael S,8,0,10,2
1708251748573,TDGR 278,A00,481307,Petrovich; Victoria A.,4,0,5,1
1708251749152,TDGR 279,A00,451400,Bokovikova; Alina V,9,0,10,1
1708251749152,TDGR 279,B00,451401,Brill; Robert L.,10,0,10,0
1708251749152,TDGR 279,C00,451402,Petrovich; Victoria A.,10,0,10,0
1708251749152,TDGR 279,D00,451403,McElver; Robert Harrison,10,0,10,0
1708251749152,TDGR 279,E00,451404,Kuhl; Christopher August,10,0,10,0
1708251749681,TDGR 286,A00,451405,Knox; Leila Elizabeth,9,0,10,1
1708251750209,TDGR 288,A00,451406,Powell; Lora,6,0,7,1
1708251750735,TDGR 292,A00,451407,Power; Jade Yukana,10,0,10,0
1708251750735,TDGR 292,B00,451408,Mehrishi; Rishika,10,0,10,0
1708251751264,TDGR 293,001,451417,Power; Jade Yukana,7,0,7,0
1708251751264,TDGR 293,002,451418,Burelle; Julie Sara Veronique,7,0,7,0
1708251751264,TDGR 293,003,451419,Yapp; Hentyle T,7,0,7,0
1708251751264,TDGR 293,005,451421,Anderson; Mysia Anyse,7,0,7,0
1708251751788,TDGR 294,001,451429,Burelle; Julie Sara Veronique,7,0,7,0
1708251751788,TDGR 294,002,451431,Power; Jade Yukana,7,0,7,0
1708251751788,TDGR 294,003,451432,Yapp; Hentyle T,7,0,7,0
1708251752317,TDGR 295,A00,451433,Barricelli; Marc Alexander,10,0,10,0
1708251752843,TDGR 296,A00,451489,Powell; Lora,6,0,7,1
1708251752843,TDGR 296,B00,451497,Porter; Lisa,6,0,7,1
1708251753372,TDHD 175,A00,451123,Jun; Grace Shin Hae,40,0,40,0
1708251753898,TDHD 176,A00,451124,Caligagan; Maria T.,40,0,40,0
1708251754428,TDHT 10,A00,450409,Power; Jade Yukana,20,0,20,0
1708251754428,TDHT 10,B00,450450,Power; Jade Yukana,19,0,20,1
1708251754953,TDHT 23,A01,450546,Salimi; Rana,24,0,24,0
1708251754953,TDHT 23,A02,450549,Salimi; Rana,22,0,24,2
1708251754953,TDHT 23,A03,450553,Salimi; Rana,24,0,24,0
1708251755480,TDHT 101,A00,451125,Anderson; Mysia Anyse,25,0,25,0
1708251755480,TDHT 101,B00,451126,Mehrishi; Rishika,23,0,25,2
1708251756005,TDHT 104,A00,451225,Basso; Beatrice,22,0,25,3
1708251756534,TDHT 109,A01,451227,Anderson; Mysia Anyse,25,0,25,0
1708251757063,TDHT 122,A00,451228,Power; Jade Yukana,21,0,25,4
1708251757589,TDMV 1,A00,450558,Caligagan; Maria T.,15,0,30,15
1708251758119,TDMV 2,A00,450627,Anabo; Cherry,24,0,30,6
1708251758650,TDMV 3,A00,450630,Arcidiacono; Kristin,37,0,40,3
1708251759176,TDMV 11,A00,481244,Fyall; DauntÉ Edward,30,0,30,0
1708251759701,TDMV 20,A00,450789,Smith; Alison D,38,0,40,2
1708251760229,TDMV 110,A00,451229,Caligagan; Maria T.,28,0,30,2
1708251760755,TDMV 111,A00,451234,Smith; Alison D,28,0,30,2
1708251761280,TDMV 120,A00,451260,Weinberg; Sadie,30,0,30,0
1708251761280,TDMV 120,B00,451261,Sammartano; Tonnie,30,0,30,0
1708251761807,TDMV 122,A00,451262,Staff,28,0,30,2
1708251762332,TDMV 123,A00,451263,Duran; Marcos Antonio,28,0,30,2
1708251762860,TDMV 130,A00,451272,Mack; Kara Shanai',30,0,30,0
1708251763386,TDMV 138,A00,451275,Jun; Grace Shin Hae,4,0,30,26
1708251763914,TDMV 140,A00,451276,Lima; Paulo Henrique,40,0,40,0
1708251763914,TDMV 140,B00,451308,Power; Jade Yukana,39,0,40,1
1708251763914,TDMV 140,C00,451371,Caligagan; Tony,40,0,40,0
1708251763914,TDMV 140,D00,451373,Corrales; Joseph Bernales,28,0,30,2
1708251764441,TDMV 141,A00,451374,Caligagan; Tony,26,0,30,4
1708251764967,TDMV 142,A00,451375,Blanco; Juan Carlos,26,0,40,14
1708251765494,TDMV 143,A00,451376,Fyall; DauntÉ Edward,39,0,40,1
1708251766021,TDMV 144,A00,451377,Anabo; Cherry,39,0,40,1
1708251766550,TDMV 149,A00,451378,Jun; Grace Shin Hae,36,0,40,4
1708251767076,TDPF 162,A00,451379,Alvarez; Ana Maria,40,0,40,0
1708251767604,TDPR 6,A01,450799,Guirguis; Mark C,50,0,50,0
1708251767604,TDPR 6,A02,450801,Guirguis; Mark C,50,0,50,0
1708251768129,TDPR 102,A00,451380,Guirguis; Mark C,20,0,20,0
1708251768655,TDPR 104,A00,451381,Powell; Lora,15,0,15,0
1708251769185,TDPW 1,A00,450808,Stein; Deborah Isobel,14,0,15,1
1708251769185,TDPW 1,B00,450864,Stein; Deborah Isobel,13,0,15,2
1708251769185,TDPW 1,C00,450865,Stein; Deborah Isobel,15,0,15,0
1708251769185,TDPW 1,D00,450868,Stein; Deborah Isobel,13,0,15,2
1708251769185,TDPW 1,E00,450874,Stein; Deborah Isobel,14,0,15,1
1708251769714,TDPW 102,A00,451382,Staff,18,0,20,2
1708251770242,TDPW 104,A00,481182,Staff,17,0,20,3
1708251770768,TDTR 10,A00,450881,Wilson; Terry A.,28,0,30,2
1708251771292,TDTR 15,A00,450882,Smith; Alison D,30,0,30,0
1708251771819,TMC 15,A00,479039,Hemans; Patricia Ann Benitez,25,0,25,0
1708251772344,TMC 87,A00,479049,Solomon; Amanda Lee Albaniel,20,0,20,0
1708251772869,UROL 296,001,467060,Anger; Jennifer Tash,49,0,50,1
1708251772869,UROL 296,002,467061,Staff,50,0,50,0
1708251773395,USP 3,A01,458852,Martin; Isaac,34,0,35,1
1708251773395,USP 3,A02,458853,Martin; Isaac,35,0,35,0
1708251773395,USP 3,A03,458861,Martin; Isaac,34,0,35,1
1708251773395,USP 3,A04,458862,Martin; Isaac,32,0,35,3
1708251773924,USP 4,A00,451772,Schwaller; Nora Louise,19,0,25,6
1708251774450,USP 5,A01,458863,Shenkman; Michael Thomas,33,0,35,2
1708251774450,USP 5,A02,458864,Shenkman; Michael Thomas,31,0,35,4
1708251774977,USP 15,A01,458931,Staff,33,0,35,2
1708251774977,USP 15,A02,459024,Staff,31,0,35,4
1708251775503,USP 25,A00,451786,Sun; Feiyang,57,0,60,3
1708251776028,USP 100,A00,451787,Moses; Kelema Lee,55,0,60,5
1708251776557,USP 108,A00,477594,Martin; Isaac,25,0,25,0
1708251777082,USP 119,A00,477595,Schwaller; Nora Louise,23,0,25,2
1708251777612,USP 124,A00,451790,Hinds; Juli Beth,62,0,70,8
1708251778139,USP 128B,A01,451910,Lewis; Leslie R,12,0,13,1
1708251778664,USP 142B,A01,451954,Lewis; Leslie R,24,0,25,1
1708251779192,USP 142C,A00,451977,Lerner; Amy M,0,0,0,0
1708251779723,USP 145,A00,451999,Yaghmaee; Saman,140,0,146,6
1708251780247,USP 150,A00,452165,Staff,44,0,50,6
1708251780773,USP 151,A00,452166,Staff,49,0,50,1
1708251781303,USP 152A,A01,459025,Weaver; Todd D,25,0,25,0
1708251781303,USP 152A,A02,459074,Weaver; Todd D,24,0,25,1
1708251781828,USP 152B,A00,452224,Moeder; Nathan L,21,0,25,4
1708251782356,USP 153,A00,452339,Shenkman; Michael Thomas,50,0,50,0
1708251782881,USP 158A,A00,452410,Sun; Feiyang,25,0,25,0
1708251783408,USP 159B,A00,452411,Gherini; Paul Pier-Carlo,6,0,8,2
1708251783936,USP 160,A00,452412,Wartell; Julie Dara,25,0,25,0
1708251784466,USP 164,A00,452413,Moses; Kelema Lee,22,0,25,3
1708251784992,USP 165C,A00,452442,Frank; Lawrence Douglas,20,0,20,0
1708251785522,USP 169,A00,452598,Bajaj; Ravi Siddharth,32,0,35,3
1708251786048,USP 170,A00,477593,Entezam; Maryam,60,0,60,0
1708251786576,USP 172,A00,452676,Peerson; Susan,19,0,25,6
1708251787104,USP 175,A00,452848,Velasco; Diego,18,0,20,2
1708251787633,USP 177A,A00,453084,Velasco; Diego,21,0,25,4
1708251788161,USP 177B,A00,453127,Peerson; Susan,22,0,25,3
1708251788687,USP 183,A00,453128,Sutton; April Marie,19,0,20,1
1708251789212,USP 188B,A00,453187,Pezzoli; Keith,30,0,30,0
1708251789737,USP 190,A00,453234,Pezzoli; Keith,0,0,0,1
1708251790267,USP 191B,A00,453240,Polat; Soydan Alihan,18,0,20,2
1708251790794,USP 193,A00,453251,Bussell; Mirle Rabinowitz,24,0,25,1
1708251791323,USP 194,A00,455342,Hill; Seth J,0,0,0,0
1708251791849,USP 265C,A00,453264,Frank; Lawrence Douglas,10,0,10,0
1708251792377,VIS 3,A01,453427,Staff,25,0,25,0
1708251792377,VIS 3,A02,453428,Staff,15,0,25,10
1708251792377,VIS 3,A03,453429,Staff,25,0,25,0
1708251792377,VIS 3,A04,453430,Staff,21,0,25,4
1708251792377,VIS 3,A05,453431,Staff,25,0,25,0
1708251792377,VIS 3,A06,453432,Staff,23,0,25,2
1708251792377,VIS 3,A07,453433,Staff,17,0,25,8
1708251792377,VIS 3,A08,453434,Staff,23,0,25,2
1708251792377,VIS 3,A09,453435,Staff,21,0,25,4
1708251792377,VIS 3,A10,453436,Staff,23,0,25,2
1708251792906,VIS 9,A00,453437,Camargo; William,116,0,146,30
1708251793431,VIS 10,A00,453438,Kiratli; Solen,189,0,200,11
1708251793960,VIS 21B,A01,453440,Shen; Kuiyi,31,0,32,1
1708251793960,VIS 21B,A02,453441,Shen; Kuiyi,31,0,32,1
1708251793960,VIS 21B,A03,453442,Shen; Kuiyi,31,0,32,1
1708251793960,VIS 21B,A04,453443,Shen; Kuiyi,32,0,32,0
1708251793960,VIS 21B,A05,453444,Shen; Kuiyi,32,0,32,0
1708251793960,VIS 21B,A06,453452,Shen; Kuiyi,32,0,32,0
1708251793960,VIS 21B,A07,453468,Shen; Kuiyi,30,0,32,2
1708251793960,VIS 21B,A08,453587,Shen; Kuiyi,32,0,32,0
1708251794488,VIS 22,A01,453589,Rose; Jordan M,32,0,32,0
1708251794488,VIS 22,A02,453590,Rose; Jordan M,32,0,32,0
1708251794488,VIS 22,A03,453615,Rose; Jordan M,31,0,32,1
1708251794488,VIS 22,A04,453616,Rose; Jordan M,32,0,32,0
1708251794488,VIS 22,A05,453617,Rose; Jordan M,30,0,32,2
1708251794488,VIS 22,A06,453618,Rose; Jordan M,30,0,32,2
1708251794488,VIS 22,A07,453620,Rose; Jordan M,32,0,32,0
1708251794488,VIS 22,A08,453621,Rose; Jordan M,32,0,32,0
1708251794488,VIS 22,A09,453635,Rose; Jordan M,32,0,32,0
1708251794488,VIS 22,A10,453636,Rose; Jordan M,32,0,32,0
1708251795014,VIS 31,A00,453637,Dominguez; Ricardo,133,0,146,13
1708251795542,VIS 41,A01,453644,D'Elena-Tweed; Jessica Erin,23,0,25,2
1708251795542,VIS 41,A02,453645,D'Elena-Tweed; Jessica Erin,22,0,25,3
1708251795542,VIS 41,A03,453646,D'Elena-Tweed; Jessica Erin,25,0,25,0
1708251795542,VIS 41,A04,453647,D'Elena-Tweed; Jessica Erin,18,0,25,7
1708251795542,VIS 41,A05,453648,D'Elena-Tweed; Jessica Erin,25,0,25,0
1708251795542,VIS 41,A06,453650,D'Elena-Tweed; Jessica Erin,24,0,25,1
1708251796076,VIS 70N,A01,453652,Garnett; Mariah J,21,0,22,1
1708251796076,VIS 70N,A02,453653,Garnett; Mariah J,21,0,22,1
1708251796076,VIS 70N,A03,453654,Garnett; Mariah J,22,0,22,0
1708251796076,VIS 70N,A04,453657,Garnett; Mariah J,22,0,22,0
1708251796076,VIS 70N,A05,453662,Garnett; Mariah J,20,0,22,2
1708251796076,VIS 70N,A06,453663,Garnett; Mariah J,22,0,22,0
1708251796607,VIS 83,A00,453664,Kester; Grant,137,0,146,9
1708251797137,VIS 101A,A00,453666,Cruz; Edwin Teddy,10,0,15,5
1708251797661,VIS 102,A00,453668,Cruz; Edwin Teddy,81,0,85,4
1708251798185,VIS 105A,A00,453669,Adler; Amy,29,0,30,1
1708251798715,VIS 105B,A00,453738,Herc-Balaszek; Malgorzata,25,0,30,5
1708251798715,VIS 105B,B00,453739,Staff,27,0,30,3
1708251799240,VIS 106A,A00,453740,Staff,22,0,25,3
1708251799766,VIS 106B,A00,453741,De Luca; Mara Julia,20,0,25,5
1708251800301,VIS 106C,A00,453746,Vangenderen; Monique Luise,11,0,15,4
1708251800829,VIS 107A,A00,453747,Gregoire; Mathieu,19,0,25,6
1708251801358,VIS 107B,A00,453748,Dean; Danielle Adobi,23,0,25,2
1708251801886,VIS 110A,A00,453749,Adler; Amy,13,0,15,2
1708251802468,VIS 110E,A00,453798,Gregoire; Mathieu,14,0,15,1
1708251803008,VIS 110F,A00,453799,Staff,15,0,15,0
1708251803534,VIS 110N,A00,453803,Dean; Danielle Adobi,15,0,15,0
1708251804061,VIS 123B,A00,453804,Gaines; Malik Julian,75,0,75,0
1708251804588,VIS 125BN,A00,453813,Welchman; John C.,75,0,75,0
1708251805115,VIS 126P,A00,453814,Wardwell; Mariana Razo,74,0,75,1
1708251805641,VIS 128E,A00,453815,Staff,75,0,75,0
1708251806170,VIS 129E,A00,453855,Shen; Kuiyi,12,0,15,3
1708251806704,VIS 131,A00,453859,Trigilio; Michael,12,0,15,3
1708251806704,VIS 131,B00,479342,Mangolte; Babette,15,0,15,0
1708251807229,VIS 133A,A00,454231,Barbosa; Erika Katrina,13,0,15,2
1708251807755,VIS 134,A00,454232,Yoldas; Pinar,59,0,75,16
1708251808284,VIS 141B,A00,454233,Stalbaum; Brett,12,0,15,3
1708251808814,VIS 145B,A00,454234,Alexander; Amy J,14,0,15,1
1708251808814,VIS 145B,B00,454235,Kiratli; Solen,8,0,15,7
1708251809340,VIS 147A,A01,454237,Stalbaum; Brett,20,0,22,2
1708251809340,VIS 147A,A02,454238,Stalbaum; Brett,18,0,22,4
1708251809865,VIS 157,A01,454240,Cartwright; Lisa,32,0,34,2
1708251809865,VIS 157,A02,454241,Cartwright; Lisa,32,0,34,2
1708251811404,VIS 159,A01,454243,Akten; Mehmet,34,0,34,0
1708251811404,VIS 159,A02,454244,Akten; Mehmet,32,0,34,2
1708251811404,VIS 159,A03,454300,Akten; Mehmet,30,0,34,4
1708251811404,VIS 159,A04,454301,Akten; Mehmet,33,0,34,1
1708251811404,VIS 159,A05,454302,Akten; Mehmet,30,0,34,4
1708251811404,VIS 159,A06,454307,Akten; Mehmet,33,0,34,1
1708251811404,VIS 159,A07,454308,Akten; Mehmet,34,0,34,0
1708251811404,VIS 159,A08,454309,Akten; Mehmet,33,0,34,1
1708251811947,VIS 160B,A00,454310,Alexander; Amy J,13,0,15,2
1708251811947,VIS 160B,B00,454311,Akten; Mehmet,14,0,15,1
1708251811947,VIS 160B,C00,454312,Stone; Patricia,12,0,15,3
1708251812474,VIS 164,A00,454313,Cross; Brian R,19,0,22,3
1708251812474,VIS 164,B00,454314,Camargo; William,22,0,22,0
1708251813002,VIS 165,A00,454315,Erdmann; Dean,22,0,22,0
1708251813532,VIS 167,A00,454316,Staff,18,0,22,4
1708251814058,VIS 169A,A00,454317,Mostajo; Lorena,21,0,22,1
1708251814583,VIS 171,A00,454318,Nakayama; Yue,21,0,22,1
1708251815108,VIS 174,A00,454319,Staff,19,0,22,3
1708251815644,VIS 177,A00,454320,Cho; Erica,21,0,22,1
1708251816170,VIS 178,A00,454321,Staff,0,0,0,0
1708251816699,VIS 179,A00,454322,Erdmann; Dean,22,0,22,0
1708251817226,VIS 180A,A00,454323,Nakayama; Yue,21,0,22,1
1708251817755,VIS 180B,A00,454341,Cross; Brian R,20,0,22,2
1708251818282,VIS 183A,A00,454342,Cho; Erica,17,0,22,5
1708251818809,VIS 185,A00,454343,Miller; Nicole L,18,0,22,4
1708251819337,VIS 190,A00,454360,Crandall; Jordan,15,0,15,0
1708251819337,VIS 190,B00,454361,D'Elena-Tweed; Jessica Erin,10,0,15,5
1708251819862,VIS 202,A00,454369,Miller; Nicole L,12,0,15,3
1708251820387,VIS 203,A00,454370,Garnett; Mariah J,8,0,15,7
1708251820916,VIS 206,A00,454376,Kester; Grant,10,0,15,5
1708251821441,VIS 208,A00,454377,Moss; Ceci,15,0,15,0
1708251821966,VIS 211,A00,454413,Segade; Alexandro Abraham,0,0,0,2
1708251822496,VIS 243,A00,454429,Rose; Jordan M,5,0,15,10
1708251823022,VIS 255,A00,454430,Welchman; John C.,8,0,15,7
1708251823548,VIS 262,A00,454431,Yoldas; Pinar,11,0,15,4
1708251824075,WCWP 10A,001,454442,Uriarte; Emma,17,0,20,3
1708251824075,WCWP 10A,002,454443,Uriarte; Emma,14,0,20,6
1708251824075,WCWP 10A,003,454479,Uriarte; Emma,19,0,20,1
1708251824075,WCWP 10A,004,454480,Staff,0,0,0,0
1708251824075,WCWP 10A,005,454484,Staff,0,0,0,0
1708251824075,WCWP 10A,006,454485,Staff,0,0,0,0
1708251824075,WCWP 10A,007,454487,Staff,0,0,0,0
1708251824075,WCWP 10A,008,454488,Susi; Natalie,14,0,20,6
1708251824075,WCWP 10A,009,454489,Staff,0,0,0,0
1708251824075,WCWP 10A,010,454490,Staff,0,0,0,0
1708251824659,WCWP 10B,001,454492,Ornelas; Tricia,20,0,20,0
1708251824659,WCWP 10B,002,454501,Ornelas; Tricia,20,0,20,0
1708251824659,WCWP 10B,003,454565,Gagnon; Jeffrey C,2,0,20,18
1708251824659,WCWP 10B,004,454604,Ornelas; Tricia,16,0,20,4
1708251824659,WCWP 10B,005,454668,Staff,16,0,16,0
1708251824659,WCWP 10B,006,454724,Staff,16,0,16,0
1708251824659,WCWP 10B,007,454725,Staff,14,0,16,2
1708251824659,WCWP 10B,008,454768,Staff,0,0,0,0
1708251824659,WCWP 10B,009,454769,Staff,0,0,0,0
1708251824659,WCWP 10B,010,454770,Staff,0,0,0,0
1708251824659,WCWP 10B,011,454771,Dhir; Simrita,16,0,20,4
1708251824659,WCWP 10B,012,454772,Dhir; Simrita,16,0,20,4
1708251824659,WCWP 10B,013,454773,Merryman; Walter,17,0,20,3
1708251824659,WCWP 10B,014,454774,Dhir; Simrita,18,0,20,2
1708251824659,WCWP 10B,015,454775,Merryman; Walter,17,0,20,3
1708251824659,WCWP 10B,016,454776,Merryman; Walter,18,0,20,2
1708251824659,WCWP 10B,017,454777,Welji; Haleema Nazir,14,0,16,2
1708251824659,WCWP 10B,018,478868,Staff,16,0,16,0
1708251824659,WCWP 10B,019,478869,Staff,0,0,0,0
1708251824659,WCWP 10B,020,478876,Staff,0,0,0,0
1708251824659,WCWP 10B,021,478877,Staff,0,0,0,0
1708251824659,WCWP 10B,022,478887,Staff,0,0,0,0
1708251824659,WCWP 10B,023,478889,Staff,16,0,16,0
1708251824659,WCWP 10B,024,478892,Staff,0,0,0,0
1708251824659,WCWP 10B,025,478907,Staff,0,0,0,0
1708251825187,WCWP 100,A00,454800,McCleary; Keith Long,20,0,20,0
1708251825187,WCWP 100,B00,454804,McCleary; Keith Long,20,0,20,0
1708251825187,WCWP 100,C00,454822,Twohig; Niall Ivan,19,0,20,1
1708251825187,WCWP 100,D00,454855,Young; Mark T,20,0,20,0
1708251825187,WCWP 100,E00,454860,Twohig; Niall Ivan,20,0,20,0
1708251825187,WCWP 100,F00,454932,Young; Mark T,20,0,20,0
1708251825187,WCWP 100,G00,454933,Young; Mark T,20,0,20,0
1708251825714,WES 207,A00,454941,Kastner; Ryan Charles,20,0,20,0
1708251826242,WES 265,A00,454942,Staff,19,0,20,1
1708251828397,AAS 10,A01,392963,Butler; Elizabeth Annette,34,0,34,0
1708251828397,AAS 10,A02,392965,Butler; Elizabeth Annette,33,0,34,1
1708251828922,AAS 170,A00,392977,Butler; Elizabeth Annette,31,0,32,1
1708251829448,AAS 198,001,479182,Childs; Dennis R.,20,0,20,0
1708251829974,AESE 261,A00,387945,Staff,33,0,33,0
1708251830500,AESE 278D,A00,387953,Staff,33,0,33,0
1708251831048,AESE 278E,A00,387954,Staff,33,0,33,0
1708251831574,AESE 279A,A00,387956,Staff,33,0,33,0
1708251832101,AIP 197P,001,494494,Goldfarb; Brian,9999,0,9999,0
1708251832634,ANAR 100,A00,387884,Shtienberg; Gilad,15,0,16,1
1708251833161,ANAR 104,A01,387886,Tamberino; Anthony Thomas,21,0,25,4
1708251833688,ANAR 111,A00,387888,Staff,36,0,36,0
1708251834214,ANAR 115,A00,387889,Shtienberg; Gilad,36,0,36,0
1708251834739,ANAR 120,A00,387890,Staff,36,0,36,0
1708251835265,ANAR 155,A00,387891,Braswell; Geoffrey E.,15,0,25,10
1708251835796,ANAR 164,A00,387892,Staff,32,0,35,3
1708251836328,ANBI 100,A00,489626,Fox; Patrick Keolu Ozer,39,0,40,1
1708251836869,ANBI 111,A00,387893,Hrvoj Mihic; Branka,37,0,40,3
1708251838163,ANBI 144,A00,387896,Wilder; Linnea Lorene,72,0,75,3
1708251838689,ANBI 149,A00,489628,Non; Amy L,0,0,0,0
1708251839219,ANBI 173,A00,387897,Wilder; Linnea Lorene,74,0,75,1
1708251839745,ANBI 174,A00,489627,Strum; Shirley C.,13,0,15,2
1708251840277,ANES 296,001,463968,Gabriel; Rodney A,49,0,50,1
1708251840277,ANES 296,002,463969,Staff,50,0,50,0
1708251840277,ANES 296,003,463970,Staff,50,0,50,0
1708251840804,ANSC 100,A00,387898,Bialecki; Jon Anthony,40,0,40,0
1708251841333,ANSC 101,A00,387900,Sloane; Julia Kathryn,34,0,40,6
1708251841859,ANSC 117,A00,387901,Martin Sandino; Amanda Maria Yoland,13,0,15,2
1708251842385,ANSC 134,A00,387902,Staff,38,0,40,2
1708251842915,ANSC 137,A00,387903,Stewart; Alexander B,80,0,80,0
1708251843448,ANSC 138,A00,387904,Parish; Steven Martin,14,0,15,1
1708251843977,ANSC 142,A00,387905,Stone; Annika Britt,34,0,40,6
1708251844504,ANSC 147,A00,387906,Stewart; Alexander B,40,0,40,0
1708251845031,ANSC 148,A00,387907,Olivas Hernandez; Olga Lid,92,0,92,0
1708251845560,ANSC 186,A00,387910,Hankins; Joseph D.,28,0,30,2
1708251846090,ANTH 2,A01,387863,Marchetto; Maria Carolina,37,0,40,3
1708251846090,ANTH 2,A02,387864,Marchetto; Maria Carolina,40,0,40,0
1708251846090,ANTH 2,A03,387865,Marchetto; Maria Carolina,36,0,40,4
1708251846090,ANTH 2,A04,387866,Marchetto; Maria Carolina,39,0,40,1
1708251846622,ANTH 3,A01,387868,Stroth; Luke Reyneri,28,0,30,2
1708251846622,ANTH 3,A02,387869,Stroth; Luke Reyneri,29,0,30,1
1708251846622,ANTH 3,A03,387870,Stroth; Luke Reyneri,30,0,30,0
1708251846622,ANTH 3,A04,387871,Stroth; Luke Reyneri,29,0,30,1
1708251847148,ANTH 10,A00,387872,Stewart; Alexander B,80,0,80,0
1708251848709,ANTH 21,A01,387874,Stone; Annika Britt,40,0,40,0
1708251848709,ANTH 21,A02,387875,Stone; Annika Britt,40,0,40,0
1708251848709,ANTH 21,A03,387876,Stone; Annika Britt,40,0,40,0
1708251848709,ANTH 21,A04,387877,Stone; Annika Britt,39,0,40,1
1708251849250,ANTH 23,A01,387879,Staff,40,0,40,0
1708251849250,ANTH 23,A02,387880,Staff,40,0,40,0
1708251849250,ANTH 23,A03,387881,Staff,40,0,40,0
1708251849250,ANTH 23,A04,387882,Staff,40,0,40,0
1708251849791,ANTH 24,A00,387883,Pedersen; David,40,0,40,0
1708251850325,ANTH 103,A00,387911,Staff,343,0,350,7
1708251850854,ANTH 105,A00,387912,Staff,73,0,75,2
1708251851381,ANTH 112,A00,387913,Staff,23,0,25,2
1708251851908,ANTH 120,A00,479486,Parish; Steven Martin,28,0,30,2
1708251852434,ANTH 128B,A01,387923,Lewis; Leslie R,12,0,12,0
1708251852962,ANTH 192,A00,387925,Varma; Saiba,20,0,20,0
1708251853489,ANTH 196C,A00,387927,Varma; Saiba,15,0,15,0
1708251854018,ANTH 212,A00,387931,Marchetto; Maria Carolina,25,0,25,0
1708251854018,ANTH 212,B00,479487,Semendeferi; Ekaterini,25,0,25,0
1708251854548,ANTH 220,A00,387932,Csordas; Thomas J.,9,0,12,3
1708251855076,ANTH 230,001,493297,Goldstein; Paul S,18,0,20,2
1708251855602,ANTH 260,A00,479223,Jenkins; Janis A.,25,0,25,0
1708251856128,ANTH 272,A00,387936,Serlin; David,5,0,5,0
1708251856657,ANTH 273,A00,387938,Gates; Kelly,5,0,5,0
1708251857183,ANTH 288,A00,387940,Braswell; Geoffrey E.,25,0,25,0
1708251857966,ANTH 295,001,493298,Algaze; Guillermo,3,0,3,0
1708251857966,ANTH 295,002,493299,Brenner; Suzanne A,3,0,3,0
1708251857966,ANTH 295,003,493300,Csordas; Thomas J.,3,0,3,0
1708251857966,ANTH 295,004,493422,Fox; Patrick Keolu Ozer,3,0,3,0
1708251857966,ANTH 295,005,493472,Gagneux; Pascal,3,0,3,0
1708251857966,ANTH 295,006,493515,Goldstein; Paul S,3,0,3,0
1708251857966,ANTH 295,007,493592,Hankins; Joseph D.,3,0,3,0
1708251857966,ANTH 295,008,493631,Jassal; Aftab,3,0,3,0
1708251857966,ANTH 295,009,493639,Jenkins; Janis A.,3,0,3,0
1708251857966,ANTH 295,010,493657,Kaiser; Bronwyn Nicole,3,0,3,0
1708251857966,ANTH 295,011,493692,Kang; Byung Chu,3,0,3,0
1708251857966,ANTH 295,012,493758,Marchetto; Maria Carolina,3,0,3,0
1708251857966,ANTH 295,013,493761,Non; Amy L,3,0,3,0
1708251857966,ANTH 295,014,493762,Pedersen; David,3,0,3,0
1708251857966,ANTH 295,015,493825,Rivera-Collazo; Isabel C,3,0,3,0
1708251857966,ANTH 295,016,493826,Varma; Saiba,3,0,3,0
1708251857966,ANTH 295,017,493828,Yeh; Rihan Wen Xin,3,0,3,0
1708251858516,ANTH 296,001,493830,Braswell; Geoffrey E.,3,0,3,0
1708251858516,ANTH 296,002,493836,Marchetto; Maria Carolina,3,0,3,0
1708251858516,ANTH 296,003,493838,Rivera-Collazo; Isabel C,3,0,3,0
1708251858516,ANTH 296,004,493840,Varma; Saiba,3,0,3,0
1708251858516,ANTH 296,005,493842,Algaze; Guillermo,3,0,3,0
1708251858516,ANTH 296,006,493845,Brenner; Suzanne A,3,0,3,0
1708251858516,ANTH 296,007,493846,Csordas; Thomas J.,3,0,3,0
1708251858516,ANTH 296,008,493907,Fox; Patrick Keolu Ozer,3,0,3,0
1708251858516,ANTH 296,009,493949,Gagneux; Pascal,3,0,3,0
1708251858516,ANTH 296,010,493960,Goldstein; Paul S,3,0,3,0
1708251858516,ANTH 296,011,493961,Hankins; Joseph D.,3,0,3,0
1708251858516,ANTH 296,012,493962,Jassal; Aftab,3,0,3,0
1708251858516,ANTH 296,013,493963,Jenkins; Janis A.,3,0,3,0
1708251858516,ANTH 296,014,493964,Kaiser; Bronwyn Nicole,3,0,3,0
1708251858516,ANTH 296,015,493965,Kang; Byung Chu,3,0,3,0
1708251858516,ANTH 296,016,493966,Levy; Thomas E,3,0,3,0
1708251858516,ANTH 296,017,493967,Non; Amy L,3,0,3,0
1708251858516,ANTH 296,018,493968,Pedersen; David,3,0,3,0
1708251858516,ANTH 296,019,493969,Postero; Nancy Grey,3,0,3,0
1708251858516,ANTH 296,020,493970,Semendeferi; Ekaterini,3,0,3,0
1708251858516,ANTH 296,021,493971,Yeh; Rihan Wen Xin,3,0,3,0
1708251859041,AUD 236,A00,480192,Harris; Jeffrey Paul,12,0,12,0
1708251859642,AUD 260,A00,480227,Spriggs; Meghan K,12,0,12,0
1708251860170,AUD 272,A00,480367,Zettner; Erika,12,0,12,0
1708251860698,AUD 275,A00,480369,Zettner; Erika,12,0,12,0
1708251861233,AUD 284,A00,480370,Zettner; Erika,12,0,12,0
1708251861233,AUD 284,B00,480372,Spriggs; Meghan K,12,0,12,0
1708251861759,AUD 291,A00,480374,Zettner; Erika,12,0,12,0
1708251862286,AUD 296,A00,480375,Zettner; Erika,12,0,12,0
1708251862286,AUD 296,B00,480376,Harris; Jeffrey Paul,12,0,12,0
1708251862286,AUD 296,C00,480377,Ryan; Allen F.,12,0,12,0
1708251862814,AWP 3,002,387672,Given; William Allan,9,0,9,0
1708251862814,AWP 3,003,387678,Staff,5,0,5,0
1708251862814,AWP 3,004,387681,Staff,0,0,0,0
1708251862814,AWP 3,007,387784,West; Geoffrey Scott,4,0,5,1
1708251862814,AWP 3,009,387786,Kolodezh; Samuel,5,0,5,0
1708251862814,AWP 3,010,387787,Gilbert; Peter W,5,0,5,0
1708251863340,AWP 4A,001,387791,Staff,12,0,12,0
1708251863340,AWP 4A,002,387792,Staff,0,0,0,0
1708251863911,AWP 4B,001,387793,Bolin; Jillian,0,0,0,0
1708251863911,AWP 4B,002,387794,Bolin; Jillian,0,0,0,0
1708251863911,AWP 4B,003,387795,Bauer; Holly Jean,0,0,0,0
1708251863911,AWP 4B,004,387796,Vaughn; Kelsey Sara,0,0,0,0
1708251863911,AWP 4B,005,387797,Vaughn; Kelsey Sara,0,0,0,0
1708251863911,AWP 4B,007,387799,Ajo; Frances Margaret,0,0,0,0
1708251863911,AWP 4B,008,387800,Ajo; Frances Margaret,0,0,0,0
1708251863911,AWP 4B,009,387801,Hall; Graham T,0,0,0,0
1708251863911,AWP 4B,010,387802,Hall; Graham T,0,0,0,0
1708251863911,AWP 4B,011,387803,Heiser; Jerrod A,0,0,0,0
1708251863911,AWP 4B,012,387804,Heiser; Jerrod A,0,0,0,0
1708251863911,AWP 4B,013,387805,Jones; William Jadie,0,0,0,0
1708251863911,AWP 4B,014,387806,Jones; William Jadie,0,0,0,0
1708251863911,AWP 4B,015,387807,Christie; Veronica Ann,0,0,0,0
1708251863911,AWP 4B,016,387808,Christie; Veronica Ann,0,0,0,0
1708251863911,AWP 4B,019,387820,Falcon; Jennifer A,0,0,0,0
1708251863911,AWP 4B,020,387821,Falcon; Jennifer A,0,0,0,0
1708251863911,AWP 4B,021,387822,Eastin; Schuyler E.,0,0,0,0
1708251863911,AWP 4B,023,387824,Coulter; Jane Elisabeth,0,0,0,0
1708251863911,AWP 4B,025,387826,O'Neil; Courtney L,0,0,0,0
1708251863911,AWP 4B,026,387827,O'Neil; Courtney L,0,0,0,0
1708251863911,AWP 4B,027,387828,Tsurska Svetina; Olena,0,0,0,0
1708251863911,AWP 4B,028,387829,Tsurska Svetina; Olena,0,0,0,0
1708251863911,AWP 4B,029,387830,Spicer; Jacqueline,0,0,0,0
1708251863911,AWP 4B,030,387831,Spicer; Jacqueline,0,0,0,0
1708251863911,AWP 4B,031,387832,Steinberg; Stacy A,0,0,0,0
1708251863911,AWP 4B,032,387833,Steinberg; Stacy A,0,0,0,0
1708251863911,AWP 4B,033,387834,Chandler; Bailee Daniele,0,0,0,0
1708251863911,AWP 4B,034,387835,Chandler; Bailee Daniele,0,0,0,0
1708251863911,AWP 4B,035,387836,Tiernan; Christa Michelle,0,0,0,0
1708251863911,AWP 4B,036,387837,Tiernan; Christa Michelle,0,0,0,0
1708251863911,AWP 4B,037,387840,Gardella; Alexander Drew,0,0,0,0
1708251863911,AWP 4B,038,387841,Gardella; Alexander Drew,0,0,0,0
1708251863911,AWP 4B,039,387857,Zimmerman; Guy,0,0,0,0
1708251863911,AWP 4B,040,387858,Zimmerman; Guy,0,0,0,0
1708251863911,AWP 4B,041,387859,Zroka; Amy Liane,0,0,0,0
1708251863911,AWP 4B,042,387860,Zroka; Amy Liane,0,0,0,0
1708251864438,BENG 87,A00,489656,Sah; Robert Lie-Yuan,20,0,20,0
1708251864438,BENG 87,B00,489657,Sah; Robert Lie-Yuan,20,0,20,0
1708251864438,BENG 87,C00,494754,Omens; Jeffrey Howard,20,0,20,0
1708251864963,BENG 100,A01,387959,Alexandrov; Ludmil B,26,0,28,2
1708251864963,BENG 100,A02,387960,Alexandrov; Ludmil B,26,0,28,2
1708251864963,BENG 100,A03,387984,Alexandrov; Ludmil B,26,0,28,2
1708251864963,BENG 100,A04,387985,Alexandrov; Ludmil B,25,0,28,3
1708251864963,BENG 100,A05,387986,Alexandrov; Ludmil B,27,0,28,1
1708251865489,BENG 102,A00,387987,Chapelin; Fanny,55,0,56,1
1708251866031,BENG 103B,A00,387993,Fraley; Stephanie I.,116,0,120,4
1708251866559,BENG 112B,A01,388053,Shi; Lingyan,26,0,30,4
1708251866559,BENG 112B,A02,388054,Shi; Lingyan,29,0,30,1
1708251867087,BENG 125,A00,388055,Hasty; Jeff M,120,0,160,40
1708251867614,BENG 133,A01,388866,Mali; Prashant Gulab Ram,36,0,40,4
1708251868144,BENG 140B,A01,388884,Cabrales; Pedro,28,0,30,2
1708251868144,BENG 140B,A02,388885,Cabrales; Pedro,30,0,30,0
1708251868144,BENG 140B,A03,388886,Cabrales; Pedro,26,0,30,4
1708251868671,BENG 160,A50,388889,Aguado; Brian Alberto,23,0,25,2
1708251868671,BENG 160,A51,388919,Aguado; Brian Alberto,25,0,25,0
1708251868671,BENG 160,A52,388920,Aguado; Brian Alberto,25,0,25,0
1708251869200,BENG 168,A01,388961,Khojah; Reem I,30,0,30,0
1708251869725,BENG 172,A50,389087,Omens; Jeffrey Howard & Cabrales; Pedro,15,0,20,5
1708251869725,BENG 172,A51,389088,Omens; Jeffrey Howard & Cabrales; Pedro,14,0,20,6
1708251870251,BENG 182,A01,389128,Bafna; Vineet,28,0,30,2
1708251870782,BENG 186A,A00,389130,Kwon; Ester Jihae,105,0,120,15
1708251871308,BENG 187A,A00,389289,Taylor Amos; Alyssa C,157,0,170,13
1708251871833,BENG 187D,A00,389290,Taylor Amos; Alyssa C,33,0,60,27
1708251871833,BENG 187D,B00,389300,Taylor Amos; Alyssa C,51,0,60,9
1708251871833,BENG 187D,C00,389302,Taylor Amos; Alyssa C,35,0,60,25
1708251872359,BENG 189,A00,389303,Contijoch; Francisco,26,0,30,4
1708251872889,BENG 193,A00,389328,Engler; Adam J.,0,0,0,0
1708251873415,BENG 196,A00,436038,Engler; Adam J.,9999,0,9999,0
1708251873942,BENG 197,A00,436081,Engler; Adam J.,9999,0,9999,0
1708251874468,BENG 203,A00,389385,Bafna; Vineet & Zhong; Sheng,20,0,20,0
1708251874996,BENG 207,A00,389386,Kwon; Ester Jihae,10,0,40,30
1708251874996,BENG 207,B00,389400,Taylor Amos; Alyssa C,8,0,30,22
1708251874996,BENG 207,C00,389432,Khojah; Reem I,20,0,40,20
1708251875523,BENG 209,A00,389456,Scholtes Acevedo; Claire,30,0,30,0
1708251876049,BENG 213,A00,389496,Palsson; Bernhard O.,16,0,20,4
1708251877105,BENG 224,A00,389515,Staff,0,0,0,0
1708251877631,BENG 226,A01,479043,Schmid-Schoenbein; Geert W,7,0,30,23
1708251878156,BENG 227,A00,389591,Fraley; Stephanie I.,55,0,120,65
1708251878686,BENG 230C,A00,389810,Mc Culloch; Andrew Douglas,43,0,90,47
1708251879212,BENG 232,A01,390161,Sah; Robert Lie-Yuan,6,0,50,44
1708251879739,BENG 233,A00,390290,Shah; Sameer B,33,0,50,17
1708251880270,BENG 234,A00,390291,Silva; Gabriel,20,0,56,36
1708251880797,BENG 235,A00,390318,Bintu; Bogdan,16,0,40,24
1708251881328,BENG 276,A00,390357,Mc Culloch; Andrew Douglas & Amaro; Rommie E,0,0,0,0
1708251881854,BENG 280C,A01,390443,McVeigh; Elliot R.,45,0,56,11
1708251882382,BENG 281,A00,390444,Kravets; Vira V.,50,0,110,60
1708251882908,BENG 283,A00,390445,Komives; Elizabeth A,4,0,4,0
1708251883438,BENG 292,A01,390623,Ross; Camille,20,0,20,0
1708251883965,BENG 294C,A00,390709,Engler; Adam J.,17,0,20,3
1708251884497,BENG 295,A00,436300,Watson; John Thomas,9999,0,9999,0
1708251885039,BGGN 205,A00,423656,Daugherty; Matthew Dorton,47,0,60,13
1708251885567,BGGN 207,A01,423703,Ross; Camille,0,0,0,0
1708251886097,BGGN 215,A00,423704,Petrie; Katherine Lynn,22,0,30,8
1708251886623,BGGN 216,A01,423855,Mueller; Liam O'Connor,37,0,50,13
1708251887149,BGGN 218,A00,423861,David; Michael,19,0,30,11
1708251887674,BGGN 223,A00,423862,Bier; Ethan,17,0,35,18
1708251888201,BGGN 230,A00,423863,Taylor; Susan S.,8,0,15,7
1708251888730,BGGN 232,A00,423864,Briggs; Steven & Troemel; Emily Ruth,25,0,30,5
1708251889260,BGGN 239,A01,424014,Kronenberg; Mitchell E.,30,0,30,0
1708251889786,BGGN 240,A01,424016,Juavinett; Ashley Lauren,0,0,6,6
1708251890312,BGGN 248,A00,424017,Halpain; Shelley,26,0,30,4
1708251891855,BGGN 249C,A00,424052,Staff,33,0,33,0
1708251892386,BGGN 250,A01,424091,Zou; Yimin,7,0,8,1
1708251892913,BGGN 252,A01,424093,Sejnowski; Terrence J,5,0,6,1
1708251893439,BGGN 255,A00,424094,Root; Cory Matthew,29,0,30,1
1708251893970,BGGN 262,A01,424096,Villa Rodriguez; Elizabeth,30,0,30,0
1708251894496,BGGN 267,A01,424099,Benna; Marcus K & Aljadeff; Johnatan,5,0,6,1
1708251895024,BGGN 270,A00,477483,Juavinett; Ashley Lauren,67,0,75,8
1708251895731,BGGN 271,001,481745,Ackerman; Susan,9998,0,9999,1
1708251895731,BGGN 271,002,481746,Akbari; Omar Sultan,9999,0,9999,0
1708251895731,BGGN 271,003,481747,Allen; Nicola J,9999,0,9999,0
1708251895731,BGGN 271,004,481748,Banegas; Matthew Patrick,9999,0,9999,0
1708251895731,BGGN 271,005,481749,Breen; Ellen C.,9998,0,9999,1
1708251895731,BGGN 271,006,481750,Briggs; Steven,9998,0,9999,1
1708251895731,BGGN 271,007,481751,Bui; Jack D,9999,0,9999,0
1708251895731,BGGN 271,008,481762,Busch; Wolfgang,9999,0,9999,0
1708251895731,BGGN 271,009,481763,Castle; Michael James,9999,0,9999,0
1708251895731,BGGN 271,010,481764,Chang; John Tzu-yu,9999,0,9999,0
1708251895731,BGGN 271,011,481765,Chen; Ju,9998,0,9999,1
1708251895731,BGGN 271,012,481766,Chen; Xu,9999,0,9999,0
1708251895731,BGGN 271,013,481767,Cheng; Christine Shiang-Ling,9999,0,9999,0
1708251895731,BGGN 271,014,481768,Cherqui; Stephanie,9999,0,9999,0
1708251895731,BGGN 271,015,481769,Cho; Yoshitake,9999,0,9999,0
1708251895731,BGGN 271,016,481770,Church; Kellie Breen,9998,0,9999,1
1708251895731,BGGN 271,017,481771,Cleland; Elsa Eleanor,9999,0,9999,0
1708251895731,BGGN 271,018,481779,Cohen; Shiran,9998,0,9999,1
1708251895731,BGGN 271,019,481814,Cook-Andersen; Heidi Leigh,9999,0,9999,0
1708251895731,BGGN 271,020,481815,Cooke; James Edward,9999,0,9999,0
1708251895731,BGGN 271,021,481816,Coufal; Nicole Gabriele,9998,0,9999,1
1708251895731,BGGN 271,022,481818,Crotty Alexander; Laura E,9999,0,9999,0
1708251895731,BGGN 271,023,481819,Daugherty; Matthew Dorton,9998,0,9999,1
1708251895731,BGGN 271,024,481820,De Guglielmo; Giordano,9998,0,9999,1
1708251895731,BGGN 271,025,481821,Doherty; Taylor Alan,9998,0,9999,1
1708251895731,BGGN 271,026,481822,Dulawa; Stephanie Carole,9999,0,9999,0
1708251895731,BGGN 271,027,481823,Esko; Jeffrey D.,9998,0,9999,1
1708251895731,BGGN 271,028,481824,Feldstein; Ariel E,9998,0,9999,1
1708251895731,BGGN 271,029,481825,Friedman; Rick Adam,9999,0,9999,0
1708251895731,BGGN 271,030,481826,Furnari; Frank,9999,0,9999,0
1708251895731,BGGN 271,031,481829,Ghosh; Pradipta,9998,0,9999,1
1708251895731,BGGN 271,032,481830,Gleeson; Joseph Gerard,9999,0,9999,0
1708251895731,BGGN 271,033,481831,Golden; Susan S.,9998,0,9999,1
1708251895731,BGGN 271,034,481832,Goren; Alon M,9998,0,9999,1
1708251895731,BGGN 271,035,481834,Gustafsson; Asa Birgitta,9999,0,9999,0
1708251895731,BGGN 271,036,481836,Hamdoun; Amr,9999,0,9999,0
1708251895731,BGGN 271,037,481837,Hao; Nan,9999,0,9999,0
1708251895731,BGGN 271,038,481840,Holway; David A.,9998,0,9999,1
1708251895731,BGGN 271,039,481841,Huffaker; Alisa,9998,0,9999,1
1708251895731,BGGN 271,040,481843,Sebat; Lilia Mikhailovna,9998,0,9999,1
1708251895731,BGGN 271,041,481889,Ideker; Trey,9999,0,9999,0
1708251895731,BGGN 271,042,481890,Jiang; Qingfei,9998,0,9999,1
1708251895731,BGGN 271,043,482311,Jin; Yishi,9999,0,9999,0
1708251895731,BGGN 271,044,482334,Joiner; William J.,9999,0,9999,0
1708251895731,BGGN 271,045,482353,Kaech; Susan Michelle,9998,0,9999,1
1708251895731,BGGN 271,046,482378,Karin; Michael,9999,0,9999,0
1708251895731,BGGN 271,047,482379,Kleinfeld; David,9999,0,9999,0
1708251895731,BGGN 271,048,482413,Koffler; Yacov,9999,0,9999,0
1708251895731,BGGN 271,049,482414,Komiyama; Takaki,9999,0,9999,0
1708251895731,BGGN 271,050,482415,Kryazhimskiy; Sergey A,9999,0,9999,0
1708251895731,BGGN 271,051,482416,Lawson; Mark Andrew,9999,0,9999,0
1708251895731,BGGN 271,052,482417,Lee; Yun Sok,9999,0,9999,0
1708251895731,BGGN 271,053,482451,Leutgeb; Stefan,9998,0,9999,1
1708251895731,BGGN 271,054,482452,Lo; Stanley M.,9999,0,9999,0
1708251895731,BGGN 271,055,482453,Lu; Pengzhe,9998,0,9999,1
1708251895731,BGGN 271,056,482454,Lykke-Andersen; Jens,9998,0,9999,1
1708251895731,BGGN 271,057,482456,McDonnell; Lisa Marie,9999,0,9999,0
1708251895731,BGGN 271,058,482461,McHugh; Colleen A,9998,0,9999,1
1708251895731,BGGN 271,059,482478,Meharena; Hiruy Sibhatu,9999,0,9999,0
1708251895731,BGGN 271,060,482497,Morris; Gerald P,9999,0,9999,0
1708251895731,BGGN 271,061,482499,Mukamel; Eran A,9998,0,9999,1
1708251895731,BGGN 271,062,482535,Muotri; Alysson,9999,0,9999,0
1708251895731,BGGN 271,063,482551,Muroyama; Andrew David,9999,0,9999,0
1708251895731,BGGN 271,064,482552,Neal; Sonya E,9999,0,9999,0
1708251895731,BGGN 271,065,482618,Nieh; James Charles,9999,0,9999,0
1708251895731,BGGN 271,066,482619,O'Donoghue; Anthony John,9999,0,9999,0
1708251895731,BGGN 271,067,482626,Pantham; Priyadarshini,9999,0,9999,0
1708251895731,BGGN 271,068,482633,Parast; Mana,9999,0,9999,0
1708251895731,BGGN 271,069,482634,Perry; Michael William,9999,0,9999,0
1708251895731,BGGN 271,070,482639,Pride; David Tevis,9999,0,9999,0
1708251895731,BGGN 271,071,482645,Pruneda-Paz; Jose L.,9999,0,9999,0
1708251895731,BGGN 271,072,482648,Rana; Tariq,9999,0,9999,0
1708251895731,BGGN 271,073,482650,Risbrough; Victoria Blythe,9999,0,9999,0
1708251895731,BGGN 271,074,482655,Rissman; Robert Andrew,9999,0,9999,0
1708251895731,BGGN 271,075,482656,Rosenfeld; Michael G,9999,0,9999,0
1708251895731,BGGN 271,076,482657,Saier; Milton H.,9999,0,9999,0
1708251895731,BGGN 271,077,482663,Sander; Maike,9999,0,9999,0
1708251895731,BGGN 271,078,482664,Schenk; Simon,9999,0,9999,0
1708251895731,BGGN 271,079,482665,Schoeneberg; Johannes,9998,0,9999,1
1708251895731,BGGN 271,080,482666,Schroeder; Julian I,9998,0,9999,1
1708251895731,BGGN 271,081,482667,Shaner; Nathan C.,9999,0,9999,0
1708251895731,BGGN 271,082,482668,Sheikh; Farah,9999,0,9999,0
1708251895731,BGGN 271,083,482669,Shurin; Jonathan,9999,0,9999,0
1708251895731,BGGN 271,084,482675,Sigurdson; Christina,9999,0,9999,0
1708251895731,BGGN 271,085,482676,Smith; David M.,9999,0,9999,0
1708251895731,BGGN 271,086,482677,Steinmetz; Nicole F,9999,0,9999,0
1708251895731,BGGN 271,087,482692,Su; Chih-Ying,9999,0,9999,0
1708251895731,BGGN 271,088,482694,Suel; Gurol Mehmet,9999,0,9999,0
1708251895731,BGGN 271,089,482695,Telese; Francesca,9999,0,9999,0
1708251895731,BGGN 271,090,482745,Thackray; Varykina G.,9999,0,9999,0
1708251895731,BGGN 271,091,482746,Towers; Christina Garlingt,9999,0,9999,0
1708251895731,BGGN 271,092,482747,Troemel; Emily Ruth,9997,0,9999,2
1708251895731,BGGN 271,093,482748,Tye; Kay M,9999,0,9999,0
1708251895731,BGGN 271,094,482749,Valdez-Jasso; Daniela,9998,0,9999,1
1708251895731,BGGN 271,095,482750,Wahlin; Karl Jonas,9997,0,9999,2
1708251895731,BGGN 271,096,482751,Welsbie; Derek,9999,0,9999,0
1708251895731,BGGN 271,097,482752,Wilkinson; Miles Frome,9999,0,9999,0
1708251895731,BGGN 271,098,482754,Yaksh; Tony L.,9999,0,9999,0
1708251895731,BGGN 271,099,482760,Yang; Jing,9999,0,9999,0
1708251895731,BGGN 271,100,482761,Yeo; Eugene Wei-Ming,9998,0,9999,1
1708251895731,BGGN 271,101,482763,Ying; Wei,9999,0,9999,0
1708251895731,BGGN 271,102,482764,Zarrinpar; Amir,9999,0,9999,0
1708251895731,BGGN 271,103,482765,Zengler; Karsten B,9999,0,9999,0
1708251895731,BGGN 271,104,482766,Zhang; Dong-Er,9999,0,9999,0
1708251895731,BGGN 271,105,482768,Zhao; Yunde,9999,0,9999,0
1708251895731,BGGN 271,106,482776,Zheng; Binhai,9999,0,9999,0
1708251895731,BGGN 271,107,482777,Zheng; Ye,9998,0,9999,1
1708251895731,BGGN 271,108,482806,Zuniga; Elina I,9999,0,9999,0
1708251896260,BGGN 273,A01,424101,Mueller; Liam O'Connor,43,0,50,7
1708251896786,BGGN 280,A00,424102,Ernst; Andreas,3,0,5,2
1708251896786,BGGN 280,C00,481361,Amaro; Rommie E,2,0,5,3
1708251897311,BGGN 281,A00,424103,Desai; Arshad & Oegema; Karen,0,0,5,5
1708251897837,BGGN 283,A00,424104,Rivera; Fabian Chavez,0,0,5,5
1708251897837,BGGN 283,B00,424105,Russell; Alistair B,4,0,5,1
1708251897837,BGGN 283,D00,424107,Wildonger; Jill Cathleen,1,0,5,4
1708251898363,BGGN 284,A00,424108,Glasgow; Stacey Marie,2,0,5,3
1708251898905,BGGN 285,A00,424109,Chisholm; Andrew D.,1,0,5,4
1708251898905,BGGN 285,B00,424110,Farley; Emma Kristen,2,0,5,3
1708251899430,BGGN 295,A00,424120,Tour; Ella,9,0,30,21
1708251899957,BGJC 204,A00,424138,Lu; Li-Fan & Chang; John Tzu-yu,9998,0,9999,1
1708251900486,BGJC 215,A00,424139,Cooke; James Edward & Lo; Stanley M.,10,0,10,0
1708251901347,BGRD 200,001,485528,Ackerman; Susan,9998,0,9999,1
1708251901347,BGRD 200,002,485529,Akbari; Omar Sultan,9999,0,9999,0
1708251901347,BGRD 200,003,485530,Allen; Eric,9999,0,9999,0
1708251901347,BGRD 200,004,485531,Allen; Nicola J,9999,0,9999,0
1708251901347,BGRD 200,005,485533,Amaro; Rommie E,9999,0,9999,0
1708251901347,BGRD 200,006,485535,Augustine; Vineet,9999,0,9999,0
1708251901347,BGRD 200,007,485536,Ayres; Janelle Samantha,9999,0,9999,0
1708251901347,BGRD 200,008,485538,Banegas; Matthew Patrick,9999,0,9999,0
1708251901347,BGRD 200,009,485539,Banghart; Matthew Ryan,9999,0,9999,0
1708251901347,BGRD 200,010,485542,Benna; Marcus K,9999,0,9999,0
1708251901347,BGRD 200,011,485543,Bennett; Eric J,9999,0,9999,0
1708251901347,BGRD 200,012,485545,Bloodgood; Brenda Laurie,9999,0,9999,0
1708251901347,BGRD 200,013,485546,Breen; Ellen C.,9998,0,9999,1
1708251901347,BGRD 200,014,485548,Briggs; Steven,9998,0,9999,1
1708251901347,BGRD 200,015,485549,Bui; Jack D,9999,0,9999,0
1708251901347,BGRD 200,016,485552,Busch; Wolfgang,9999,0,9999,0
1708251901347,BGRD 200,017,485621,Callaway; Edward M,9999,0,9999,0
1708251901347,BGRD 200,018,485622,Castle; Michael James,9999,0,9999,0
1708251901347,BGRD 200,019,485623,Chaim; Isaac,9999,0,9999,0
1708251901347,BGRD 200,020,485624,Chang; John Tzu-yu,9999,0,9999,0
1708251901347,BGRD 200,021,485625,Chen; Ju,9999,0,9999,0
1708251901347,BGRD 200,022,485626,Chen; Xu,9999,0,9999,0
1708251901347,BGRD 200,023,485627,Cheng; Christine Shiang-Ling,9999,0,9999,0
1708251901347,BGRD 200,024,485632,Cherqui; Stephanie,9999,0,9999,0
1708251901347,BGRD 200,025,485633,Cho; Yoshitake,9999,0,9999,0
1708251901347,BGRD 200,026,485634,Church; Kellie Breen,9999,0,9999,0
1708251901347,BGRD 200,027,485635,Cleland; Elsa Eleanor,9999,0,9999,0
1708251901347,BGRD 200,028,485636,Cohen; Shiran,9998,0,9999,1
1708251901347,BGRD 200,029,485639,Cook-Andersen; Heidi Leigh,9999,0,9999,0
1708251901347,BGRD 200,030,485686,Cooke; James Edward,9999,0,9999,0
1708251901347,BGRD 200,031,485688,Cooper; Kimberly Lynn,9999,0,9999,0
1708251901347,BGRD 200,032,485689,Coufal; Nicole Gabriele,9998,0,9999,1
1708251901347,BGRD 200,033,485690,Crotty Alexander; Laura E,9999,0,9999,0
1708251901347,BGRD 200,034,485691,Staff,9999,0,9999,0
1708251901347,BGRD 200,035,485692,De Guglielmo; Giordano,9999,0,9999,0
1708251901347,BGRD 200,036,485693,De Silva; Shermin,9999,0,9999,0
1708251901347,BGRD 200,037,485694,Desai; Arshad,9999,0,9999,0
1708251901347,BGRD 200,038,485695,Dickinson; Alexandra Jazz,9999,0,9999,0
1708251901347,BGRD 200,039,485717,Doherty; Taylor Alan,9998,0,9999,1
1708251901347,BGRD 200,040,485720,Dulawa; Stephanie Carole,9999,0,9999,0
1708251901347,BGRD 200,041,485721,Ecker; Joseph R,9999,0,9999,0
1708251901347,BGRD 200,042,485760,Engle; Dannielle D,9999,0,9999,0
1708251901347,BGRD 200,043,485761,Ernst; Andreas,9998,0,9999,1
1708251901347,BGRD 200,044,485766,Esko; Jeffrey D.,9998,0,9999,1
1708251901347,BGRD 200,045,485905,Evans; Ronald M,9999,0,9999,0
1708251901347,BGRD 200,046,485907,Staff,9999,0,9999,0
1708251901347,BGRD 200,047,485918,Feldstein; Ariel E,9998,0,9999,1
1708251901347,BGRD 200,048,485938,Friedman; Rick Adam,9999,0,9999,0
1708251901347,BGRD 200,049,485986,Furnari; Frank,9999,0,9999,0
1708251901347,BGRD 200,050,486018,Gage; Fred H,9999,0,9999,0
1708251901347,BGRD 200,051,486139,George; Monique Leana,9999,0,9999,0
1708251901347,BGRD 200,052,486140,Ghosh; Pradipta,9998,0,9999,1
1708251901347,BGRD 200,053,486141,Glass; Christopher,9998,0,9999,1
1708251901347,BGRD 200,054,486142,Gleeson; Joseph Gerard,9999,0,9999,0
1708251901347,BGRD 200,055,486143,Golden; Susan S.,9999,0,9999,0
1708251901347,BGRD 200,056,486144,Goldrath; Ananda,9999,0,9999,0
1708251901347,BGRD 200,057,486145,Goren; Alon M,9998,0,9999,1
1708251901347,BGRD 200,058,486146,Gustafsson; Asa Birgitta,9999,0,9999,0
1708251901347,BGRD 200,059,486164,Gutkind; Jorge Silvio,9999,0,9999,0
1708251901347,BGRD 200,060,486203,Hamdoun; Amr,9999,0,9999,0
1708251901347,BGRD 200,061,486204,Hampton; Randolph Y.,9999,0,9999,0
1708251901347,BGRD 200,062,486205,Hao; Nan,9999,0,9999,0
1708251901347,BGRD 200,063,486206,Staff,9999,0,9999,0
1708251901347,BGRD 200,064,486207,Hasty; Jeff M,9999,0,9999,0
1708251901347,BGRD 200,065,486208,Hollern; Daniel Patrick,9999,0,9999,0
1708251901347,BGRD 200,066,486209,Holway; David A.,9997,0,9999,2
1708251901347,BGRD 200,067,486214,Huffaker; Alisa,9998,0,9999,1
1708251901347,BGRD 200,068,486215,Hui; Enfu,9999,0,9999,0
1708251901347,BGRD 200,069,486216,Hwa; Terence T.,9999,0,9999,0
1708251901347,BGRD 200,070,486217,Sebat; Lilia Mikhailovna,9998,0,9999,1
1708251901347,BGRD 200,071,486218,Ideker; Trey,9999,0,9999,0
1708251901347,BGRD 200,072,486219,Jackrel; Sara,9998,0,9999,1
1708251901347,BGRD 200,073,486224,Jiang; Qingfei,9998,0,9999,1
1708251901347,BGRD 200,074,486225,Jin; Yishi,9999,0,9999,0
1708251901347,BGRD 200,075,486226,Joiner; William J.,9999,0,9999,0
1708251901347,BGRD 200,076,486227,Jun; Suckjoon,9999,0,9999,0
1708251901347,BGRD 200,077,486228,Kadonaga; James T,9998,0,9999,1
1708251901347,BGRD 200,078,486229,Kaech; Susan Michelle,9997,0,9999,2
1708251901347,BGRD 200,079,486237,Karin; Michael,9999,0,9999,0
1708251901347,BGRD 200,080,486238,Kleinfeld; David,9999,0,9999,0
1708251901347,BGRD 200,081,486239,Knight; Robin,9999,0,9999,0
1708251901347,BGRD 200,082,486335,Koffler; Yacov,9999,0,9999,0
1708251901347,BGRD 200,083,486336,Komiyama; Takaki,9999,0,9999,0
1708251901347,BGRD 200,084,486337,Kosuri; Pallav,9999,0,9999,0
1708251901347,BGRD 200,085,486353,Kryazhimskiy; Sergey A,9999,0,9999,0
1708251901347,BGRD 200,086,486354,Kurle; Carolyn M.,9999,0,9999,0
1708251901347,BGRD 200,087,486355,Law; Julie A,9999,0,9999,0
1708251901347,BGRD 200,088,486356,Lawson; Mark Andrew,9999,0,9999,0
1708251901347,BGRD 200,089,486357,Lee; Kuo Fen,9999,0,9999,0
1708251901347,BGRD 200,090,486376,Lee; Yun Sok,9999,0,9999,0
1708251901347,BGRD 200,091,486413,Leutgeb; Jill K.,9999,0,9999,0
1708251901347,BGRD 200,092,486414,Leutgeb; Stefan,9998,0,9999,1
1708251901347,BGRD 200,093,486415,Lim; Byungkook,9999,0,9999,0
1708251901347,BGRD 200,094,486419,Lo; Stanley M.,9999,0,9999,0
1708251901347,BGRD 200,095,486420,Looger; Loren Lee,9999,0,9999,0
1708251901347,BGRD 200,096,486422,Lovett-Barron; Matthew Rod,9999,0,9999,0
1708251901347,BGRD 200,097,486423,Lu; Li-Fan,9998,0,9999,1
1708251901347,BGRD 200,098,486424,Lu; Pengzhe,9998,0,9999,1
1708251901347,BGRD 200,099,486425,Lykke-Andersen; Jens,9998,0,9999,1
1708251901347,BGRD 200,100,486426,Lyumkis; Dmitry Evgenievich,9999,0,9999,0
1708251901347,BGRD 200,101,486427,Madigan; Cressida Ariana,9999,0,9999,0
1708251901347,BGRD 200,102,486428,Staff,9999,0,9999,0
1708251901347,BGRD 200,103,486429,Mayfield; Stephen P.,9998,0,9999,1
1708251901347,BGRD 200,104,486430,McDonnell; Lisa Marie,9999,0,9999,0
1708251901347,BGRD 200,105,486620,McHugh; Colleen A,9998,0,9999,1
1708251901347,BGRD 200,106,486621,Meharena; Hiruy Sibhatu,9999,0,9999,0
1708251901347,BGRD 200,107,486622,Staff,9999,0,9999,0
1708251901347,BGRD 200,108,486681,Morris; Gerald P,9999,0,9999,0
1708251901347,BGRD 200,109,486682,Mukamel; Eran A,9998,0,9999,1
1708251901347,BGRD 200,110,486683,Muotri; Alysson,9999,0,9999,0
1708251901347,BGRD 200,111,486684,Muroyama; Andrew David,9999,0,9999,0
1708251901347,BGRD 200,112,486687,Murre; Cornelis,9999,0,9999,0
1708251901347,BGRD 200,113,486691,Neal; Sonya E,9999,0,9999,0
1708251901347,BGRD 200,114,486692,Nieh; James Charles,9998,0,9999,1
1708251901347,BGRD 200,115,486693,Nimmerjahn; Axel,9999,0,9999,0
1708251901347,BGRD 200,116,486694,Nizet; Victor F.,9999,0,9999,0
1708251901347,BGRD 200,117,486695,O'Donoghue; Anthony John,9999,0,9999,0
1708251901347,BGRD 200,118,486706,Oegema; Karen,9999,0,9999,0
1708251901347,BGRD 200,119,486708,O'Shea; Clodagh,9999,0,9999,0
1708251901347,BGRD 200,120,486709,Pantham; Priyadarshini,9999,0,9999,0
1708251901347,BGRD 200,121,486715,Parast; Mana,9999,0,9999,0
1708251901347,BGRD 200,122,486716,Pasquinelli; Amy,9998,0,9999,1
1708251901347,BGRD 200,123,486718,Pekkurnaz Banghart; Gulcin,9999,0,9999,0
1708251901347,BGRD 200,124,486720,Perry; Michael William,9999,0,9999,0
1708251901347,BGRD 200,125,486721,Pfaff; Samuel,9999,0,9999,0
1708251901347,BGRD 200,126,486723,Pogliano; Joseph,9999,0,9999,0
1708251901347,BGRD 200,127,486724,Pogliano; Kit J.,9999,0,9999,0
1708251901347,BGRD 200,128,486727,Pride; David Tevis,9999,0,9999,0
1708251901347,BGRD 200,129,486728,Pruneda-Paz; Jose L.,9999,0,9999,0
1708251901347,BGRD 200,130,486733,Staff,9999,0,9999,0
1708251901347,BGRD 200,131,486734,Rana; Tariq,9999,0,9999,0
1708251901347,BGRD 200,132,486736,Reck-Peterson; Samara L,9999,0,9999,0
1708251901347,BGRD 200,133,486738,Rennison; Diana,9999,0,9999,0
1708251901347,BGRD 200,134,486741,Rifkin; Scott,9999,0,9999,0
1708251901347,BGRD 200,135,486743,Risbrough; Victoria Blythe,9999,0,9999,0
1708251901347,BGRD 200,136,486749,Rissman; Robert Andrew,9999,0,9999,0
1708251901347,BGRD 200,137,486750,Rivera; Fabian Chavez,9999,0,9999,0
1708251901347,BGRD 200,138,486753,Root; Cory Matthew,9999,0,9999,0
1708251901347,BGRD 200,139,486760,Rosenfeld; Michael G,9998,0,9999,1
1708251901347,BGRD 200,140,486763,Russell; Alistair B,9999,0,9999,0
1708251901347,BGRD 200,141,486766,Saier; Milton H.,9999,0,9999,0
1708251901347,BGRD 200,142,486768,Sander; Maike,9999,0,9999,0
1708251901347,BGRD 200,143,486770,Saphire; Erica Ollmann,9999,0,9999,0
1708251901347,BGRD 200,144,486771,Schenk; Simon,9999,0,9999,0
1708251901347,BGRD 200,145,486774,Schoeneberg; Johannes,9999,0,9999,0
1708251901347,BGRD 200,146,486777,Schroeder; Julian I,9998,0,9999,1
1708251901347,BGRD 200,147,486783,Shah; Sameer B,9999,0,9999,0
1708251901347,BGRD 200,148,486784,Shaner; Nathan C.,9999,0,9999,0
1708251901347,BGRD 200,149,486785,Shaw; Reuben,9999,0,9999,0
1708251901347,BGRD 200,150,486786,Sheikh; Farah,9999,0,9999,0
1708251901347,BGRD 200,151,486787,Staff,9999,0,9999,0
1708251901347,BGRD 200,152,486788,Signer; Robert,9999,0,9999,0
1708251901347,BGRD 200,153,486789,Sigurdson; Christina,9999,0,9999,0
1708251901347,BGRD 200,154,486790,Smith; David M.,9999,0,9999,0
1708251901347,BGRD 200,155,486791,Soncin; Francesca,9999,0,9999,0
1708251901347,BGRD 200,156,486792,Steinmetz; Nicole F,9999,0,9999,0
1708251901347,BGRD 200,157,486793,Su; Chih-Ying,9999,0,9999,0
1708251901347,BGRD 200,158,486794,Suel; Gurol Mehmet,9999,0,9999,0
1708251901347,BGRD 200,159,486795,Sun; Xin,9999,0,9999,0
1708251901347,BGRD 200,160,486796,Telese; Francesca,9999,0,9999,0
1708251901347,BGRD 200,161,486797,Thackray; Varykina G.,9999,0,9999,0
1708251901347,BGRD 200,162,486798,Towers; Christina Garlingt,9999,0,9999,0
1708251901347,BGRD 200,163,486799,Traver; David,9999,0,9999,0
1708251901347,BGRD 200,164,486800,Troemel; Emily Ruth,9998,0,9999,1
1708251901347,BGRD 200,165,486801,Tye; Kay M,9999,0,9999,0
1708251901347,BGRD 200,166,486802,Valdez-Jasso; Daniela,9998,0,9999,1
1708251901347,BGRD 200,167,486803,Vijayanand; Pandurangan,9999,0,9999,0
1708251901347,BGRD 200,168,486804,Villa Rodriguez; Elizabeth,9999,0,9999,0
1708251901347,BGRD 200,169,486805,Wahlin; Karl Jonas,9997,0,9999,2
1708251901347,BGRD 200,170,486806,Wang; Jean Yin Jen,9999,0,9999,0
1708251901347,BGRD 200,171,486807,Welsbie; Derek,9999,0,9999,0
1708251901347,BGRD 200,172,486808,Wildonger; Jill Cathleen,9998,0,9999,1
1708251901347,BGRD 200,173,486809,Wilkinson; Miles Frome,9999,0,9999,0
1708251901347,BGRD 200,174,486810,Winzeler; Elizabeth A,9999,0,9999,0
1708251901347,BGRD 200,175,486811,Yaksh; Tony L.,9999,0,9999,0
1708251901347,BGRD 200,176,486812,Yang; Jing,9999,0,9999,0
1708251901347,BGRD 200,177,486813,Staff,9999,0,9999,0
1708251901347,BGRD 200,178,486814,Yeo; Eugene Wei-Ming,9998,0,9999,1
1708251901347,BGRD 200,179,486815,Ying; Wei,9999,0,9999,0
1708251901347,BGRD 200,180,486816,Zarrinpar; Amir,9999,0,9999,0
1708251901347,BGRD 200,181,486817,Zengler; Karsten B,9999,0,9999,0
1708251901347,BGRD 200,182,486818,Zhang; Dong-Er,9999,0,9999,0
1708251901347,BGRD 200,183,486819,Zhao; Yunde,9999,0,9999,0
1708251901347,BGRD 200,184,486820,Zheng; Binhai,9999,0,9999,0
1708251901347,BGRD 200,185,486821,Zheng; Ye,9998,0,9999,1
1708251901347,BGRD 200,186,486822,Zuniga; Elina I,9999,0,9999,0
1708251901874,BGSE 200,A00,424140,Tour; Ella & Petrie; Katherine Lynn,9995,0,9999,4
1708251902400,BGSE 205,A00,424177,Bennett; Eric J,49,0,50,1
1708251902400,BGSE 205,B00,424179,Bennett; Eric J,48,0,50,2
1708251902400,BGSE 205,C00,424182,Bennett; Eric J,47,0,50,3
1708251902400,BGSE 205,D00,424184,Bennett; Eric J,46,0,50,4
1708251902400,BGSE 205,E00,424185,Bennett; Eric J,50,0,50,0
1708251902929,BIBC 100,A01,425401,Corbett; Kevin Daniel,150,0,158,8
1708251902929,BIBC 100,B01,477769,Amaro; Rommie E,156,0,158,2
1708251903480,BIBC 102,A01,425425,Bozinovic; Goran,255,0,256,1
1708251903480,BIBC 102,B01,425440,Hampton; Randolph Y.,250,0,256,6
1708251903480,BIBC 102,C01,486849,Flagg; Matthew Paul,61,0,120,59
1708251904012,BIBC 103,A01,425476,Grossman; Emily N,17,0,24,7
1708251904012,BIBC 103,A02,425509,Grossman; Emily N,21,0,24,3
1708251904012,BIBC 103,A03,425530,Grossman; Emily N,18,0,24,6
1708251904012,BIBC 103,A04,425536,Grossman; Emily N,22,0,24,2
1708251904012,BIBC 103,B01,425538,Boumechache; Miyyada,20,0,24,4
1708251904012,BIBC 103,B02,425539,Boumechache; Miyyada,24,0,24,0
1708251904012,BIBC 103,B03,425548,Boumechache; Miyyada,24,0,24,0
1708251904012,BIBC 103,B04,425549,Boumechache; Miyyada,24,0,24,0
1708251904543,BIBC 120,A01,425592,Coleman; Aaron B.,242,0,256,14
1708251905074,BIBC 194,A00,425609,Ernst; Andreas,21,0,27,6
1708251905074,BIBC 194,B00,477632,Saier; Milton H.,26,0,27,1
1708251905074,BIBC 194,C00,481360,Amaro; Rommie E,23,0,27,4
1708251905074,BIBC 194,D00,486852,Flagg; Matthew Paul,21,0,32,11
1708251905619,BICD 100,A01,470377,Troemel; Emily Ruth,127,0,128,1
1708251905619,BICD 100,A02,470378,Troemel; Emily Ruth,126,0,128,2
1708251905619,BICD 100,B01,470409,Reinagel; Pam,59,0,64,5
1708251905619,BICD 100,B02,470413,Reinagel; Pam,62,0,64,2
1708251905619,BICD 100,B03,470464,Reinagel; Pam,64,0,64,0
1708251905619,BICD 100,B04,470468,Reinagel; Pam,63,0,64,1
1708251905619,BICD 100,C01,470469,Beyhan; Sinem,51,0,64,13
1708251905619,BICD 100,C02,470605,Beyhan; Sinem,58,0,64,6
1708251905619,BICD 100,C03,470606,Beyhan; Sinem,60,0,64,4
1708251905619,BICD 100,C04,470607,Beyhan; Sinem,63,0,64,1
1708251905619,BICD 100,D01,477465,Nguyen; Vu Quang,158,0,160,2
1708251906145,BICD 100R,A01,425674,Smith; Laurie,29,0,34,5
1708251906145,BICD 100R,A02,425675,Smith; Laurie,30,0,34,4
1708251906145,BICD 100R,A03,425676,Smith; Laurie,30,0,34,4
1708251906671,BICD 104,A01,425696,Greenspan; Ralph J.,60,0,64,4
1708251907199,BICD 110,A01,470608,Muroyama; Andrew David,264,0,275,11
1708251907199,BICD 110,B01,425721,Ernst; Andreas,245,0,275,30
1708251907728,BICD 112,A01,458177,Cooper; Kimberly Lynn & Traver; David,10,0,32,22
1708251907728,BICD 112,A02,458180,Cooper; Kimberly Lynn & Traver; David,28,0,32,4
1708251908257,BICD 123,A01,425725,Zhao; Yunde,24,0,32,8
1708251908788,BICD 140,A01,425728,Lu; Li-Fan,227,0,240,13
1708251909312,BICD 158,A01,425730,Bier; Ethan,136,0,145,9
1708251909840,BICD 194,A00,425731,Desai; Arshad & Oegema; Karen,18,0,27,9
1708251909840,BICD 194,B00,481735,Wilhelm; James E.,29,0,32,3
1708251910367,BIEB 121,A00,425732,Butler; Shannon Rhey,21,0,32,11
1708251910367,BIEB 121,B00,425733,Butler; Shannon Rhey,24,0,32,8
1708251910897,BIEB 130,A01,425735,Kurle; Carolyn M.,243,0,295,52
1708251912438,BIEB 146,A01,425737,Petrie; Katherine Lynn,365,0,395,30
1708251912979,BIEB 148,A01,470637,Rose; Noah Hartmann,59,0,63,4
1708251912979,BIEB 148,A02,470638,Rose; Noah Hartmann,61,0,63,2
1708251913509,BIEB 154,A01,458184,Stockwell; Sarah R,29,0,30,1
1708251913509,BIEB 154,A02,458186,Stockwell; Sarah R,29,0,30,1
1708251914036,BIEB 176,A01,425741,De Silva; Shermin,56,0,64,8
1708251914563,BIEB 182,A01,458194,Roy; Kaustuv,25,0,32,7
1708251914563,BIEB 182,A02,458215,Roy; Kaustuv,31,0,32,1
1708251915106,BILD 1,A01,424267,Patrick; Gentry,249,0,250,1
1708251915106,BILD 1,B01,424272,Burg; Michael,231,0,250,19
1708251915106,BILD 1,C01,424293,Pickett; Brooke Elizabeth,245,0,250,5
1708251915106,BILD 1,D01,458292,Gonzalez Gamboa; Ivonne,48,0,50,2
1708251915106,BILD 1,D02,458295,Gonzalez Gamboa; Ivonne,50,0,50,0
1708251915106,BILD 1,D03,458296,Gonzalez Gamboa; Ivonne,50,0,50,0
1708251915106,BILD 1,D04,458297,Gonzalez Gamboa; Ivonne,49,0,50,1
1708251915106,BILD 1,D05,458303,Gonzalez Gamboa; Ivonne,50,0,50,0
1708251915696,BILD 2,A01,458304,Reyes Gonzalez; Catalina,53,0,56,3
1708251915696,BILD 2,A02,458307,Reyes Gonzalez; Catalina,55,0,56,1
1708251915696,BILD 2,A03,458313,Reyes Gonzalez; Catalina,55,0,56,1
1708251915696,BILD 2,A04,458320,Reyes Gonzalez; Catalina,56,0,56,0
1708251915696,BILD 2,B01,458324,Reyes Gonzalez; Catalina,47,0,56,9
1708251915696,BILD 2,B02,458327,Reyes Gonzalez; Catalina,54,0,56,2
1708251915696,BILD 2,B03,458339,Reyes Gonzalez; Catalina,56,0,56,0
1708251915696,BILD 2,B04,458340,Reyes Gonzalez; Catalina,56,0,56,0
1708251915696,BILD 2,C01,458387,Park; Ji Young,44,0,49,5
1708251915696,BILD 2,C02,458544,Park; Ji Young,46,0,49,3
1708251915696,BILD 2,C03,458557,Park; Ji Young,47,0,49,2
1708251915696,BILD 2,C04,458563,Park; Ji Young,46,0,49,3
1708251916223,BILD 3,A01,424312,Hammond; LaTisha Marie,331,0,350,19
1708251916223,BILD 3,B01,470107,Stockwell; Sarah R,66,0,70,4
1708251916223,BILD 3,B02,470110,Stockwell; Sarah R,70,0,70,0
1708251916223,BILD 3,B03,470116,Stockwell; Sarah R,70,0,70,0
1708251916223,BILD 3,B04,470123,Stockwell; Sarah R,67,0,70,3
1708251916223,BILD 3,B05,470150,Stockwell; Sarah R,70,0,70,0
1708251916223,BILD 3,C01,470159,Cooper; Kimberly Lynn,67,0,70,3
1708251916223,BILD 3,C02,470160,Cooper; Kimberly Lynn,69,0,70,1
1708251916223,BILD 3,C03,470164,Cooper; Kimberly Lynn,70,0,70,0
1708251916223,BILD 3,C04,470165,Cooper; Kimberly Lynn,69,0,70,1
1708251916223,BILD 3,C05,470374,Cooper; Kimberly Lynn,68,0,70,2
1708251916752,BILD 4,A01,424318,Staff,22,0,24,2
1708251916752,BILD 4,A02,424324,Staff,24,0,24,0
1708251916752,BILD 4,A03,424325,Staff,24,0,24,0
1708251916752,BILD 4,A04,424326,Staff,22,0,24,2
1708251916752,BILD 4,A05,424327,Staff,24,0,24,0
1708251916752,BILD 4,A06,424330,Staff,24,0,24,0
1708251916752,BILD 4,A07,424331,Staff,24,0,24,0
1708251916752,BILD 4,A08,424342,Staff,24,0,24,0
1708251916752,BILD 4,B01,424462,Pickett; Brooke Elizabeth,23,0,24,1
1708251916752,BILD 4,B02,424466,Pickett; Brooke Elizabeth,24,0,24,0
1708251916752,BILD 4,B03,424469,Pickett; Brooke Elizabeth,23,0,24,1
1708251916752,BILD 4,B04,424470,Pickett; Brooke Elizabeth,22,0,24,2
1708251916752,BILD 4,B05,424700,Pickett; Brooke Elizabeth,23,0,24,1
1708251916752,BILD 4,B06,424723,Pickett; Brooke Elizabeth,24,0,24,0
1708251916752,BILD 4,B07,424730,Pickett; Brooke Elizabeth,24,0,24,0
1708251916752,BILD 4,B08,424929,Pickett; Brooke Elizabeth,22,0,24,2
1708251916752,BILD 4,C01,424947,Gonzalez Gamboa; Ivonne,22,0,24,2
1708251916752,BILD 4,C02,424951,Gonzalez Gamboa; Ivonne,23,0,24,1
1708251916752,BILD 4,C03,424991,Gonzalez Gamboa; Ivonne,23,0,24,1
1708251916752,BILD 4,C04,424993,Gonzalez Gamboa; Ivonne,24,0,24,0
1708251916752,BILD 4,C05,424994,Gonzalez Gamboa; Ivonne,24,0,24,0
1708251916752,BILD 4,C06,425209,Gonzalez Gamboa; Ivonne,24,0,24,0
1708251916752,BILD 4,C07,425233,Gonzalez Gamboa; Ivonne,24,0,24,0
1708251916752,BILD 4,C08,425247,Gonzalez Gamboa; Ivonne,24,0,24,0
1708251917283,BILD 60,A01,425326,Hammond; LaTisha Marie,62,0,64,2
1708251917813,BILD 83,A00,425347,Pogliano; Joseph,25,0,30,5
1708251918340,BILD 87,A00,425368,Saier; Milton H.,20,0,20,0
1708251918867,BIMM 100,A01,425744,Cooper; Andrew Michael,303,0,320,17
1708251918867,BIMM 100,B01,425746,Cooper; Andrew Michael,315,0,320,5
1708251919403,BIMM 101,A01,425748,McDonnell; Lisa Marie,8,0,24,16
1708251919403,BIMM 101,A02,425749,McDonnell; Lisa Marie,23,0,24,1
1708251919403,BIMM 101,B01,425751,Day; Christopher D,22,0,24,2
1708251919403,BIMM 101,B02,425752,Day; Christopher D,24,0,24,0
1708251919403,BIMM 101,B03,425753,Day; Christopher D,22,0,24,2
1708251919403,BIMM 101,B04,425754,Day; Christopher D,24,0,24,0
1708251919403,BIMM 101,C01,425756,Rusert; Jessica Marie,16,0,24,8
1708251919403,BIMM 101,C02,425757,Rusert; Jessica Marie,23,0,24,1
1708251919403,BIMM 101,C03,425758,Rusert; Jessica Marie,23,0,24,1
1708251919403,BIMM 101,C04,425759,Rusert; Jessica Marie,23,0,24,1
1708251919930,BIMM 110,A01,425764,Niwa; Maho,55,0,56,1
1708251919930,BIMM 110,A02,425765,Niwa; Maho,56,0,56,0
1708251919930,BIMM 110,A03,425766,Niwa; Maho,56,0,56,0
1708251919930,BIMM 110,A04,425767,Niwa; Maho,55,0,56,1
1708251920457,BIMM 116R,A01,425771,Golden; Susan S. & Gorman; Michael R.,55,0,72,17
1708251920457,BIMM 116R,A02,425772,Golden; Susan S. & Gorman; Michael R.,53,0,72,19
1708251920457,BIMM 116R,A03,425773,Golden; Susan S. & Gorman; Michael R.,66,0,72,6
1708251920457,BIMM 116R,A04,425774,Golden; Susan S. & Gorman; Michael R.,70,0,72,2
1708251920984,BIMM 118,A01,425779,David; Michael,83,0,96,13
1708251921517,BIMM 120,A01,425792,Pirino; Giorgia,203,0,216,13
1708251921517,BIMM 120,B01,470639,Saier; Milton H.,201,0,216,15
1708251922051,BIMM 121,A01,425830,Gustafson-Brown; Cindy,18,0,24,6
1708251922051,BIMM 121,A02,425831,Gustafson-Brown; Cindy,21,0,24,3
1708251922051,BIMM 121,A03,425832,Gustafson-Brown; Cindy,24,0,24,0
1708251922051,BIMM 121,A04,425833,Gustafson-Brown; Cindy,23,0,24,1
1708251922051,BIMM 121,B01,425835,Pirino; Giorgia,17,0,24,7
1708251922051,BIMM 121,B02,425836,Pirino; Giorgia,24,0,24,0
1708251922051,BIMM 121,C01,425838,Park; Ji Young,6,0,24,18
1708251922051,BIMM 121,C02,425839,Park; Ji Young,20,0,24,4
1708251922576,BIMM 134,A01,425841,Burg; Michael,393,0,416,23
1708251923103,BIMM 143,A01,425843,Grant; Barry J,17,0,40,23
1708251923103,BIMM 143,B01,425845,Bozinovic; Goran,33,0,40,7
1708251923629,BIMM 182,A01,455012,Bafna; Vineet,28,0,50,22
1708251924161,BIMM 194,A00,425847,Rivera; Fabian Chavez,24,0,27,3
1708251924161,BIMM 194,B00,425868,Russell; Alistair B,16,0,27,11
1708251924161,BIMM 194,D00,425870,Wildonger; Jill Cathleen,14,0,27,13
1708251924691,BIOM 202,A00,390710,Corbett; Kevin Daniel,93,0,100,7
1708251925217,BIOM 219,A00,390713,Ross; Camille,0,0,0,7
1708251925750,BIOM 231,A00,455099,Furnari; Frank,0,0,0,0
1708251925750,BIOM 231,B00,455100,Lopez Ramirez; Miguel Alej,0,0,0,0
1708251926280,BIOM 242,A00,390714,Hamilton; Bruce Alan,20,0,20,0
1708251926806,BIOM 246,A00,492784,Gordts; Philip & Varki; Ajit P & Lewis; Amanda Lark & Godula; Kamil & Gagneux; Pascal & Esko; Jeffrey D. & Bode; Lars,0,0,0,0
1708251927335,BIOM 252,A00,390715,Ayyagari; Radha,27,0,28,1
1708251927864,BIOM 254,A00,390718,Corbett; Kevin Daniel,14,0,20,6
1708251928393,BIOM 272,A00,390722,Hangauer; Matthew John,16,0,20,4
1708251928920,BIOM 274,A00,390725,Sun; Bryan Kee-Hong,7,0,15,8
1708251929450,BIOM 283,A00,390728,Komives; Elizabeth A,2,0,2,0
1708251929979,BIOM 285,A00,390730,Gaulton; Kyle J,10,0,20,10
1708251930507,BIOM 295,A00,455083,Brown; Joan Heller,0,0,0,0
1708251931035,BIPN 100,A01,425872,Augustine; Vineet,240,0,245,5
1708251931035,BIPN 100,B01,425874,George; Monique Leana,240,0,245,5
1708251931035,BIPN 100,C01,458640,Maita; Isabella Vincenza,44,0,49,5
1708251931035,BIPN 100,C02,458646,Maita; Isabella Vincenza,48,0,49,1
1708251931035,BIPN 100,C03,458714,Maita; Isabella Vincenza,48,0,49,1
1708251931035,BIPN 100,C04,458716,Maita; Isabella Vincenza,48,0,49,1
1708251931035,BIPN 100,C05,458717,Maita; Isabella Vincenza,46,0,49,3
1708251931562,BIPN 105,A01,425877,Armour; Jon Christopher,12,0,21,9
1708251931562,BIPN 105,A02,425878,Armour; Jon Christopher,21,0,21,0
1708251931562,BIPN 105,A03,425879,Armour; Jon Christopher,10,0,21,11
1708251931562,BIPN 105,A04,425880,Armour; Jon Christopher,20,0,21,1
1708251932093,BIPN 120,A01,425882,Cooke; James Edward,371,0,395,24
1708251932620,BIPN 140,A01,425884,Hibbs; Ryan E.,183,0,192,9
1708251933151,BIPN 144,A01,425886,Zou; Yimin,153,0,158,5
1708251933682,BIPN 145,A01,425888,Maita; Isabella Vincenza,41,0,42,1
1708251933682,BIPN 145,B01,425918,Marino; Marc J,37,0,42,5
1708251933682,BIPN 145,B02,425954,Marino; Marc J,40,0,42,2
1708251934208,BIPN 147,A01,426086,Sejnowski; Terrence J,53,0,64,11
1708251934737,BIPN 152,A01,426112,Halpain; Shelley,97,0,128,31
1708251935264,BIPN 162,A01,426120,Juavinett; Ashley Lauren,17,0,30,13
1708251935789,BIPN 164,A01,455010,Benna; Marcus K & Aljadeff; Johnatan,120,0,120,0
1708251936316,BIPN 194,A00,426122,Glasgow; Stacey Marie,20,0,27,7
1708251936842,BISP 170,A00,426158,French; Kathleen Ann,26,0,30,4
1708251937368,BISP 182,A00,426168,Pogliano; Joseph,9999,0,9999,0
1708251937895,BISP 194,A00,426240,Chisholm; Andrew D.,11,0,27,16
1708251937895,BISP 194,B00,426241,Farley; Emma Kristen,25,0,27,2
1708251938421,BNFO 281,A00,427175,Gaasterland; Theresa,85,0,100,15
1708251938949,BNFO 283,A00,427211,Carter; Hannah Kathryn & Chavez; Alejandro,39,0,50,11
1708251938949,BNFO 283,B00,480483,Amariuta-Bartell; Tiffany & Dorrestein; Pieter,21,0,30,9
1708251939476,BNFO 294,B01,427269,Ross; Camille,47,0,50,3
1708251940014,CAT 3,A01,396994,Glaser; Amelia,15,0,15,0
1708251940014,CAT 3,A02,396995,Glaser; Amelia,15,0,15,0
1708251940014,CAT 3,A03,396996,Glaser; Amelia,7,0,15,8
1708251940014,CAT 3,A04,396997,Glaser; Amelia,12,0,15,3
1708251940014,CAT 3,A05,397004,Glaser; Amelia,15,0,15,0
1708251940014,CAT 3,A06,397039,Glaser; Amelia,11,0,15,4
1708251940014,CAT 3,A07,397040,Glaser; Amelia,13,0,15,2
1708251940014,CAT 3,A08,397084,Glaser; Amelia,15,0,15,0
1708251940014,CAT 3,A09,397269,Glaser; Amelia,13,0,15,2
1708251940014,CAT 3,A10,397270,Glaser; Amelia,0,0,15,15
1708251940014,CAT 3,A11,397271,Glaser; Amelia,9,0,15,6
1708251940014,CAT 3,A12,397272,Glaser; Amelia,12,0,15,3
1708251940014,CAT 3,A13,397273,Glaser; Amelia,15,0,15,0
1708251940014,CAT 3,A14,397274,Glaser; Amelia,14,0,15,1
1708251940014,CAT 3,B01,397276,Porter; Lisa,15,0,15,0
1708251940014,CAT 3,B02,397277,Porter; Lisa,15,0,15,0
1708251940014,CAT 3,B03,397278,Porter; Lisa,14,0,15,1
1708251940014,CAT 3,B04,397279,Porter; Lisa,15,0,15,0
1708251940014,CAT 3,B06,397281,Porter; Lisa,15,0,15,0
1708251940014,CAT 3,B07,397291,Porter; Lisa,15,0,15,0
1708251940014,CAT 3,B09,397293,Porter; Lisa,15,0,15,0
1708251940014,CAT 3,B10,397294,Porter; Lisa,15,0,15,0
1708251940014,CAT 3,B11,397295,Porter; Lisa,12,0,15,3
1708251940014,CAT 3,B12,397296,Porter; Lisa,14,0,15,1
1708251940014,CAT 3,B13,397297,Porter; Lisa,11,0,15,4
1708251940014,CAT 3,B14,397298,Porter; Lisa,15,0,15,0
1708251940014,CAT 3,B15,397299,Porter; Lisa,15,0,15,0
1708251940014,CAT 3,B16,397300,Porter; Lisa,15,0,15,0
1708251940014,CAT 3,C01,397302,Marchisotto; Jennifer Anne,13,0,15,2
1708251940014,CAT 3,C02,397308,Marchisotto; Jennifer Anne,9,0,15,6
1708251940014,CAT 3,C03,397309,Marchisotto; Jennifer Anne,9,0,15,6
1708251940014,CAT 3,C04,397315,Marchisotto; Jennifer Anne,11,0,15,4
1708251940014,CAT 3,C05,397316,Marchisotto; Jennifer Anne,14,0,15,1
1708251940014,CAT 3,C06,397322,Marchisotto; Jennifer Anne,15,0,15,0
1708251940014,CAT 3,C07,397323,Marchisotto; Jennifer Anne,15,0,15,0
1708251940014,CAT 3,C08,397329,Marchisotto; Jennifer Anne,15,0,15,0
1708251940014,CAT 3,C09,397333,Marchisotto; Jennifer Anne,15,0,15,0
1708251940014,CAT 3,C10,397336,Marchisotto; Jennifer Anne,15,0,15,0
1708251940014,CAT 3,C11,397354,Marchisotto; Jennifer Anne,13,0,15,2
1708251940014,CAT 3,C12,397357,Marchisotto; Jennifer Anne,15,0,15,0
1708251940014,CAT 3,C13,397364,Marchisotto; Jennifer Anne,14,0,15,1
1708251940014,CAT 3,C14,397367,Marchisotto; Jennifer Anne,14,0,15,1
1708251940014,CAT 3,C15,397369,Marchisotto; Jennifer Anne,15,0,15,0
1708251940014,CAT 3,C16,397373,Marchisotto; Jennifer Anne,15,0,15,0
1708251940014,CAT 3,C17,397374,Marchisotto; Jennifer Anne,15,0,15,0
1708251940014,CAT 3,C18,397380,Marchisotto; Jennifer Anne,14,0,15,1
1708251940014,CAT 3,D02,397405,Rahimi; Babak,13,0,15,2
1708251940014,CAT 3,D03,397408,Rahimi; Babak,14,0,15,1
1708251940014,CAT 3,D04,397415,Rahimi; Babak,15,0,15,0
1708251940014,CAT 3,D05,397416,Rahimi; Babak,15,0,15,0
1708251940014,CAT 3,D06,397422,Rahimi; Babak,15,0,15,0
1708251940014,CAT 3,D07,397426,Rahimi; Babak,14,0,15,1
1708251940014,CAT 3,D09,397447,Rahimi; Babak,11,0,15,4
1708251940014,CAT 3,D10,397450,Rahimi; Babak,13,0,15,2
1708251940014,CAT 3,D11,397625,Rahimi; Babak,13,0,15,2
1708251940014,CAT 3,D12,397630,Rahimi; Babak,15,0,15,0
1708251940014,CAT 3,D13,397631,Rahimi; Babak,14,0,15,1
1708251940014,CAT 3,D14,397635,Rahimi; Babak,14,0,15,1
1708251940544,CAT 3CE,A01,397642,Bronstein; Phoebe Malan,25,0,25,0
1708251941070,CAT 87,A00,397645,Bronstein; Phoebe Malan,19,0,20,1
1708251941597,CAT 90,A00,480731,Bronstein; Phoebe Malan,20,0,20,0
1708251942128,CAT 124,A01,397662,Knight; Amy,5,0,5,0
1708251942128,CAT 124,A02,397722,Knight; Amy,5,0,5,0
1708251942128,CAT 124,A03,397726,Knight; Amy,5,0,5,0
1708251942128,CAT 124,A04,397829,Knight; Amy,4,0,5,1
1708251942669,CAT 125,001,397832,Popko; Elizabeth Ashley,20,0,20,0
1708251942669,CAT 125,002,397833,Delaville; Romain,20,0,20,0
1708251942669,CAT 125,003,397834,Marchisotto; Jennifer Anne,18,0,20,2
1708251942669,CAT 125,004,397835,Bigham; David Joseph,20,0,20,0
1708251942669,CAT 125,005,397836,Bigham; David Joseph,19,0,20,1
1708251942669,CAT 125,006,397837,Bigham; David Joseph,16,0,20,4
1708251942669,CAT 125,007,397838,Vanderschuit; Maya Alysia,20,0,20,0
1708251942669,CAT 125,008,397839,Vanderschuit; Maya Alysia,20,0,20,0
1708251942669,CAT 125,009,397840,Vanderschuit; Maya Alysia,20,0,20,0
1708251942669,CAT 125,010,397841,Morales; Celeste Georgianna,15,0,16,1
1708251942669,CAT 125,011,397842,Morales; Celeste Georgianna,16,0,16,0
1708251942669,CAT 125,012,397881,Morales; Celeste Georgianna,19,0,20,1
1708251942669,CAT 125,013,397954,Rose; Becca Rae,18,0,20,2
1708251942669,CAT 125,014,397956,Rose; Becca Rae,20,0,20,0
1708251942669,CAT 125,015,397998,Rose; Becca Rae,19,0,20,1
1708251942669,CAT 125,016,397999,Tosun; Adriana,20,0,20,0
1708251942669,CAT 125,017,398001,Tosun; Adriana,20,0,20,0
1708251942669,CAT 125,018,398009,Irwin; Matthew Joseph,19,0,20,1
1708251942669,CAT 125,019,398010,Irwin; Matthew Joseph,18,0,20,2
1708251942669,CAT 125,020,398014,Irwin; Matthew Joseph,20,0,20,0
1708251943205,CAT 125R,A00,398015,Smith; Lauryn Alissa,19,0,20,1
1708251943205,CAT 125R,B00,398016,Smith; Lauryn Alissa,17,0,20,3
1708251943205,CAT 125R,C00,398017,Smith; Lauryn Alissa,19,0,20,1
1708251943205,CAT 125R,D00,398019,Tosun; Adriana,19,0,20,1
1708251943205,CAT 125R,E00,398020,Hyland; Tina Mae,12,0,20,8
1708251943205,CAT 125R,F00,398027,Hyland; Tina Mae,18,0,20,2
1708251943205,CAT 125R,G00,398028,Hyland; Tina Mae,18,0,20,2
1708251943735,CCE 1,A01,396087,Kenley Grounds; Nicole,40,0,40,0
1708251943735,CCE 1,B01,396142,Quijada; David,39,0,40,1
1708251943735,CCE 1,C01,396159,Bigley; Michele Heather,39,0,40,1
1708251943735,CCE 1,D01,396164,Bigley; Michele Heather,40,0,40,0
1708251943735,CCE 1,E01,396166,Lee; Kassandra,40,0,40,0
1708251943735,CCE 1,F01,396168,Lee; Kassandra,40,0,40,0
1708251943735,CCE 1,G01,396170,Staff,40,0,40,0
1708251943735,CCE 1,H01,396172,Staff,40,0,40,0
1708251944262,CENG 101B,A00,392993,Chen; Shaochen,44,0,45,1
1708251944791,CENG 101C,A00,392997,Li; Yanran,148,0,150,2
1708251945317,CENG 113,A00,393000,Chen; Zheng,69,0,70,1
1708251945317,CENG 113,B00,393001,Li; Wan-Lu,69,0,70,1
1708251945849,CENG 124B,A00,393036,Powell; Alyssa & Russ; Benjamin Edward,113,0,120,7
1708251946375,CENG 157,A00,393220,Opatkiewicz; Justin Paul,50,0,57,7
1708251946901,CENG 160,A00,393231,Powell; Alyssa,70,0,80,10
1708251947429,CENG 170,A01,393238,Drews; Aaron,27,0,30,3
1708251947957,CENG 175,A00,393239,Steinmetz; Nicole F,34,0,35,1
1708251948487,CENG 176B,A01,393285,Opatkiewicz; Justin Paul,46,0,52,6
1708251948487,CENG 176B,B01,393629,Zhang; Liangfang,40,0,49,9
1708251949013,CENG 205,A00,393681,Jahed Motlagh; Zeinab,53,0,60,7
1708251949539,CENG 257,A00,393682,Opatkiewicz; Justin Paul,10,0,13,3
1708251950065,CGS 87,A00,489609,Wesling; Megan E.,20,0,20,0
1708251950592,CGS 100B,A00,396181,Whitley; Leila Marie,28,0,30,2
1708251951122,CGS 109,A00,396194,Whitley; Leila Marie,19,0,20,1
1708251951649,CGS 112,A00,396220,Martin Sandino; Amanda Maria Yoland,22,0,25,3
1708251952174,CGS 114,A00,396223,Steelman; Katherine Wallis,14,0,16,2
1708251952702,CGS 116,A00,396295,Staff,19,0,20,1
1708251953229,CGS 117,A00,396306,Martin Sandino; Amanda Maria Yoland,14,0,15,1
1708251953754,CGS 118,A00,396314,Hankins; Joseph D.,28,0,29,1
1708251954280,CGS 128,A00,396366,Whitley; Leila Marie,14,0,15,1
1708251954808,CGS 137,A00,396865,Martin Sandino; Amanda Maria Yoland,16,0,19,3
1708251955339,CGS 150,A00,396901,Taylor-Garcia; Daphne,18,0,18,0
1708251955866,CGS 196B,A00,396904,Lo; Stanley M.,7,0,7,0
1708251955866,CGS 196B,B00,396973,Brenner; Suzanne A,7,0,7,0
1708251955866,CGS 196B,C00,396985,Jones; Makeba,7,0,7,0
1708251956396,CGS 198,001,396987,Anderson; Patrick W.,0,0,0,0
1708251956396,CGS 198,002,396988,Anderson; Patrick W.,0,0,0,0
1708251956396,CGS 198,003,396989,Anderson; Patrick W.,0,0,0,0
1708251956396,CGS 198,004,396990,Anderson; Patrick W.,0,0,0,0
1708251956926,CGS 200,A00,396991,Perez; Roy,0,0,0,3
1708251957455,CHEM 6A,A01,459563,Deshmukh; Lalit,40,0,40,0
1708251957455,CHEM 6A,A02,459564,Deshmukh; Lalit,35,0,40,5
1708251957455,CHEM 6A,A03,459565,Deshmukh; Lalit,31,0,40,9
1708251957455,CHEM 6A,A04,459566,Deshmukh; Lalit,30,0,38,8
1708251957455,CHEM 6A,A05,459567,Deshmukh; Lalit,40,0,40,0
1708251957455,CHEM 6A,A06,459568,Deshmukh; Lalit,37,0,40,3
1708251957455,CHEM 6A,A07,459569,Deshmukh; Lalit,37,0,40,3
1708251957455,CHEM 6A,A08,459570,Deshmukh; Lalit,0,0,0,0
1708251957988,CHEM 6B,A01,467314,Ortony; Julia Helen,39,0,40,1
1708251957988,CHEM 6B,A02,467322,Ortony; Julia Helen,32,0,40,8
1708251957988,CHEM 6B,A03,467323,Ortony; Julia Helen,40,0,40,0
1708251957988,CHEM 6B,A04,467325,Ortony; Julia Helen,31,0,40,9
1708251957988,CHEM 6B,A05,467326,Ortony; Julia Helen,39,0,40,1
1708251957988,CHEM 6B,A06,467346,Ortony; Julia Helen,40,0,40,0
1708251957988,CHEM 6B,B01,467360,Hopkins; Patrycja Anna,35,0,40,5
1708251957988,CHEM 6B,B02,467363,Hopkins; Patrycja Anna,38,0,40,2
1708251957988,CHEM 6B,B03,467364,Hopkins; Patrycja Anna,35,0,40,5
1708251957988,CHEM 6B,B04,467380,Hopkins; Patrycja Anna,40,0,40,0
1708251957988,CHEM 6B,B05,467381,Hopkins; Patrycja Anna,40,0,40,0
1708251957988,CHEM 6B,B06,467382,Hopkins; Patrycja Anna,39,0,40,1
1708251958529,CHEM 6C,A01,468994,Ternansky; Robert J.,39,0,40,1
1708251958529,CHEM 6C,A02,469054,Ternansky; Robert J.,38,0,40,2
1708251958529,CHEM 6C,A03,469065,Ternansky; Robert J.,39,0,40,1
1708251958529,CHEM 6C,A04,469069,Ternansky; Robert J.,40,0,40,0
1708251958529,CHEM 6C,A05,469080,Ternansky; Robert J.,40,0,40,0
1708251958529,CHEM 6C,B01,469318,Ternansky; Robert J.,39,0,40,1
1708251958529,CHEM 6C,B02,469319,Ternansky; Robert J.,40,0,40,0
1708251958529,CHEM 6C,B03,469320,Ternansky; Robert J.,39,0,40,1
1708251958529,CHEM 6C,B04,469321,Ternansky; Robert J.,40,0,40,0
1708251958529,CHEM 6C,B05,469322,Ternansky; Robert J.,40,0,40,0
1708251958529,CHEM 6C,C01,469323,Schurmeier; Kimberly,38,0,40,2
1708251958529,CHEM 6C,C02,469324,Schurmeier; Kimberly,36,0,40,4
1708251958529,CHEM 6C,C03,469325,Schurmeier; Kimberly,38,0,40,2
1708251958529,CHEM 6C,C04,469326,Schurmeier; Kimberly,36,0,40,4
1708251958529,CHEM 6C,C05,469327,Schurmeier; Kimberly,40,0,40,0
1708251958529,CHEM 6C,D01,460183,Schurmeier; Kimberly,39,0,40,1
1708251958529,CHEM 6C,D02,460184,Schurmeier; Kimberly,32,0,40,8
1708251958529,CHEM 6C,D03,460185,Schurmeier; Kimberly,26,0,40,14
1708251958529,CHEM 6C,D04,460186,Schurmeier; Kimberly,38,0,40,2
1708251958529,CHEM 6C,D05,460187,Schurmeier; Kimberly,40,0,40,0
1708251958529,CHEM 6C,E01,460188,Stallings; Dontarie M,24,0,40,16
1708251958529,CHEM 6C,E02,460190,Stallings; Dontarie M,25,0,40,15
1708251958529,CHEM 6C,E03,460191,Stallings; Dontarie M,3,0,20,17
1708251958529,CHEM 6C,E04,460192,Stallings; Dontarie M,36,0,40,4
1708251958529,CHEM 6C,E05,460193,Stallings; Dontarie M,37,0,40,3
1708251959055,CHEM 6CH,A01,459630,Tezcan; Faik,40,0,40,0
1708251959587,CHEM 7L,A01,393998,Jazzar; Rodolphe,0,0,0,3
1708251959587,CHEM 7L,A02,393999,Jazzar; Rodolphe,10,0,24,14
1708251959587,CHEM 7L,A03,394000,Jazzar; Rodolphe,21,0,24,3
1708251959587,CHEM 7L,A04,394001,Jazzar; Rodolphe,22,0,24,2
1708251959587,CHEM 7L,A05,394002,Jazzar; Rodolphe,18,0,24,6
1708251959587,CHEM 7L,A06,394003,Jazzar; Rodolphe,22,0,24,2
1708251959587,CHEM 7L,A07,394004,Jazzar; Rodolphe,18,0,21,3
1708251959587,CHEM 7L,A08,394005,Jazzar; Rodolphe,0,0,0,0
1708251959587,CHEM 7L,A09,394006,Jazzar; Rodolphe,20,0,24,4
1708251959587,CHEM 7L,A10,394007,Jazzar; Rodolphe,24,0,24,0
1708251959587,CHEM 7L,B01,394009,Jazzar; Rodolphe,0,0,0,1
1708251959587,CHEM 7L,B02,394010,Jazzar; Rodolphe,1,0,6,5
1708251959587,CHEM 7L,B03,394011,Jazzar; Rodolphe,15,0,24,9
1708251959587,CHEM 7L,B04,394012,Jazzar; Rodolphe,18,0,21,3
1708251959587,CHEM 7L,B05,394013,Jazzar; Rodolphe,0,0,0,0
1708251959587,CHEM 7L,B06,394014,Jazzar; Rodolphe,15,0,24,9
1708251959587,CHEM 7L,B07,394015,Jazzar; Rodolphe,18,0,24,6
1708251959587,CHEM 7L,B08,394016,Jazzar; Rodolphe,23,0,24,1
1708251959587,CHEM 7L,B09,394017,Jazzar; Rodolphe,24,0,24,0
1708251959587,CHEM 7L,B10,394018,Jazzar; Rodolphe,24,0,24,0
1708251959587,CHEM 7L,C01,394020,Staff,0,0,0,0
1708251959587,CHEM 7L,C02,394021,Staff,21,0,24,3
1708251959587,CHEM 7L,C03,394022,Staff,23,0,24,1
1708251959587,CHEM 7L,C04,394023,Staff,24,0,24,0
1708251959587,CHEM 7L,C05,394024,Staff,0,0,0,0
1708251959587,CHEM 7L,C06,394025,Staff,20,0,24,4
1708251959587,CHEM 7L,C07,394026,Staff,22,0,24,2
1708251959587,CHEM 7L,C08,394027,Staff,23,0,24,1
1708251959587,CHEM 7L,C09,394028,Staff,24,0,24,0
1708251959587,CHEM 7L,C10,394029,Staff,23,0,24,1
1708251960113,CHEM 11,A01,459661,Staff,42,0,44,2
1708251960113,CHEM 11,A02,459664,Staff,44,0,44,0
1708251960113,CHEM 11,A03,459702,Staff,42,0,44,2
1708251960113,CHEM 11,A04,459707,Staff,44,0,44,0
1708251960113,CHEM 11,A05,459708,Staff,43,0,44,1
1708251960113,CHEM 11,A06,459711,Staff,41,0,44,3
1708251960645,CHEM 40A,A01,459576,Albizati; Kim F.,36,0,40,4
1708251960645,CHEM 40A,A02,459577,Albizati; Kim F.,33,0,40,7
1708251960645,CHEM 40A,A03,459578,Albizati; Kim F.,37,0,40,3
1708251960645,CHEM 40A,A04,459579,Albizati; Kim F.,38,0,40,2
1708251960645,CHEM 40A,A05,459580,Albizati; Kim F.,40,0,40,0
1708251960645,CHEM 40A,A06,459581,Albizati; Kim F.,37,0,40,3
1708251960645,CHEM 40A,A07,459582,Albizati; Kim F.,38,0,40,2
1708251960645,CHEM 40A,A08,459588,Albizati; Kim F.,39,0,40,1
1708251961180,CHEM 40B,A01,467442,Weizman; Haim,29,0,40,11
1708251961180,CHEM 40B,A02,467443,Weizman; Haim,33,0,40,7
1708251961180,CHEM 40B,A03,467444,Weizman; Haim,39,0,40,1
1708251961180,CHEM 40B,A04,467445,Weizman; Haim,38,0,40,2
1708251961180,CHEM 40B,A05,467446,Weizman; Haim,39,0,40,1
1708251961180,CHEM 40B,A06,467447,Weizman; Haim,37,0,40,3
1708251961180,CHEM 40B,A07,467448,Weizman; Haim,31,0,40,9
1708251961180,CHEM 40B,A08,467449,Weizman; Haim,40,0,40,0
1708251961180,CHEM 40B,B01,467383,Molinski; Tadeusz,40,0,40,0
1708251961180,CHEM 40B,B02,467384,Molinski; Tadeusz,40,0,40,0
1708251961180,CHEM 40B,B03,467385,Molinski; Tadeusz,40,0,40,0
1708251961180,CHEM 40B,B04,467399,Molinski; Tadeusz,40,0,40,0
1708251961180,CHEM 40B,B05,467400,Molinski; Tadeusz,40,0,40,0
1708251961180,CHEM 40B,B06,467401,Molinski; Tadeusz,40,0,40,0
1708251961180,CHEM 40B,B07,467402,Molinski; Tadeusz,40,0,40,0
1708251961180,CHEM 40B,B08,467404,Molinski; Tadeusz,39,0,40,1
1708251961709,CHEM 41B,A01,459571,Klosterman; Jeremy K,40,0,40,0
1708251961709,CHEM 41B,A02,459572,Klosterman; Jeremy K,36,0,37,1
1708251961709,CHEM 41B,A03,459573,Klosterman; Jeremy K,40,0,40,0
1708251962241,CHEM 41C,A01,459589,Tor; Yitzhak,40,0,40,0
1708251962241,CHEM 41C,A02,459624,Tor; Yitzhak,38,0,40,2
1708251962241,CHEM 41C,A03,459625,Tor; Yitzhak,40,0,40,0
1708251962241,CHEM 41C,A04,459626,Tor; Yitzhak,40,0,40,0
1708251962241,CHEM 41C,A05,459627,Tor; Yitzhak,29,0,29,0
1708251962241,CHEM 41C,A06,459628,Tor; Yitzhak,38,0,40,2
1708251962241,CHEM 41C,A07,459629,Tor; Yitzhak,40,0,40,0
1708251962782,CHEM 43A,A01,394068,Lam; Tin Yiu,12,0,24,12
1708251962782,CHEM 43A,A02,394088,Lam; Tin Yiu,23,0,24,1
1708251962782,CHEM 43A,A03,394092,Lam; Tin Yiu,23,0,24,1
1708251962782,CHEM 43A,A04,394093,Lam; Tin Yiu,21,0,24,3
1708251962782,CHEM 43A,A05,394094,Lam; Tin Yiu,23,0,24,1
1708251962782,CHEM 43A,A06,394096,Lam; Tin Yiu,15,0,24,9
1708251962782,CHEM 43A,A07,394115,Lam; Tin Yiu,20,0,24,4
1708251962782,CHEM 43A,A08,394116,Lam; Tin Yiu,22,0,24,2
1708251962782,CHEM 43A,A09,394117,Lam; Tin Yiu,22,0,24,2
1708251962782,CHEM 43A,A10,394118,Lam; Tin Yiu,20,0,24,4
1708251962782,CHEM 43A,A11,394119,Lam; Tin Yiu,8,0,13,5
1708251962782,CHEM 43A,A12,394120,Lam; Tin Yiu,24,0,24,0
1708251962782,CHEM 43A,A13,394132,Lam; Tin Yiu,24,0,24,0
1708251962782,CHEM 43A,B01,394134,Lam; Tin Yiu,24,0,24,0
1708251962782,CHEM 43A,B02,394135,Lam; Tin Yiu,16,0,24,8
1708251962782,CHEM 43A,B03,394136,Lam; Tin Yiu,13,0,24,11
1708251962782,CHEM 43A,B04,394137,Lam; Tin Yiu,17,0,24,7
1708251962782,CHEM 43A,B05,394138,Lam; Tin Yiu,20,0,24,4
1708251962782,CHEM 43A,B06,394139,Lam; Tin Yiu,19,0,24,5
1708251962782,CHEM 43A,B07,394140,Lam; Tin Yiu,20,0,24,4
1708251962782,CHEM 43A,B08,394141,Lam; Tin Yiu,24,0,24,0
1708251962782,CHEM 43A,B09,394142,Lam; Tin Yiu,20,0,24,4
1708251962782,CHEM 43A,B10,394143,Lam; Tin Yiu,24,0,24,0
1708251962782,CHEM 43A,B11,394145,Lam; Tin Yiu,22,0,24,2
1708251962782,CHEM 43A,B12,394146,Lam; Tin Yiu,23,0,24,1
1708251963307,CHEM 96,A00,394159,Bussey; Thomas J,24,0,25,1
1708251963835,CHEM 100A,A01,394161,Li; Shaowei,16,0,22,6
1708251963835,CHEM 100A,A02,394162,Li; Shaowei,20,0,24,4
1708251963835,CHEM 100A,A03,394163,Li; Shaowei,22,0,24,2
1708251963835,CHEM 100A,A04,394164,Li; Shaowei,24,0,24,0
1708251963835,CHEM 100A,A05,394165,Li; Shaowei,24,0,24,0
1708251963835,CHEM 100A,A06,394166,Li; Shaowei,20,0,22,2
1708251964363,CHEM 100B,A01,394175,Pomeroy; Robert S.,19,0,25,6
1708251964889,CHEM 105A,A01,394177,Young; Mark,31,0,39,8
1708251964889,CHEM 105A,B01,394179,Young; Mark,0,0,0,0
1708251965415,CHEM 108,A01,394181,Staff,14,0,20,6
1708251965415,CHEM 108,A02,394182,Staff,23,0,24,1
1708251965415,CHEM 108,B01,394184,Staff,4,0,20,16
1708251965415,CHEM 108,B02,394185,Staff,23,0,24,1
1708251965948,CHEM 109,A01,394187,Piercy; Marc Anthony,17,0,20,3
1708251965948,CHEM 109,A02,394188,Piercy; Marc Anthony,22,0,24,2
1708251965948,CHEM 109,B01,394193,Piercy; Marc Anthony,12,0,20,8
1708251965948,CHEM 109,B02,394194,Piercy; Marc Anthony,23,0,24,1
1708251966478,CHEM 111,A00,394195,Thiemens; Mark H,97,0,100,3
1708251967005,CHEM 114B,A01,459574,Piercy; Marc Anthony,39,0,45,6
1708251967005,CHEM 114B,A02,459575,Piercy; Marc Anthony,40,0,45,5
1708251967532,CHEM 114C,A01,467286,Komives; Elizabeth A,32,0,44,12
1708251967532,CHEM 114C,A02,467287,Komives; Elizabeth A,42,0,44,2
1708251967532,CHEM 114C,A03,467290,Komives; Elizabeth A,42,0,44,2
1708251967532,CHEM 114C,A04,467295,Komives; Elizabeth A,43,0,44,1
1708251968062,CHEM 114D,A00,394198,Ghosh; Gourisankar,29,0,30,1
1708251968589,CHEM 118,A01,459788,Donoghue; Daniel J.,37,0,40,3
1708251968589,CHEM 118,A02,459800,Donoghue; Daniel J.,37,0,40,3
1708251968589,CHEM 118,A03,459807,Donoghue; Daniel J.,36,0,40,4
1708251968589,CHEM 118,A04,459809,Donoghue; Daniel J.,38,0,40,2
1708251968589,CHEM 118,A05,459811,Donoghue; Daniel J.,37,0,40,3
1708251968589,CHEM 118,A06,459826,Donoghue; Daniel J.,39,0,40,1
1708251969167,CHEM 119,A01,467427,Joseph; Simpson,35,0,40,5
1708251969167,CHEM 119,A02,467441,Joseph; Simpson,0,0,0,0
1708251969698,CHEM 120B,A01,467450,Griffith; Kent,37,0,40,3
1708251969698,CHEM 120B,A02,467451,Griffith; Kent,34,0,40,6
1708251969698,CHEM 120B,A03,467452,Griffith; Kent,35,0,40,5
1708251970223,CHEM 123,A00,394211,Schimpf; Alina M,0,0,0,1
1708251970753,CHEM 125,A00,394217,Tezcan; Faik,18,0,20,2
1708251971282,CHEM 126A,A01,459715,Yong; Haiwang,39,0,40,1
1708251971282,CHEM 126A,A02,459725,Yong; Haiwang,36,0,40,4
1708251971809,CHEM 126B,A01,467405,Tauber; Michael,36,0,40,4
1708251971809,CHEM 126B,A02,467406,Tauber; Michael,39,0,40,1
1708251971809,CHEM 126B,A03,467426,Tauber; Michael,39,0,40,1
1708251972337,CHEM 132,A01,460181,Galperin; Michael,42,0,45,3
1708251972337,CHEM 132,A02,460182,Galperin; Michael,37,0,45,8
1708251972867,CHEM 135,A01,394222,Tauber; Michael,15,0,15,0
1708251973397,CHEM 143B,A01,394229,Klosterman; Jeremy K,16,0,24,8
1708251973397,CHEM 143B,A02,394230,Klosterman; Jeremy K,21,0,24,3
1708251973923,CHEM 156,A00,394231,Romero; Erik Anthony,30,0,30,0
1708251974450,CHEM 157,A00,394232,Tor; Yitzhak,74,0,80,6
1708251974980,CHEM 165,A01,460194,Herzik; Mark Anthony,21,0,25,4
1708251975510,CHEM 167,A01,467296,Deshmukh; Lalit,39,0,40,1
1708251975510,CHEM 167,A02,467297,Deshmukh; Lalit,33,0,40,7
1708251975510,CHEM 167,A03,467298,Deshmukh; Lalit,37,0,40,3
1708251975510,CHEM 167,A04,467312,Deshmukh; Lalit,37,0,40,3
1708251976035,CHEM 173,A00,394284,Young; Mark,48,0,50,2
1708251976561,CHEM 174,A01,455015,Pomeroy; Robert S.,45,0,50,5
1708251977089,CHEM 186,A00,477716,Paesani; Francesco & Gilson; Michael K.,6,0,12,6
1708251977618,CHEM 188,A00,394294,Bussey; Thomas J,19,0,20,1
1708251978148,CHEM 214,A00,394336,Ghosh; Gourisankar,12,0,20,8
1708251978676,CHEM 217,A00,394341,Joseph; Simpson,25,0,30,5
1708251979206,CHEM 221,A00,394425,Taylor; Susan S.,10,0,20,10
1708251979730,CHEM 225,A00,394429,Tezcan; Faik,4,0,10,6
1708251980259,CHEM 227,A00,394430,Schimpf; Alina M,26,0,30,4
1708251980785,CHEM 229,A00,394431,Stauber; Julia Megan,13,0,20,7
1708251981311,CHEM 235,A01,394433,Tauber; Michael,20,0,20,0
1708251981839,CHEM 236,A00,394434,Kummel; Andrew C,14,0,15,1
1708251982367,CHEM 241,A00,394435,Pokorski; Jonathan Kyle,14,0,15,1
1708251982899,CHEM 250,A00,394436,Weizman; Haim,0,0,0,16
1708251983425,CHEM 256,A00,394437,Romero; Erik Anthony,15,0,20,5
1708251983956,CHEM 257,A00,394438,Tor; Yitzhak,23,0,30,7
1708251984487,CHEM 265,A01,460195,Herzik; Mark Anthony,13,0,20,7
1708251985014,CHEM 273,A00,394440,Young; Mark,13,0,20,7
1708251985541,CHEM 276,A00,394441,Mc Culloch; Andrew Douglas & Amaro; Rommie E,0,0,0,0
1708251986066,CHEM 283,A00,394443,Komives; Elizabeth A,2,0,4,2
1708251986595,CHEM 286,A00,477693,Paesani; Francesco & Gilson; Michael K.,26,0,34,8
1708251987119,CHEM 291,A00,394446,Komives; Elizabeth A,20,0,20,0
1708251987648,CHEM 294,A00,394447,Romero; Erik Anthony,50,0,50,0
1708251988175,CHIN 10CD,A01,394453,Liu; Mingming,17,0,17,0
1708251988175,CHIN 10CD,A02,394457,Liu; Mingming,18,0,18,0
1708251988702,CHIN 10CM,A01,394465,Chen; Pei-Chia,11,0,12,1
1708251988702,CHIN 10CM,A02,394466,Chen; Pei-Chia,12,0,12,0
1708251988702,CHIN 10CM,B01,394468,Liu; Mingming,11,0,13,2
1708251988702,CHIN 10CM,B02,394469,Liu; Mingming,13,0,13,0
1708251989229,CHIN 10CN,A01,394581,Xu; Li,14,0,14,0
1708251989229,CHIN 10CN,A02,394582,Xu; Li,14,0,14,0
1708251989229,CHIN 10CN,B01,394585,Xu; Li,14,0,14,0
1708251989229,CHIN 10CN,B02,394586,Xu; Li,13,0,14,1
1708251989759,CHIN 20CD,A01,394591,Wang; Xiao,11,0,12,1
1708251989759,CHIN 20CD,A02,394592,Wang; Xiao,11,0,12,1
1708251990292,CHIN 20CN,A01,394597,Anderson; Qin-Hong,7,0,8,1
1708251990292,CHIN 20CN,A02,394599,Anderson; Qin-Hong,8,0,8,0
1708251990292,CHIN 20CN,B01,394601,Anderson; Qin-Hong,14,0,15,1
1708251990819,CHIN 100CM,A00,394602,Anderson; Qin-Hong,19,0,20,1
1708251991344,CHIN 100CN,A00,394603,Chen; Pei-Chia,24,0,24,0
1708251991871,CHIN 169B,A00,394623,Wang; Xiao,19,0,20,1
1708251992400,CLAS 87,A00,394669,Herbst; Matthew,19,0,20,1
1708251992928,CLAS 121R,A01,394671,Herbst; Matthew,11,0,12,1
1708251992928,CLAS 121R,B01,486854,Herbst; Matthew,8,0,8,0
1708251993455,CLIN 294C,A00,476856,Wierenga; Christina E & Banks; Sarah Jane,20,0,20,0
1708251993984,CLIN 296,001,476768,Brookman; Lauren Irene,94,0,100,6
1708251993984,CLIN 296,002,476855,Brookman; Lauren Irene,10,0,10,0
1708251994512,CLRE 238R,A00,394675,Mehta; Ravindra L.,9998,0,9999,1
1708251995041,CLRE 254,A00,394678,Vaida; Florin,9999,0,9999,0
1708251995567,CLRE 256,A00,394685,Morris; Sheldon,9999,0,9999,0
1708251996096,CLRE 258,A00,394692,Mehta; Ravindra L.,9999,0,9999,0
1708251996621,CLRE 260,A00,394693,Cuomo; Raphael Eduardo,9999,0,9999,0
1708251997147,CLRE 264,A00,394696,Mehta; Ravindra L.,9999,0,9999,0
1708251997675,CLRE 267,A00,394703,Vaida; Florin,9999,0,9999,0
1708251998201,CLRE 297,001,394705,Cuomo; Raphael Eduardo,9999,0,9999,0
1708251998727,CMM 246,A00,492783,Gordts; Philip & Varki; Ajit P & Lewis; Amanda Lark & Godula; Kamil & Gagneux; Pascal & Esko; Jeffrey D. & Bode; Lars,9,0,10,1
1708251999253,CMM 250,A00,492943,Willert; Karl Heinrich,31,0,40,9
1708251999783,COGR 200B,A00,395746,Jack; Caroline Sarah,2,0,5,3
1708252000309,COGR 225B,A00,395750,Serlin; David,1,0,5,4
1708252000836,COGR 225C,A00,395753,Gates; Kelly,1,0,5,4
1708252001371,COGR 275,A00,395943,Goldfarb; Brian,6,0,10,4
1708252001371,COGR 275,B00,396046,Fattal; Alexander Leor,4,0,10,6
1708252001371,COGR 275,C00,396047,Kidman; Shawna F,4,0,10,6
1708252001897,COGR 280,A00,396048,Ahn; Patricia Jeehyun,6,0,10,4
1708252002421,COGS 1,A01,407484,Boyle; Mary E. T.,52,0,60,8
1708252002421,COGS 1,A02,407498,Boyle; Mary E. T.,54,0,60,6
1708252002421,COGS 1,A03,407504,Boyle; Mary E. T.,59,0,60,1
1708252002421,COGS 1,A04,407512,Boyle; Mary E. T.,57,0,60,3
1708252002421,COGS 1,A05,407513,Boyle; Mary E. T.,60,0,60,0
1708252002421,COGS 1,A06,407514,Boyle; Mary E. T.,58,0,60,2
1708252002421,COGS 1,A07,407515,Boyle; Mary E. T.,57,0,57,0
1708252002952,COGS 9,A01,407520,Shannon; Kyle Michael,54,0,60,6
1708252002952,COGS 9,A02,407521,Shannon; Kyle Michael,60,0,60,0
1708252002952,COGS 9,A03,407522,Shannon; Kyle Michael,59,0,60,1
1708252002952,COGS 9,A04,407524,Shannon; Kyle Michael,57,0,60,3
1708252002952,COGS 9,A05,407525,Shannon; Kyle Michael,59,0,60,1
1708252003480,COGS 10,A01,407527,Morgan; Eric,45,0,50,5
1708252003480,COGS 10,A02,407530,Morgan; Eric,46,0,50,4
1708252003480,COGS 10,A03,407531,Morgan; Eric,46,0,50,4
1708252003480,COGS 10,A04,407532,Morgan; Eric,47,0,50,3
1708252003480,COGS 10,A05,407534,Morgan; Eric,47,0,50,3
1708252003480,COGS 10,A06,407539,Morgan; Eric,50,0,50,0
1708252003480,COGS 10,A07,407628,Morgan; Eric,50,0,50,0
1708252004009,COGS 11,A01,407699,Boroditsky; Lera,179,0,180,1
1708252004535,COGS 12,A00,407702,Boroditsky; Lera,75,0,75,0
1708252005061,COGS 14A,A01,407706,Barrera; Steven James,51,0,57,6
1708252005061,COGS 14A,A02,407707,Barrera; Steven James,54,0,57,3
1708252005061,COGS 14A,A03,407712,Barrera; Steven James,0,0,0,1
1708252005061,COGS 14A,A04,407715,Barrera; Steven James,57,0,57,0
1708252005061,COGS 14A,A05,407717,Barrera; Steven James,55,0,56,1
1708252005061,COGS 14A,A06,407718,Barrera; Steven James,52,0,55,3
1708252005061,COGS 14A,A07,407720,Barrera; Steven James,49,0,55,6
1708252005591,COGS 14B,A01,407723,Hoffman; Drew Ellen,52,0,57,5
1708252005591,COGS 14B,A02,407726,Hoffman; Drew Ellen,48,0,55,7
1708252005591,COGS 14B,A03,407727,Hoffman; Drew Ellen,52,0,55,3
1708252005591,COGS 14B,A04,407729,Hoffman; Drew Ellen,52,0,55,3
1708252005591,COGS 14B,A05,407730,Hoffman; Drew Ellen,50,0,55,5
1708252006118,COGS 17,A01,407733,Johnson; Christine M.,50,0,50,0
1708252006118,COGS 17,A02,407734,Johnson; Christine M.,48,0,50,2
1708252006118,COGS 17,A03,407735,Johnson; Christine M.,46,0,50,4
1708252006118,COGS 17,A04,407740,Johnson; Christine M.,47,0,50,3
1708252006118,COGS 17,A05,407745,Johnson; Christine M.,48,0,50,2
1708252006118,COGS 17,A06,407824,Johnson; Christine M.,48,0,50,2
1708252006118,COGS 17,A07,407878,Johnson; Christine M.,50,0,55,5
1708252006118,COGS 17,A08,408015,Johnson; Christine M.,52,0,55,3
1708252006650,COGS 18,A01,408118,Ellis; Shannon Elizabeth,27,0,35,8
1708252006650,COGS 18,A02,408119,Ellis; Shannon Elizabeth,31,0,35,4
1708252006650,COGS 18,A03,408120,Ellis; Shannon Elizabeth,23,0,35,12
1708252006650,COGS 18,A04,408136,Ellis; Shannon Elizabeth,33,0,35,2
1708252006650,COGS 18,A05,408141,Ellis; Shannon Elizabeth,35,0,35,0
1708252006650,COGS 18,A06,408143,Ellis; Shannon Elizabeth,34,0,35,1
1708252006650,COGS 18,A07,408144,Ellis; Shannon Elizabeth,35,0,35,0
1708252006650,COGS 18,A08,408145,Ellis; Shannon Elizabeth,34,0,35,1
1708252006650,COGS 18,A09,408146,Ellis; Shannon Elizabeth,35,0,35,0
1708252006650,COGS 18,B01,408148,Ellis; Shannon Elizabeth,30,0,32,2
1708252006650,COGS 18,B02,408149,Ellis; Shannon Elizabeth,26,0,32,6
1708252006650,COGS 18,B03,408151,Ellis; Shannon Elizabeth,27,0,33,6
1708252006650,COGS 18,B04,408154,Ellis; Shannon Elizabeth,32,0,33,1
1708252006650,COGS 18,B05,408163,Ellis; Shannon Elizabeth,29,0,33,4
1708252006650,COGS 18,B06,408176,Ellis; Shannon Elizabeth,33,0,33,0
1708252006650,COGS 18,B07,408177,Ellis; Shannon Elizabeth,31,0,33,2
1708252006650,COGS 18,B08,408178,Ellis; Shannon Elizabeth,32,0,33,1
1708252006650,COGS 18,B09,408195,Ellis; Shannon Elizabeth,31,0,33,2
1708252007181,COGS 87,A00,408196,Deak; Gedeon O.,20,0,20,0
1708252007181,COGS 87,B00,479478,Fleischer; Jason G,20,0,20,0
1708252007707,COGS 100,A01,408262,Allen; Michael Gordon,54,0,56,2
1708252007707,COGS 100,A02,408263,Allen; Michael Gordon,52,0,56,4
1708252007707,COGS 100,A03,408264,Allen; Michael Gordon,55,0,56,1
1708252007707,COGS 100,A04,408265,Allen; Michael Gordon,56,0,56,0
1708252007707,COGS 100,A05,408266,Allen; Michael Gordon,56,0,56,0
1708252007707,COGS 100,A06,408349,Allen; Michael Gordon,55,0,56,1
1708252008237,COGS 101A,A01,408352,Morgan; Eric,60,0,60,0
1708252008237,COGS 101A,A02,408353,Morgan; Eric,58,0,60,2
1708252008237,COGS 101A,A03,408354,Morgan; Eric,57,0,60,3
1708252008237,COGS 101A,A04,408355,Morgan; Eric,59,0,60,1
1708252008764,COGS 101B,A01,408373,Barrera; Steven James,47,0,50,3
1708252008764,COGS 101B,A02,408380,Barrera; Steven James,46,0,50,4
1708252008764,COGS 101B,A03,408384,Barrera; Steven James,38,0,50,12
1708252008764,COGS 101B,A04,408385,Barrera; Steven James,37,0,50,13
1708252009289,COGS 101C,A01,408387,Trott; Sean Thomas,48,0,50,2
1708252009289,COGS 101C,A02,408388,Trott; Sean Thomas,43,0,50,7
1708252009289,COGS 101C,A03,408389,Trott; Sean Thomas,45,0,50,5
1708252009815,COGS 107A,A01,408396,Boyle; Mary E. T.,54,0,56,2
1708252009815,COGS 107A,A02,408397,Boyle; Mary E. T.,54,0,56,2
1708252009815,COGS 107A,A03,408399,Boyle; Mary E. T.,51,0,56,5
1708252009815,COGS 107A,A04,408409,Boyle; Mary E. T.,50,0,56,6
1708252009815,COGS 107A,A05,408410,Boyle; Mary E. T.,51,0,56,5
1708252009815,COGS 107A,A06,408411,Boyle; Mary E. T.,55,0,56,1
1708252010340,COGS 107B,A01,408413,Mooshagian; Eric Frederick,46,0,50,4
1708252010340,COGS 107B,A02,408414,Mooshagian; Eric Frederick,43,0,50,7
1708252010340,COGS 107B,A03,408428,Mooshagian; Eric Frederick,43,0,50,7
1708252010340,COGS 107B,A04,408434,Mooshagian; Eric Frederick,46,0,50,4
1708252010340,COGS 107B,A05,408435,Mooshagian; Eric Frederick,50,0,50,0
1708252010340,COGS 107B,A06,408446,Mooshagian; Eric Frederick,49,0,50,1
1708252010867,COGS 107C,A01,408500,Chiba; Andrea,51,0,60,9
1708252010867,COGS 107C,A02,408519,Chiba; Andrea,55,0,60,5
1708252010867,COGS 107C,A03,408524,Chiba; Andrea,56,0,60,4
1708252011393,COGS 108,A01,408532,Fleischer; Jason G,45,0,60,15
1708252011393,COGS 108,A02,408543,Fleischer; Jason G,58,0,60,2
1708252011393,COGS 108,A03,408544,Fleischer; Jason G,59,0,60,1
1708252011393,COGS 108,A04,408552,Fleischer; Jason G,32,0,60,28
1708252011393,COGS 108,A05,408554,Fleischer; Jason G,47,0,60,13
1708252011393,COGS 108,A06,408574,Fleischer; Jason G,43,0,60,17
1708252011393,COGS 108,A07,408576,Fleischer; Jason G,56,0,60,4
1708252011920,COGS 112,A01,408682,Hoffman; Drew Ellen,32,0,50,18
1708252011920,COGS 112,A02,408683,Hoffman; Drew Ellen,38,0,50,12
1708252011920,COGS 112,A03,408684,Hoffman; Drew Ellen,48,0,60,12
1708252012447,COGS 122,A01,408695,Dow; Steven P,21,0,50,29
1708252012974,COGS 125,A00,408697,Klemmer; Scott R,36,0,50,14
1708252013499,COGS 126,A01,408787,Hollan; James D.,44,0,50,6
1708252014025,COGS 138,A01,408866,Khosla; Meenakshi,71,0,75,4
1708252014554,COGS 142,A01,408868,Rossano; Federico,49,0,50,1
1708252015080,COGS 144,A01,408950,Rossano; Federico,48,0,50,2
1708252015606,COGS 155,A01,408993,Staff,49,0,50,1
1708252016136,COGS 157,A00,408994,Creel; Sarah,0,0,0,0
1708252016663,COGS 160,A00,409031,Deak; Gedeon O.,20,0,20,0
1708252017192,COGS 175,A01,409035,Rill; Bryan,67,0,75,8
1708252017725,COGS 178,A00,409274,Jernigan; Terry Lynne,68,0,70,2
1708252018251,COGS 179,A00,409278,Staff,40,0,40,0
1708252018779,COGS 184,A01,409317,Johnson; Christine M.,42,0,50,8
1708252019305,COGS 185,A01,409476,Tu; Zhuowen,33,0,50,17
1708252019305,COGS 185,A02,409525,Tu; Zhuowen,45,0,50,5
1708252019830,COGS 188,A01,409527,Fleischer; Jason G,44,0,75,31
1708252020360,COGS 190C,001,409528,Chiba; Andrea,9999,0,9999,0
1708252020360,COGS 190C,002,409530,Fleischer; Jason G,9999,0,9999,0
1708252020360,COGS 190C,003,409531,Boyle; Mary E. T.,9999,0,9999,0
1708252020360,COGS 190C,004,409532,Nitz; Douglas A.,9999,0,9999,0
1708252020360,COGS 190C,005,409535,Rangel; Lara M,9999,0,9999,0
1708252020360,COGS 190C,006,409536,Rossano; Federico,9999,0,9999,0
1708252020360,COGS 190C,007,409537,Deak; Gedeon O.,9999,0,9999,0
1708252020360,COGS 190C,008,409538,Trott; Sean Thomas,9999,0,9999,0
1708252020360,COGS 190C,009,409540,Creel; Sarah,9999,0,9999,0
1708252020360,COGS 190C,010,409541,Voytek; Bradley Thomas,9999,0,9999,0
1708252020360,COGS 190C,011,409542,Greene; Deanna Jacquelyn,9999,0,9999,0
1708252020360,COGS 190C,012,409543,Ellis; Shannon Elizabeth,9999,0,9999,0
1708252020360,COGS 190C,013,409546,Kirsh; David Joel,9999,0,9999,0
1708252020886,COGS 190D,A00,409547,Voytek; Bradley Thomas,20,0,20,0
1708252021411,COGS 194,A00,409548,Hill; Seth J,9999,0,9999,0
1708252021941,COGS 200,A01,406697,Creel; Sarah,0,0,0,0
1708252022521,COGS 205,A00,406698,Chiba; Andrea,20,0,20,0
1708252023045,COGS 209,A00,406699,Mukamel; Eran A,41,0,68,27
1708252023580,COGS 210C,001,406700,Kirsh; David Joel,9999,0,9999,0
1708252023580,COGS 210C,002,406701,Greene; Deanna Jacquelyn,9998,0,9999,1
1708252023580,COGS 210C,003,406702,Xia; Haijun,9999,0,9999,0
1708252023580,COGS 210C,004,406703,Nitz; Douglas A.,9998,0,9999,1
1708252023580,COGS 210C,005,406710,Hollan; James D.,9999,0,9999,0
1708252023580,COGS 210C,006,406713,De Sa; Virginia,9999,0,9999,0
1708252023580,COGS 210C,007,406714,Rossano; Federico,9999,0,9999,0
1708252023580,COGS 210C,008,406740,Kiyonaga; Anastasia,9999,0,9999,0
1708252023580,COGS 210C,009,406745,Guo; Philip J,9998,0,9999,1
1708252023580,COGS 210C,010,406746,Dow; Steven P,9999,0,9999,0
1708252023580,COGS 210C,011,406747,Bergen; Benjamin,9999,0,9999,0
1708252023580,COGS 210C,012,406758,Coulson; Seana M,9999,0,9999,0
1708252024105,COGS 211C,A00,406763,Coulson; Seana M,17,0,20,3
1708252024634,COGS 229,A00,406788,Hollan; James D. & Xia; Haijun,4,0,10,6
1708252025159,COGS 238,A00,406789,Bergen; Benjamin,17,0,20,3
1708252025688,COGS 278,A00,406794,Jernigan; Terry Lynne,18,0,20,2
1708252026218,COMM 10,A01,394711,Schmidt; Thomas Rainer,20,0,24,4
1708252026218,COMM 10,A02,394714,Schmidt; Thomas Rainer,24,0,24,0
1708252026218,COMM 10,A03,394716,Schmidt; Thomas Rainer,24,0,24,0
1708252026218,COMM 10,A04,394717,Schmidt; Thomas Rainer,22,0,24,2
1708252026218,COMM 10,A05,394731,Schmidt; Thomas Rainer,24,0,24,0
1708252026218,COMM 10,A06,394733,Schmidt; Thomas Rainer,24,0,24,0
1708252026218,COMM 10,A07,394740,Schmidt; Thomas Rainer,24,0,24,0
1708252026218,COMM 10,A08,394741,Schmidt; Thomas Rainer,24,0,24,0
1708252026218,COMM 10,A09,394751,Schmidt; Thomas Rainer,23,0,24,1
1708252026218,COMM 10,A10,394779,Schmidt; Thomas Rainer,24,0,24,0
1708252026218,COMM 10,A11,394809,Schmidt; Thomas Rainer,24,0,24,0
1708252026218,COMM 10,A12,394811,Schmidt; Thomas Rainer,24,0,24,0
1708252026218,COMM 10,A13,394818,Schmidt; Thomas Rainer,24,0,24,0
1708252026218,COMM 10,A14,394825,Schmidt; Thomas Rainer,23,0,24,1
1708252026218,COMM 10,A15,394828,Schmidt; Thomas Rainer,24,0,24,0
1708252026218,COMM 10,A16,394829,Schmidt; Thomas Rainer,0,0,0,0
1708252026218,COMM 10,A17,486828,Schmidt; Thomas Rainer,20,0,21,1
1708252026744,COMM 20,A01,394834,McKenna; Denise,69,0,70,1
1708252027269,COMM 80,A01,394849,Campbell; Robert Harold,120,0,120,0
1708252027818,COMM 100C,A01,394957,Kidman; Shawna F,24,0,25,1
1708252027818,COMM 100C,A02,394972,Kidman; Shawna F,25,0,25,0
1708252027818,COMM 100C,A03,394977,Kidman; Shawna F,22,0,25,3
1708252027818,COMM 100C,A04,394981,Kidman; Shawna F,25,0,25,0
1708252027818,COMM 100C,A05,394985,Kidman; Shawna F,24,0,25,1
1708252027818,COMM 100C,A06,394989,Kidman; Shawna F,23,0,25,2
1708252027818,COMM 100C,A07,394993,Kidman; Shawna F,24,0,25,1
1708252027818,COMM 100C,A08,394997,Kidman; Shawna F,23,0,25,2
1708252027818,COMM 100C,A09,394999,Kidman; Shawna F,25,0,25,0
1708252027818,COMM 100C,A10,395018,Kidman; Shawna F,25,0,25,0
1708252027818,COMM 100C,A11,395041,Kidman; Shawna F,24,0,25,1
1708252027818,COMM 100C,A12,395080,Kidman; Shawna F,24,0,25,1
1708252028345,COMM 101,A01,395135,Halm; Gavin Patrick,15,0,15,0
1708252028345,COMM 101,A02,395252,Halm; Gavin Patrick,15,0,15,0
1708252028345,COMM 101,A03,395253,Halm; Gavin Patrick,15,0,15,0
1708252028345,COMM 101,A04,395263,Halm; Gavin Patrick,15,0,15,0
1708252028885,COMM 101D,A00,395264,Martinico; Daniel J,13,0,16,3
1708252029413,COMM 101K,A00,395266,Ahn; Patricia Jeehyun,16,0,18,2
1708252029939,COMM 101N,A00,395267,Martinico; Daniel J,16,0,16,0
1708252030464,COMM 102C,A01,395270,Campion; Camille E,5,0,6,1
1708252030464,COMM 102C,A02,395271,Campion; Camille E,6,0,6,0
1708252030464,COMM 102C,A03,395272,Campion; Camille E,5,0,6,1
1708252030991,COMM 102M,A01,395285,Davis; Zeinabu I.,9,0,10,1
1708252030991,COMM 102M,A02,395288,Davis; Zeinabu I.,8,0,10,2
1708252032535,COMM 103D,A00,395343,Gates; Kelly,34,0,35,1
1708252033061,COMM 107,A00,395461,Serlin; David,33,0,35,2
1708252033589,COMM 109D,A00,395462,Halm; Gavin Patrick,72,0,75,3
1708252034119,COMM 110G,A00,395481,Whitworth-Smith; Andrew C,32,0,35,3
1708252034647,COMM 110M,A00,395482,Harb; Anthony Joseph,34,0,35,1
1708252035173,COMM 111A,A00,487217,Pavon Aramburu; Maria Laur,34,0,35,1
1708252035700,COMM 113T,A00,395516,Fields; Gary,35,0,35,0
1708252036233,COMM 114A,A00,395517,Zilberg; Elana,32,0,35,3
1708252036761,COMM 114B,A00,395523,Zilberg; Elana,19,0,20,1
1708252037288,COMM 114E,A00,487218,Pavon Aramburu; Maria Laur,34,0,35,1
1708252037815,COMM 114W,A00,395524,Walkover; Lillian B,17,0,18,1
1708252038342,COMM 126,A00,479341,Staff,26,0,30,4
1708252038872,COMM 132,A00,481491,Rojo Solis; Juan Jose,0,0,0,0
1708252039398,COMM 134,A00,395578,Abuelhiga; Soraya Jill,28,0,30,2
1708252039928,COMM 143,A00,395579,Rojo Solis; Juan Jose,28,0,30,2
1708252040455,COMM 146,A00,395584,Jack; Caroline Sarah,29,0,30,1
1708252040996,COMM 168,A00,395592,Harb; Anthony Joseph,29,0,30,1
1708252041522,COMM 170,A00,395608,Pavon Aramburu; Maria Laur,30,0,30,0
1708252042047,COMM 173,A00,395609,Alac; Morana,29,0,30,1
1708252042588,COMM 174,A00,395679,Alac; Morana,30,0,30,0
1708252043119,COMM 190,A00,395682,Abuelhiga; Soraya Jill,19,0,23,4
1708252043119,COMM 190,B00,395696,Staff,21,0,23,2
1708252043119,COMM 190,C00,395697,Fattal; Alexander Leor,22,0,23,1
1708252043646,CSE 8A,A50,459200,Miranda; Gregory Joseph,34,0,35,1
1708252043646,CSE 8A,A51,459205,Miranda; Gregory Joseph,34,0,35,1
1708252043646,CSE 8A,A52,459206,Miranda; Gregory Joseph,34,0,35,1
1708252043646,CSE 8A,A53,459212,Miranda; Gregory Joseph,34,0,35,1
1708252043646,CSE 8A,A54,459213,Miranda; Gregory Joseph,34,0,35,1
1708252043646,CSE 8A,A55,459232,Miranda; Gregory Joseph,34,0,35,1
1708252044175,CSE 11,A01,470735,Ochoa; Benjamin Lawrence,180,0,195,15
1708252044699,CSE 12,A01,470744,Cao; Yingjun,189,0,200,11
1708252044699,CSE 12,B01,470752,Miranda; Gregory Joseph,71,0,100,29
1708252044699,CSE 12,B02,470760,Miranda; Gregory Joseph,93,0,100,7
1708252045228,CSE 15L,A01,410174,Solares; Edwin A,6,0,10,4
1708252045228,CSE 15L,B01,410215,Solares; Edwin A,7,0,10,3
1708252045228,CSE 15L,C01,410305,Solares; Edwin A,3,0,10,7
1708252045228,CSE 15L,D01,410400,Solares; Edwin A,1,0,10,9
1708252045757,CSE 20,A01,470765,Minnes Kemp; Mor Mia,145,0,150,5
1708252046283,CSE 21,A01,470776,Jones; Miles E,68,0,73,5
1708252046283,CSE 21,A02,482889,Jones; Miles E,68,0,72,4
1708252047843,CSE 29,A01,494014,Soosai Raj; Adalbert Geral,48,0,50,2
1708252047843,CSE 29,A02,494016,Soosai Raj; Adalbert Geral,40,0,50,10
1708252047843,CSE 29,B01,494018,Shalev; Aaron D,16,0,20,4
1708252048385,CSE 30,A01,470784,Cao; Yingjun,141,0,150,9
1708252048385,CSE 30,B01,467469,Muller; P Keith,98,0,120,22
1708252048911,CSE 87,A00,410528,Moshiri; Niema,20,0,20,0
1708252049440,CSE 90,A00,486885,Minnes Kemp; Mor Mia,0,0,0,0
1708252049969,CSE 91,A00,486872,Minnes Kemp; Mor Mia,0,0,0,0
1708252049969,CSE 91,B00,486873,Minnes Kemp; Mor Mia,0,0,0,0
1708252050494,CSE 95,A00,410529,Minnes Kemp; Mor Mia,50,0,50,0
1708252051020,CSE 100,A01,470792,Sahoo; Debashis,54,0,70,16
1708252051547,CSE 100R,A01,410556,Moshiri; Niema,1,0,40,39
1708252052077,CSE 101,A01,470797,Jones; Miles E,14,0,44,30
1708252052077,CSE 101,A02,482892,Jones; Miles E,32,0,43,11
1708252052622,CSE 105,A01,470800,Micciancio; Daniele,85,0,98,13
1708252053148,CSE 107,A01,467479,Bellare; Mihir,141,0,146,5
1708252053676,CSE 109,A01,459538,Shang; Jingbo,0,0,25,25
1708252054203,CSE 110,A50,459395,Powell; Thomas Allan,49,0,50,1
1708252054203,CSE 110,A51,459512,Powell; Thomas Allan,37,0,50,13
1708252054203,CSE 110,A52,459513,Powell; Thomas Allan,46,0,50,4
1708252054203,CSE 110,A53,459514,Powell; Thomas Allan,48,0,50,2
1708252054203,CSE 110,A54,459515,Powell; Thomas Allan,47,0,50,3
1708252054203,CSE 110,A55,459516,Powell; Thomas Allan,45,0,50,5
1708252054203,CSE 110,A56,459517,Powell; Thomas Allan,47,0,48,1
1708252054744,CSE 112,A50,459518,Powell; Thomas Allan,132,0,146,14
1708252055273,CSE 120,A01,470808,Zhou; Yuan-Yuan,167,0,200,33
1708252055798,CSE 125,A00,410564,Voelker; Geoffrey M.,30,0,30,0
1708252056323,CSE 127,A01,467484,Fernandes; Earlence T,175,0,196,21
1708252056849,CSE 130,A01,467485,Polikarpova; Nadezhda,176,0,192,16
1708252057375,CSE 131,A01,459522,Ding; Yufei,36,0,50,14
1708252057900,CSE 132B,A01,470816,Deutsch; Alin Bernard,60,0,70,10
1708252058428,CSE 140,A01,410606,Orailoglu; Alex,99,0,100,1
1708252058428,CSE 140,B01,410622,Eldon; John,130,0,146,16
1708252058958,CSE 140L,A01,410655,Orailoglu; Alex,98,0,100,2
1708252058958,CSE 140L,B01,410658,Eldon; John,123,0,146,23
1708252059484,CSE 141,A01,467486,Zhao; Jishen,173,0,196,23
1708252060010,CSE 141L,A01,410685,Eldon; John,162,0,196,34
1708252060537,CSE 145,A01,410713,Kastner; Ryan Charles,25,0,25,0
1708252061063,CSE 150B,A01,470824,Gao; Sicun,310,0,362,52
1708252061589,CSE 156,A01,467487,Nakashole; Ndapandula,138,0,192,54
1708252062115,CSE 165,A01,410757,Weibel; Nadir & Schulze; Jurgen P.,40,0,50,10
1708252062641,CSE 168,A01,410759,Ramamoorthi; Ravi,24,0,25,1
1708252062641,CSE 168,A02,410761,Ramamoorthi; Ravi,24,0,25,1
1708252063171,CSE 175,A01,410764,Kumar; Rakesh,48,0,50,2
1708252063697,CSE 182,A01,455011,Bafna; Vineet,47,0,50,3
1708252064223,CSE 185,A01,410895,Gymrek; Melissa Ann,41,0,57,16
1708252064223,CSE 185,A02,479240,Gymrek; Melissa Ann,53,0,58,5
1708252064755,CSE 190,A00,410982,Grier; Daniel T,48,0,50,2
1708252064755,CSE 190,B00,410983,Riek; Laurel D,50,0,50,0
1708252064755,CSE 190,C00,410984,Staff,36,0,50,14
1708252064755,CSE 190,D00,481666,Saha; Barna & Impagliazzo; Russell,27,0,28,1
1708252065286,CSE 203A,A00,410985,Saha; Barna & Impagliazzo; Russell,0,0,0,0
1708252065828,CSE 209A,A00,410986,Grier; Daniel T,0,0,0,0
1708252066359,CSE 209B,A00,410987,Bellare; Mihir,0,0,0,0
1708252066888,CSE 217,A01,459553,Weibel; Nadir,0,0,0,0
1708252067415,CSE 218,A00,410989,Griswold; William G.,0,0,0,0
1708252067942,CSE 219,A00,410990,Hollan; James D. & Xia; Haijun,0,0,0,0
1708252068485,CSE 224,A01,470832,Snoeren; Alex C.,0,0,0,0
1708252069010,CSE 229A,A00,410993,Shalev; Aaron D,0,0,0,0
1708252069536,CSE 229C,A00,410994,Fernandes; Earlence T,0,0,0,0
1708252070079,CSE 231,A01,467488,Jhala; Ranjit,0,0,0,0
1708252070611,CSE 233,A00,410996,Vianu; Victor Dan,0,0,0,0
1708252071135,CSE 237D,A00,410998,Kastner; Ryan Charles,0,0,0,0
1708252071663,CSE 239A,A00,410999,Vianu; Victor Dan,0,0,0,0
1708252072189,CSE 239B,A00,411000,Coblenz; Michael J,0,0,0,0
1708252072715,CSE 240A,A00,411001,Chin; Bryan W.,0,0,0,0
1708252073247,CSE 252D,A00,411004,Chandraker; Manmohan Krishna,0,0,0,0
1708252073772,CSE 256,A00,411005,Nakashole; Ndapandula,0,0,0,0
1708252074298,CSE 260,A01,467491,Chin; Bryan W.,0,0,0,0
1708252074828,CSE 276B,A00,411007,Riek; Laurel D,0,0,0,0
1708252075359,CSE 276F,A01,459554,Su; Hao,0,0,0,0
1708252075883,CSE 283,A00,411009,Bafna; Vineet & Zhong; Sheng,0,0,0,0
1708252076410,CSE 290,A00,411010,Gao; Sicun,0,0,0,0
1708252076410,CSE 290,B00,411011,Chern; Albert Ren-Haur,0,0,0,0
1708252076410,CSE 290,C00,411012,Swanson; Steven James,0,0,0,0
1708252076410,CSE 290,E00,411013,Su; Hao,0,0,0,0
1708252076410,CSE 290,F00,411014,Riek; Laurel D,0,0,0,0
1708252076410,CSE 290,G00,411015,Gymrek; Melissa Ann,0,0,0,0
1708252076410,CSE 290,H00,479239,Dasgupta; Sanjoy & Gymrek; Melissa Ann,0,0,0,0
1708252076410,CSE 290,I00,481669,Bafna; Vineet,0,0,0,0
1708252076410,CSE 290,J00,494949,Paturi; Ramamohan,0,0,0,0
1708252076958,CSE 291,A00,411016,Li; Tzumao,0,0,0,0
1708252076958,CSE 291,B00,411017,Heninger; Nadia A,0,0,0,0
1708252076958,CSE 291,C00,411114,Chern; Albert Ren-Haur,0,0,0,0
1708252076958,CSE 291,D00,411115,Zhang; Yiying,0,0,0,0
1708252076958,CSE 291,E00,411116,Cheng; Chung Kuan,0,0,0,0
1708252076958,CSE 291,G00,411118,Lerner; Sorin,0,0,0,0
1708252076958,CSE 291,I00,481509,Shang; Jingbo,0,0,0,0
1708252076958,CSE 291,J00,494844,Savage; Stefan & Stefan; Deian,50,0,50,0
1708252077589,CSE 293,001,487239,Bafna; Vineet,9999,0,9999,0
1708252077589,CSE 293,002,487240,Bellare; Mihir,9999,0,9999,0
1708252077589,CSE 293,003,487241,Berg-Kirkpatrick; Taylor D,9999,0,9999,0
1708252077589,CSE 293,004,487242,Chandraker; Manmohan Krishna,9999,0,9999,0
1708252077589,CSE 293,005,487243,Cheng; Chung Kuan,9999,0,9999,0
1708252077589,CSE 293,006,487244,Christensen; Henrik I,9999,0,9999,0
1708252077589,CSE 293,007,487245,Coblenz; Michael J,9999,0,9999,0
1708252077589,CSE 293,008,487363,Cottrell; Garrison W,9999,0,9999,0
1708252077589,CSE 293,009,487366,Deutsch; Alin Bernard,9999,0,9999,0
1708252077589,CSE 293,010,487433,Esmaeilzadeh; Hadi,9999,0,9999,0
1708252077589,CSE 293,011,487434,Freund; Yoav,9999,0,9999,0
1708252077589,CSE 293,012,487455,Griswold; William G.,9999,0,9999,0
1708252077589,CSE 293,013,487469,Gymrek; Melissa Ann,9999,0,9999,0
1708252077589,CSE 293,014,487470,Heninger; Nadia A,9999,0,9999,0
1708252077589,CSE 293,015,487471,Impagliazzo; Russell,9999,0,9999,0
1708252077589,CSE 293,016,487472,Jhala; Ranjit,9999,0,9999,0
1708252077589,CSE 293,017,487473,Kahng; Andrew Byun,9999,0,9999,0
1708252077589,CSE 293,018,487474,Kane; Daniel Mertz,9999,0,9999,0
1708252077589,CSE 293,019,487475,Kriegman; David J,9999,0,9999,0
1708252077589,CSE 293,020,487476,Kumar; Arun Kumar,9999,0,9999,0
1708252077589,CSE 293,021,487477,Lerner; Sorin,9999,0,9999,0
1708252077589,CSE 293,022,487478,Lovett; Shachar,9999,0,9999,0
1708252077589,CSE 293,023,487520,McAuley; Julian John,9999,0,9999,0
1708252077589,CSE 293,024,487522,Micciancio; Daniele,9999,0,9999,0
1708252077589,CSE 293,025,487577,Orailoglu; Alex,9999,0,9999,0
1708252077589,CSE 293,026,487586,Pannuto; Patrick William,9999,0,9999,0
1708252077589,CSE 293,027,487598,Paturi; Ramamohan,9999,0,9999,0
1708252077589,CSE 293,028,487604,Polikarpova; Nadezhda,9999,0,9999,0
1708252077589,CSE 293,029,487609,Politz; Joseph Gibbs,9999,0,9999,0
1708252077589,CSE 293,030,487642,Porter; George M,9999,0,9999,0
1708252077589,CSE 293,031,487665,Porter; Leonard Emerson,9999,0,9999,0
1708252077589,CSE 293,032,487689,Ramamoorthi; Ravi,9999,0,9999,0
1708252077589,CSE 293,033,487698,Riek; Laurel D,9999,0,9999,0
1708252077589,CSE 293,034,487712,Sahoo; Debashis,9999,0,9999,0
1708252077589,CSE 293,035,487721,Saul; Lawrence,9999,0,9999,0
1708252077589,CSE 293,036,487735,Savage; Stefan,9999,0,9999,0
1708252077589,CSE 293,037,487744,Schulze; Jurgen P.,9999,0,9999,0
1708252077589,CSE 293,038,487758,Snoeren; Alex C.,9999,0,9999,0
1708252077589,CSE 293,039,487767,Shang; Jingbo,9999,0,9999,0
1708252077589,CSE 293,040,487790,Stefan; Deian,9999,0,9999,0
1708252077589,CSE 293,041,487817,Su; Hao,9999,0,9999,0
1708252077589,CSE 293,042,487827,Swanson; Steven James,9999,0,9999,0
1708252077589,CSE 293,043,487830,Tullsen; Dean Michael,9999,0,9999,0
1708252077589,CSE 293,044,487837,Vaccaro; Kristen Marie,9999,0,9999,0
1708252077589,CSE 293,045,487838,Voelker; Geoffrey M.,9999,0,9999,0
1708252077589,CSE 293,046,487842,Zhao; Jishen,9999,0,9999,0
1708252077589,CSE 293,047,487847,Zhou; Yuan-Yuan,9999,0,9999,0
1708252077589,CSE 293,048,487852,Gao; Sicun,9999,0,9999,0
1708252077589,CSE 293,049,487853,Weibel; Nadir,9999,0,9999,0
1708252077589,CSE 293,050,487854,Gupta; Rajesh K.,9999,0,9999,0
1708252077589,CSE 293,051,487855,Soosai Raj; Adalbert Geral,9999,0,9999,0
1708252077589,CSE 293,052,494373,Zhang; Hao,9999,0,9999,0
1708252078175,CSE 294,A00,411124,Voelker; Geoffrey M.,15,0,15,0
1708252078701,CSS 100,A01,396053,Trott; Sean Thomas,43,0,50,7
1708252079230,CSS 120,A01,479237,Mignozzetti; Umberto,47,0,50,3
1708252079230,CSS 120,A02,479238,Mignozzetti; Umberto,50,0,50,0
1708252079755,CSS 209,A00,396054,Styler; William Francis,21,0,35,14
1708252080283,CSS 296,001,396055,Mignozzetti; Umberto,0,0,0,1
1708252080283,CSS 296,002,396056,Styler; William Francis,0,0,0,1
1708252080283,CSS 296,003,396057,Broz; James Lawrence,0,0,0,2
1708252080283,CSS 296,004,396058,Elliott; Graham,0,0,0,5
1708252080283,CSS 296,005,396059,Sun; Feiyang,0,0,0,0
1708252080283,CSS 296,006,396060,Dewaard; Andrew Michael,0,0,0,0
1708252080809,DDPM 210,A00,400652,Ma; Joseph David,36,0,36,0
1708252081335,DDPM 211,A00,400653,Ma; Joseph David,36,0,36,0
1708252081864,DDPM 214,A00,400720,Ma; Joseph David,36,0,36,0
1708252082390,DERM 296,001,464131,Staff,50,0,50,0
1708252082390,DERM 296,002,464178,Staff,50,0,50,0
1708252082390,DERM 296,003,464181,Staff,50,0,50,0
1708252082957,DOC 3,A01,399409,Strom; Megan C.,0,0,0,0
1708252082957,DOC 3,A02,399414,Strom; Megan C.,0,0,0,0
1708252082957,DOC 3,A03,399432,Strom; Megan C.,0,0,0,0
1708252082957,DOC 3,A04,399461,Strom; Megan C.,0,0,0,0
1708252082957,DOC 3,A05,399470,Strom; Megan C.,0,0,0,0
1708252082957,DOC 3,A06,399476,Strom; Megan C.,0,0,0,0
1708252082957,DOC 3,A07,399547,Strom; Megan C.,0,0,0,0
1708252082957,DOC 3,A08,399548,Strom; Megan C.,0,0,0,0
1708252082957,DOC 3,A09,399675,Strom; Megan C.,0,0,0,0
1708252082957,DOC 3,A10,399687,Strom; Megan C.,0,0,0,0
1708252082957,DOC 3,A11,399704,Strom; Megan C.,0,0,0,0
1708252082957,DOC 3,A12,399707,Strom; Megan C.,0,0,0,0
1708252082957,DOC 3,A13,399714,Strom; Megan C.,0,0,0,0
1708252082957,DOC 3,A14,399721,Strom; Megan C.,0,0,0,0
1708252082957,DOC 3,A15,399765,Strom; Megan C.,0,0,0,0
1708252082957,DOC 3,A16,399766,Strom; Megan C.,0,0,0,0
1708252082957,DOC 3,B01,399786,Strom; Megan C.,0,0,0,0
1708252082957,DOC 3,B02,399787,Strom; Megan C.,0,0,0,0
1708252082957,DOC 3,B03,399788,Strom; Megan C.,0,0,0,0
1708252082957,DOC 3,B04,399845,Strom; Megan C.,0,0,0,0
1708252082957,DOC 3,B05,399846,Strom; Megan C.,0,0,0,0
1708252082957,DOC 3,B06,399895,Strom; Megan C.,0,0,0,0
1708252082957,DOC 3,B07,399916,Strom; Megan C.,0,0,0,0
1708252082957,DOC 3,B08,400073,Strom; Megan C.,0,0,0,0
1708252082957,DOC 3,B09,400074,Strom; Megan C.,0,0,0,0
1708252082957,DOC 3,B10,400076,Strom; Megan C.,0,0,0,0
1708252082957,DOC 3,B11,400077,Strom; Megan C.,0,0,0,0
1708252082957,DOC 3,B12,400078,Strom; Megan C.,0,0,0,0
1708252082957,DOC 3,B13,400079,Strom; Megan C.,0,0,0,0
1708252082957,DOC 3,B14,400080,Strom; Megan C.,0,0,0,0
1708252082957,DOC 3,B15,400081,Strom; Megan C.,0,0,0,0
1708252082957,DOC 3,B16,400082,Strom; Megan C.,0,0,0,0
1708252082957,DOC 3,C01,400084,Chapman; Dillon,0,0,0,0
1708252082957,DOC 3,C02,400085,Chapman; Dillon,0,0,0,0
1708252082957,DOC 3,C03,400086,Chapman; Dillon,0,0,0,0
1708252082957,DOC 3,C04,400087,Chapman; Dillon,0,0,0,0
1708252082957,DOC 3,C05,400113,Chapman; Dillon,0,0,0,0
1708252082957,DOC 3,C06,400114,Chapman; Dillon,0,0,0,0
1708252082957,DOC 3,C07,400117,Chapman; Dillon,0,0,0,0
1708252082957,DOC 3,C08,400118,Chapman; Dillon,0,0,0,0
1708252082957,DOC 3,C09,400119,Chapman; Dillon,0,0,0,0
1708252082957,DOC 3,C10,400121,Chapman; Dillon,0,0,0,0
1708252082957,DOC 3,C11,400122,Chapman; Dillon,0,0,0,0
1708252082957,DOC 3,C12,400126,Chapman; Dillon,0,0,0,0
1708252082957,DOC 3,C13,400157,Chapman; Dillon,0,0,0,0
1708252082957,DOC 3,C14,400240,Chapman; Dillon,0,0,0,0
1708252082957,DOC 3,C15,400241,Chapman; Dillon,0,0,0,0
1708252082957,DOC 3,C16,400242,Chapman; Dillon,0,0,0,0
1708252082957,DOC 3,D01,400253,Chapman; Dillon,0,0,0,0
1708252082957,DOC 3,D02,400294,Chapman; Dillon,0,0,0,0
1708252082957,DOC 3,D03,400295,Chapman; Dillon,0,0,0,0
1708252082957,DOC 3,D04,400430,Chapman; Dillon,0,0,0,0
1708252082957,DOC 3,D05,400438,Chapman; Dillon,0,0,0,0
1708252082957,DOC 3,D06,400439,Chapman; Dillon,0,0,0,0
1708252082957,DOC 3,D07,400441,Chapman; Dillon,0,0,0,0
1708252082957,DOC 3,D08,400442,Chapman; Dillon,0,0,0,0
1708252082957,DOC 3,D09,400443,Chapman; Dillon,0,0,0,0
1708252082957,DOC 3,D10,400445,Chapman; Dillon,0,0,0,0
1708252082957,DOC 3,D11,400446,Chapman; Dillon,0,0,0,0
1708252082957,DOC 3,D12,400447,Chapman; Dillon,0,0,0,0
1708252082957,DOC 3,D13,400448,Chapman; Dillon,0,0,0,0
1708252082957,DOC 3,D14,400646,Chapman; Dillon,0,0,0,0
1708252082957,DOC 3,D15,400647,Chapman; Dillon,0,0,0,0
1708252082957,DOC 3,D16,400648,Chapman; Dillon,0,0,0,0
1708252083484,DOC 100D,A00,400649,Pass; Natalye Joann,22,0,25,3
1708252083484,DOC 100D,B00,400650,Pass; Natalye Joann,25,0,25,0
1708252084019,DSC 10,A01,398041,Tiefenbruck; Janine LoBue,142,0,147,5
1708252084019,DSC 10,B01,398180,Tiefenbruck; Janine LoBue,144,0,147,3
1708252084019,DSC 10,C01,398400,Tiefenbruck; Janine LoBue,143,0,147,4
1708252084545,DSC 20,A01,398415,Langlois; Marina,200,0,200,0
1708252085071,DSC 30,A01,398436,Langlois; Marina,156,0,158,2
1708252085071,DSC 30,B01,398439,Langlois; Marina,144,0,150,6
1708252085597,DSC 40A,A01,398441,Rampure; Suraj,123,0,125,2
1708252085597,DSC 40A,B01,398443,Rampure; Suraj,125,0,125,0
1708252086122,DSC 40B,A01,398445,Staff,150,0,150,0
1708252086653,DSC 80,A01,398470,Lau; Samuel Ethan,70,0,70,0
1708252086653,DSC 80,B01,398541,Lau; Samuel Ethan,68,0,70,2
1708252087194,DSC 95,A01,398650,Rampure; Suraj,50,0,50,0
1708252087723,DSC 100,A01,398683,Salimi; Babak,147,0,150,3
1708252088252,DSC 102,A01,398708,Jin; Haojian,145,0,150,5
1708252088779,DSC 106,A01,398711,Wilber; Jared Dane,146,0,149,3
1708252090560,DSC 140A,A01,398724,Eldridge; Justin Matthew,98,0,100,2
1708252090560,DSC 140A,B01,479346,Ustun; Tevfik Berk,50,0,50,0
1708252091090,DSC 140B,A01,398726,Weng; Tsui-Wei (lily),144,0,150,6
1708252091632,DSC 190,A01,398738,Silberman; Jack,20,0,20,0
1708252091632,DSC 190,B01,479475,Ustun; Tevfik Berk,29,0,30,1
1708252091632,DSC 190,C01,481341,Rahman; Tauhidur,50,0,50,0
1708252092173,DSC 197,001,494360,Eldridge; Justin Matthew,9999,0,9999,0
1708252092702,DSC 214,A00,477322,Staff,21,0,60,39
1708252093231,DSC 231,A01,398863,Gupta; Rajesh K.,60,0,60,0
1708252093757,DSC 232R,A01,487133,Solares; Edwin A,39,0,60,21
1708252094285,DSC 240,A00,398957,Belkin; Mikhail,74,0,90,16
1708252095336,DSC 243,A00,398958,Ma; Yian,59,0,60,1
1708252095864,DSC 245,A00,398959,Huang; Biwei,41,0,60,19
1708252096390,DSC 253,A00,398960,Shang; Jingbo,0,0,30,30
1708252096919,DSC 258R,A01,398962,Shang; Jingbo,43,0,60,17
1708252097447,DSC 267R,A01,398964,Staff,56,0,60,4
1708252097975,DSC 291,A00,398965,Belkin; Mikhail,90,0,90,0
1708252097975,DSC 291,B00,398966,Weng; Tsui-Wei (lily),90,0,90,0
1708252097975,DSC 291,C00,398997,Staff,60,0,60,0
1708252097975,DSC 291,D00,398998,Zhang; Hao,40,0,40,0
1708252097975,DSC 291,E00,477386,Staff,50,0,50,0
1708252098501,DSC 293,A00,477388,Ustun; Tevfik Berk,9989,0,9999,10
1708252099268,DSC 295,A00,480826,Danks; David J,30,0,40,10
1708252099813,DSE 220,A00,398034,Dasgupta; Sanjoy,20,0,20,0
1708252100342,DSE 230,A00,398035,Nguyen; Mai Huong,20,0,20,0
1708252100868,DSE 260B,A00,398037,Altintas De Callaf; Ilkay,20,0,20,0
1708252101394,DSGN 1,A01,408210,Klemmer; Scott R,46,0,50,4
1708252101394,DSGN 1,A02,408245,Klemmer; Scott R,47,0,50,3
1708252101923,DSGN 119,A00,407467,Hollan; James D. & Xia; Haijun,76,0,90,14
1708252102450,DSGN 160,A00,494371,Aronoff-Spencer; Eliah Sea,15,0,20,5
1708252102980,DSGN 219,A00,474323,Hollan; James D. & Xia; Haijun,15,0,15,0
1708252103506,ECE 5,A01,428645,Morris; Karcher William,21,0,24,3
1708252103506,ECE 5,A02,428646,Morris; Karcher William,24,0,24,0
1708252103506,ECE 5,A03,428647,Morris; Karcher William,24,0,24,0
1708252103506,ECE 5,A04,428648,Morris; Karcher William,24,0,24,0
1708252104032,ECE 15,A01,428650,Sahay; Rajeev,119,0,120,1
1708252104563,ECE 16,A01,428652,Wang; Edward Jay,22,0,30,8
1708252105092,ECE 17,A01,428654,Sahay; Rajeev,48,0,60,12
1708252105625,ECE 25,A50,428657,Dey; Sujit,30,0,30,0
1708252105625,ECE 25,A51,428658,Dey; Sujit,30,0,30,0
1708252106152,ECE 30,A50,428674,Mir Arabbaygi; Siavash,27,0,30,3
1708252106152,ECE 30,A51,428675,Mir Arabbaygi; Siavash,28,0,30,2
1708252106152,ECE 30,A52,428676,Mir Arabbaygi; Siavash,28,0,30,2
1708252106152,ECE 30,A53,428679,Mir Arabbaygi; Siavash,29,0,30,1
1708252106152,ECE 30,A54,428680,Mir Arabbaygi; Siavash,30,0,30,0
1708252106683,ECE 35,A50,428684,Taur; Yuan,29,0,30,1
1708252106683,ECE 35,A51,428685,Taur; Yuan,30,0,30,0
1708252106683,ECE 35,A52,428686,Taur; Yuan,30,0,30,0
1708252106683,ECE 35,A53,428687,Taur; Yuan,29,0,30,1
1708252107211,ECE 45,A01,428689,Zeger; Kenneth A.,137,0,150,13
1708252107737,ECE 65,A50,428701,Baghdadchi; Saharnaz,28,0,30,2
1708252107737,ECE 65,A51,428742,Baghdadchi; Saharnaz,29,0,30,1
1708252107737,ECE 65,A52,428743,Baghdadchi; Saharnaz,30,0,30,0
1708252107737,ECE 65,A53,428754,Baghdadchi; Saharnaz,26,0,30,4
1708252107737,ECE 65,A54,428796,Baghdadchi; Saharnaz,30,0,30,0
1708252107737,ECE 65,A55,428797,Baghdadchi; Saharnaz,29,0,30,1
1708252107737,ECE 65,A56,428803,Baghdadchi; Saharnaz,30,0,30,0
1708252108283,ECE 100,A01,428978,Baghdadchi; Saharnaz,29,0,30,1
1708252108283,ECE 100,A02,428988,Baghdadchi; Saharnaz,30,0,30,0
1708252108283,ECE 100,A03,428989,Baghdadchi; Saharnaz,29,0,30,1
1708252108283,ECE 100,A04,429008,Baghdadchi; Saharnaz,29,0,30,1
1708252108811,ECE 101,A01,429017,Bharadia; Dinesh,57,0,60,3
1708252108811,ECE 101,A02,429019,Bharadia; Dinesh,60,0,60,0
1708252109338,ECE 103,A01,429027,Kuzum; Duygu,74,0,75,1
1708252109879,ECE 107,A01,429055,Fullerton; Eric E,73,0,75,2
1708252110404,ECE 108,A01,429068,Kang; Mingu,53,0,60,7
1708252110936,ECE 109,A01,429085,Orlitsky; Alon,98,0,100,2
1708252110936,ECE 109,A02,429098,Orlitsky; Alon,96,0,100,4
1708252111462,ECE 111,A01,429132,Turakhia; Yatish Girish,173,0,180,7
1708252111992,ECE 115,A01,429314,Yip; Michael,22,0,26,4
1708252112520,ECE 123,A01,429327,Sievenpiper; Daniel F.,56,0,60,4
1708252113047,ECE 125B,A50,429397,Esmaili; Gholamreza,23,0,24,1
1708252113047,ECE 125B,A51,429627,Esmaili; Gholamreza,23,0,24,1
1708252113576,ECE 134,A00,429630,Ng; Tse Nga,50,0,50,0
1708252114107,ECE 136L,A01,429634,Dayeh; Shadi Ahmad,3,0,5,2
1708252114107,ECE 136L,A02,429636,Dayeh; Shadi Ahmad,3,0,5,2
1708252114107,ECE 136L,A03,429637,Dayeh; Shadi Ahmad,5,0,5,0
1708252114107,ECE 136L,A04,429641,Dayeh; Shadi Ahmad,5,0,5,0
1708252114638,ECE 139,A00,429642,Nomura; Kenji,17,0,20,3
1708252115182,ECE 140B,A01,455349,Khoshabeh; Ramsin & Gessner; Richard K.,19,0,24,5
1708252115182,ECE 140B,A02,455351,Khoshabeh; Ramsin & Gessner; Richard K.,23,0,24,1
1708252115182,ECE 140B,A03,455354,Khoshabeh; Ramsin & Gessner; Richard K.,21,0,22,1
1708252115709,ECE 141B,A01,455355,Gessner; Richard K.,48,0,50,2
1708252116234,ECE 148,A01,492803,Silberman; Jack,0,0,0,0
1708252116760,ECE 153,A01,429655,Naghizadeh Ardabili; Parin,94,0,100,6
1708252117291,ECE 157A,A01,429657,Bharadia; Dinesh,22,0,25,3
1708252117816,ECE 158B,A01,429659,Zhang; Xinyu,14,0,20,6
1708252118347,ECE 161C,A00,429660,Cosman; Pamela C.,58,0,60,2
1708252118880,ECE 163,A00,429664,Hsueh; Tzu-Chien,95,0,100,5
1708252119408,ECE 165,A51,429672,Mercier; Patrick Philip,20,0,30,10
1708252119408,ECE 165,A52,429673,Mercier; Patrick Philip,22,0,30,8
1708252119408,ECE 165,A53,429674,Mercier; Patrick Philip,30,0,30,0
1708252119408,ECE 165,A54,429675,Mercier; Patrick Philip,30,0,30,0
1708252119940,ECE 171A,A01,429813,Zheng; Yang,96,0,100,4
1708252120471,ECE 175B,A01,429886,Xie; Pengtao,72,0,75,3
1708252121002,ECE 183,A01,430023,Mookherjea; Shayan,26,0,30,4
1708252121528,ECE 185,A01,430025,Papen; George C.,19,0,20,1
1708252122056,ECE 191,A00,430039,Zhang; Xinyu,30,0,30,0
1708252122587,ECE 196,A00,430040,Morris; Karcher William,18,0,24,6
1708252122587,ECE 196,B00,430045,Morris; Karcher William,23,0,24,1
1708252123117,ECE 198,001,430052,Nguyen; Truong Quang,9999,0,9999,0
1708252123708,ECE 200,001,438659,Atanasov; Nikolay A.,9999,0,9999,0
1708252123708,ECE 200,002,438660,Bharadia; Dinesh,9999,0,9999,0
1708252123708,ECE 200,003,438668,Cheng; Chung Kuan,9999,0,9999,0
1708252123708,ECE 200,004,438845,Cosman; Pamela C.,9999,0,9999,0
1708252123708,ECE 200,005,438846,Dayeh; Shadi Ahmad,9999,0,9999,0
1708252123708,ECE 200,006,438847,Fainman; Yeshaiahu,9999,0,9999,0
1708252123708,ECE 200,007,438848,Ford; Joseph Earl,9999,0,9999,0
1708252123708,ECE 200,008,438849,Franceschetti; Massimo,9999,0,9999,0
1708252123708,ECE 200,009,438850,Fullerton; Eric E,9999,0,9999,0
1708252123708,ECE 200,010,438851,Galton; Ian A,9999,0,9999,0
1708252123708,ECE 200,011,438852,Gilja; Vikash,9999,0,9999,0
1708252123708,ECE 200,012,438853,Hall; Drew A.,9999,0,9999,0
1708252123708,ECE 200,013,438854,Hsueh; Tzu-Chien,9999,0,9999,0
1708252123708,ECE 200,014,438855,Javidi; Tara,9999,0,9999,0
1708252123708,ECE 200,015,438865,Kahng; Andrew Byun,9999,0,9999,0
1708252123708,ECE 200,016,438866,Kim; Young-Han,9999,0,9999,0
1708252123708,ECE 200,017,438876,Koushanfar; Farinaz,9999,0,9999,0
1708252123708,ECE 200,018,438877,Kuzum; Duygu,9999,0,9999,0
1708252123708,ECE 200,019,438934,Le; Hanh-Phuc,9999,0,9999,0
1708252123708,ECE 200,020,438954,Lin; Bill,9999,0,9999,0
1708252123708,ECE 200,021,438955,Liu; Zhaowei,9999,0,9999,0
1708252123708,ECE 200,022,438957,Lo; Yu-Hwa,9999,0,9999,0
1708252123708,ECE 200,023,439086,Lomakin; Vitaliy,9999,0,9999,0
1708252123708,ECE 200,024,439087,Mercier; Patrick Philip,9999,0,9999,0
1708252123708,ECE 200,025,439088,Meyer; Florian,9999,0,9999,0
1708252123708,ECE 200,026,439090,Milstein; Laurence B.,9999,0,9999,0
1708252123708,ECE 200,027,439208,Mir Arabbaygi; Siavash,9999,0,9999,0
1708252123708,ECE 200,028,439209,Mookherjea; Shayan,9999,0,9999,0
1708252123708,ECE 200,029,439210,Morris; Karcher William,9999,0,9999,0
1708252123708,ECE 200,030,439211,Ng; Tse Nga,9999,0,9999,0
1708252123708,ECE 200,031,439219,Nguyen; Truong Quang,9999,0,9999,0
1708252123708,ECE 200,032,439220,Nomura; Kenji,9999,0,9999,0
1708252123708,ECE 200,033,439221,Orlitsky; Alon,9999,0,9999,0
1708252123708,ECE 200,034,439222,Pal; Piya,9999,0,9999,0
1708252123708,ECE 200,035,439223,Papen; George C.,9999,0,9999,0
1708252123708,ECE 200,036,439224,Radic; Stojan,9999,0,9999,0
1708252123708,ECE 200,037,439225,Rao; Bhaskar D.,9999,0,9999,0
1708252123708,ECE 200,038,439227,Rao; Ramesh R,9999,0,9999,0
1708252123708,ECE 200,039,439231,Rebeiz; Gabriel,9999,0,9999,0
1708252123708,ECE 200,040,439232,Sanford; John R,9999,0,9999,0
1708252123708,ECE 200,041,439302,Siegel; Paul H.,9999,0,9999,0
1708252123708,ECE 200,042,439303,Sievenpiper; Daniel F.,9999,0,9999,0
1708252123708,ECE 200,043,439305,Sworder; David D.,9999,0,9999,0
1708252123708,ECE 200,044,439306,Taur; Yuan,9999,0,9999,0
1708252123708,ECE 200,045,439419,Touri; Behrouz,9999,0,9999,0
1708252123708,ECE 200,046,439425,Trivedi; Mohan M.,9999,0,9999,0
1708252123708,ECE 200,047,439538,Vasconcelos; Nuno,9999,0,9999,0
1708252123708,ECE 200,048,439546,Wang; Xiaolong,9999,0,9999,0
1708252123708,ECE 200,049,439549,Xie; Pengtao,9999,0,9999,0
1708252123708,ECE 200,050,439551,Yip; Michael,9999,0,9999,0
1708252123708,ECE 200,051,439553,Zeger; Kenneth A.,9999,0,9999,0
1708252123708,ECE 200,052,439554,Zhang; Xinyu,9999,0,9999,0
1708252123708,ECE 200,053,439555,Zheng; Yang,9999,0,9999,0
1708252123708,ECE 200,054,439557,Turakhia; Yatish Girish,9999,0,9999,0
1708252123708,ECE 200,055,439558,Kang; Mingu,9999,0,9999,0
1708252123708,ECE 200,056,439560,Shi; Yuanyuan,9999,0,9999,0
1708252123708,ECE 200,057,439564,Wang; Edward Jay,9999,0,9999,0
1708252123708,ECE 200,058,439565,Antipa; Nicholas A,9999,0,9999,0
1708252123708,ECE 200,059,439566,Zheng; Yang,9999,0,9999,0
1708252123708,ECE 200,060,492991,Yu; Paul K L,9999,0,9999,0
1708252123708,ECE 200,061,492992,Ndao; Abdoulaye,9999,0,9999,0
1708252123708,ECE 200,062,493019,Naghizadeh Ardabili; Parin,9999,0,9999,0
1708252123708,ECE 200,063,493033,Sahay; Rajeev,9999,0,9999,0
1708252124235,ECE 208,A00,430053,Mir Arabbaygi; Siavash,0,0,0,0
1708252124762,ECE 212CN,A00,430054,Liu; Zhaowei,0,0,0,0
1708252125291,ECE 222C,A00,430055,Lomakin; Vitaliy,0,0,0,0
1708252125816,ECE 227,A00,430057,Franceschetti; Massimo,0,0,0,0
1708252126360,ECE 228,A00,430078,Shi; Yuanyuan,0,0,0,0
1708252126887,ECE 230C,A00,430079,Yu; Paul K L,0,0,0,0
1708252127414,ECE 235,A00,430081,Taur; Yuan,0,0,0,0
1708252127941,ECE 236B,A00,430082,Lo; Yu-Hwa,0,0,0,0
1708252128480,ECE 240C,A00,430083,Mookherjea; Shayan,0,0,0,0
1708252129010,ECE 250,A00,430115,Touri; Behrouz,0,0,0,0
1708252129538,ECE 251B,A00,430166,Vasconcelos; Manuela,0,0,0,0
1708252130079,ECE 258B,A00,430167,Milstein; Laurence B.,0,0,0,0
1708252130609,ECE 260C,A00,430168,Eldon; John,0,0,0,0
1708252131134,ECE 264B,A00,430169,Galton; Ian A,0,0,0,0
1708252131663,ECE 265B,A00,430170,Gudem; Prasad S.S.,0,0,0,0
1708252132193,ECE 266,A01,430273,Hall; Drew A.,0,0,0,0
1708252132719,ECE 271C,A00,430283,Vasconcelos; Nuno,0,0,0,0
1708252133300,ECE 272A,A01,430340,Poveda Fonseca; Jorge,0,0,0,0
1708252133829,ECE 273,A00,430352,Wang; Jun-Kun,0,0,0,0
1708252134357,ECE 276B,A00,430353,Atanasov; Nikolay A.,0,0,0,0
1708252134884,ECE 284,A00,430385,Wang; Edward,0,0,0,0
1708252135413,ECE 285,A00,430386,Wang; Xiaolong,0,0,0,0
1708252135413,ECE 285,B00,430387,Antipa; Nicholas A,0,0,0,0
1708252135941,ECON 1,A01,409576,Crane; Meredith Helen,87,0,100,13
1708252135941,ECON 1,A02,409577,Crane; Meredith Helen,96,0,100,4
1708252135941,ECON 1,A03,409578,Crane; Meredith Helen,97,0,100,3
1708252136469,ECON 2,A01,409580,Candido; Maria Teresa,70,0,75,5
1708252136997,ECON 3,A01,409582,Crane; Meredith Helen,109,0,120,11
1708252136997,ECON 3,A02,409583,Crane; Meredith Helen,114,0,115,1
1708252136997,ECON 3,A03,409584,Crane; Meredith Helen,110,0,115,5
1708252137527,ECON 4,A01,409586,Levkoff; Steven B.,88,0,92,4
1708252137527,ECON 4,A02,409587,Levkoff; Steven B.,89,0,90,1
1708252138056,ECON 5,A01,409589,Dai; Yinlin,53,0,58,5
1708252138056,ECON 5,A02,409590,Dai; Yinlin,56,0,58,2
1708252138056,ECON 5,A03,409591,Dai; Yinlin,54,0,54,0
1708252138056,ECON 5,A04,409593,Dai; Yinlin,55,0,55,0
1708252138056,ECON 5,B01,409595,Dai; Yinlin,57,0,58,1
1708252138056,ECON 5,B02,409596,Dai; Yinlin,49,0,49,0
1708252138056,ECON 5,B03,409597,Dai; Yinlin,59,0,59,0
1708252138056,ECON 5,B04,409598,Dai; Yinlin,55,0,55,0
1708252138056,ECON 5,C01,487209,Staff,40,0,45,5
1708252138582,ECON 100A,A01,409600,Famulari; Melissa,94,0,100,6
1708252138582,ECON 100A,A02,409601,Famulari; Melissa,98,0,100,2
1708252138582,ECON 100A,A03,409604,Famulari; Melissa,98,0,100,2
1708252138582,ECON 100A,B01,409610,Famulari; Melissa,76,0,80,4
1708252139114,ECON 100AH,A00,409612,Famulari; Melissa,19,0,20,1
1708252139640,ECON 100B,A01,409614,Grigoryan; Aram,109,0,120,11
1708252139640,ECON 100B,A02,409616,Grigoryan; Aram,117,0,120,3
1708252139640,ECON 100B,B01,409626,Grigoryan; Aram,47,0,50,3
1708252139640,ECON 100B,B02,409627,Grigoryan; Aram,49,0,50,1
1708252140168,ECON 100C,A01,409629,Levkoff; Steven B.,143,0,146,3
1708252140168,ECON 100C,B01,409632,Levkoff; Steven B.,143,0,146,3
1708252140699,ECON 106,A00,409633,Bowen; T. Renee,90,0,90,0
1708252141226,ECON 109T,A00,409634,Trevino; Isabel,18,0,20,2
1708252141754,ECON 110A,A01,409637,Staff,68,0,75,7
1708252142280,ECON 110B,A01,409663,Herreno Lopera; Juan,119,0,125,6
1708252142280,ECON 110B,A02,409682,Herreno Lopera; Juan,125,0,125,0
1708252142280,ECON 110B,B01,409734,Herreno Lopera; Juan,99,0,100,1
1708252142810,ECON 120A,A01,409739,Candido; Maria Teresa,84,0,90,6
1708252142810,ECON 120A,A02,409740,Candido; Maria Teresa,87,0,90,3
1708252142810,ECON 120A,B01,409742,Candido; Maria Teresa,85,0,90,5
1708252142810,ECON 120A,B02,409743,Candido; Maria Teresa,90,0,90,0
1708252143343,ECON 120B,A01,409748,Ma; Xinwei,128,0,130,2
1708252143343,ECON 120B,A02,409754,Ma; Xinwei,128,0,130,2
1708252143343,ECON 120B,B01,409756,Ma; Xinwei,25,0,40,15
1708252143870,ECON 120C,A01,409758,Sun; Yixiao,141,0,146,5
1708252143870,ECON 120C,B01,409762,Sun; Yixiao,144,0,146,2
1708252144396,ECON 129,A00,409763,Eckert; Fabian Paul,44,0,50,6
1708252144922,ECON 134,A00,409764,Gelber; Alexander Michael,45,0,50,5
1708252144922,ECON 134,B00,409765,Gelber; Alexander Michael,49,0,50,1
1708252145449,ECON 137,A00,409766,Niehaus; Paul,19,0,20,1
1708252145977,ECON 142,A00,409767,Trevino; Isabel,39,0,40,1
1708252145977,ECON 142,B00,409768,Trevino; Isabel,38,0,40,2
1708252146502,ECON 164,A00,409771,Muralidharan; Karthik,118,0,120,2
1708252147029,ECON 172A,A01,409773,Newhouse; Herbert S,67,0,75,8
1708252147558,ECON 172B,A01,409775,Newhouse; Herbert S,74,0,75,1
1708252147558,ECON 172B,B01,409777,Newhouse; Herbert S,71,0,75,4
1708252148613,ECON 191A,A00,409780,Cullen; Julie,20,0,20,0
1708252149139,ECON 200C,A00,409782,Du; Songzi,34,0,35,1
1708252149673,ECON 210C,A00,409784,Herreno Lopera; Juan & Wieland; Johannes Friedrich,35,0,35,0
1708252150199,ECON 220C,A00,409785,Sun; Yixiao,35,0,35,0
1708252150725,ECON 220F,A00,409786,Carson; Richard T,27,0,30,3
1708252151252,ECON 221,A00,409787,Zhu; Ying,25,0,25,0
1708252151779,ECON 241,A00,409788,Muralidharan; Karthik,18,0,20,2
1708252152303,ECON 243,A00,409789,Niehaus; Paul,18,0,20,2
1708252152833,ECON 248,A00,409790,Eckert; Fabian Paul,18,0,20,2
1708252153363,ECON 250C,A00,409791,Arnold; David Hall & Betts; Julian,25,0,25,0
1708252153889,ECON 268,A00,409792,Jacobsen; Mark,24,0,25,1
1708252154416,ECON 281,A00,409793,Meckel; Katherine Hunter,19,0,20,1
1708252154416,ECON 281,B00,409794,Herreno Lopera; Juan & Wieland; Johannes Friedrich,19,0,20,1
1708252154416,ECON 281,C00,477854,Herreno Lopera; Juan & Wieland; Johannes Friedrich,18,0,20,2
1708252154943,ECON 285,A00,409795,Eckert; Fabian Paul,20,0,20,0
1708252155470,ECON 286,A00,409796,Ma; Xinwei,15,0,15,0
1708252155470,ECON 286,B00,409797,Hamilton; James D.,15,0,15,0
1708252155470,ECON 286,C00,409798,Grigoryan; Aram,15,0,15,0
1708252155470,ECON 286,D00,409799,Niehaus; Paul,15,0,15,0
1708252155996,ECON 296,A00,409800,Eckert; Fabian Paul,20,0,20,0
1708252156528,EDS 31,A00,409801,Bussey; Thomas J,9,0,10,1
1708252157059,EDS 38,A01,409803,Chung; Luz Marina,25,0,25,0
1708252157589,EDS 39,A01,409805,Heinzman; Erica M.,24,0,25,1
1708252158119,EDS 102,A01,409807,Ambo; Theresa Jean,37,0,45,8
1708252158645,EDS 110R,A01,409809,Staff,42,0,50,8
1708252158645,EDS 110R,B01,481358,Staff,20,0,20,0
1708252159182,EDS 111,A00,479044,Wishard Guerra; Alison G.,56,0,60,4
1708252159713,EDS 117,A01,409818,Jones; Gabrielle Anastasia,21,0,23,2
1708252159713,EDS 117,A02,409819,Jones; Gabrielle Anastasia,23,0,23,0
1708252159713,EDS 117,A03,409820,Jones; Gabrielle Anastasia,22,0,23,1
1708252159713,EDS 117,A04,409821,Jones; Gabrielle Anastasia,21,0,21,0
1708252160241,EDS 118,A00,409828,Warstadt; Melissa Fawn,46,0,50,4
1708252160772,EDS 123,A00,409831,Bussey; Thomas J,10,0,10,0
1708252161297,EDS 124AR,A00,419352,Simon; Elizabeth A,81,0,100,19
1708252161297,EDS 124AR,B00,419377,Simon; Elizabeth A,97,0,100,3
1708252161297,EDS 124AR,C00,481485,Simon; Elizabeth A,25,0,25,0
1708252161297,EDS 124AR,D00,481490,Simon; Elizabeth A,25,0,25,0
1708252161827,EDS 124BR,A00,409838,Eguchi; Emi,52,0,75,23
1708252161827,EDS 124BR,B00,481363,Eguchi; Emi,25,0,25,0
1708252162353,EDS 125,A00,409839,Aragon; Maria Jose,48,0,50,2
1708252162885,EDS 126,A01,409843,Jones; Makeba,19,0,25,6
1708252162885,EDS 126,A02,409844,Jones; Makeba,25,0,25,0
1708252162885,EDS 126,A03,409846,Jones; Makeba,25,0,25,0
1708252162885,EDS 126,A04,409847,Jones; Makeba,25,0,25,0
1708252163414,EDS 128B,A01,409851,Pappas; Elizabeth,49,0,50,1
1708252163940,EDS 129C,A01,409906,Millstone; Rachel Diana,44,0,50,6
1708252164473,EDS 130,A01,409954,Mendez; Kathrina Mendoza,14,0,15,1
1708252164473,EDS 130,A02,409955,Mendez; Kathrina Mendoza,24,0,25,1
1708252164473,EDS 130,A03,409956,Mendez; Kathrina Mendoza,20,0,20,0
1708252165002,EDS 133,A01,409961,Bintliff; Amy S.V.,15,0,20,5
1708252165002,EDS 133,A02,409962,Bintliff; Amy S.V.,20,0,20,0
1708252165002,EDS 133,A03,489636,Bintliff; Amy S.V.,15,0,15,0
1708252165528,EDS 136,A01,409964,Chung; Luz Marina,30,0,30,0
1708252165528,EDS 136,A02,409977,Chung; Luz Marina,30,0,30,0
1708252166057,EDS 139,A00,479197,Millstone; Rachel Diana,42,0,50,8
1708252166057,EDS 139,B00,479198,Pappas; Elizabeth,49,0,50,1
1708252166057,EDS 139,C00,479199,Mendez; Kathrina Mendoza,58,0,60,2
1708252166057,EDS 139,D00,479200,Bintliff; Amy S.V.,56,0,60,4
1708252166057,EDS 139,E00,479201,Chung; Luz Marina,59,0,60,1
1708252166057,EDS 139,F00,479202,Bintliff; Amy S.V.,15,0,15,0
1708252166057,EDS 139,G00,479203,Mamas; Christoforos,27,0,30,3
1708252166057,EDS 139,H00,493997,Choi; Bailey Miyeon,28,0,30,2
1708252166586,EDS 141,A00,409979,Mamas; Christoforos,38,0,40,2
1708252167111,EDS 145,A01,409989,Choi; Bailey Miyeon,13,0,15,2
1708252167111,EDS 145,A02,409990,Choi; Bailey Miyeon,15,0,15,0
1708252167643,EDS 180,A00,409991,Chapman; Thandeka K,30,0,30,0
1708252167643,EDS 180,B00,409992,Ambo; Theresa Jean,24,0,25,1
1708252167643,EDS 180,C00,409993,Jones; Gabrielle Anastasia,20,0,20,0
1708252167643,EDS 180,D00,409994,Phuong; Andrew,24,0,24,0
1708252168170,EDS 198,001,487216,Eguchi; Emi,20,0,20,0
1708252168697,EDS 205B,A00,409995,Staff,40,0,45,5
1708252168697,EDS 205B,B00,409997,Staff,42,0,45,3
1708252169228,EDS 232,A00,409999,Hopkins; Megan Beth,9,0,12,3
1708252169754,EDS 255,A00,410001,Phuong; Andrew,14,0,15,1
1708252170287,EDS 257,A00,410003,Datnow; Amanda Lee,14,0,15,1
1708252170818,EDS 282,A00,479192,Daly; Alan J.,16,0,16,0
1708252171344,EDS 287B,A00,479193,Daly; Alan J.,16,0,16,0
1708252171872,EDS 288A,A00,410005,Staff,18,0,18,0
1708252172402,EDS 288C,A00,410007,Staff,18,0,18,0
1708252172928,EDS 289B,A01,410009,Daly; Alan J.,18,0,18,0
1708252173456,EDS 290,A00,410010,Black; Alison Michelle,30,0,30,0
1708252173456,EDS 290,B00,410012,Choi; Bailey Miyeon,29,0,30,1
1708252173456,EDS 290,C00,479205,Heinzman; Erica M.,0,0,0,0
1708252173985,EDS 291B,A01,479195,Daly; Alan J.,16,0,16,0
1708252174511,EDS 293B,A01,410016,Staff,18,0,18,0
1708252175036,EDS 294B,A00,479196,Burrell; Sade Renee,16,0,16,0
1708252175576,EDS 296,001,478927,Ambo; Theresa Jean,0,0,0,0
1708252175576,EDS 296,002,478935,Aragon; Maria Jose,0,0,0,1
1708252175576,EDS 296,003,478936,Chapman; Thandeka K,0,0,0,0
1708252175576,EDS 296,004,478942,Bintliff; Amy S.V.,0,0,0,0
1708252175576,EDS 296,005,478943,Clarke; Sherice Nicole,0,0,0,0
1708252175576,EDS 296,006,478967,Cohen; Shana R,0,0,0,1
1708252175576,EDS 296,007,478968,Datnow; Amanda Lee,0,0,0,0
1708252175576,EDS 296,008,478969,Daly; Alan J.,0,0,0,0
1708252175576,EDS 296,009,478970,Eguchi; Emi,0,0,0,0
1708252175576,EDS 296,010,478971,Fine; Sarah,0,0,0,0
1708252175576,EDS 296,011,478972,Jones; Gabrielle Anastasia,0,0,0,0
1708252175576,EDS 296,012,479020,Jones; Makeba,0,0,0,0
1708252175576,EDS 296,013,479021,Halter; Christopher P.,0,0,0,0
1708252175576,EDS 296,014,479027,Hofstetter; Carolyn,0,0,0,0
1708252175576,EDS 296,015,479028,Hopkins; Megan Beth,0,0,0,0
1708252175576,EDS 296,016,479034,Mamas; Christoforos,0,0,0,0
1708252175576,EDS 296,017,479035,Pollock; Mica,0,0,0,0
1708252175576,EDS 296,018,479036,Wishard Guerra; Alison G.,0,0,0,0
1708252175576,EDS 296,019,494549,Phuong; Andrew,0,0,0,0
1708252176108,EMED 296,001,464428,Singh; Sukhdeep,49,0,50,1
1708252176108,EMED 296,002,464438,Subramony; Rachna,49,0,50,1
1708252176108,EMED 296,003,464490,Staff,50,0,50,0
1708252176635,ENG 10,A00,399006,Evdokimenko; Ekaterina,30,0,30,0
1708252177160,ENG 100D,A00,399084,Ngo; Anh-Thu T.,33,0,50,17
1708252177691,ENG 100DR,A00,479230,Ngo; Anh-Thu T.,29,0,40,11
1708252178218,ENG 100L,A00,399163,Kleissl; Jan,6,0,6,0
1708252178218,ENG 100L,B00,399217,Bratton; Maryann,8,0,8,0
1708252178218,ENG 100L,C00,399218,Yu; Paul K L,8,0,8,0
1708252178218,ENG 100L,D00,399257,Bratton; Maryann,6,0,6,0
1708252178218,ENG 100L,E00,399258,de Oliveira; Mauricio,9,0,10,1
1708252178218,ENG 100L,F00,399314,Bratton; Maryann,7,0,7,0
1708252178218,ENG 100L,G00,399394,Boyle; Mary E. T.,14,0,15,1
1708252178746,ENVR 102,A00,400777,Daly; Heather Marie,19,0,20,1
1708252178746,ENVR 102,B00,400778,Montejo; Carolina,24,0,25,1
1708252178746,ENVR 102,C00,400791,Staff,23,0,25,2
1708252179276,ENVR 140,A01,400813,Siapno; Jacqueline A,12,0,15,3
1708252179276,ENVR 140,A02,400870,Siapno; Jacqueline A,15,0,15,0
1708252179276,ENVR 140,A03,400889,Siapno; Jacqueline A,15,0,15,0
1708252179276,ENVR 140,A04,400890,Siapno; Jacqueline A,15,0,15,0
1708252179803,ENVR 144,A01,400929,Herbst; Matthew,20,0,20,0
1708252180333,ERC 20,A00,400722,Evans; Ivan T,30,0,30,0
1708252180860,ESYS 103,A01,400931,Lerner; Amy M,32,0,34,2
1708252180860,ESYS 103,A02,400934,Lerner; Amy M,34,0,34,0
1708252180860,ESYS 103,A03,400938,Lerner; Amy M,28,0,34,6
1708252180860,ESYS 103,A04,400939,Lerner; Amy M,33,0,34,1
1708252180860,ESYS 103,A05,400940,Lerner; Amy M,34,0,34,0
1708252180860,ESYS 103,A06,400941,Lerner; Amy M,33,0,34,1
1708252181386,ESYS 187C,A01,400945,Hetherington; Elizabeth Dorsey,28,0,40,12
1708252181386,ESYS 187C,A02,400946,Hetherington; Elizabeth Dorsey,39,0,40,1
1708252181915,ETHN 3R,A01,400948,Streeby; Shelley,21,0,25,4
1708252181915,ETHN 3R,A02,401220,Streeby; Shelley,24,0,25,1
1708252181915,ETHN 3R,A03,401231,Streeby; Shelley,22,0,25,3
1708252181915,ETHN 3R,A04,401236,Streeby; Shelley,23,0,25,2
1708252181915,ETHN 3R,A05,401241,Streeby; Shelley,21,0,25,4
1708252181915,ETHN 3R,A06,401311,Streeby; Shelley,21,0,25,4
1708252181915,ETHN 3R,A07,401318,Streeby; Shelley,25,0,25,0
1708252181915,ETHN 3R,A08,401319,Streeby; Shelley,25,0,25,0
1708252181915,ETHN 3R,A09,401397,Streeby; Shelley,25,0,25,0
1708252181915,ETHN 3R,A10,401398,Streeby; Shelley,25,0,25,0
1708252181915,ETHN 3R,A11,401399,Streeby; Shelley,24,0,25,1
1708252181915,ETHN 3R,A12,401518,Streeby; Shelley,25,0,25,0
1708252181915,ETHN 3R,A13,401551,Streeby; Shelley,24,0,25,1
1708252181915,ETHN 3R,A14,401552,Streeby; Shelley,23,0,25,2
1708252182440,ETHN 30,A01,401554,Fuste; Jose Ignacio,24,0,25,1
1708252182440,ETHN 30,A02,401555,Fuste; Jose Ignacio,25,0,25,0
1708252182440,ETHN 30,A03,401556,Fuste; Jose Ignacio,25,0,25,0
1708252182440,ETHN 30,A04,401557,Fuste; Jose Ignacio,25,0,25,0
1708252182968,ETHN 100C,A00,401558,Museus; Samuel David,36,0,40,4
1708252183499,ETHN 101TV,A01,401560,Marez; Curtis F.,21,0,25,4
1708252183499,ETHN 101TV,A02,401564,Marez; Curtis F.,25,0,25,0
1708252184025,ETHN 108,A00,401584,Hankins; Sarah E.,25,0,29,4
1708252184555,ETHN 113A,A00,401657,Werner; Bradley T.,15,0,15,0
1708252185082,ETHN 114B,A00,401724,Frank; Ross H.,19,0,20,1
1708252185610,ETHN 120D,A01,401848,Alvarez; Luis A,8,0,10,2
1708252185610,ETHN 120D,A02,401853,Alvarez; Luis A,10,0,10,0
1708252186135,ETHN 125R,A00,401858,Sasaki; Christen T,39,0,50,11
1708252187735,ETHN 126,A00,401865,Tran; Ly Thi Hai,39,0,40,1
1708252188262,ETHN 127,A00,401866,Martin Sandino; Amanda Maria Yoland,24,0,25,1
1708252188791,ETHN 137,A00,401867,Martin Sandino; Amanda Maria Yoland,19,0,19,0
1708252189321,ETHN 139,A00,401992,Perreira; Christopher Michael,25,0,25,0
1708252189852,ETHN 143,A00,402059,Marez; Curtis F.,39,0,40,1
1708252190378,ETHN 144M,A00,402060,Jolivette; Andrew J,62,0,65,3
1708252190907,ETHN 150,A00,402158,Taylor-Garcia; Daphne,16,0,18,2
1708252191438,ETHN 153,A00,402160,Martinez-Matsuda; Veronica,24,0,25,1
1708252191965,ETHN 179,A00,402165,Richards; Stephanie F,23,0,25,2
1708252192493,ETHN 183,A00,402217,Steelman; Katherine Wallis,16,0,16,0
1708252193020,ETHN 186,A00,402313,Perez; Roy,15,0,15,0
1708252193550,ETHN 189,A00,479226,Museus; Samuel David,29,0,30,1
1708252194080,ETHN 196H,A00,402314,Espiritu; Yen,0,0,0,0
1708252194080,ETHN 196H,B00,402325,Perreira; Christopher Michael,0,0,0,0
1708252194080,ETHN 196H,C00,402344,Perez; Roy,0,0,0,0
1708252194080,ETHN 196H,D00,402345,Streeby; Shelley,0,0,0,0
1708252194080,ETHN 196H,E00,402346,Taylor-Garcia; Daphne,0,0,0,0
1708252194624,ETHN 200C,A00,402358,Fuste; Jose Ignacio,19,0,20,1
1708252195149,ETHN 230,A00,402359,Streeby; Shelley,16,0,20,4
1708252195673,ETHN 291,A00,402363,Perreira; Christopher Michael,16,0,20,4
1708252196202,EXPR 100,A00,477778,Staff,9999,0,9999,0
1708252196728,EXPR 105,A00,477779,Staff,9999,0,9999,0
1708252197253,EXPR 201,A00,477780,Staff,9999,0,9999,0
1708252197782,EXPR 205,A00,477781,Staff,9999,0,9999,0
1708252198308,FILM 87,A00,402794,Rahimi; Babak,19,0,20,1
1708252198308,FILM 87,B00,402796,Rahimi; Babak,20,0,20,0
1708252198308,FILM 87,C00,402821,Havis; Allan,19,0,20,1
1708252198834,FMPH 95,A00,481734,Larsen; Britta Ann,0,0,0,2
1708252199361,FMPH 101,A00,404648,Tan; Gene Brian,31,0,40,9
1708252199892,FMPH 102,A01,404692,Rana; Brinda Kanti,25,0,28,3
1708252199892,FMPH 102,A02,404714,Rana; Brinda Kanti,28,0,28,0
1708252199892,FMPH 102,B01,404739,Rana; Brinda Kanti,26,0,28,2
1708252199892,FMPH 102,B02,404746,Rana; Brinda Kanti,28,0,28,0
1708252200419,FMPH 110,A00,404747,Campbell; Chadwick Karl,52,0,55,3
1708252200419,FMPH 110,B00,404789,Zoumas-Morse; Christine E.,24,0,30,6
1708252200946,FMPH 120,A00,404792,Nguyen-Grozavu; France T.,48,0,60,12
1708252201493,FMPH 130,A00,404859,Gould; Carlos Francisco,49,0,55,6
1708252201493,FMPH 130,B00,479047,Ciborowski; Haley Minae,52,0,55,3
1708252202017,FMPH 155,A00,404864,Fielding-Miller; Rebecca,65,0,65,0
1708252202543,FMPH 161,A00,404865,Zoumas-Morse; Christine E.,27,0,35,8
1708252203069,FMPH 191,A00,404866,Eikey; Elizabeth Victoria,35,0,35,0
1708252203613,FMPH 194,A00,404938,Larsen; Britta Ann,0,0,0,0
1708252203613,FMPH 194,B00,404939,Marquez; Becky,0,0,0,0
1708252203613,FMPH 194,C00,404949,Nguyen-Grozavu; France T.,0,0,0,0
1708252203613,FMPH 194,D00,404950,Stone; Matthew David,0,0,0,0
1708252203613,FMPH 194,E00,404958,White; Anne Elizabeth Clar,0,0,0,0
1708252203613,FMPH 194,F00,404969,Zoumas-Morse; Christine E.,0,0,0,0
1708252204165,FMPH 223,A00,404977,Vaida; Florin,7,0,26,19
1708252204690,FMPH 225,A00,404978,Zou; Jingjing,0,0,0,0
1708252205219,FMPH 291,A00,404992,Salem; Rany Mansour,15,0,15,0
1708252205219,FMPH 291,C00,405005,Schwartzman; Armin,0,0,0,11
1708252205219,FMPH 291,D00,479113,Shadyab; Aladdin Hassan,0,0,0,0
1708252205219,FMPH 291,E00,479114,Shadyab; Aladdin Hassan,0,0,0,0
1708252205219,FMPH 291,F00,479115,Wynn; Adriane Michelle,0,0,0,3
1708252205219,FMPH 291,G00,479116,Xu; Ronghui,0,0,0,10
1708252205219,FMPH 291,H00,479119,Vaida; Florin,0,0,0,2
1708252205744,FPM 258C,A00,405129,Chen; Brian Hwa-Yang,11,0,15,4
1708252206269,FPM 259C,A00,405130,Nguyen; Annie Lu & Araneta; Maria Rosario Gorrez,4,0,5,1
1708252206797,FPM 278,A00,405131,Strong; David R,13,0,15,2
1708252207340,FPM 280C,A01,405133,Banegas; Matthew Patrick,10,0,10,0
1708252207865,FPM 296,001,464651,Johnson; Michelle Lee,49,0,50,1
1708252207865,FPM 296,002,464652,Staff,50,0,50,0
1708252207865,FPM 296,003,464653,Staff,50,0,50,0
1708252208392,FPM 297,001,479175,Vaida; Florin,9999,0,9999,0
1708252208392,FPM 297,002,494007,Strong; David R,9999,0,9999,0
1708252208392,FPM 297,003,494364,Bazzi; Angela Robertson,9999,0,9999,0
1708252208923,GLBH 20,A00,405134,Elwardani; Nile Regina,143,0,146,3
1708252209449,GLBH 100,A00,405135,Bhavsar; Radhika,68,0,70,2
1708252209449,GLBH 100,B00,477773,Villarino; Margarita,39,0,44,5
1708252209449,GLBH 100,C00,477855,Jenkins; Janis A.,20,0,20,0
1708252209449,GLBH 100,D00,481337,Mishra; Jyoti,40,0,40,0
1708252209975,GLBH 101,A00,405136,Sloane; Julia Kathryn,40,0,40,0
1708252210502,GLBH 107,A00,405137,Wilson; Brenda K,63,0,70,7
1708252211032,GLBH 111,A01,486865,Burgos; Jose L.,0,0,0,0
1708252211032,GLBH 111,B01,486867,Burgos; Jose L.,0,0,0,0
1708252211562,GLBH 114W,A00,405138,Walkover; Lillian B,17,0,17,0
1708252212089,GLBH 118,A00,405140,Wilson; Brenda K,31,0,32,1
1708252212622,GLBH 147,A00,405141,Stewart; Alexander B,40,0,40,0
1708252213148,GLBH 148,A00,405142,Olivas Hernandez; Olga Lid,93,0,100,7
1708252213677,GLBH 150B,A00,486855,Sanchez; Giselle,0,0,0,0
1708252214204,GLBH 181,A00,405154,Burgos; Jose L.,211,0,216,5
1708252214733,GLBH 215,A00,479241,Walkover; Lillian B,18,0,18,0
1708252215260,GLBH 260,A00,480722,Elwardani; Nile Regina,18,0,18,0
1708252215788,GSS 20,A00,405155,Siapno; Jacqueline A,25,0,30,5
1708252216313,GSS 25,A00,405156,Batarseh; Amanda Alicia,24,0,30,6
1708252216841,HDS 1,A01,405160,Reese; Clarissa Jane,25,0,25,0
1708252216841,HDS 1,A02,405168,Reese; Clarissa Jane,25,0,25,0
1708252216841,HDS 1,A03,405169,Reese; Clarissa Jane,22,0,25,3
1708252216841,HDS 1,A04,405170,Reese; Clarissa Jane,24,0,25,1
1708252216841,HDS 1,A05,405171,Reese; Clarissa Jane,23,0,25,2
1708252216841,HDS 1,A06,405172,Reese; Clarissa Jane,24,0,25,1
1708252216841,HDS 1,A07,405173,Reese; Clarissa Jane,24,0,25,1
1708252217367,HDS 60,A01,405175,Warstadt; Melissa Fawn,34,0,35,1
1708252217367,HDS 60,A02,405176,Warstadt; Melissa Fawn,33,0,35,2
1708252217895,HDS 95,A00,405177,Staff,38,0,40,2
1708252218425,HDS 120,A00,405178,Staff,0,0,0,0
1708252218951,HDS 122,A00,405179,Rodriguez; Victoria Calip,64,0,75,11
1708252219478,HDS 150,A00,405180,Staff,20,0,20,0
1708252219478,HDS 150,B00,405181,Staff,20,0,20,0
1708252219478,HDS 150,C00,405182,Staff,20,0,20,0
1708252220009,HDS 181,A01,405185,Bjorklund; Peter,30,0,30,0
1708252220554,HDS 191,A01,405187,Reese; Clarissa Jane,40,0,40,0
1708252220554,HDS 191,B01,405194,Staff,25,0,25,0
1708252221081,HIAF 113,A00,403736,Prestholdt; Jeremy,74,0,75,1
1708252221610,HIAF 114,A00,403738,Gyamfi; Bright,49,0,50,1
1708252222139,HIEA 132,A00,403740,Kletzer; Benjamin Nathan,25,0,30,5
1708252222664,HIEA 154,A00,403741,Henry; Todd A.,62,0,64,2
1708252223191,HIEU 139,A00,403742,Strasser; Ulrike,52,0,56,4
1708252223719,HIEU 171,A00,403743,Hansen; Jan Eric,62,0,64,2
1708252224244,HIEU 176,A00,403744,Hertz; Deborah,14,0,15,1
1708252224775,HIEU 183,A00,403800,Gallant; Thomas W.,15,0,15,0
1708252225304,HIEU 276,A00,403862,Hertz; Deborah,0,0,0,0
1708252225832,HIGL 127,A00,403802,Ivey; James Alexander,56,0,56,0
1708252226357,HIGR 201,A00,494372,Pineda De Avila; Nydia,9,0,10,1
1708252226885,HIGR 205,A00,403863,Strasser; Ulrike,11,0,15,4
1708252227411,HIGR 217C,A00,403864,Lu; Weijing,9,0,10,1
1708252227942,HIGR 239,A00,403865,Serlin; David,4,0,5,1
1708252228468,HIGR 240,A00,403875,Gates; Kelly,2,0,5,3
1708252228996,HILA 101,A00,403818,LeNeave; Kimiko Nicole,62,0,64,2
1708252229521,HILA 119,A00,403819,Kozameh; Sara J,47,0,50,3
1708252230052,HILA 144,A00,403821,Kozameh; Sara J,50,0,50,0
1708252230579,HILD 2C,A01,402843,Hendrickson; Gerald M.,31,0,32,1
1708252230579,HILD 2C,A02,403030,Hendrickson; Gerald M.,31,0,32,1
1708252230579,HILD 2C,A03,403042,Hendrickson; Gerald M.,32,0,32,0
1708252230579,HILD 2C,A04,403048,Hendrickson; Gerald M.,30,0,32,2
1708252230579,HILD 2C,A05,403049,Hendrickson; Gerald M.,32,0,32,0
1708252230579,HILD 2C,A06,403098,Hendrickson; Gerald M.,32,0,32,0
1708252231111,HILD 7C,A01,403501,Bermudez; Rosie Cano,27,0,32,5
1708252231111,HILD 7C,A02,403513,Bermudez; Rosie Cano,30,0,32,2
1708252231111,HILD 7C,A03,403570,Bermudez; Rosie Cano,32,0,32,0
1708252231111,HILD 7C,A04,403572,Bermudez; Rosie Cano,32,0,32,0
1708252231111,HILD 7C,A05,403587,Bermudez; Rosie Cano,32,0,32,0
1708252231111,HILD 7C,A06,403588,Bermudez; Rosie Cano,32,0,32,0
1708252231111,HILD 7C,A07,403589,Bermudez; Rosie Cano,29,0,32,3
1708252231111,HILD 7C,A08,403590,Bermudez; Rosie Cano,32,0,32,0
1708252231111,HILD 7C,A09,403601,Bermudez; Rosie Cano,30,0,32,2
1708252231111,HILD 7C,A10,403602,Bermudez; Rosie Cano,32,0,32,0
1708252231111,HILD 7C,A11,403603,Bermudez; Rosie Cano,32,0,32,0
1708252231111,HILD 7C,A12,403604,Bermudez; Rosie Cano,32,0,32,0
1708252231654,HILD 12,A01,403607,Henry; Todd A.,32,0,32,0
1708252231654,HILD 12,A02,403608,Henry; Todd A.,31,0,32,1
1708252231654,HILD 12,A03,403609,Henry; Todd A.,32,0,32,0
1708252231654,HILD 12,A04,403699,Henry; Todd A.,32,0,32,0
1708252231654,HILD 12,A05,403700,Henry; Todd A.,32,0,32,0
1708252231654,HILD 12,A06,403701,Henry; Todd A.,32,0,32,0
1708252232183,HILD 30,A01,403703,Soleiman; Matthew Teymour,29,0,32,3
1708252232183,HILD 30,A02,403704,Soleiman; Matthew Teymour,30,0,32,2
1708252232710,HINE 118,A00,403822,Kayali; Hasan,50,0,50,0
1708252233239,HISC 119,A00,403823,Golan; Tal,26,0,30,4
1708252233768,HISC 123,A00,403839,Pineda De Avila; Nydia,44,0,50,6
1708252234297,HITO 87,A00,403707,Patterson; Patrick H.,15,0,15,0
1708252234297,HITO 87,B00,403709,Patterson; Patrick H.,15,0,15,0
1708252234297,HITO 87,C00,403735,Schneewind; Sarah,15,0,15,0
1708252234824,HITO 100,B00,403841,Klann; Mary Cameron,24,0,25,1
1708252235350,HITO 170,A00,403842,Watts; Edward J.,8,0,10,2
1708252235878,HITO 193,A00,455333,Hill; Seth J,0,0,0,0
1708252236405,HIUS 114A,A00,403843,Lewandoski; Julia Mavis,52,0,56,4
1708252236937,HIUS 120D,A01,403854,Alvarez; Luis A,8,0,10,2
1708252236937,HIUS 120D,A02,403855,Alvarez; Luis A,10,0,10,0
1708252237463,HIUS 136,A00,403857,Martinez-Matsuda; Veronica,21,0,25,4
1708252238012,HIUS 144,A00,403858,Martinez-Matsuda; Veronica,55,0,56,1
1708252238012,HIUS 144,B00,403859,Vandevelde; Kenneth Joseph,54,0,56,2
1708252238012,HIUS 144,C00,403860,Klann; Mary Cameron,52,0,56,4
1708252238012,HIUS 144,D00,403861,Lewandoski; Julia Mavis,55,0,56,1
1708252238636,HUM 2,A01,422723,Watts; Edward J.,16,0,16,0
1708252238636,HUM 2,A02,422735,Watts; Edward J.,15,0,16,1
1708252238636,HUM 2,A03,422736,Watts; Edward J.,15,0,16,1
1708252238636,HUM 2,A04,422737,Watts; Edward J.,16,0,16,0
1708252238636,HUM 2,A05,422738,Watts; Edward J.,15,0,16,1
1708252238636,HUM 2,A06,422760,Watts; Edward J.,15,0,16,1
1708252238636,HUM 2,A07,422778,Watts; Edward J.,16,0,16,0
1708252238636,HUM 2,A08,422793,Watts; Edward J.,16,0,16,0
1708252238636,HUM 2,A09,422794,Watts; Edward J.,16,0,16,0
1708252238636,HUM 2,A10,422795,Watts; Edward J.,16,0,16,0
1708252238636,HUM 2,B01,422805,Markman; Kristina,13,0,16,3
1708252238636,HUM 2,B02,422806,Markman; Kristina,14,0,16,2
1708252238636,HUM 2,B03,422807,Markman; Kristina,14,0,16,2
1708252238636,HUM 2,B04,422808,Markman; Kristina,16,0,16,0
1708252238636,HUM 2,B05,422809,Markman; Kristina,16,0,16,0
1708252238636,HUM 2,B06,422842,Markman; Kristina,16,0,16,0
1708252238636,HUM 2,B07,422843,Markman; Kristina,15,0,16,1
1708252238636,HUM 2,B08,422848,Markman; Kristina,16,0,16,0
1708252238636,HUM 2,B09,422850,Markman; Kristina,15,0,16,1
1708252238636,HUM 2,B10,422851,Markman; Kristina,12,0,16,4
1708252238636,HUM 2,B11,422852,Markman; Kristina,15,0,16,1
1708252238636,HUM 2,B12,422853,Markman; Kristina,16,0,16,0
1708252238636,HUM 2,C01,422855,Rodriguez; Bretton Sigfred,15,0,16,1
1708252238636,HUM 2,C02,422856,Rodriguez; Bretton Sigfred,16,0,16,0
1708252238636,HUM 2,C03,422859,Rodriguez; Bretton Sigfred,15,0,16,1
1708252238636,HUM 2,C04,423106,Rodriguez; Bretton Sigfred,12,0,16,4
1708252238636,HUM 2,C05,423107,Rodriguez; Bretton Sigfred,15,0,16,1
1708252238636,HUM 2,C06,423108,Rodriguez; Bretton Sigfred,14,0,16,2
1708252238636,HUM 2,C07,423109,Rodriguez; Bretton Sigfred,15,0,16,1
1708252238636,HUM 2,C08,423110,Rodriguez; Bretton Sigfred,15,0,16,1
1708252238636,HUM 2,C09,423133,Rodriguez; Bretton Sigfred,14,0,16,2
1708252238636,HUM 2,C10,423134,Rodriguez; Bretton Sigfred,14,0,16,2
1708252238636,HUM 2,C11,423135,Rodriguez; Bretton Sigfred,16,0,16,0
1708252238636,HUM 2,C12,423136,Rodriguez; Bretton Sigfred,15,0,16,1
1708252238636,HUM 2,C13,423137,Rodriguez; Bretton Sigfred,16,0,16,0
1708252238636,HUM 2,C14,423138,Rodriguez; Bretton Sigfred,16,0,16,0
1708252238636,HUM 2,D01,423140,West; Geoffrey Scott,13,0,16,3
1708252238636,HUM 2,D02,423141,West; Geoffrey Scott,15,0,16,1
1708252238636,HUM 2,D03,423142,West; Geoffrey Scott,15,0,16,1
1708252238636,HUM 2,D04,423143,West; Geoffrey Scott,14,0,16,2
1708252238636,HUM 2,D05,423144,West; Geoffrey Scott,16,0,16,0
1708252238636,HUM 2,D06,423145,West; Geoffrey Scott,16,0,16,0
1708252238636,HUM 2,D07,423146,West; Geoffrey Scott,16,0,16,0
1708252238636,HUM 2,D08,423158,West; Geoffrey Scott,16,0,16,0
1708252238636,HUM 2,D09,423169,West; Geoffrey Scott,16,0,16,0
1708252238636,HUM 2,D10,423174,West; Geoffrey Scott,16,0,16,0
1708252238636,HUM 2,D11,423175,West; Geoffrey Scott,16,0,16,0
1708252238636,HUM 2,D12,423179,West; Geoffrey Scott,15,0,16,1
1708252238636,HUM 2,D13,423188,West; Geoffrey Scott,15,0,16,1
1708252238636,HUM 2,D14,423204,West; Geoffrey Scott,16,0,16,0
1708252239179,HUM 5,A01,423221,Lyon; Antony J.,26,0,30,4
1708252239179,HUM 5,A02,423232,Lyon; Antony J.,24,0,30,6
1708252239179,HUM 5,A03,423237,Lyon; Antony J.,18,0,30,12
1708252239179,HUM 5,A04,423240,Lyon; Antony J.,25,0,30,5
1708252239179,HUM 5,A05,423242,Lyon; Antony J.,28,0,30,2
1708252239179,HUM 5,A06,423244,Lyon; Antony J.,23,0,30,7
1708252239179,HUM 5,A07,423247,Lyon; Antony J.,27,0,30,3
1708252239179,HUM 5,A08,423254,Lyon; Antony J.,27,0,30,3
1708252239179,HUM 5,B01,423286,Patterson; Patrick H.,28,0,30,2
1708252239179,HUM 5,B02,423291,Patterson; Patrick H.,29,0,30,1
1708252239179,HUM 5,B03,423294,Patterson; Patrick H.,28,0,30,2
1708252239179,HUM 5,B04,423297,Patterson; Patrick H.,29,0,30,1
1708252239179,HUM 5,B05,423313,Patterson; Patrick H.,30,0,30,0
1708252239179,HUM 5,B06,423318,Patterson; Patrick H.,30,0,30,0
1708252239179,HUM 5,B07,423362,Patterson; Patrick H.,29,0,30,1
1708252239179,HUM 5,B08,423363,Patterson; Patrick H.,29,0,30,1
1708252239179,HUM 5,C01,423365,Caldwell; Michael Alan,23,0,30,7
1708252239179,HUM 5,C02,423474,Caldwell; Michael Alan,24,0,30,6
1708252239179,HUM 5,C03,423528,Caldwell; Michael Alan,30,0,30,0
1708252239179,HUM 5,C04,423529,Caldwell; Michael Alan,27,0,30,3
1708252239179,HUM 5,C05,423545,Caldwell; Michael Alan,30,0,30,0
1708252239179,HUM 5,C06,423546,Caldwell; Michael Alan,30,0,30,0
1708252239179,HUM 5,C07,423547,Caldwell; Michael Alan,29,0,30,1
1708252239179,HUM 5,C08,423548,Caldwell; Michael Alan,28,0,30,2
1708252239710,INTL 101,A01,404350,Day; Joel Keith,23,0,25,2
1708252239710,INTL 101,A02,404356,Day; Joel Keith,25,0,25,0
1708252239710,INTL 101,A03,404357,Day; Joel Keith,24,0,25,1
1708252239710,INTL 101,A04,404360,Day; Joel Keith,25,0,25,0
1708252240237,INTL 102,A01,404375,Fisk; David Lee,25,0,25,0
1708252240237,INTL 102,A02,404376,Fisk; David Lee,22,0,25,3
1708252240237,INTL 102,A03,404377,Fisk; David Lee,20,0,25,5
1708252240237,INTL 102,A04,404381,Fisk; David Lee,25,0,25,0
1708252240790,INTL 190,A00,404396,Samphantharak; Krislert,24,0,25,1
1708252240790,INTL 190,B00,404402,McIntosh; Justin Daniel,24,0,25,1
1708252240790,INTL 190,C00,404403,Vos; Stacie N.,24,0,25,1
1708252240790,INTL 190,D00,404404,Nadkarni; Vidya,24,0,25,1
1708252240790,INTL 190,E00,404407,Scott; Jeffrey F,25,0,25,0
1708252240790,INTL 190,F00,404409,Auerbach; Bradford C,25,0,25,0
1708252240790,INTL 190,G00,404442,Auerbach; Bradford C,25,0,25,0
1708252240790,INTL 190,H00,404465,Segui; Alan S,25,0,25,0
1708252240790,INTL 190,I00,404481,Segui; Alan S,25,0,25,0
1708252241431,JAPN 10C,A01,403881,Iwamoto; Naoki,15,0,15,0
1708252241431,JAPN 10C,B01,403884,McKee; Mayumi Mochizuki,15,0,15,0
1708252241431,JAPN 10C,C01,403887,Sato; Kyoko,10,0,10,0
1708252241431,JAPN 10C,C02,403888,Sato; Kyoko,10,0,10,0
1708252241431,JAPN 10C,D01,403890,Inada; Minori,8,0,10,2
1708252241431,JAPN 10C,D02,403891,Inada; Minori,10,0,10,0
1708252241431,JAPN 10C,E01,403893,Sato; Kyoko,10,0,10,0
1708252241431,JAPN 10C,E02,403894,Sato; Kyoko,10,0,10,0
1708252241431,JAPN 10C,F01,403896,McKee; Mayumi Mochizuki,10,0,10,0
1708252241431,JAPN 10C,F02,403897,McKee; Mayumi Mochizuki,10,0,10,0
1708252241431,JAPN 10C,G01,403899,Homma; Kunihiko,10,0,10,0
1708252241431,JAPN 10C,G02,403900,Homma; Kunihiko,10,0,10,0
1708252241431,JAPN 10C,H01,403902,Maruyama; Rie,10,0,10,0
1708252241431,JAPN 10C,H02,403903,Maruyama; Rie,9,0,10,1
1708252241431,JAPN 10C,I01,403905,Inada; Minori,10,0,10,0
1708252241431,JAPN 10C,I02,403906,Inada; Minori,9,0,10,1
1708252241431,JAPN 10C,J01,403915,Iwamoto; Naoki,10,0,10,0
1708252241431,JAPN 10C,J02,403916,Iwamoto; Naoki,9,0,10,1
1708252241431,JAPN 10C,K01,403918,Ross; Kayoko F,10,0,10,0
1708252241431,JAPN 10C,K02,403928,Ross; Kayoko F,10,0,10,0
1708252241431,JAPN 10C,L01,403935,Homma; Kunihiko,9,0,10,1
1708252241431,JAPN 10C,L02,403936,Homma; Kunihiko,10,0,10,0
1708252241431,JAPN 10C,M02,403939,Kamioka; Sachiko,13,0,15,2
1708252241431,JAPN 10C,N01,479041,Iwamoto; Naoki,15,0,15,0
1708252241957,JAPN 10CR,A01,403982,Inada; Minori,12,0,12,0
1708252241957,JAPN 10CR,A02,403983,Inada; Minori,12,0,12,0
1708252242492,JAPN 20C,A01,403988,Homma; Kunihiko,10,0,12,2
1708252242492,JAPN 20C,B02,404029,Kamioka; Sachiko,10,0,12,2
1708252242492,JAPN 20C,C01,404033,Takeda; Izumi,8,0,12,4
1708252242492,JAPN 20C,D02,404114,Kamioka; Sachiko,11,0,12,1
1708252242492,JAPN 20C,E01,404135,Simpson; Junko Tokuda,12,0,12,0
1708252243020,JAPN 130C,A01,404144,Maruyama; Rie,9,0,9,0
1708252243020,JAPN 130C,A02,404145,Maruyama; Rie,9,0,9,0
1708252243020,JAPN 130C,B01,404147,Simpson; Junko Tokuda,8,0,9,1
1708252243020,JAPN 130C,B02,404148,Simpson; Junko Tokuda,9,0,9,0
1708252243549,JAPN 135C,A00,404176,Ross; Kayoko F,16,0,16,0
1708252243549,JAPN 135C,B00,404253,Takeda; Izumi,14,0,16,2
1708252244075,JAPN 140C,A00,404255,Sato; Kyoko,18,0,20,2
1708252244600,JAPN 150C,A00,404258,McKee; Mayumi Mochizuki,14,0,14,0
1708252245130,JAPN 190,A00,404260,Miyao; Daisuke,17,0,20,3
1708252245659,JAPN 196B,001,487237,Turner; Christena L.,9999,0,9999,0
1708252246189,JWSP 3,A01,404485,Shuster; Alana,20,0,20,0
1708252246719,LATI 10,A01,405201,Kennemore; Amy Michelle,27,0,30,3
1708252246719,LATI 10,A02,405202,Kennemore; Amy Michelle,27,0,30,3
1708252246719,LATI 10,A03,405208,Kennemore; Amy Michelle,28,0,30,2
1708252247245,LATI 50,A01,405214,Kokinis; Troy Andreas,34,0,35,1
1708252247245,LATI 50,A02,405215,Kokinis; Troy Andreas,34,0,35,1
1708252247777,LATI 130,A01,482880,Alvarez; Camila Huerta,29,0,30,1
1708252248305,LATI 160,A01,477482,Kokinis; Troy Andreas,30,0,30,0
1708252248832,LATI 180,A00,405221,Kennemore; Amy Michelle,28,0,30,2
1708252248832,LATI 180,B00,405222,Mostajo; Lorena,30,0,30,0
1708252249363,LIAB 1C,A00,405278,Saab; Dima,13,0,14,1
1708252249363,LIAB 1C,B00,405279,Saab; Dima,11,0,14,3
1708252249895,LIAB 1CX,A00,405281,Akjeje; Abdelhak,19,0,20,1
1708252249895,LIAB 1CX,B00,405291,Akjeje; Abdelhak,20,0,20,0
1708252250422,LIAB 1F,A00,482814,El Cheddadi; Youniss,14,0,14,0
1708252250950,LIDS 19,001,492979,Goodall; Grant Todd,9999,0,9999,0
1708252250950,LIDS 19,002,492980,Goodall; Grant Todd,9999,0,9999,0
1708252250950,LIDS 19,003,492981,Goodall; Grant Todd,9999,0,9999,0
1708252250950,LIDS 19,004,492982,Goodall; Grant Todd,9999,0,9999,0
1708252250950,LIDS 19,005,492983,Goodall; Grant Todd,9999,0,9999,0
1708252250950,LIDS 19,006,492984,Goodall; Grant Todd,9999,0,9999,0
1708252250950,LIDS 19,007,492985,Goodall; Grant Todd,9999,0,9999,0
1708252250950,LIDS 19,008,492986,Goodall; Grant Todd,9999,0,9999,0
1708252250950,LIDS 19,009,492987,Goodall; Grant Todd,9999,0,9999,0
1708252250950,LIDS 19,010,492988,Goodall; Grant Todd,9999,0,9999,0
1708252250950,LIDS 19,011,492989,Goodall; Grant Todd,9999,0,9999,0
1708252250950,LIDS 19,012,492990,Goodall; Grant Todd,9999,0,9999,0
1708252251477,LIFR 1A,A00,405299,Van Moer; Vinciane G,13,0,14,1
1708252251477,LIFR 1A,B00,405300,Van Moer; Vinciane G,13,0,14,1
1708252251477,LIFR 1A,C00,405301,Van Moer; Vinciane G,13,0,14,1
1708252251477,LIFR 1A,D00,405307,Van Moer; Vinciane G,14,0,14,0
1708252252005,LIFR 1AX,A00,405308,Van Moer; Vinciane G,27,0,28,1
1708252252005,LIFR 1AX,B00,405309,Van Moer; Vinciane G,27,0,28,1
1708252252537,LIFR 1C,A00,405310,Van Moer; Vinciane G,14,0,14,0
1708252252537,LIFR 1C,B00,405311,Van Moer; Vinciane G,12,0,14,2
1708252252537,LIFR 1C,C00,405325,Van Moer; Vinciane G,13,0,14,1
1708252252537,LIFR 1C,D00,405326,Van Moer; Vinciane G,11,0,14,3
1708252253066,LIFR 1CX,A00,405332,Van Moer; Vinciane G,25,0,28,3
1708252253066,LIFR 1CX,B00,405333,Van Moer; Vinciane G,27,0,28,1
1708252253591,LIFR 1D,A00,405334,Van Moer; Vinciane G,13,0,14,1
1708252253591,LIFR 1D,B00,405335,Van Moer; Vinciane G,13,0,14,1
1708252253591,LIFR 1D,C00,405336,Van Moer; Vinciane G,13,0,14,1
1708252253591,LIFR 1D,D00,405337,Van Moer; Vinciane G,13,0,14,1
1708252254117,LIFR 1DX,A00,405338,Van Moer; Vinciane G,25,0,28,3
1708252254117,LIFR 1DX,B00,405394,Van Moer; Vinciane G,27,0,28,1
1708252254644,LIFR 11,001,405395,Goodall; Grant Todd,999,0,999,0
1708252255174,LIGM 1C,A00,405398,Fischer-Grunski; Eva K,12,0,14,2
1708252255174,LIGM 1C,B00,405400,Fischer-Grunski; Eva K,13,0,14,1
1708252255174,LIGM 1C,C00,405403,Fischer-Grunski; Eva K,13,0,14,1
1708252255174,LIGM 1C,D00,405404,Fischer-Grunski; Eva K,13,0,14,1
1708252255699,LIGM 1CX,A00,405407,Fischer-Grunski; Eva K,27,0,28,1
1708252255699,LIGM 1CX,B00,405408,Fischer-Grunski; Eva K,26,0,28,2
1708252256230,LIGM 11,001,405464,Goodall; Grant Todd,999,0,999,0
1708252256759,LIGN 8,A00,411133,McIntosh; Justin Daniel,232,0,240,8
1708252257287,LIGN 17,A00,411141,Kehler; Andrew Scott,287,0,300,13
1708252257813,LIGN 101,A01,411144,Staff,28,0,30,2
1708252257813,LIGN 101,A02,411147,Staff,29,0,30,1
1708252257813,LIGN 101,A03,411154,Staff,27,0,30,3
1708252257813,LIGN 101,A04,411163,Staff,29,0,30,1
1708252258353,LIGN 120,A01,411165,Ackerman; Farrell,28,0,30,2
1708252258353,LIGN 120,A02,411177,Ackerman; Farrell,23,0,27,4
1708252258879,LIGN 130,A01,411223,Staff,29,0,30,1
1708252258879,LIGN 130,A02,411231,Staff,30,0,30,0
1708252258879,LIGN 130,A03,411232,Staff,29,0,30,1
1708252259406,LIGN 141,A00,411276,Rose; Sharon,37,0,40,3
1708252259935,LIGN 144,A00,411277,Lott; Margaret S.,22,0,24,2
1708252260478,LIGN 148,A00,411278,Mayberry; Rachel,71,0,75,4
1708252261006,LIGN 165,A00,411279,Bergen; Leon,41,0,70,29
1708252261537,LIGN 168,A01,411281,Styler; William Francis,65,0,70,5
1708252262065,LIGN 175,A00,482816,Rodriguez Aispuro; Alejandro,35,0,40,5
1708252262596,LIGN 230,A00,411293,Caponigro; Ivano,19,0,20,1
1708252263121,LIGN 238,A00,411308,Bergen; Benjamin,20,0,20,0
1708252263647,LIGN 252,A00,411309,Bergen; Leon,28,0,30,2
1708252264178,LIGN 256,A00,411310,Nakashole; Ndapandula,0,0,5,5
1708252264704,LIGN 272,A00,482887,Kluender; Robert,10,0,10,0
1708252265229,LIHL 112P,A00,405228,Pagkalinawan; Leticia Cant,27,0,28,1
1708252265755,LIHL 114P,A00,405229,Nguyen; Hoan Thi,26,0,28,2
1708252266283,LIHL 117P,A00,405256,Sadegholvad; Elham,27,0,28,1
1708252266812,LIHL 118,A00,405257,Chen; Areana Yen,28,0,28,0
1708252267338,LIHL 124P,A00,405262,Nguyen; Hoan Thi,28,0,28,0
1708252267867,LIHL 132P,A00,405263,Pagkalinawan; Leticia Cant,28,0,28,0
1708252268395,LIHL 134P,A00,405269,Nguyen; Hoan Thi,28,0,28,0
1708252268924,LIHL 138,A00,405270,Chen; Areana Yen,27,0,28,1
1708252269455,LIIT 1C,A00,405465,Carnelos; Chiara,12,0,14,2
1708252269455,LIIT 1C,B00,405466,Carnelos; Chiara,14,0,14,0
1708252269981,LIIT 1CX,A00,405594,Carnelos; Chiara,28,0,28,0
1708252270507,LIPO 1C,A00,405595,Paladini; Denise,13,0,14,1
1708252270507,LIPO 1C,B00,405596,Paladini; Denise,14,0,14,0
1708252271035,LIPO 1CX,A00,405597,De Abreu; Cassia,28,0,28,0
1708252271566,LISL 1A,C00,405600,Lott; Margaret S.,13,0,14,1
1708252271566,LISL 1A,D00,405601,Lott; Margaret S.,10,0,14,4
1708252271566,LISL 1A,E00,405602,Lott; Margaret S.,13,0,14,1
1708252271566,LISL 1A,F00,405603,Lott; Margaret S.,13,0,14,1
1708252272090,LISL 1AR,A00,480605,Lott; Margaret S.,13,0,15,2
1708252272090,LISL 1AR,B00,480606,Lott; Margaret S.,14,0,15,1
1708252272621,LISL 1AX,A00,405754,Lott; Margaret S.,26,0,28,2
1708252272621,LISL 1AX,B00,405755,Lott; Margaret S.,23,0,28,5
1708252273148,LISL 1C,A00,405776,Lott; Margaret S.,13,0,14,1
1708252273148,LISL 1C,B00,405779,Lott; Margaret S.,14,0,14,0
1708252273148,LISL 1C,C00,405785,Lott; Margaret S.,14,0,14,0
1708252273148,LISL 1C,D00,405787,Lott; Margaret S.,9,0,14,5
1708252273148,LISL 1C,E00,405827,Lott; Margaret S.,12,0,14,2
1708252273148,LISL 1C,F00,405830,Lott; Margaret S.,13,0,14,1
1708252273689,LISL 1CX,A00,405844,Lott; Margaret S.,25,0,28,3
1708252273689,LISL 1CX,B00,405848,Lott; Margaret S.,25,0,28,3
1708252273689,LISL 1CX,C00,405849,Lott; Margaret S.,28,0,28,0
1708252274215,LISL 1D,A00,405850,Lott; Margaret S.,8,0,14,6
1708252274215,LISL 1D,B00,405851,Lott; Margaret S.,13,0,14,1
1708252274215,LISL 1D,C00,405852,Lott; Margaret S.,10,0,14,4
1708252274739,LISL 1DX,A00,405854,Lott; Margaret S.,17,0,22,5
1708252274739,LISL 1DX,B00,405855,Lott; Margaret S.,18,0,22,4
1708252275271,LISP 1A,001,405856,Munoz Sanchez; Alicia,11,0,14,3
1708252275271,LISP 1A,002,405857,Munoz Sanchez; Alicia,13,0,14,1
1708252275271,LISP 1A,003,405858,Munoz Sanchez; Alicia,14,0,14,0
1708252275271,LISP 1A,004,405861,Munoz Sanchez; Alicia,14,0,14,0
1708252275796,LISP 1AX,001,405862,Munoz Sanchez; Alicia,28,0,28,0
1708252275796,LISP 1AX,002,405863,Munoz Sanchez; Alicia,25,0,28,3
1708252276323,LISP 1C,001,405864,Munoz Sanchez; Alicia,13,0,14,1
1708252276323,LISP 1C,002,405865,Munoz Sanchez; Alicia,12,0,14,2
1708252276323,LISP 1C,003,405879,Munoz Sanchez; Alicia,12,0,14,2
1708252276323,LISP 1C,004,405880,Munoz Sanchez; Alicia,13,0,14,1
1708252276323,LISP 1C,005,405881,Munoz Sanchez; Alicia,12,0,14,2
1708252276323,LISP 1C,006,405882,Munoz Sanchez; Alicia,12,0,14,2
1708252276323,LISP 1C,007,405904,Munoz Sanchez; Alicia,14,0,14,0
1708252276323,LISP 1C,008,405905,Munoz Sanchez; Alicia,14,0,14,0
1708252276323,LISP 1C,009,405908,Munoz Sanchez; Alicia,14,0,14,0
1708252276323,LISP 1C,010,405917,Munoz Sanchez; Alicia,13,0,14,1
1708252276855,LISP 1CX,001,405922,Munoz Sanchez; Alicia,24,0,28,4
1708252276855,LISP 1CX,002,405990,Munoz Sanchez; Alicia,26,0,28,2
1708252276855,LISP 1CX,003,406007,Munoz Sanchez; Alicia,27,0,28,1
1708252276855,LISP 1CX,004,406008,Munoz Sanchez; Alicia,25,0,28,3
1708252276855,LISP 1CX,005,406015,Munoz Sanchez; Alicia,26,0,28,2
1708252277400,LISP 1D,001,406016,Munoz Sanchez; Alicia,12,0,14,2
1708252277400,LISP 1D,002,406017,Munoz Sanchez; Alicia,13,0,14,1
1708252277400,LISP 1D,003,406018,Munoz Sanchez; Alicia,14,0,14,0
1708252277400,LISP 1D,004,406019,Munoz Sanchez; Alicia,11,0,14,3
1708252277400,LISP 1D,005,406020,Munoz Sanchez; Alicia,13,0,14,1
1708252277400,LISP 1D,006,406021,Munoz Sanchez; Alicia,10,0,14,4
1708252277400,LISP 1D,007,406022,Munoz Sanchez; Alicia,12,0,14,2
1708252277400,LISP 1D,008,406023,Munoz Sanchez; Alicia,13,0,14,1
1708252277400,LISP 1D,009,406024,Munoz Sanchez; Alicia,11,0,14,3
1708252277400,LISP 1D,010,406025,Munoz Sanchez; Alicia,12,0,14,2
1708252277400,LISP 1D,011,406026,Munoz Sanchez; Alicia,13,0,14,1
1708252277400,LISP 1D,012,406027,Munoz Sanchez; Alicia,13,0,14,1
1708252277400,LISP 1D,013,406028,Munoz Sanchez; Alicia,12,0,14,2
1708252277400,LISP 1D,014,406029,Munoz Sanchez; Alicia,12,0,14,2
1708252277400,LISP 1D,015,406030,Munoz Sanchez; Alicia,10,0,14,4
1708252277400,LISP 1D,016,406031,Munoz Sanchez; Alicia,14,0,14,0
1708252277400,LISP 1D,017,406032,Munoz Sanchez; Alicia,14,0,14,0
1708252277400,LISP 1D,018,406033,Munoz Sanchez; Alicia,12,0,14,2
1708252277400,LISP 1D,019,406034,Munoz Sanchez; Alicia,13,0,14,1
1708252277400,LISP 1D,020,406035,Munoz Sanchez; Alicia,14,0,14,0
1708252277400,LISP 1D,021,406036,Munoz Sanchez; Alicia,13,0,14,1
1708252277400,LISP 1D,022,406037,Munoz Sanchez; Alicia,14,0,14,0
1708252277400,LISP 1D,023,406038,Munoz Sanchez; Alicia,14,0,14,0
1708252277400,LISP 1D,024,406039,Munoz Sanchez; Alicia,13,0,14,1
1708252277949,LISP 1DX,001,406040,Munoz Sanchez; Alicia,28,0,28,0
1708252277949,LISP 1DX,002,406041,Munoz Sanchez; Alicia,27,0,28,1
1708252277949,LISP 1DX,003,406127,Munoz Sanchez; Alicia,24,0,28,4
1708252277949,LISP 1DX,004,406128,Munoz Sanchez; Alicia,17,0,28,11
1708252277949,LISP 1DX,005,406418,Munoz Sanchez; Alicia,24,0,28,4
1708252277949,LISP 1DX,006,406536,Munoz Sanchez; Alicia,27,0,28,1
1708252277949,LISP 1DX,007,406561,Munoz Sanchez; Alicia,23,0,28,5
1708252277949,LISP 1DX,008,406576,Munoz Sanchez; Alicia,25,0,28,3
1708252277949,LISP 1DX,009,406679,Munoz Sanchez; Alicia,28,0,28,0
1708252277949,LISP 1DX,010,406691,Munoz Sanchez; Alicia,26,0,28,2
1708252277949,LISP 1DX,011,406692,Munoz Sanchez; Alicia,28,0,28,0
1708252277949,LISP 1DX,012,406693,Munoz Sanchez; Alicia,28,0,28,0
1708252278482,LISP 17,001,406694,Munoz Sanchez; Alicia,18,0,20,2
1708252279008,LISP 18,001,406695,Munoz Sanchez; Alicia,20,0,20,0
1708252279536,LTAM 105,A00,412520,Ruiz; Ariana,28,0,40,12
1708252280082,LTCH 101,A00,479214,Zhu; Ping,39,0,40,1
1708252280610,LTCS 87,A00,492906,Nguyen; Hoang Tan,20,0,20,0
1708252280610,LTCS 87,B00,492907,Nguyen; Hoang Tan,20,0,20,0
1708252281138,LTCS 150,A00,412543,Liao; Ping H,39,0,40,1
1708252281665,LTCS 225,A00,412819,Mendoza; Andrea,14,0,15,1
1708252282190,LTCS 250,A00,412821,Lee; Jin-Kyung,15,0,15,0
1708252282719,LTEA 110B,A00,412548,Liao; Ping H,60,0,60,0
1708252283245,LTEA 120A,A00,479216,Zhu; Ping,36,0,40,4
1708252283773,LTEA 120C,A00,412552,Fiss; Geraldine Anna,295,0,300,5
1708252284298,LTEA 132,A00,412561,Mendoza; Andrea,51,0,60,9
1708252284825,LTEA 141,A00,412565,Lee; Jin-Kyung,37,0,40,3
1708252285353,LTEN 23,A01,411317,Vijay; Ameeth Varma,24,0,25,1
1708252285353,LTEN 23,A02,411318,Vijay; Ameeth Varma,24,0,25,1
1708252285353,LTEN 23,A03,411371,Vijay; Ameeth Varma,25,0,25,0
1708252285353,LTEN 23,A04,411375,Vijay; Ameeth Varma,24,0,25,1
1708252285879,LTEN 28,A01,411632,Blanco; John D,25,0,25,0
1708252285879,LTEN 28,A02,411697,Blanco; John D,25,0,25,0
1708252285879,LTEN 28,A03,411698,Blanco; John D,25,0,25,0
1708252285879,LTEN 28,A04,411709,Blanco; John D,25,0,25,0
1708252285879,LTEN 28,A05,411719,Blanco; John D,25,0,25,0
1708252285879,LTEN 28,A06,411744,Blanco; John D,25,0,25,0
1708252285879,LTEN 28,A07,411780,Blanco; John D,25,0,25,0
1708252285879,LTEN 28,A08,411820,Blanco; John D,25,0,25,0
1708252286405,LTEN 110,A00,486891,Vitkus; Daniel J.,38,0,40,2
1708252286933,LTEN 144,A00,412570,Vijay; Ameeth Varma,39,0,40,1
1708252287463,LTEN 180,A00,412581,Perreira; Christopher Michael,18,0,25,7
1708252287990,LTEN 181,A00,412582,Mukherjee; Silpa,55,0,60,5
1708252288517,LTEN 245,A00,412824,Johnson; Sara E.,13,0,15,2
1708252289284,LTEN 259,A00,412825,Streeby; Shelley,13,0,15,2
1708252289810,LTEU 111,A00,412588,Kontje; Todd Curtis,38,0,40,2
1708252290344,LTEU 140,A00,480172,De Marchi Gherini; Adriana,36,0,37,1
1708252290873,LTEU 141,A00,412592,Cohen; Alain J. J.,40,0,40,0
1708252291400,LTFR 2A,A01,411996,Ploye; Catherine,25,0,25,0
1708252291942,LTFR 2C,A00,411997,Ploye; Catherine,24,0,25,1
1708252292468,LTFR 142,A00,412597,Zhiri; Oumelbanine,20,0,20,0
1708252292998,LTGK 3,A00,412001,Murray; Kourtney Kristine,30,0,30,0
1708252293528,LTGM 2C,A00,412002,Fischer-Grunski; Eva K,25,0,25,0
1708252294070,LTKO 1C,A01,412029,Cho; Hye Jin,24,0,25,1
1708252294070,LTKO 1C,B01,412164,Cho; Hye Jin,23,0,25,2
1708252294070,LTKO 1C,C01,412168,Cho; Hye Jin,25,0,25,0
1708252294070,LTKO 1C,D01,412353,Yim; Nancy,24,0,25,1
1708252294070,LTKO 1C,E01,412372,Yim; Nancy,25,0,25,0
1708252294599,LTKO 2C,A01,412374,Yim; Nancy,21,0,25,4
1708252295182,LTKO 130P,A00,412601,Lee; Jeyseon,25,0,25,0
1708252295708,LTKO 135,A00,412606,Lee; Jeyseon,25,0,25,0
1708252296236,LTLA 3,A00,412375,Murray; Kourtney Kristine,36,0,40,4
1708252296763,LTRU 1C,A01,412491,Wells; Patricia Rebecca,24,0,25,1
1708252297289,LTRU 104A,A01,412614,Wells; Patricia Rebecca,20,0,20,0
1708252297821,LTSP 2A,A01,412493,Lampell; Toni,24,0,25,1
1708252298349,LTSP 2B,A01,412497,Lampell; Toni,22,0,25,3
1708252298349,LTSP 2B,B01,479218,Lampell; Toni,24,0,25,1
1708252298875,LTSP 2C,A01,412499,Mastromartino; Alexandra L,23,0,25,2
1708252299401,LTSP 2D,A00,412500,Dominguez; Noelia,24,0,25,1
1708252299927,LTSP 2E,A00,412501,Mastromartino; Alexandra L,24,0,25,1
1708252299927,LTSP 2E,B00,412502,Mastromartino; Alexandra L,25,0,25,0
1708252300453,LTSP 87,A00,479212,Bessett; Ryan Matthew,20,0,20,0
1708252300981,LTSP 100B,A00,412619,Dominguez; Noelia,25,0,25,0
1708252300981,LTSP 100B,B00,412623,Dominguez; Noelia,24,0,25,1
1708252301505,LTSP 116,A00,412628,Blanco; John D,28,0,30,2
1708252302034,LTSP 135A,A00,412631,Parra; Max,27,0,30,3
1708252302559,LTSP 174,A00,479213,Staff,28,0,30,2
1708252303087,LTTH 115,A00,412632,Kontje; Todd Curtis,35,0,40,5
1708252303617,LTTH 210C,A00,412826,Batarseh; Amanda Alicia,14,0,15,1
1708252304143,LTTH 255,A00,412827,Ali; Mohammad Kazim,13,0,15,2
1708252304674,LTTH 260,A00,412828,Kim; Joo Ok,30,0,30,0
1708252305199,LTWL 19C,A00,412503,Kelting; Edward William,40,0,40,0
1708252305725,LTWL 101,A00,412633,Kelting; Edward William,39,0,40,1
1708252306250,LTWL 114,A00,412656,Fiss; Geraldine Anna,60,0,60,0
1708252306775,LTWL 123,A00,412674,Lampert-Weissig; Lisa,31,0,40,9
1708252307300,LTWL 172,A00,412729,De Marchi Gherini; Adriana,37,0,40,3
1708252307825,LTWL 183,A00,412731,Cohen; Alain J. J.,38,0,40,2
1708252308353,LTWL 184,A00,479219,Mukherjee; Silpa,38,0,40,2
1708252308881,LTWL 194A,A00,489635,Vijay; Ameeth Varma,27,0,31,4
1708252309408,LTWR 8A,A01,412505,Springer; Anna Joy,24,0,25,1
1708252309408,LTWR 8A,A02,412506,Springer; Anna Joy,24,0,25,1
1708252309408,LTWR 8A,A03,412507,Springer; Anna Joy,25,0,25,0
1708252309408,LTWR 8A,A04,412508,Springer; Anna Joy,23,0,25,2
1708252309940,LTWR 8C,A01,412511,Forbes; Camille,23,0,25,2
1708252309940,LTWR 8C,A02,412512,Forbes; Camille,25,0,25,0
1708252309940,LTWR 8C,A03,412514,Forbes; Camille,25,0,25,0
1708252309940,LTWR 8C,A04,412519,Forbes; Camille,24,0,25,1
1708252310466,LTWR 100,A00,412734,Forbes; Camille,7,0,15,8
1708252310994,LTWR 113,A00,412816,Carroll; Amy Sara,28,0,30,2
1708252311522,LTWR 114,A00,412817,Springer; Anna Joy,23,0,30,7
1708252312048,LTWR 126,A00,412818,Hoang; Lily Kim,25,0,30,5
1708252312576,LTWR 215,A00,412880,Carroll; Amy Sara,19,0,20,1
1708252313104,MAE 3,A01,435606,Qi; Huihui,16,0,20,4
1708252313104,MAE 3,A02,435607,Qi; Huihui,15,0,20,5
1708252313104,MAE 3,A03,435608,Qi; Huihui,19,0,20,1
1708252313104,MAE 3,B01,435618,Delson; Nathan Joseph & Mullin; Jennifer S,20,0,20,0
1708252313104,MAE 3,B02,435626,Delson; Nathan Joseph & Mullin; Jennifer S,20,0,20,0
1708252313104,MAE 3,B03,435666,Delson; Nathan Joseph & Mullin; Jennifer S,20,0,20,0
1708252313104,MAE 3,B04,435679,Delson; Nathan Joseph & Mullin; Jennifer S,20,0,20,0
1708252313104,MAE 3,B05,494545,Delson; Nathan Joseph & Mullin; Jennifer S,20,0,20,0
1708252313633,MAE 8,A01,435688,Pham; Hieu Tan,197,0,200,3
1708252314163,MAE 30B,A00,435689,Lubarda; Marko,128,0,130,2
1708252314163,MAE 30B,B00,435701,Ghazinejad; Maziar,117,0,130,13
1708252314698,MAE 101B,A00,435702,Saintillan; David,146,0,150,4
1708252314698,MAE 101B,B00,435703,Nomura; Keiko K.,138,0,146,8
1708252315222,MAE 101C,A00,435704,Sadeghizadeh; Zahra,53,0,65,12
1708252315750,MAE 101D,A00,435705,Chen; Renkun,14,0,20,6
1708252316276,MAE 105,A00,435706,Becker; Janet Maria,115,0,120,5
1708252316802,MAE 107,A00,435707,Lindsey; Stephanie,48,0,50,2
1708252316802,MAE 107,B00,435708,Davidson; Michael R,55,0,60,5
1708252317328,MAE 119,A00,435710,Hidalgo-Gonzalez; Patricia,100,0,120,20
1708252317859,MAE 120,A00,435722,Arefiev; Alexey,49,0,65,16
1708252318385,MAE 125,A00,435723,Kleissl; Jan,60,0,65,5
1708252318913,MAE 131A,A00,435724,Qi; Huihui,119,0,125,6
1708252318913,MAE 131A,B00,435725,Meyers; Marc,123,0,125,2
1708252319439,MAE 143B,A00,435726,Morimoto; Tania,114,0,120,6
1708252319439,MAE 143B,B00,435727,Herbert; Sylvia Lee,117,0,120,3
1708252319439,MAE 143B,C00,435728,Diagne; Mamadou Lamine,108,0,120,12
1708252319965,MAE 145,A00,435729,Martinez; Sonia,41,0,60,19
1708252320495,MAE 148,A01,492802,Silberman; Jack,14,0,24,10
1708252321022,MAE 150,A00,435730,Pham; Hieu Tan,52,0,60,8
1708252321551,MAE 152,A00,435731,Llewellyn Smith; Stefan G.,14,0,14,0
1708252321551,MAE 152,B00,435747,Llewellyn Smith; Stefan G.,12,0,14,2
1708252321551,MAE 152,C00,435748,Llewellyn Smith; Stefan G.,12,0,14,2
1708252321551,MAE 152,D00,435749,Llewellyn Smith; Stefan G.,8,0,14,6
1708252321551,MAE 152,E00,435750,Llewellyn Smith; Stefan G.,13,0,14,1
1708252322076,MAE 155B,A01,435752,Hwang; John T,36,0,50,14
1708252322076,MAE 155B,B01,435768,Anderson; Mark Ronald,27,0,50,23
1708252322076,MAE 155B,C01,494006,Saha; Abhishek,0,0,0,0
1708252322603,MAE 156B,A01,435770,Tustaniwskyj; Jerry I,33,0,40,7
1708252322603,MAE 156B,B01,435772,Ghazinejad; Maziar,35,0,40,5
1708252322603,MAE 156B,C01,435774,Delson; Nathan Joseph,38,0,40,2
1708252322603,MAE 156B,D01,435776,Saha; Abhishek,31,0,40,9
1708252323132,MAE 166,A00,435777,Fullerton; Eric E,44,0,50,6
1708252323658,MAE 170,A01,435779,Lubarda; Marko,30,0,32,2
1708252323658,MAE 170,A02,435780,Lubarda; Marko,27,0,32,5
1708252323658,MAE 170,A03,435781,Lubarda; Marko,32,0,32,0
1708252323658,MAE 170,A04,435782,Lubarda; Marko,31,0,32,1
1708252323658,MAE 170,A05,435783,Lubarda; Marko,29,0,32,3
1708252323658,MAE 170,A06,435784,Lubarda; Marko,30,0,32,2
1708252323658,MAE 170,B01,435786,Evdokimenko; Ekaterina,23,0,24,1
1708252323658,MAE 170,B02,435787,Evdokimenko; Ekaterina,20,0,24,4
1708252323658,MAE 170,B03,435788,Evdokimenko; Ekaterina,23,0,24,1
1708252323658,MAE 170,B04,435789,Evdokimenko; Ekaterina,23,0,24,1
1708252323658,MAE 170,B05,435790,Evdokimenko; Ekaterina,19,0,24,5
1708252323658,MAE 170,B06,435791,Evdokimenko; Ekaterina,23,0,24,1
1708252324185,MAE 180,A00,479477,Sadeghizadeh; Zahra,55,0,60,5
1708252324715,MAE 184,A00,435792,Anderson; Mark Ronald,7,0,50,43
1708252325242,MAE 190,A00,435793,Beg; Farhat N.,17,0,20,3
1708252325242,MAE 190,B00,479209,Gerardo; Hortense Flotilde,12,0,15,3
1708252325771,MAE 202,A00,435794,Bandaru; Prabhakar,32,0,70,38
1708252326300,MAE 205,A00,435804,Hwang; John T & Tynan; George Robert & Seshadri; Kalyanasundaram & Rangamani; Padmini & Bandaru; Prabhakar,9990,0,9999,9
1708252326829,MAE 207,A00,435805,Beg; Farhat N.,9,0,10,1
1708252326829,MAE 207,B00,435815,Campbell; Edward Michael,6,0,10,4
1708252326829,MAE 207,C00,477499,Gerardo; Hortense Flotilde,6,0,30,24
1708252327355,MAE 209,A00,435816,Scholtes Acevedo; Claire,25,0,30,5
1708252327880,MAE 210C,A00,435817,Becker; Janet Maria,22,0,30,8
1708252328406,MAE 211,A00,435818,Seshadri; Kalyanasundaram,20,0,30,10
1708252328931,MAE 214A,A00,435819,Sarkar; Sutanu,27,0,35,8
1708252329457,MAE 217C,A00,435820,Marinoni; Alessandro,10,0,10,0
1708252329983,MAE 221C,A00,435821,Seshadri; Kalyanasundaram,9,0,15,6
1708252330513,MAE 221D,A00,435822,Poulikakos; Lisa Voula,23,0,30,7
1708252331038,MAE 224A,A00,435823,Pawlak; Geno Ronald,5,0,10,5
1708252331564,MAE 227,A00,435824,Hidalgo-Gonzalez; Patricia,21,0,35,14
1708252332091,MAE 231A,A00,435825,Boechler; Nicholas Sebastia,14,0,30,16
1708252332620,MAE 240,A00,435826,Rosengren; Aaron,19,0,30,11
1708252333146,MAE 242,A00,435827,Martinez; Sonia,0,0,45,45
1708252333674,MAE 249,A00,435842,Tolley; Michael Thomas,0,0,35,35
1708252334199,MAE 253,A00,435891,Staff,24,0,25,1
1708252334725,MAE 256,A00,435949,Coimbra; Carlos F.,6,0,10,4
1708252335253,MAE 263,A00,435987,Rangamani; Padmini,10,0,10,0
1708252335779,MAE 266,A00,435988,Evdokimenko; Ekaterina,7,0,30,23
1708252336304,MAE 271C,A00,435990,Arzt; Eduard,10,0,10,0
1708252336835,MAE 281B,A00,435991,Cortes; Jorge,9,0,25,16
1708252337360,MAE 288A,A00,435998,McEneaney; William Michael,6,0,40,34
1708252337889,MAE 288B,A00,435999,Bitmead; Robert R.,41,0,45,4
1708252338415,MAE 290C,A00,436008,Schmidt; Oliver,26,0,30,4
1708252338940,MAE 294C,A01,436010,Young; William Roy,19,0,20,1
1708252339470,MATH 2,A01,431271,Staff,31,0,35,4
1708252339470,MATH 2,B01,431273,Staff,29,0,35,6
1708252339470,MATH 2,C01,431275,Staff,31,0,35,4
1708252339997,MATH 3C,A01,431277,Safii; Soheil,12,0,15,3
1708252339997,MATH 3C,A02,431278,Safii; Soheil,12,0,15,3
1708252339997,MATH 3C,A03,431279,Safii; Soheil,12,0,15,3
1708252339997,MATH 3C,A04,431280,Safii; Soheil,15,0,15,0
1708252339997,MATH 3C,A05,431281,Safii; Soheil,14,0,15,1
1708252339997,MATH 3C,A06,431282,Safii; Soheil,15,0,15,0
1708252340532,MATH 10A,A01,431284,Bowers; Adam R.,20,0,30,10
1708252340532,MATH 10A,A02,431285,Bowers; Adam R.,18,0,30,12
1708252340532,MATH 10A,A03,431369,Bowers; Adam R.,28,0,30,2
1708252340532,MATH 10A,A04,431395,Bowers; Adam R.,27,0,30,3
1708252340532,MATH 10A,A05,431450,Bowers; Adam R.,28,0,30,2
1708252340532,MATH 10A,A06,431508,Bowers; Adam R.,30,0,30,0
1708252340532,MATH 10A,B01,431572,Kowalenko; Ethan J,24,0,30,6
1708252340532,MATH 10A,B02,431573,Kowalenko; Ethan J,29,0,30,1
1708252340532,MATH 10A,B03,431574,Kowalenko; Ethan J,30,0,30,0
1708252340532,MATH 10A,B04,431576,Kowalenko; Ethan J,30,0,30,0
1708252340532,MATH 10A,B05,431577,Kowalenko; Ethan J,30,0,30,0
1708252340532,MATH 10A,B06,431583,Kowalenko; Ethan J,30,0,30,0
1708252341062,MATH 10B,A01,431595,Habib; Yousaf,29,0,36,7
1708252341062,MATH 10B,A02,431597,Habib; Yousaf,35,0,36,1
1708252341062,MATH 10B,A03,431669,Habib; Yousaf,37,0,37,0
1708252341062,MATH 10B,A04,431670,Habib; Yousaf,36,0,37,1
1708252341062,MATH 10B,A05,431671,Habib; Yousaf,70,0,70,0
1708252341062,MATH 10B,B01,431673,Habib; Yousaf,25,0,33,8
1708252341062,MATH 10B,B02,431712,Habib; Yousaf,33,0,33,0
1708252341062,MATH 10B,B03,431713,Habib; Yousaf,33,0,33,0
1708252341062,MATH 10B,B04,431714,Habib; Yousaf,33,0,33,0
1708252341062,MATH 10B,B05,431715,Habib; Yousaf,60,0,60,0
1708252341062,MATH 10B,C01,431717,Bach; Quang Tran,57,0,60,3
1708252341062,MATH 10B,C02,431718,Bach; Quang Tran,18,0,34,16
1708252341062,MATH 10B,C03,431719,Bach; Quang Tran,34,0,34,0
1708252341062,MATH 10B,C04,431720,Bach; Quang Tran,33,0,34,1
1708252341062,MATH 10B,C05,431721,Bach; Quang Tran,32,0,34,2
1708252341062,MATH 10B,D01,431723,Staff,28,0,34,6
1708252341062,MATH 10B,D02,431724,Staff,34,0,34,0
1708252341062,MATH 10B,D03,431725,Staff,34,0,34,0
1708252341062,MATH 10B,D04,431726,Staff,34,0,34,0
1708252341062,MATH 10B,D05,431727,Staff,57,0,60,3
1708252341593,MATH 10C,A01,431741,Staff,94,0,96,2
1708252341593,MATH 10C,A02,431742,Staff,39,0,40,1
1708252341593,MATH 10C,B01,431744,Staff,95,0,96,1
1708252341593,MATH 10C,B02,431746,Staff,27,0,40,13
1708252341593,MATH 10C,C01,431748,Pardo Guerra; Sebastian,30,0,40,10
1708252341593,MATH 10C,C02,431885,Pardo Guerra; Sebastian,40,0,40,0
1708252341593,MATH 10C,C03,431895,Pardo Guerra; Sebastian,32,0,33,1
1708252341593,MATH 10C,C04,431896,Pardo Guerra; Sebastian,32,0,32,0
1708252342119,MATH 11,A01,431933,Rava; Denise,82,0,100,18
1708252342119,MATH 11,A02,431960,Rava; Denise,66,0,70,4
1708252342119,MATH 11,A03,431971,Rava; Denise,39,0,40,1
1708252342119,MATH 11,B01,432053,Staff,99,0,100,1
1708252342119,MATH 11,B02,432064,Staff,37,0,45,8
1708252342119,MATH 11,B03,432073,Staff,44,0,45,1
1708252342647,MATH 18,A01,432082,Mackall; Eoin Travis,65,0,70,5
1708252342647,MATH 18,A02,432086,Mackall; Eoin Travis,68,0,70,2
1708252342647,MATH 18,B01,432089,Suk; Andrew Hoon,39,0,40,1
1708252342647,MATH 18,B02,432090,Suk; Andrew Hoon,35,0,40,5
1708252342647,MATH 18,B03,432091,Suk; Andrew Hoon,33,0,40,7
1708252342647,MATH 18,B04,432092,Suk; Andrew Hoon,30,0,40,10
1708252342647,MATH 18,B05,432093,Suk; Andrew Hoon,34,0,35,1
1708252342647,MATH 18,B06,432094,Suk; Andrew Hoon,33,0,35,2
1708252342647,MATH 18,B07,432095,Suk; Andrew Hoon,98,0,100,2
1708252342647,MATH 18,B08,432096,Suk; Andrew Hoon,100,0,100,0
1708252342647,MATH 18,B09,432097,Suk; Andrew Hoon,98,0,100,2
1708252342647,MATH 18,B10,432098,Suk; Andrew Hoon,69,0,70,1
1708252343177,MATH 20A,A01,432101,Briones; Jor-el Thomas Caparas,30,0,40,10
1708252343177,MATH 20A,A02,432102,Briones; Jor-el Thomas Caparas,98,0,100,2
1708252343177,MATH 20A,B01,432104,Briones; Jor-el Thomas Caparas,99,0,100,1
1708252343177,MATH 20A,B02,432105,Briones; Jor-el Thomas Caparas,40,0,40,0
1708252343705,MATH 20B,A01,432107,Quarfoot; David James,33,0,35,2
1708252343705,MATH 20B,A02,432108,Quarfoot; David James,18,0,35,17
1708252343705,MATH 20B,A03,432109,Quarfoot; David James,32,0,35,3
1708252343705,MATH 20B,A04,432110,Quarfoot; David James,34,0,35,1
1708252343705,MATH 20B,A05,432331,Quarfoot; David James,26,0,32,6
1708252343705,MATH 20B,A06,432411,Quarfoot; David James,31,0,32,1
1708252343705,MATH 20B,B01,432413,Mackall; Eoin Travis,62,0,65,3
1708252343705,MATH 20B,B02,432443,Mackall; Eoin Travis,65,0,65,0
1708252343705,MATH 20B,B03,432444,Mackall; Eoin Travis,60,0,60,0
1708252343705,MATH 20B,B04,432471,Mackall; Eoin Travis,60,0,60,0
1708252344240,MATH 20C,A01,432473,Ohm; Ko Woon,26,0,38,12
1708252344240,MATH 20C,A02,432474,Ohm; Ko Woon,36,0,38,2
1708252344240,MATH 20C,A03,432475,Ohm; Ko Woon,34,0,37,3
1708252344240,MATH 20C,A04,432546,Ohm; Ko Woon,36,0,37,1
1708252344240,MATH 20C,A05,432550,Ohm; Ko Woon,88,0,90,2
1708252344240,MATH 20C,B01,432568,Ohm; Ko Woon,43,0,45,2
1708252344240,MATH 20C,B02,432594,Ohm; Ko Woon,40,0,45,5
1708252344240,MATH 20C,B03,432609,Ohm; Ko Woon,85,0,90,5
1708252344240,MATH 20C,C01,432613,Cheng; Hsiao-Bing,67,0,70,3
1708252344240,MATH 20C,C02,432614,Cheng; Hsiao-Bing,68,0,70,2
1708252344240,MATH 20C,C03,432615,Cheng; Hsiao-Bing,70,0,70,0
1708252344240,MATH 20C,D01,432617,Cheng; Hsiao-Bing,69,0,70,1
1708252344240,MATH 20C,D02,432618,Cheng; Hsiao-Bing,68,0,70,2
1708252344240,MATH 20C,D03,432619,Cheng; Hsiao-Bing,70,0,70,0
1708252344771,MATH 20D,A01,432622,Hammock; Frances H,58,0,60,2
1708252344771,MATH 20D,A02,432623,Hammock; Frances H,58,0,60,2
1708252344771,MATH 20D,A03,432658,Hammock; Frances H,35,0,35,0
1708252344771,MATH 20D,A04,432660,Hammock; Frances H,35,0,35,0
1708252344771,MATH 20D,B01,432702,Hammock; Frances H,66,0,70,4
1708252344771,MATH 20D,B02,432703,Hammock; Frances H,70,0,70,0
1708252344771,MATH 20D,B03,432766,Hammock; Frances H,30,0,30,0
1708252344771,MATH 20D,B04,432782,Hammock; Frances H,20,0,30,10
1708252344771,MATH 20D,C01,432811,Sheng; Hongyi,60,0,60,0
1708252344771,MATH 20D,C02,432931,Sheng; Hongyi,60,0,60,0
1708252344771,MATH 20D,C03,432945,Sheng; Hongyi,28,0,30,2
1708252344771,MATH 20D,C04,432949,Sheng; Hongyi,30,0,30,0
1708252345299,MATH 20E,A01,433007,Eggers; John Dietrich,70,0,80,10
1708252345299,MATH 20E,A02,433070,Eggers; John Dietrich,77,0,80,3
1708252345299,MATH 20E,A03,433079,Eggers; John Dietrich,32,0,35,3
1708252345299,MATH 20E,B01,433092,Staff,86,0,90,4
1708252345299,MATH 20E,B02,433093,Staff,90,0,90,0
1708252345299,MATH 20E,C01,433237,Bach; Quang Tran,52,0,60,8
1708252345299,MATH 20E,C02,433238,Bach; Quang Tran,69,0,70,1
1708252345299,MATH 20E,C03,433239,Bach; Quang Tran,70,0,70,0
1708252345825,MATH 31CH,A01,433241,Rabin; Jeffrey Mark,35,0,35,0
1708252346352,MATH 95,A00,433242,Stevens; Laura Jeanne,30,0,30,0
1708252346884,MATH 100C,A01,433244,Pollack; Aaron,31,0,35,4
1708252346884,MATH 100C,A02,433245,Pollack; Aaron,35,0,35,0
1708252347409,MATH 102,A01,433298,Ophir; Amit,29,0,30,1
1708252347409,MATH 102,A02,433369,Ophir; Amit,30,0,30,0
1708252347409,MATH 102,A03,433373,Ophir; Amit,30,0,30,0
1708252347409,MATH 102,A04,433374,Ophir; Amit,29,0,30,1
1708252347409,MATH 102,B01,433572,Zhang; Ming,28,0,30,2
1708252347409,MATH 102,B02,433732,Zhang; Ming,30,0,30,0
1708252347409,MATH 102,B03,433733,Zhang; Ming,30,0,30,0
1708252347409,MATH 102,B04,433734,Zhang; Ming,29,0,30,1
1708252347936,MATH 103B,A01,433793,Lu; Yunze,23,0,30,7
1708252347936,MATH 103B,A02,433795,Lu; Yunze,30,0,30,0
1708252347936,MATH 103B,A03,433830,Lu; Yunze,28,0,30,2
1708252347936,MATH 103B,B01,433845,Lahiri; Aranya,24,0,30,6
1708252347936,MATH 103B,B02,433846,Lahiri; Aranya,28,0,30,2
1708252347936,MATH 103B,B03,433847,Lahiri; Aranya,27,0,30,3
1708252348518,MATH 109,A01,433849,Aycock; Jon Merrill,6,0,10,4
1708252348518,MATH 109,A02,433850,Aycock; Jon Merrill,9,0,10,1
1708252348518,MATH 109,B01,433852,Klevdal; Christian Sleek,10,0,10,0
1708252348518,MATH 109,B02,433859,Klevdal; Christian Sleek,10,0,10,0
1708252348518,MATH 109,C01,433861,Treuer; John N,5,0,10,5
1708252348518,MATH 109,C02,433862,Treuer; John N,10,0,10,0
1708252348518,MATH 109,D01,433864,Treuer; John N,8,0,10,2
1708252348518,MATH 109,D02,433865,Treuer; John N,8,0,10,2
1708252348518,MATH 109,E01,433868,Sheng; Hongyi,10,0,10,0
1708252348518,MATH 109,E02,433869,Sheng; Hongyi,19,0,20,1
1708252349048,MATH 110,A01,433871,Pillai; Mohandas K,24,0,35,11
1708252349048,MATH 110,A02,433872,Pillai; Mohandas K,33,0,35,2
1708252349575,MATH 112B,A01,480683,Komarova; Natalia,27,0,27,0
1708252350104,MATH 120B,A01,433885,Xiao; Ming,32,0,35,3
1708252350104,MATH 120B,A02,433886,Xiao; Ming,34,0,35,1
1708252350630,MATH 121B,A01,433888,Stevens; Laura Jeanne,29,0,30,1
1708252351159,MATH 140B,A01,433890,Seward; Brandon M.,31,0,35,4
1708252351159,MATH 140B,A02,433891,Seward; Brandon M.,35,0,35,0
1708252351686,MATH 140C,A01,433895,Spolaor; Luca,32,0,35,3
1708252351686,MATH 140C,A02,433896,Spolaor; Luca,35,0,35,0
1708252352220,MATH 142B,A01,433966,Eggers; John Dietrich,25,0,35,10
1708252352220,MATH 142B,A02,434063,Eggers; John Dietrich,32,0,35,3
1708252352220,MATH 142B,B01,434071,Sanchez; Anthony,32,0,35,3
1708252352220,MATH 142B,B02,434083,Sanchez; Anthony,34,0,35,1
1708252352220,MATH 142B,C01,434094,Kunnawalkam Elayavalli; Sr,31,0,35,4
1708252352220,MATH 142B,C02,434095,Kunnawalkam Elayavalli; Sr,34,0,35,1
1708252352750,MATH 144,A01,434097,Cloninger; Alexander,30,0,30,0
1708252353275,MATH 150B,A01,434104,Parise; Davide,33,0,35,2
1708252353805,MATH 152,A01,434107,Grier; Daniel T,20,0,40,20
1708252354338,MATH 154,A01,434109,Wesley; William J,31,0,35,4
1708252354338,MATH 154,A02,434119,Wesley; William J,35,0,35,0
1708252354338,MATH 154,A03,434120,Wesley; William J,35,0,35,0
1708252354338,MATH 154,A04,434121,Wesley; William J,34,0,35,1
1708252354338,MATH 154,B01,434126,Aliabadi Sr.; Mohsen,26,0,35,9
1708252354338,MATH 154,B02,434127,Aliabadi Sr.; Mohsen,34,0,35,1
1708252354338,MATH 154,B03,434138,Aliabadi Sr.; Mohsen,35,0,35,0
1708252354338,MATH 154,B04,434139,Aliabadi Sr.; Mohsen,35,0,35,0
1708252354863,MATH 163,A01,434144,Bowers; Adam R.,0,0,5,5
1708252355392,MATH 170A,A01,434148,Nag; Panchali,36,0,36,0
1708252355392,MATH 170A,A02,434149,Nag; Panchali,36,0,36,0
1708252355392,MATH 170A,A03,434150,Nag; Panchali,36,0,37,1
1708252355392,MATH 170A,A04,434151,Nag; Panchali,36,0,36,0
1708252355917,MATH 170B,A01,434155,Huang; Lei,31,0,35,4
1708252355917,MATH 170B,A02,434160,Huang; Lei,35,0,35,0
1708252355917,MATH 170B,A03,434161,Huang; Lei,35,0,35,0
1708252355917,MATH 170B,A04,434162,Huang; Lei,35,0,35,0
1708252356444,MATH 170C,A01,434176,Leok; Melvin,30,0,35,5
1708252356444,MATH 170C,A02,434300,Leok; Melvin,34,0,35,1
1708252356973,MATH 171B,A01,434576,Nie; Jiawang,24,0,35,11
1708252356973,MATH 171B,A02,434583,Nie; Jiawang,35,0,35,0
1708252356973,MATH 171B,A03,434584,Nie; Jiawang,35,0,35,0
1708252356973,MATH 171B,A04,434609,Nie; Jiawang,35,0,35,0
1708252357499,MATH 180A,A01,434638,Gartland; Christopher John,29,0,30,1
1708252357499,MATH 180A,A02,434821,Gartland; Christopher John,28,0,30,2
1708252357499,MATH 180A,A03,434833,Gartland; Christopher John,24,0,30,6
1708252357499,MATH 180A,A04,434839,Gartland; Christopher John,30,0,30,0
1708252357499,MATH 180A,A05,434843,Gartland; Christopher John,30,0,30,0
1708252357499,MATH 180A,A06,434895,Gartland; Christopher John,30,0,30,0
1708252358024,MATH 180B,A01,435085,Gartland; Christopher John,30,0,35,5
1708252358024,MATH 180B,A02,435086,Gartland; Christopher John,35,0,35,0
1708252358024,MATH 180B,A03,435087,Gartland; Christopher John,34,0,35,1
1708252358024,MATH 180B,A04,435088,Gartland; Christopher John,35,0,35,0
1708252358552,MATH 180C,A01,435090,Carfagnini; Marco,29,0,35,6
1708252358552,MATH 180C,A02,435091,Carfagnini; Marco,35,0,35,0
1708252358552,MATH 180C,A03,435092,Carfagnini; Marco,32,0,35,3
1708252358552,MATH 180C,A04,435113,Carfagnini; Marco,35,0,35,0
1708252359077,MATH 181A,A01,435279,Zhang; Danna,30,0,35,5
1708252359077,MATH 181A,A02,435300,Zhang; Danna,35,0,35,0
1708252359077,MATH 181A,A03,435301,Zhang; Danna,21,0,35,14
1708252359077,MATH 181A,A04,435302,Zhang; Danna,31,0,35,4
1708252359602,MATH 181B,A01,435315,Rava; Denise,33,0,35,2
1708252359602,MATH 181B,A02,435316,Rava; Denise,32,0,35,3
1708252359602,MATH 181B,A03,435317,Rava; Denise,33,0,35,2
1708252359602,MATH 181B,A04,435318,Rava; Denise,35,0,35,0
1708252360132,MATH 183,A01,435320,Quarfoot; David James,26,0,35,9
1708252360132,MATH 183,A02,435321,Quarfoot; David James,35,0,35,0
1708252360132,MATH 183,A03,435322,Quarfoot; David James,32,0,35,3
1708252360132,MATH 183,A04,435323,Quarfoot; David James,34,0,35,1
1708252360132,MATH 183,A05,435327,Quarfoot; David James,34,0,35,1
1708252360132,MATH 183,A06,435329,Quarfoot; David James,33,0,35,2
1708252360658,MATH 184,A01,435337,Verstraete; Jacques Allan,32,0,35,3
1708252360658,MATH 184,A02,435338,Verstraete; Jacques Allan,35,0,35,0
1708252360658,MATH 184,A03,435339,Verstraete; Jacques Allan,34,0,35,1
1708252360658,MATH 184,A04,435347,Verstraete; Jacques Allan,30,0,35,5
1708252361186,MATH 185,A01,435432,Arias-Castro; Ery,15,0,30,15
1708252361186,MATH 185,A02,435436,Arias-Castro; Ery,30,0,30,0
1708252361186,MATH 185,A03,435437,Arias-Castro; Ery,30,0,30,0
1708252361186,MATH 185,A04,435438,Arias-Castro; Ery,30,0,30,0
1708252361717,MATH 187A,A01,435443,Agrawal; Shishir,15,0,30,15
1708252361717,MATH 187A,A02,435444,Agrawal; Shishir,30,0,30,0
1708252361717,MATH 187A,A03,435503,Agrawal; Shishir,28,0,30,2
1708252361717,MATH 187A,A04,435507,Agrawal; Shishir,30,0,30,0
1708252361717,MATH 187A,A05,435554,Agrawal; Shishir,22,0,30,8
1708252361717,MATH 187A,A06,435558,Agrawal; Shishir,28,0,30,2
1708252362243,MATH 187B,A01,435570,Bucur; Alina Ioana,24,0,35,11
1708252362243,MATH 187B,A02,435571,Bucur; Alina Ioana,35,0,35,0
1708252362771,MATH 188,A01,435573,Kunnawalkam Elayavalli; Sr,35,0,35,0
1708252363296,MATH 189,A01,435577,Vishwanath; Siddharth,0,0,10,10
1708252363296,MATH 189,A02,435594,Vishwanath; Siddharth,0,0,10,10
1708252363296,MATH 189,A03,435595,Vishwanath; Siddharth,0,0,10,10
1708252363296,MATH 189,A04,435596,Vishwanath; Siddharth,0,0,10,10
1708252363296,MATH 189,A05,480706,Vishwanath; Siddharth,2,0,10,8
1708252363296,MATH 189,A06,481362,Vishwanath; Siddharth,6,0,10,4
1708252363825,MATH 200C,A00,430388,Bucur; Alina Ioana,15,0,15,0
1708252364355,MATH 202C,A00,430389,Rhoades; Brendon Patrick,15,0,15,0
1708252364883,MATH 203C,A00,430390,Izadi; Elham,15,0,15,0
1708252365409,MATH 204C,A00,430391,Sorensen; Claus M,15,0,15,0
1708252365934,MATH 208,A00,430392,Izadi; Elham,8,0,10,2
1708252366463,MATH 209,A00,430393,Pollack; Aaron,10,0,10,0
1708252366988,MATH 211A,A00,430394,Salehi Golsefidy; Alireza,10,0,10,0
1708252367516,MATH 211B,A00,430395,Seward; Brandon M.,10,0,10,0
1708252368042,MATH 212B,A01,480692,Komarova; Natalia,5,0,5,0
1708252368565,MATH 216C,A00,430429,Saab; Rayan,13,0,15,2
1708252369093,MATH 217,A00,430430,Li; Bo,13,0,15,2
1708252369618,MATH 218,A00,430431,Li; Bo,8,0,10,2
1708252370143,MATH 220C,A00,430432,Xiao; Ming,15,0,15,0
1708252370672,MATH 240C,A00,430433,Ebenfelt; Peter F,14,0,15,1
1708252371198,MATH 241B,A00,430434,Ioana; Adrian,14,0,15,1
1708252371726,MATH 243,A00,430435,Kunnawalkam Elayavalli; Sr,9,0,10,1
1708252372254,MATH 248,A00,430436,Bejenaru; Ioan,9,0,10,1
1708252372785,MATH 251C,A00,430437,Wenzl; Hans G,15,0,15,0
1708252373310,MATH 258,A00,430438,Spolaor; Luca,10,0,10,0
1708252373838,MATH 261C,A00,430439,Manners; Frederick,14,0,15,1
1708252374363,MATH 262A,A00,430440,Warnke; Lutz Peter,14,0,15,1
1708252374893,MATH 268,A00,430441,Buss; Samuel R,10,0,10,0
1708252375422,MATH 269,A00,430442,Rhoades; Brendon Patrick & Warnke; Lutz Peter,10,0,10,0
1708252375953,MATH 270C,A00,430445,Cheng; Li-Tien,15,0,15,0
1708252376482,MATH 273B,A00,430452,Zhu; Yuhua,15,0,15,0
1708252377007,MATH 276,A00,430458,Mc Culloch; Andrew Douglas & Amaro; Rommie E,0,0,0,0
1708252377537,MATH 277A,A00,430464,Dumitriu; Ioana,14,0,15,1
1708252378063,MATH 278A,A00,430470,Cheng; Li-Tien,9,0,10,1
1708252378591,MATH 278B,A00,430471,Cloninger; Alexander,10,0,10,0
1708252379120,MATH 278C,A00,430472,Nie; Jiawang,9,0,10,1
1708252379646,MATH 280C,A00,430485,Schweinsberg; Jason,13,0,15,2
1708252380171,MATH 281C,A00,430496,Arias-Castro; Ery,8,0,15,7
1708252380698,MATH 284,A00,430503,Xu; Ronghui,11,0,15,4
1708252381228,MATH 287C,A00,430520,Zhang; Danna,14,0,15,1
1708252381754,MATH 288,A00,430527,Carfagnini; Marco,9,0,10,1
1708252382285,MATH 289A,A00,430541,Novak; Jonathan I,14,0,15,1
1708252382816,MATH 290C,A00,430548,Roberts; Justin Deritter,13,0,15,2
1708252383342,MATH 292,A00,430660,Lu; Yunze,10,0,10,0
1708252383870,MATH 294,A00,430678,Fitzsimmons; Patrick J,11,0,15,4
1708252384398,MATH 295,A00,430692,Bejenaru; Ioan,15,0,15,0
1708252384924,MATH 297,001,430721,Gamst; Anthony Collins,0,0,0,0
1708252385454,MATS 200,A00,414457,Graeve; Olivia A,9995,0,9999,4
1708252385980,MATS 201C,A00,414465,Arzt; Eduard,38,0,50,12
1708252386509,MATS 236,A00,414466,Staff,17,0,20,3
1708252387035,MATS 252,A00,414467,Evdokimenko; Ekaterina,42,0,45,3
1708252387564,MATS 261B,A00,414468,Qiao; Yu,17,0,25,8
1708252388090,MATS 295,A00,414469,Graeve; Olivia A,9999,0,9999,0
1708252388090,MATS 295,B00,478858,Kummel; Andrew C,9999,0,9999,0
1708252388617,MCWP 40,001,414476,Montejo; Carolina,19,0,20,1
1708252388617,MCWP 40,004,414480,Wastal; Carrie King,13,0,15,2
1708252388617,MCWP 40,005,414481,Wastal; Carrie King,10,0,15,5
1708252388617,MCWP 40,006,414482,Wastal; Carrie King,12,0,15,3
1708252388617,MCWP 40,007,414483,Wastal; Carrie King,13,0,15,2
1708252388617,MCWP 40,008,414484,Wastal; Carrie King,15,0,15,0
1708252388617,MCWP 40,009,414487,Wastal; Carrie King,12,0,15,3
1708252388617,MCWP 40,014,414505,Staff,20,0,20,0
1708252388617,MCWP 40,015,494362,Wastal; Carrie King,14,0,15,1
1708252389158,MCWP 50,002,414534,Bartulis; Jason Michael,20,0,20,0
1708252389158,MCWP 50,003,414536,Bartulis; Jason Michael,20,0,20,0
1708252389158,MCWP 50,004,414538,Krone; Jarret,16,0,20,4
1708252389158,MCWP 50,005,414539,Krone; Jarret,19,0,20,1
1708252389158,MCWP 50,006,414540,Smith; Haydee Marie,16,0,20,4
1708252389158,MCWP 50,007,414544,Compas; Sean Matthew,14,0,20,6
1708252389158,MCWP 50,008,414549,Redela; Pamela Morgan,20,0,20,0
1708252389158,MCWP 50,011,414557,Carter; Andrea L,16,0,20,4
1708252389158,MCWP 50,012,414592,Silva; Kelly B,20,0,20,0
1708252389158,MCWP 50,013,414593,Silva; Kelly B,19,0,20,1
1708252389158,MCWP 50,014,414594,Carter; Andrea L,20,0,20,0
1708252389158,MCWP 50,016,414596,Morshed; Michael James,14,0,20,6
1708252389158,MCWP 50,017,414598,Morshed; Michael James,17,0,20,3
1708252389158,MCWP 50,019,414601,Redela; Pamela Morgan,17,0,20,3
1708252389158,MCWP 50,020,414606,Carter; Jennifer A,20,0,20,0
1708252389158,MCWP 50,021,414607,Carter; Jennifer A,19,0,20,1
1708252389158,MCWP 50,022,414649,Compas; Sean Matthew,11,0,20,9
1708252389158,MCWP 50,023,414650,Smith; Haydee Marie,20,0,20,0
1708252389158,MCWP 50,024,414651,Nies; Laurie Elizabeth,19,0,20,1
1708252389158,MCWP 50,025,414655,Nies; Laurie Elizabeth,18,0,20,2
1708252389158,MCWP 50,026,414656,Pham; Vincent Minhduc,19,0,20,1
1708252389158,MCWP 50,027,414657,Pham; Vincent Minhduc,20,0,20,0
1708252389158,MCWP 50,028,414668,Morshed; Michael James,16,0,20,4
1708252389158,MCWP 50,029,414669,Morshed; Michael James,19,0,20,1
1708252389684,MCWP 50R,A00,486838,Miller; Elizabeth Deen,19,0,20,1
1708252389684,MCWP 50R,B00,486843,Miller; Elizabeth Deen,16,0,20,4
1708252389684,MCWP 50R,C00,486844,Miller; Elizabeth Deen,19,0,20,1
1708252390214,MCWP 125,A00,414670,Wilson; Marion E.,20,0,20,0
1708252390214,MCWP 125,B00,414674,Guillen; Melinda,20,0,20,0
1708252390214,MCWP 125,C00,414678,Guillen; Melinda,20,0,20,0
1708252390214,MCWP 125,D00,414682,Guillen; Melinda,20,0,20,0
1708252390742,MED 231,A00,476440,Hurst; Samantha,7,0,7,0
1708252391276,MED 246,A00,492785,Gordts; Philip & Varki; Ajit P & Lewis; Amanda Lark & Godula; Kamil & Gagneux; Pascal & Esko; Jeffrey D. & Bode; Lars,10,0,10,0
1708252391805,MED 262,A00,492942,Koola; Jejo David,28,0,30,2
1708252392330,MED 267,A01,492789,Hogarth; Michael Andrew,25,0,30,5
1708252392856,MED 275,A00,464684,Liu; George Yenhsi,10,0,10,0
1708252393385,MED 276,A00,492786,Sitapati; Amy,23,0,25,2
1708252393911,MED 278,A00,492787,Carter; Hannah Kathryn & Mesirov; Jill P. & Curtius; Kathleen Mary,20,0,20,0
1708252394437,MED 296,001,464685,Chi; Neil C.,48,0,50,2
1708252394437,MED 296,002,464686,Hong; Kimberly N,49,0,50,1
1708252394437,MED 296,003,464687,Staff,50,0,50,0
1708252394968,MGT 3,A00,442429,Wagner; Timothy Ryan,95,0,98,3
1708252395496,MGT 4,A01,442443,Levkoff; Steven B.,0,0,5,5
1708252395496,MGT 4,A02,442444,Levkoff; Steven B.,4,0,5,1
1708252396025,MGT 5,A00,442446,Molloie Jr.; William H,184,0,196,12
1708252396552,MGT 12,A00,442447,Lindenberger; Wade Douglas,83,0,100,17
1708252396552,MGT 12,B00,442448,Lindenberger; Wade Douglas,71,0,100,29
1708252396552,MGT 12,C00,442449,Pecore; Joseph P.,88,0,100,12
1708252397079,MGT 16,A00,442452,Buchanan; Harold G,97,0,100,3
1708252397079,MGT 16,B00,442459,Buchanan; Harold G,92,0,100,8
1708252397079,MGT 16,C00,442461,Campbell; Robert Harold,113,0,120,7
1708252397079,MGT 16,D00,442475,Campbell; Robert Harold,118,0,120,2
1708252397610,MGT 18,A00,442477,McKay; Michael J,98,0,98,0
1708252397610,MGT 18,B00,442491,McKay; Michael J,96,0,98,2
1708252397610,MGT 18,C00,442493,McKay; Michael J,98,0,98,0
1708252397610,MGT 18,D00,442503,Chamberlain; Travis Dean,98,0,98,0
1708252398137,MGT 45,A00,442508,Pecore; Joseph P.,146,0,150,4
1708252398137,MGT 45,B00,442510,Pecore; Joseph P.,142,0,150,8
1708252398667,MGT 71,A00,442524,Lee; Hyun Seok,77,0,98,21
1708252399193,MGT 71R,A00,442526,Phiroz; Zal Navroze,77,0,98,21
1708252399723,MGT 100,A00,442541,Wilbur; Kenneth C,82,0,98,16
1708252399723,MGT 100,B00,442542,Wilbur; Kenneth C,89,0,98,9
1708252400252,MGT 103,A00,442543,Eberhard; Craig A,98,0,98,0
1708252400252,MGT 103,B00,442544,Eberhard; Craig A,95,0,98,3
1708252400252,MGT 103,C00,442545,Ehrich; Kristine R,90,0,98,8
1708252400252,MGT 103,D00,442547,Ehrich; Kristine R,96,0,98,2
1708252400252,MGT 103,E00,442548,Ehrich; Kristine R,97,0,98,1
1708252400252,MGT 103,F00,442549,Demill; Burritt,92,0,98,6
1708252400252,MGT 103,G00,442550,Bates; Kenneth Walter,97,0,98,1
1708252400784,MGT 105,A00,442558,Bates; Kenneth Walter,86,0,98,12
1708252401311,MGT 106,A00,442560,Eberhard; Craig A,95,0,98,3
1708252401908,MGT 109,A00,442574,Campbell; Colin Leslie,90,0,98,8
1708252402435,MGT 112,A00,442576,Somasundaram; Tyagarajan,96,0,98,2
1708252402435,MGT 112,B00,442590,Somasundaram; Tyagarajan,94,0,98,4
1708252402435,MGT 112,C00,442592,Zimmermann; Carsten,87,0,98,11
1708252402965,MGT 119,A00,442602,Staff,97,0,98,1
1708252402965,MGT 119,B00,442603,Anderson; Jon Marcus,96,0,98,2
1708252403493,MGT 121B,A00,442606,Klaas; Jeffrey David,94,0,98,4
1708252404018,MGT 128R,A00,442607,Krishnan; Viswanathan,84,0,98,14
1708252404544,MGT 131A,A00,442608,Houskeeper; Robert,148,0,150,2
1708252405070,MGT 131B,A00,442609,Houskeeper; Robert,100,0,100,0
1708252405600,MGT 132,A00,442610,Blakley; Bruce,97,0,98,1
1708252406126,MGT 137,A00,442611,Lindenberger; Wade Douglas,86,0,98,12
1708252406651,MGT 147,A00,442612,Anderson; John Charles,32,0,40,8
1708252407180,MGT 151R,A00,442613,Phiroz; Zal Navroze,92,0,98,6
1708252407708,MGT 153,A00,442650,Perols; Johan Lars,55,0,80,25
1708252408241,MGT 162,A00,442652,Demill; Burritt,81,0,98,17
1708252408241,MGT 162,B00,442654,Demill; Burritt,88,0,98,10
1708252408241,MGT 162,C00,442776,Staff,95,0,98,3
1708252408241,MGT 162,D00,442778,Staff,96,0,98,2
1708252408772,MGT 164,A00,442780,McKay; Mary A,97,0,98,1
1708252408772,MGT 164,B00,442849,McKay; Mary A,96,0,98,2
1708252408772,MGT 164,C00,442917,McKay; Mary A,97,0,98,1
1708252408772,MGT 164,D00,442949,Meyer; Alison Bloomfield,90,0,98,8
1708252409299,MGT 166,A00,443017,Moran; Cathleen L.,95,0,98,3
1708252409299,MGT 166,B00,443045,Moran; Cathleen L.,97,0,98,1
1708252409299,MGT 166,C00,443046,Moran; Cathleen L.,98,0,98,0
1708252409825,MGT 167,A00,443047,Klaas; Jeffrey David,93,0,98,5
1708252410351,MGT 171R,A00,443048,Phiroz; Zal Navroze,86,0,98,12
1708252410876,MGT 172,A00,443049,Hedges; Kathleen & Royal; Rebecca,116,0,120,4
1708252410876,MGT 172,B00,443050,Hedges; Kathleen,95,0,98,3
1708252410876,MGT 172,C00,443051,Zimmermann; Carsten,96,0,98,2
1708252411405,MGT 173,A00,443052,Hayes; Sherry Lorine,92,0,100,8
1708252411948,MGT 175,A00,443053,Gopal; Christopher S.,98,0,98,0
1708252412477,MGT 180,A00,443055,Bliss; Barbara Ann,139,0,150,11
1708252412477,MGT 180,B00,443069,Bliss; Barbara Ann,145,0,150,5
1708252413003,MGT 181,A00,443120,Buchanan; Harold G,147,0,150,3
1708252413537,MGT 183,A00,443121,Banerjee; Snehal,88,0,98,10
1708252414063,MGT 185,A00,443122,Dunn; Louis Jean,90,0,98,8
1708252414592,MGT 187,A00,443133,Dunn; Louis Jean,95,0,100,5
1708252415118,MGT 189,A00,443134,Avenancio-Leon; Carlos,98,0,98,0
1708252415645,MGT 227,A00,479242,Serra Garcia; Marta,19,0,20,1
1708252416172,MGT 259,A00,443135,Oveis; Christopher S,19,0,20,1
1708252416717,MGT 296,001,481416,Gneezy; Ayelet,3,0,3,0
1708252416717,MGT 296,002,481420,Amir; On,3,0,3,0
1708252416717,MGT 296,003,481466,Amir; On & Karmarkar; Uma R,3,0,3,0
1708252416717,MGT 296,004,481468,Liu; Jun,3,0,3,0
1708252416717,MGT 296,005,481469,Misra; Kanishka,3,0,3,0
1708252416717,MGT 296,006,481470,Erat; Sanjiv,3,0,3,0
1708252416717,MGT 296,007,481473,Timmermann; Allan,3,0,3,0
1708252416717,MGT 296,008,481474,Smith; Pamela Karen,3,0,3,0
1708252416717,MGT 296,009,481477,Zhang; Zhe,3,0,3,0
1708252416717,MGT 296,010,481478,Oveis; Christopher S,3,0,3,0
1708252416717,MGT 296,011,481479,Amir; On & Gneezy; Ayelet,3,0,3,0
1708252416717,MGT 296,012,481481,Wilbur; Kenneth C,3,0,3,0
1708252417344,MMW 13,A01,412918,Chang; Edmond Yi-Teh,15,0,16,1
1708252417344,MMW 13,A02,412928,Chang; Edmond Yi-Teh,16,0,16,0
1708252417344,MMW 13,A03,413017,Chang; Edmond Yi-Teh,16,0,16,0
1708252417344,MMW 13,A04,413018,Chang; Edmond Yi-Teh,16,0,16,0
1708252417344,MMW 13,A05,413019,Chang; Edmond Yi-Teh,15,0,16,1
1708252417344,MMW 13,A06,413020,Chang; Edmond Yi-Teh,16,0,16,0
1708252417344,MMW 13,A07,413021,Chang; Edmond Yi-Teh,15,0,16,1
1708252417344,MMW 13,A08,413023,Chang; Edmond Yi-Teh,16,0,16,0
1708252417344,MMW 13,A09,413024,Chang; Edmond Yi-Teh,16,0,16,0
1708252417344,MMW 13,A10,413025,Chang; Edmond Yi-Teh,16,0,16,0
1708252417344,MMW 13,A11,413026,Chang; Edmond Yi-Teh,16,0,16,0
1708252417344,MMW 13,A12,413027,Chang; Edmond Yi-Teh,16,0,16,0
1708252417344,MMW 13,A13,413028,Chang; Edmond Yi-Teh,0,0,0,0
1708252417344,MMW 13,A14,413029,Chang; Edmond Yi-Teh,0,0,0,0
1708252417344,MMW 13,A15,413030,Chang; Edmond Yi-Teh,14,0,16,2
1708252417344,MMW 13,A16,413031,Chang; Edmond Yi-Teh,15,0,16,1
1708252417344,MMW 13,A17,413032,Chang; Edmond Yi-Teh,16,0,16,0
1708252417344,MMW 13,A18,413034,Chang; Edmond Yi-Teh,14,0,16,2
1708252417344,MMW 13,A19,413035,Chang; Edmond Yi-Teh,16,0,16,0
1708252417344,MMW 13,A20,413036,Chang; Edmond Yi-Teh,16,0,16,0
1708252417344,MMW 13,A21,413037,Chang; Edmond Yi-Teh,0,0,0,0
1708252417344,MMW 13,A22,413038,Chang; Edmond Yi-Teh,0,0,0,0
1708252417344,MMW 13,B01,413290,Zhiri; Oumelbanine,15,0,16,1
1708252417344,MMW 13,B02,413291,Zhiri; Oumelbanine,15,0,16,1
1708252417344,MMW 13,B03,413308,Zhiri; Oumelbanine,14,0,16,2
1708252417344,MMW 13,B04,413322,Zhiri; Oumelbanine,14,0,16,2
1708252417344,MMW 13,B05,413343,Zhiri; Oumelbanine,12,0,16,4
1708252417344,MMW 13,B06,413344,Zhiri; Oumelbanine,14,0,16,2
1708252417344,MMW 13,B07,413524,Zhiri; Oumelbanine,16,0,16,0
1708252417344,MMW 13,B08,413584,Zhiri; Oumelbanine,16,0,16,0
1708252417344,MMW 13,B09,413588,Zhiri; Oumelbanine,15,0,16,1
1708252417344,MMW 13,B10,413590,Zhiri; Oumelbanine,16,0,16,0
1708252417344,MMW 13,B11,413779,Zhiri; Oumelbanine,12,0,16,4
1708252417344,MMW 13,B12,413780,Zhiri; Oumelbanine,9,0,16,7
1708252417344,MMW 13,B13,413781,Zhiri; Oumelbanine,0,0,0,0
1708252417344,MMW 13,B14,413782,Zhiri; Oumelbanine,0,0,0,0
1708252417344,MMW 13,B15,413808,Zhiri; Oumelbanine,16,0,16,0
1708252417344,MMW 13,B16,413815,Zhiri; Oumelbanine,15,0,16,1
1708252417344,MMW 13,B17,413816,Zhiri; Oumelbanine,15,0,16,1
1708252417344,MMW 13,B18,413817,Zhiri; Oumelbanine,12,0,16,4
1708252417344,MMW 13,B19,413822,Zhiri; Oumelbanine,16,0,16,0
1708252417344,MMW 13,B20,413823,Zhiri; Oumelbanine,14,0,16,2
1708252417344,MMW 13,B21,413825,Zhiri; Oumelbanine,0,0,0,0
1708252417344,MMW 13,B22,413826,Zhiri; Oumelbanine,0,0,0,0
1708252417344,MMW 13,B23,413827,Zhiri; Oumelbanine,16,0,16,0
1708252417344,MMW 13,B24,413834,Zhiri; Oumelbanine,15,0,16,1
1708252417344,MMW 13,C01,413859,Vitkus; Daniel J.,16,0,16,0
1708252417344,MMW 13,C02,413860,Vitkus; Daniel J.,16,0,16,0
1708252417344,MMW 13,C04,413868,Vitkus; Daniel J.,0,0,0,0
1708252417344,MMW 13,C05,413869,Vitkus; Daniel J.,16,0,16,0
1708252417344,MMW 13,C06,413871,Vitkus; Daniel J.,16,0,16,0
1708252417344,MMW 13,C07,413886,Vitkus; Daniel J.,16,0,16,0
1708252417344,MMW 13,C08,413908,Vitkus; Daniel J.,16,0,16,0
1708252417344,MMW 13,C09,413930,Vitkus; Daniel J.,16,0,16,0
1708252417344,MMW 13,C10,413952,Vitkus; Daniel J.,15,0,16,1
1708252417344,MMW 13,C11,413972,Vitkus; Daniel J.,16,0,16,0
1708252417344,MMW 13,C12,413991,Vitkus; Daniel J.,16,0,16,0
1708252417344,MMW 13,C13,414007,Vitkus; Daniel J.,0,0,0,0
1708252417344,MMW 13,C14,414017,Vitkus; Daniel J.,0,0,0,0
1708252417344,MMW 13,C15,414030,Vitkus; Daniel J.,16,0,16,0
1708252417344,MMW 13,C16,414032,Vitkus; Daniel J.,16,0,16,0
1708252417344,MMW 13,C17,414033,Vitkus; Daniel J.,15,0,16,1
1708252417344,MMW 13,C18,414034,Vitkus; Daniel J.,16,0,16,0
1708252417344,MMW 13,C19,414041,Vitkus; Daniel J.,16,0,16,0
1708252417344,MMW 13,C20,414056,Vitkus; Daniel J.,16,0,16,0
1708252417344,MMW 13,C21,414057,Vitkus; Daniel J.,15,0,16,1
1708252417344,MMW 13,C22,414059,Vitkus; Daniel J.,16,0,16,0
1708252417921,MMW 15,A01,414065,Chang; Edmond Yi-Teh,28,0,28,0
1708252417921,MMW 15,A02,414067,Chang; Edmond Yi-Teh,27,0,28,1
1708252417921,MMW 15,A03,414092,Chang; Edmond Yi-Teh,26,0,28,2
1708252417921,MMW 15,A04,414104,Chang; Edmond Yi-Teh,28,0,28,0
1708252417921,MMW 15,A05,414121,Chang; Edmond Yi-Teh,0,0,0,0
1708252417921,MMW 15,A06,414122,Chang; Edmond Yi-Teh,0,0,0,0
1708252417921,MMW 15,A07,414123,Chang; Edmond Yi-Teh,27,0,28,1
1708252417921,MMW 15,A08,414124,Chang; Edmond Yi-Teh,28,0,28,0
1708252417921,MMW 15,A09,414125,Chang; Edmond Yi-Teh,0,0,0,0
1708252417921,MMW 15,A10,414130,Chang; Edmond Yi-Teh,0,0,0,0
1708252417921,MMW 15,B01,414132,Radcliff; Pamela B.,27,0,28,1
1708252417921,MMW 15,B02,414134,Radcliff; Pamela B.,27,0,28,1
1708252417921,MMW 15,B03,414135,Radcliff; Pamela B.,26,0,28,2
1708252417921,MMW 15,B04,414136,Radcliff; Pamela B.,27,0,28,1
1708252417921,MMW 15,B05,414137,Radcliff; Pamela B.,28,0,28,0
1708252417921,MMW 15,B06,414138,Radcliff; Pamela B.,27,0,28,1
1708252417921,MMW 15,B07,414140,Radcliff; Pamela B.,26,0,28,2
1708252417921,MMW 15,B08,414141,Radcliff; Pamela B.,28,0,28,0
1708252417921,MMW 15,C01,414143,Prestholdt; Jeremy,0,0,0,0
1708252417921,MMW 15,C02,414144,Prestholdt; Jeremy,0,0,0,0
1708252417921,MMW 15,C03,414145,Prestholdt; Jeremy,24,0,28,4
1708252417921,MMW 15,C04,414147,Prestholdt; Jeremy,17,0,28,11
1708252417921,MMW 15,C05,414148,Prestholdt; Jeremy,28,0,28,0
1708252417921,MMW 15,C06,414149,Prestholdt; Jeremy,26,0,28,2
1708252417921,MMW 15,C07,414152,Prestholdt; Jeremy,25,0,28,3
1708252417921,MMW 15,C08,414153,Prestholdt; Jeremy,23,0,28,5
1708252418448,MSED 295,A00,477850,Rabin; Jeffrey Mark,5,0,5,0
1708252418448,MSED 295,B00,477852,Lo; Stanley M.,5,0,5,0
1708252418977,MSED 296C,A00,477853,Staff,14,0,15,1
1708252419505,MUS 1C,A01,416488,Ishov; Alexander Alexandrovich,24,0,25,1
1708252419505,MUS 1C,A02,416502,Ishov; Alexander Alexandrovich,25,0,25,0
1708252419505,MUS 1C,A03,416519,Ishov; Alexander Alexandrovich,25,0,25,0
1708252419505,MUS 1C,A04,416520,Ishov; Alexander Alexandrovich,25,0,25,0
1708252419505,MUS 1C,A05,416521,Ishov; Alexander Alexandrovich,25,0,25,0
1708252420031,MUS 2C,A01,416523,Richards; Stephanie F,30,0,30,0
1708252420558,MUS 2CK,A00,416524,Ohnishi; Takae,15,0,15,0
1708252420558,MUS 2CK,B00,416547,Ohnishi; Takae,15,0,15,0
1708252421088,MUS 2JK,A00,416548,Kenyatta; Kamau,15,0,15,0
1708252421631,MUS 4,A01,416562,Staff,25,0,25,0
1708252421631,MUS 4,A02,416634,Staff,24,0,25,1
1708252421631,MUS 4,A03,416644,Staff,25,0,25,0
1708252421631,MUS 4,A04,416659,Staff,24,0,25,1
1708252421631,MUS 4,A05,416667,Staff,25,0,25,0
1708252421631,MUS 4,A06,416757,Staff,25,0,25,0
1708252421631,MUS 4,A07,416830,Staff,25,0,25,0
1708252421631,MUS 4,A08,416953,Staff,23,0,25,2
1708252421631,MUS 4,A09,417005,Staff,25,0,25,0
1708252421631,MUS 4,A10,417007,Staff,24,0,25,1
1708252422167,MUS 7,A01,417048,Staff,23,0,24,1
1708252422167,MUS 7,A02,417102,Staff,23,0,24,1
1708252422167,MUS 7,A03,417103,Staff,23,0,24,1
1708252422167,MUS 7,A04,417114,Staff,22,0,24,2
1708252422693,MUS 8,A01,417119,Staff,14,0,20,6
1708252422693,MUS 8,A02,417163,Staff,16,0,20,4
1708252422693,MUS 8,A03,417164,Staff,16,0,20,4
1708252422693,MUS 8,A04,417165,Staff,17,0,20,3
1708252422693,MUS 8,A05,417194,Staff,18,0,20,2
1708252422693,MUS 8,A06,417198,Staff,20,0,20,0
1708252423225,MUS 11,A01,417201,Terrazas Perez; Wilfrido D,21,0,25,4
1708252423225,MUS 11,A02,417219,Terrazas Perez; Wilfrido D,23,0,25,2
1708252423225,MUS 11,A03,417220,Terrazas Perez; Wilfrido D,25,0,25,0
1708252423225,MUS 11,A04,417222,Terrazas Perez; Wilfrido D,25,0,25,0
1708252423225,MUS 11,A05,417223,Terrazas Perez; Wilfrido D,24,0,25,1
1708252423225,MUS 11,A06,417295,Terrazas Perez; Wilfrido D,23,0,25,2
1708252423225,MUS 11,A07,417297,Terrazas Perez; Wilfrido D,24,0,25,1
1708252423225,MUS 11,A08,417298,Terrazas Perez; Wilfrido D,25,0,25,0
1708252423751,MUS 12,A01,417300,Guy; Nancy,25,0,25,0
1708252423751,MUS 12,A02,417301,Guy; Nancy,25,0,25,0
1708252423751,MUS 12,A03,417302,Guy; Nancy,25,0,25,0
1708252423751,MUS 12,A04,417303,Guy; Nancy,25,0,25,0
1708252424277,MUS 13,A01,417305,Leslie Santana; Myrta,25,0,25,0
1708252424277,MUS 13,A02,417306,Leslie Santana; Myrta,25,0,25,0
1708252424277,MUS 13,A03,417307,Leslie Santana; Myrta,25,0,25,0
1708252424277,MUS 13,A04,417308,Leslie Santana; Myrta,25,0,25,0
1708252424809,MUS 15,A01,417327,Schaffer; Max Benjamin,18,0,20,2
1708252424809,MUS 15,A02,417331,Schaffer; Max Benjamin,19,0,20,1
1708252424809,MUS 15,A03,417358,Schaffer; Max Benjamin,19,0,20,1
1708252424809,MUS 15,A04,417359,Schaffer; Max Benjamin,17,0,20,3
1708252424809,MUS 15,A05,417360,Schaffer; Max Benjamin,20,0,20,0
1708252424809,MUS 15,A06,417370,Schaffer; Max Benjamin,20,0,20,0
1708252424809,MUS 15,A07,417371,Schaffer; Max Benjamin,17,0,20,3
1708252424809,MUS 15,A08,417372,Schaffer; Max Benjamin,18,0,20,2
1708252424809,MUS 15,A09,417378,Schaffer; Max Benjamin,19,0,20,1
1708252424809,MUS 15,A10,417379,Schaffer; Max Benjamin,19,0,20,1
1708252425334,MUS 17,A01,417381,Staff,22,0,25,3
1708252425334,MUS 17,A02,417406,Staff,24,0,25,1
1708252425334,MUS 17,A03,417420,Staff,24,0,25,1
1708252425334,MUS 17,A04,417594,Staff,24,0,25,1
1708252425334,MUS 17,A05,417595,Staff,25,0,25,0
1708252425334,MUS 17,A06,417605,Staff,21,0,25,4
1708252425334,MUS 17,A07,417606,Staff,25,0,25,0
1708252425334,MUS 17,A08,417627,Staff,25,0,25,0
1708252425334,MUS 17,A09,417628,Staff,21,0,25,4
1708252425334,MUS 17,A10,417629,Staff,24,0,25,1
1708252425334,MUS 17,A11,417630,Staff,25,0,25,0
1708252425334,MUS 17,A12,417631,Staff,24,0,25,1
1708252425334,MUS 17,A13,417632,Staff,25,0,25,0
1708252425334,MUS 17,A14,417633,Staff,25,0,25,0
1708252425864,MUS 32,001,418855,Dresser; Mark Stuart,10,0,10,0
1708252425864,MUS 32,002,418856,Kenyatta; Kamau,9,0,10,1
1708252425864,MUS 32,003,418864,Curtis; Charles Rector,10,0,10,0
1708252425864,MUS 32,004,418865,Carlstrom; Mitchell Kraig,9,0,10,1
1708252425864,MUS 32,005,418868,Terrazas Perez; Wilfrido D,10,0,10,0
1708252425864,MUS 32,006,418869,Ohnishi; Takae,10,0,10,0
1708252425864,MUS 32,007,418872,Burr; Anthony I,10,0,10,0
1708252425864,MUS 32,008,418873,Carlson; Erik Norman,10,0,10,0
1708252425864,MUS 32,009,418874,Blair; Kyle Adam,10,0,10,0
1708252425864,MUS 32,010,418875,Richards; Stephanie F,10,0,10,0
1708252426395,MUS 32V,A00,417634,Narucki; Susan M,10,0,10,0
1708252426395,MUS 32V,B00,417635,Staff,10,0,10,0
1708252426922,MUS 32VM,A00,417636,Staff,15,0,15,0
1708252427448,MUS 33C,A00,417637,Taylor; Alexander Lawther,20,0,20,0
1708252427974,MUS 43,A00,417647,Burr; Anthony I,83,0,90,7
1708252428500,MUS 95D,A00,417919,Staff,40,0,40,0
1708252429028,MUS 95E,A00,417933,Henson; Matthew Alexander,55,0,55,0
1708252429554,MUS 95G,A00,417935,Anderson; Kenneth,387,0,395,8
1708252429554,MUS 95G,B00,417937,Anderson; Kenneth,394,0,395,1
1708252430081,MUS 95JC,A00,417939,Kenyatta; Kamau,30,0,30,0
1708252430609,MUS 95L,A00,417940,Jones; Michael David,50,0,50,0
1708252431135,MUS 95W,A00,417946,Seshadri; Kartik,29,0,30,1
1708252431135,MUS 95W,B00,417948,Seshadri; Kartik,30,0,30,0
1708252431665,MUS 101C,A01,417951,Burr; Anthony I,33,0,35,2
1708252432194,MUS 103C,A00,417952,Davis; Anthony Curtis,14,0,15,1
1708252432720,MUS 103F,A00,417959,Obermueller; Karola,1,0,1,0
1708252433247,MUS 113,A00,418015,Narucki; Susan M,13,0,15,2
1708252433777,MUS 120C,A01,418032,Leslie Santana; Myrta,25,0,25,0
1708252434302,MUS 127,A00,418037,Richards; Stephanie F,92,0,100,8
1708252434833,MUS 130,A00,418047,Ohnishi; Takae,30,0,30,0
1708252435358,MUS 131,A00,418065,Roberts; Matana,30,0,30,0
1708252435885,MUS 132,001,418883,Dresser; Mark Stuart,10,0,10,0
1708252435885,MUS 132,002,418885,Kenyatta; Kamau,10,0,10,0
1708252435885,MUS 132,003,418886,Curtis; Charles Rector,10,0,10,0
1708252435885,MUS 132,004,418887,Carlstrom; Mitchell Kraig,10,0,10,0
1708252435885,MUS 132,005,418888,Jones; Michael David,10,0,10,0
1708252435885,MUS 132,006,418889,Terrazas Perez; Wilfrido D,10,0,10,0
1708252435885,MUS 132,007,418893,Ohnishi; Takae,10,0,10,0
1708252435885,MUS 132,008,418894,Burr; Anthony I,10,0,10,0
1708252435885,MUS 132,009,418896,Carlson; Erik Norman,10,0,10,0
1708252435885,MUS 132,010,418900,Blair; Kyle Adam,10,0,10,0
1708252435885,MUS 132,011,418932,Richards; Stephanie F,10,0,10,0
1708252435885,MUS 132,012,418933,Nourai; Keyarash,10,0,10,0
1708252436411,MUS 132R,A00,418067,Burr; Anthony I,5,0,5,0
1708252436411,MUS 132R,B00,418078,Jones; Michael David,5,0,5,0
1708252436937,MUS 132V,A00,418092,Narucki; Susan M,15,0,15,0
1708252436937,MUS 132V,B00,418096,Staff,15,0,15,0
1708252437462,MUS 134,A00,418098,Staff,40,0,40,0
1708252437988,MUS 137C,A00,418109,Kenyatta; Kamau,25,0,25,0
1708252438513,MUS 143,A00,418123,Burr; Anthony I,33,0,40,7
1708252439040,MUS 150,A00,418127,Davis; Anthony Curtis,28,0,30,2
1708252439566,MUS 151,A00,418129,Hankins; Sarah E.,20,0,30,10
1708252440096,MUS 160B,A00,418172,Staff,11,0,15,4
1708252440096,MUS 160B,B00,418175,Dubnov; Shlomo,14,0,15,1
1708252440626,MUS 172,A01,418178,Staff,36,0,40,4
1708252441152,MUS 174C,A00,418179,Erbe; Tom,24,0,27,3
1708252441684,MUS 175,A00,418247,Smyth; Tamara R.,28,0,30,2
1708252442208,MUS 177,A00,418265,Erbe; Tom,11,0,15,4
1708252442737,MUS 201A,A00,418267,Narucki; Susan M,15,0,15,0
1708252442737,MUS 201A,B00,418268,Dresser; Mark Stuart,13,0,15,2
1708252443264,MUS 203C,A00,418269,Lou; Michelle Siulai,15,0,15,0
1708252443791,MUS 203D,A00,418272,Davis; Anthony Curtis,4,0,5,1
1708252443791,MUS 203D,B00,418275,Obermueller; Karola,5,0,5,0
1708252443791,MUS 203D,C00,418277,Liang; Lei,5,0,5,0
1708252443791,MUS 203D,D00,418323,Lou; Michelle Siulai,5,0,5,0
1708252444318,MUS 204,A00,418324,Obermueller; Karola,24,0,25,1
1708252444846,MUS 205,A00,418325,Cimini; Amy Marie,22,0,25,3
1708252445373,MUS 206,A00,418326,Liang; Lei,13,0,15,2
1708252445373,MUS 206,B00,418327,Roberts; Matana,13,0,15,2
1708252445899,MUS 215C,A00,418328,Cimini; Amy Marie,14,0,15,1
1708252446426,MUS 232,001,418937,Dresser; Mark Stuart,9,0,10,1
1708252446426,MUS 232,002,418969,Kenyatta; Kamau,10,0,10,0
1708252446426,MUS 232,003,418971,Curtis; Charles Rector,10,0,10,0
1708252446426,MUS 232,004,418974,Terrazas Perez; Wilfrido D,10,0,10,0
1708252446426,MUS 232,005,418979,Ohnishi; Takae,10,0,10,0
1708252446426,MUS 232,006,418980,Burr; Anthony I,10,0,10,0
1708252446426,MUS 232,007,418981,Carlson; Erik Norman,10,0,10,0
1708252446426,MUS 232,008,418982,Richards; Stephanie F,10,0,10,0
1708252446426,MUS 232,009,418985,Narucki; Susan M,10,0,10,0
1708252446954,MUS 234,A00,418329,Staff,15,0,15,0
1708252447479,MUS 245,A00,418330,Carlson; Erik Norman,14,0,15,1
1708252448007,MUS 267,A00,418331,Erbe; Tom,15,0,15,0
1708252448535,MUS 270B,A00,418332,Staff,15,0,15,0
1708252449061,MUS 270D,A00,479231,Smyth; Tamara R.,15,0,15,0
1708252449591,NANO 103,A00,414714,Jahed Motlagh; Zeinab,40,0,40,0
1708252450356,NANO 108,A00,414740,Lubarda; Vlado,70,0,70,0
1708252450884,NANO 112,A01,414825,Vazquez Mena; Oscar,70,0,70,0
1708252451426,NANO 115L,A01,414830,Yang; Kesong,37,0,38,1
1708252451426,NANO 115L,B01,414832,Xu; Sheng,35,0,38,3
1708252451959,NANO 120B,A01,414835,Vecchio; Kenneth S,33,0,35,2
1708252451959,NANO 120B,B01,414841,Fenning; David,30,0,35,5
1708252452486,NANO 156,A00,414843,Fullerton; Eric E,24,0,30,6
1708252453013,NANO 158,A00,414844,Luo; Jian,29,0,30,1
1708252453543,NANO 175,A00,414850,Steinmetz; Nicole F,30,0,35,5
1708252454069,NANO 200,A00,414852,Jahed Motlagh; Zeinab,118,0,120,2
1708252454599,NANO 241,A00,414854,Pokorski; Jonathan Kyle,18,0,25,7
1708252455139,NANO 262,A00,414858,Wang; Joseph,50,0,50,0
1708252455736,NANO 271,A00,414862,Cubukcu; Ertugrul,22,0,25,3
1708252456265,NANO 272,A00,414877,Xu; Sheng,42,0,50,8
1708252456791,NANO 279,A00,414878,Liu; Ping,32,0,40,8
1708252457320,NANO 282,A00,414879,Steinmetz; Nicole F,30,0,30,0
1708252457844,NEU 200C,A00,455013,Staff,0,0,0,1
1708252458375,NEU 276,A01,479489,Staff,35,0,36,1
1708252458901,NEU 277,A00,479492,Risbrough; Victoria Blythe,0,0,0,0
1708252459428,NEU 296,001,464921,Evans; Sean Jeffrey,48,0,50,2
1708252459428,NEU 296,002,464922,Staff,50,0,50,0
1708252459428,NEU 296,003,464925,Staff,50,0,50,0
1708252459958,NEUG 221,A00,479490,Zheng; Binhai,15,0,15,0
1708252460485,NEUG 280,A00,479491,Chen; Xu,0,0,0,0
1708252461014,NEUG 296,A00,479493,Bloodgood; Brenda Laurie,9998,0,9999,1
1708252461541,OPTH 296,001,465054,Baxter; Sally Liu,49,0,50,1
1708252461541,OPTH 296,002,465068,Afshari; Natalie,49,0,50,1
1708252461541,OPTH 296,003,465074,Staff,50,0,50,0
1708252462069,ORTH 296,A00,465104,Staff,50,0,50,0
1708252462069,ORTH 296,001,465111,Staff,50,0,50,0
1708252462069,ORTH 296,002,465120,Staff,50,0,50,0
1708252462595,PATH 224,A01,494386,Ross; Camille,11,0,12,1
1708252463122,PATH 296,001,465373,Calcutt; Nigel A,49,0,50,1
1708252463122,PATH 296,002,465374,Staff,50,0,50,0
1708252463122,PATH 296,003,465375,Staff,50,0,50,0
1708252463651,PEDS 296,001,465527,Weiss; Katherine Jean,49,0,50,1
1708252463651,PEDS 296,002,465528,Staff,50,0,50,0
1708252463651,PEDS 296,003,465529,Staff,50,0,50,0
1708252464177,PH 196BH,A01,405158,Binkin; Nancy Jeanne,20,0,20,0
1708252464706,PHAR 219,A00,415016,Ross; Camille,1,0,1,0
1708252465237,PHAR 231,A00,415017,Furnari; Frank,20,0,20,0
1708252465237,PHAR 231,B00,415018,Lopez Ramirez; Miguel Alej,20,0,20,0
1708252465763,PHAR 276,A00,415020,Mc Culloch; Andrew Douglas & Amaro; Rommie E,1,0,1,0
1708252466291,PHAR 295,A00,415022,Brown; Joan Heller,15,0,15,0
1708252466819,PHIL 1,A00,415023,Harrell; Maralee Mae,58,0,60,2
1708252467346,PHIL 10,A01,415026,Grush; Rick Scott,40,0,44,4
1708252467346,PHIL 10,A02,415028,Grush; Rick Scott,42,0,44,2
1708252467346,PHIL 10,A03,415029,Grush; Rick Scott,0,0,0,0
1708252467346,PHIL 10,A04,415031,Grush; Rick Scott,0,0,0,0
1708252467346,PHIL 10,A05,415113,Grush; Rick Scott,43,0,44,1
1708252467346,PHIL 10,A06,415114,Grush; Rick Scott,43,0,44,1
1708252467346,PHIL 10,A07,415116,Grush; Rick Scott,44,0,44,0
1708252467346,PHIL 10,A08,415118,Grush; Rick Scott,43,0,44,1
1708252467872,PHIL 12,A01,415120,McKenzie; Kerry V.,28,0,30,2
1708252467872,PHIL 12,A02,415136,McKenzie; Kerry V.,30,0,30,0
1708252467872,PHIL 12,A03,415137,McKenzie; Kerry V.,27,0,30,3
1708252467872,PHIL 12,A04,415142,McKenzie; Kerry V.,30,0,30,0
1708252468399,PHIL 13,A01,415165,Brink; David O.,25,0,25,0
1708252468399,PHIL 13,A02,415179,Brink; David O.,22,0,25,3
1708252468399,PHIL 13,A03,415185,Brink; David O.,24,0,25,1
1708252468399,PHIL 13,A04,415201,Brink; David O.,25,0,25,0
1708252468399,PHIL 13,A05,415204,Brink; David O.,25,0,25,0
1708252468399,PHIL 13,A06,415220,Brink; David O.,25,0,25,0
1708252468929,PHIL 15,A01,415250,Fulkerson; Matthew Todd,26,0,30,4
1708252468929,PHIL 15,A02,415281,Fulkerson; Matthew Todd,29,0,30,1
1708252469463,PHIL 27,A01,415293,Brandt; Reuven A,20,0,25,5
1708252469463,PHIL 27,A02,415296,Brandt; Reuven A,0,0,0,0
1708252469463,PHIL 27,A03,415332,Brandt; Reuven A,22,0,25,3
1708252469463,PHIL 27,A04,415333,Brandt; Reuven A,22,0,25,3
1708252469463,PHIL 27,A05,415342,Brandt; Reuven A,20,0,25,5
1708252469463,PHIL 27,A06,415384,Brandt; Reuven A,24,0,25,1
1708252469463,PHIL 27,A07,415385,Brandt; Reuven A,25,0,25,0
1708252469463,PHIL 27,A08,415391,Brandt; Reuven A,0,0,0,0
1708252469463,PHIL 27,A09,415406,Brandt; Reuven A,0,0,0,0
1708252469463,PHIL 27,A10,415407,Brandt; Reuven A,0,0,0,0
1708252469990,PHIL 28,A01,415412,Lamey; Andy M.,24,0,25,1
1708252469990,PHIL 28,A02,415470,Lamey; Andy M.,20,0,25,5
1708252469990,PHIL 28,A03,415474,Lamey; Andy M.,0,0,0,0
1708252469990,PHIL 28,A04,415475,Lamey; Andy M.,22,0,25,3
1708252469990,PHIL 28,A05,415487,Lamey; Andy M.,24,0,25,1
1708252469990,PHIL 28,A06,415506,Lamey; Andy M.,21,0,25,4
1708252469990,PHIL 28,A07,415507,Lamey; Andy M.,25,0,25,0
1708252469990,PHIL 28,A08,415508,Lamey; Andy M.,24,0,25,1
1708252469990,PHIL 28,A09,415509,Lamey; Andy M.,25,0,25,0
1708252469990,PHIL 28,A10,415510,Lamey; Andy M.,0,0,0,0
1708252470522,PHIL 33,A01,415521,Hardimon; Michael O.,35,0,35,0
1708252470522,PHIL 33,A02,415522,Hardimon; Michael O.,35,0,35,0
1708252471049,PHIL 60,A00,415523,Marechal; Patricia,55,0,60,5
1708252471576,PHIL 102,A00,415524,Johnson; Monte,37,0,40,3
1708252472102,PHIL 106,A00,415544,Watkins; Eric,40,0,40,0
1708252472628,PHIL 112,A00,415545,Watkins; Eric,34,0,40,6
1708252473156,PHIL 115,A00,415548,Nelkin; Dana Kay,20,0,20,0
1708252473683,PHIL 120,A00,415549,Carr; Jennifer Rose,64,0,65,1
1708252474211,PHIL 134,A00,415552,Carr; Jennifer Rose,40,0,40,0
1708252474737,PHIL 150,A00,415553,Cohen; Jonathan David,38,0,40,2
1708252475263,PHIL 171,A00,415561,Brink; David O.,39,0,40,1
1708252475789,PHIL 172,A00,415563,Lamey; Andy M.,40,0,40,0
1708252476314,PHIL 174,A01,415576,Danks; David J,21,0,25,4
1708252476314,PHIL 174,A02,415582,Danks; David J,22,0,25,3
1708252476314,PHIL 174,A03,415583,Danks; David J,24,0,25,1
1708252476314,PHIL 174,A04,415584,Danks; David J,25,0,25,0
1708252476841,PHIL 175,A00,415585,Shields; Christopher John,40,0,40,0
1708252477371,PHIL 181,A00,415601,Tolley; Clinton,34,0,40,6
1708252477897,PHIL 209B,A00,415655,Serlin; David,4,0,5,1
1708252478424,PHIL 209C,A00,415658,Gates; Kelly,5,0,5,0
1708252478954,PHIL 210,A00,415659,Marechal; Patricia,20,0,20,0
1708252479482,PHIL 230,A00,415661,Grush; Rick Scott,20,0,20,0
1708252480008,PHIL 232,A00,415662,Sher; Gila,20,0,20,0
1708252480536,PHIL 260,A00,415675,Bazargan-Forward; Saba,20,0,20,0
1708252481064,PHIL 277,A00,479176,Tolley; Clinton,9,0,10,1
1708252481594,PHIL 285,A00,415685,Kovaka; Karenc,20,0,20,0
1708252482120,PHIL 287,A00,415697,Marechal; Patricia,5,0,5,0
1708252482649,PHIL 290,001,415701,Nelkin; Dana Kay,9999,0,9999,0
1708252482649,PHIL 290,002,415721,Bazargan-Forward; Saba,9999,0,9999,0
1708252482649,PHIL 290,003,415731,Brandt; Reuven A,9999,0,9999,0
1708252482649,PHIL 290,004,415743,Brink; David O.,9999,0,9999,0
1708252482649,PHIL 290,005,415747,Callender; Craig Adam,9999,0,9999,0
1708252482649,PHIL 290,006,415779,Carr; Jennifer Rose,9999,0,9999,0
1708252482649,PHIL 290,007,415780,Cartwright; Nancy D.,9999,0,9999,0
1708252482649,PHIL 290,008,415781,Cohen; Jonathan David,9999,0,9999,0
1708252482649,PHIL 290,009,415782,Danks; David J,9999,0,9999,0
1708252482649,PHIL 290,010,415783,Fulkerson; Matthew Todd,9999,0,9999,0
1708252482649,PHIL 290,011,415784,Grush; Rick Scott,9999,0,9999,0
1708252482649,PHIL 290,012,415785,Hardimon; Michael O.,9999,0,9999,0
1708252482649,PHIL 290,013,415786,Harrell; Maralee Mae,9999,0,9999,0
1708252482649,PHIL 290,014,415787,Johnson; Monte,9999,0,9999,0
1708252482649,PHIL 290,015,415788,Kovaka; Karenc,9999,0,9999,0
1708252482649,PHIL 290,016,415789,Lamey; Andy M.,9999,0,9999,0
1708252482649,PHIL 290,017,415790,Marechal; Patricia,9999,0,9999,0
1708252482649,PHIL 290,018,415791,McKenzie; Kerry V.,9999,0,9999,0
1708252482649,PHIL 290,019,415792,Rickless; Samuel Charles,9999,0,9999,0
1708252482649,PHIL 290,020,415793,Sher; Gila,9999,0,9999,0
1708252482649,PHIL 290,021,415794,Shields; Christopher John,9999,0,9999,0
1708252482649,PHIL 290,022,415805,Tolley; Clinton,9999,0,9999,0
1708252482649,PHIL 290,023,415806,Vargas; Manuel Rogelio,9999,0,9999,0
1708252482649,PHIL 290,024,415807,Watkins; Eric,9999,0,9999,0
1708252482649,PHIL 290,025,415815,Chen; Keming,9999,0,9999,0
1708252483184,PHIL 295,001,415816,Bazargan-Forward; Saba,9999,0,9999,0
1708252483184,PHIL 295,002,415857,Brandt; Reuven A,9999,0,9999,0
1708252483184,PHIL 295,003,415858,Brink; David O.,9999,0,9999,0
1708252483184,PHIL 295,004,415877,Callender; Craig Adam,9999,0,9999,0
1708252483184,PHIL 295,005,415878,Carr; Jennifer Rose,9999,0,9999,0
1708252483184,PHIL 295,006,415884,Cartwright; Nancy D.,9999,0,9999,0
1708252483184,PHIL 295,007,415885,Chen; Keming,9999,0,9999,0
1708252483184,PHIL 295,008,415891,Cohen; Jonathan David,9999,0,9999,0
1708252483184,PHIL 295,009,415892,Danks; David J,9999,0,9999,0
1708252483184,PHIL 295,010,415937,Fulkerson; Matthew Todd,9999,0,9999,0
1708252483184,PHIL 295,011,415940,Grush; Rick Scott,9999,0,9999,0
1708252483184,PHIL 295,012,415945,Hardimon; Michael O.,9999,0,9999,0
1708252483184,PHIL 295,013,415946,Harrell; Maralee Mae,9999,0,9999,0
1708252483184,PHIL 295,014,415953,Johnson; Monte,9999,0,9999,0
1708252483184,PHIL 295,015,415954,Kovaka; Karenc,9999,0,9999,0
1708252483184,PHIL 295,016,415957,Lamey; Andy M.,9999,0,9999,0
1708252483184,PHIL 295,017,415958,Marechal; Patricia,9999,0,9999,0
1708252483184,PHIL 295,018,415959,McKenzie; Kerry V.,9999,0,9999,0
1708252483184,PHIL 295,019,415960,Nelkin; Dana Kay,9999,0,9999,0
1708252483184,PHIL 295,020,415961,Rickless; Samuel Charles,9999,0,9999,0
1708252483184,PHIL 295,021,415987,Sher; Gila,9999,0,9999,0
1708252483184,PHIL 295,022,416027,Shields; Christopher John,9999,0,9999,0
1708252483184,PHIL 295,023,416030,Tolley; Clinton,9999,0,9999,0
1708252483184,PHIL 295,024,416033,Vargas; Manuel Rogelio,9999,0,9999,0
1708252483184,PHIL 295,025,416034,Watkins; Eric,9999,0,9999,0
1708252483710,PHYA 224,A00,442106,Sandstrom; Karin Marie,30,0,30,0
1708252484240,PHYS 1A,A00,441607,Gilbert; Dylan Paul,346,0,362,16
1708252484769,PHYS 1AL,001,441608,Arlett; Jessica Lynn & Yagil; Avi,30,0,30,0
1708252484769,PHYS 1AL,002,441609,Arlett; Jessica Lynn & Yagil; Avi,28,0,30,2
1708252484769,PHYS 1AL,003,441610,Arlett; Jessica Lynn & Yagil; Avi,26,0,30,4
1708252484769,PHYS 1AL,004,441611,Arlett; Jessica Lynn & Yagil; Avi,29,0,30,1
1708252484769,PHYS 1AL,005,441612,Arlett; Jessica Lynn & Yagil; Avi,28,0,30,2
1708252484769,PHYS 1AL,006,441616,Arlett; Jessica Lynn & Yagil; Avi,28,0,30,2
1708252484769,PHYS 1AL,007,441618,Arlett; Jessica Lynn & Yagil; Avi,26,0,30,4
1708252484769,PHYS 1AL,008,441620,Arlett; Jessica Lynn & Yagil; Avi,29,0,30,1
1708252484769,PHYS 1AL,009,441623,Arlett; Jessica Lynn & Yagil; Avi,29,0,30,1
1708252484769,PHYS 1AL,010,441625,Arlett; Jessica Lynn & Yagil; Avi,29,0,30,1
1708252484769,PHYS 1AL,011,441626,Arlett; Jessica Lynn & Yagil; Avi,29,0,30,1
1708252484769,PHYS 1AL,012,441627,Arlett; Jessica Lynn & Yagil; Avi,29,0,30,1
1708252485296,PHYS 1B,A00,441630,Groisman; Alexander,351,0,362,11
1708252485826,PHYS 1BL,001,441632,Arlett; Jessica Lynn & Yagil; Avi,28,0,30,2
1708252485826,PHYS 1BL,002,441634,Arlett; Jessica Lynn & Yagil; Avi,29,0,30,1
1708252485826,PHYS 1BL,003,441636,Arlett; Jessica Lynn & Yagil; Avi,29,0,30,1
1708252485826,PHYS 1BL,004,441637,Arlett; Jessica Lynn & Yagil; Avi,29,0,30,1
1708252485826,PHYS 1BL,005,441639,Arlett; Jessica Lynn & Yagil; Avi,29,0,30,1
1708252485826,PHYS 1BL,006,441641,Arlett; Jessica Lynn & Yagil; Avi,26,0,30,4
1708252485826,PHYS 1BL,007,441642,Arlett; Jessica Lynn & Yagil; Avi,23,0,30,7
1708252485826,PHYS 1BL,008,441643,Arlett; Jessica Lynn & Yagil; Avi,30,0,30,0
1708252485826,PHYS 1BL,009,441646,Arlett; Jessica Lynn & Yagil; Avi,29,0,30,1
1708252485826,PHYS 1BL,010,441648,Arlett; Jessica Lynn & Yagil; Avi,29,0,30,1
1708252485826,PHYS 1BL,011,441652,Arlett; Jessica Lynn & Yagil; Avi,29,0,30,1
1708252485826,PHYS 1BL,012,441654,Arlett; Jessica Lynn & Yagil; Avi,30,0,30,0
1708252486356,PHYS 1C,A00,441658,Popmintchev; Tenio,587,0,600,13
1708252486356,PHYS 1C,B00,441662,Popmintchev; Tenio,558,0,600,42
1708252486890,PHYS 1CL,001,441664,Arlett; Jessica Lynn & Yagil; Avi,29,0,30,1
1708252486890,PHYS 1CL,002,441665,Arlett; Jessica Lynn & Yagil; Avi,27,0,30,3
1708252486890,PHYS 1CL,003,441666,Arlett; Jessica Lynn & Yagil; Avi,25,0,30,5
1708252486890,PHYS 1CL,004,441667,Arlett; Jessica Lynn & Yagil; Avi,30,0,30,0
1708252486890,PHYS 1CL,005,441668,Arlett; Jessica Lynn & Yagil; Avi,28,0,30,2
1708252486890,PHYS 1CL,006,441669,Arlett; Jessica Lynn & Yagil; Avi,25,0,30,5
1708252486890,PHYS 1CL,007,441671,Arlett; Jessica Lynn & Yagil; Avi,27,0,30,3
1708252486890,PHYS 1CL,008,441673,Arlett; Jessica Lynn & Yagil; Avi,30,0,30,0
1708252486890,PHYS 1CL,009,441674,Arlett; Jessica Lynn & Yagil; Avi,26,0,30,4
1708252486890,PHYS 1CL,010,441676,Arlett; Jessica Lynn & Yagil; Avi,30,0,30,0
1708252486890,PHYS 1CL,011,441677,Arlett; Jessica Lynn & Yagil; Avi,30,0,30,0
1708252486890,PHYS 1CL,012,441683,Arlett; Jessica Lynn & Yagil; Avi,30,0,30,0
1708252486890,PHYS 1CL,013,441685,Arlett; Jessica Lynn & Yagil; Avi,28,0,30,2
1708252486890,PHYS 1CL,014,441687,Arlett; Jessica Lynn & Yagil; Avi,30,0,30,0
1708252486890,PHYS 1CL,015,441689,Arlett; Jessica Lynn & Yagil; Avi,17,0,30,13
1708252486890,PHYS 1CL,016,441692,Arlett; Jessica Lynn & Yagil; Avi,29,0,30,1
1708252486890,PHYS 1CL,017,441696,Arlett; Jessica Lynn & Yagil; Avi,24,0,30,6
1708252486890,PHYS 1CL,018,441698,Arlett; Jessica Lynn & Yagil; Avi,25,0,30,5
1708252486890,PHYS 1CL,019,441702,Arlett; Jessica Lynn & Yagil; Avi,25,0,30,5
1708252486890,PHYS 1CL,020,441705,Arlett; Jessica Lynn & Yagil; Avi,29,0,30,1
1708252486890,PHYS 1CL,021,441706,Arlett; Jessica Lynn & Yagil; Avi,30,0,30,0
1708252486890,PHYS 1CL,022,441707,Arlett; Jessica Lynn & Yagil; Avi,30,0,30,0
1708252486890,PHYS 1CL,023,441708,Arlett; Jessica Lynn & Yagil; Avi,27,0,30,3
1708252486890,PHYS 1CL,024,441710,Arlett; Jessica Lynn & Yagil; Avi,29,0,30,1
1708252486890,PHYS 1CL,025,441711,Arlett; Jessica Lynn & Yagil; Avi,28,0,30,2
1708252486890,PHYS 1CL,026,441712,Arlett; Jessica Lynn & Yagil; Avi,29,0,30,1
1708252486890,PHYS 1CL,027,441713,Arlett; Jessica Lynn & Yagil; Avi,26,0,30,4
1708252486890,PHYS 1CL,028,441714,Arlett; Jessica Lynn & Yagil; Avi,29,0,30,1
1708252486890,PHYS 1CL,029,441715,Arlett; Jessica Lynn & Yagil; Avi,25,0,30,5
1708252486890,PHYS 1CL,030,441717,Arlett; Jessica Lynn & Yagil; Avi,29,0,30,1
1708252486890,PHYS 1CL,031,441718,Arlett; Jessica Lynn & Yagil; Avi,27,0,30,3
1708252486890,PHYS 1CL,032,441721,Arlett; Jessica Lynn & Yagil; Avi,30,0,30,0
1708252486890,PHYS 1CL,033,441724,Arlett; Jessica Lynn & Yagil; Avi,28,0,30,2
1708252486890,PHYS 1CL,034,441726,Arlett; Jessica Lynn & Yagil; Avi,29,0,30,1
1708252486890,PHYS 1CL,035,441728,Arlett; Jessica Lynn & Yagil; Avi,29,0,30,1
1708252486890,PHYS 1CL,036,441729,Arlett; Jessica Lynn & Yagil; Avi,30,0,30,0
1708252486890,PHYS 1CL,037,441730,Arlett; Jessica Lynn & Yagil; Avi,27,0,30,3
1708252486890,PHYS 1CL,038,441732,Arlett; Jessica Lynn & Yagil; Avi,29,0,30,1
1708252486890,PHYS 1CL,039,441733,Arlett; Jessica Lynn & Yagil; Avi,27,0,30,3
1708252486890,PHYS 1CL,040,441734,Arlett; Jessica Lynn & Yagil; Avi,30,0,30,0
1708252486890,PHYS 1CL,041,441735,Arlett; Jessica Lynn & Yagil; Avi,29,0,30,1
1708252486890,PHYS 1CL,042,441766,Arlett; Jessica Lynn & Yagil; Avi,30,0,30,0
1708252486890,PHYS 1CL,043,441768,Arlett; Jessica Lynn & Yagil; Avi,29,0,30,1
1708252486890,PHYS 1CL,044,441770,Arlett; Jessica Lynn & Yagil; Avi,30,0,30,0
1708252487423,PHYS 2A,A01,460308,Bal; Gurleen K,28,0,30,2
1708252487423,PHYS 2A,A02,460320,Bal; Gurleen K,30,0,30,0
1708252487423,PHYS 2A,A03,460321,Bal; Gurleen K,29,0,30,1
1708252487423,PHYS 2A,A04,460325,Bal; Gurleen K,28,0,30,2
1708252487423,PHYS 2A,A05,460326,Bal; Gurleen K,29,0,30,1
1708252487423,PHYS 2A,A06,460327,Bal; Gurleen K,30,0,30,0
1708252487423,PHYS 2A,A07,460495,Bal; Gurleen K,28,0,30,2
1708252487423,PHYS 2A,A08,460535,Bal; Gurleen K,27,0,30,3
1708252487423,PHYS 2A,A09,460536,Bal; Gurleen K,30,0,30,0
1708252487423,PHYS 2A,A10,460537,Bal; Gurleen K,30,0,30,0
1708252487423,PHYS 2A,A11,460538,Bal; Gurleen K,30,0,30,0
1708252487423,PHYS 2A,A12,460539,Bal; Gurleen K,30,0,30,0
1708252487954,PHYS 2B,A01,460620,Barreiro Guerrero; Julio,30,0,30,0
1708252487954,PHYS 2B,A02,460625,Barreiro Guerrero; Julio,30,0,30,0
1708252487954,PHYS 2B,A03,460626,Barreiro Guerrero; Julio,29,0,30,1
1708252487954,PHYS 2B,A04,460716,Barreiro Guerrero; Julio,26,0,30,4
1708252487954,PHYS 2B,A05,460756,Barreiro Guerrero; Julio,29,0,30,1
1708252487954,PHYS 2B,A06,460837,Barreiro Guerrero; Julio,30,0,30,0
1708252487954,PHYS 2B,A07,460865,Barreiro Guerrero; Julio,30,0,30,0
1708252487954,PHYS 2B,A08,460866,Barreiro Guerrero; Julio,30,0,30,0
1708252487954,PHYS 2B,A09,460867,Barreiro Guerrero; Julio,29,0,30,1
1708252487954,PHYS 2B,A10,460868,Barreiro Guerrero; Julio,30,0,30,0
1708252487954,PHYS 2B,A11,460869,Barreiro Guerrero; Julio,30,0,30,0
1708252487954,PHYS 2B,A12,460874,Barreiro Guerrero; Julio,30,0,30,0
1708252487954,PHYS 2B,B01,469381,Barreiro Guerrero; Julio,30,0,30,0
1708252487954,PHYS 2B,B02,469382,Barreiro Guerrero; Julio,29,0,30,1
1708252487954,PHYS 2B,B03,469402,Barreiro Guerrero; Julio,27,0,30,3
1708252487954,PHYS 2B,B04,469403,Barreiro Guerrero; Julio,28,0,30,2
1708252487954,PHYS 2B,B05,469442,Barreiro Guerrero; Julio,30,0,30,0
1708252487954,PHYS 2B,B06,469449,Barreiro Guerrero; Julio,30,0,30,0
1708252487954,PHYS 2B,B07,469450,Barreiro Guerrero; Julio,29,0,30,1
1708252487954,PHYS 2B,B08,469451,Barreiro Guerrero; Julio,30,0,30,0
1708252487954,PHYS 2B,B09,469457,Barreiro Guerrero; Julio,29,0,30,1
1708252487954,PHYS 2B,B10,469460,Barreiro Guerrero; Julio,30,0,30,0
1708252487954,PHYS 2B,B11,469468,Barreiro Guerrero; Julio,30,0,30,0
1708252487954,PHYS 2B,B12,469475,Barreiro Guerrero; Julio,30,0,30,0
1708252488487,PHYS 2BL,A01,441779,Meyertholen; Andrew D.,21,0,24,3
1708252488487,PHYS 2BL,A02,441780,Meyertholen; Andrew D.,17,0,24,7
1708252488487,PHYS 2BL,A03,441781,Meyertholen; Andrew D.,20,0,24,4
1708252488487,PHYS 2BL,A04,441782,Meyertholen; Andrew D.,21,0,24,3
1708252488487,PHYS 2BL,A05,441784,Meyertholen; Andrew D.,23,0,24,1
1708252488487,PHYS 2BL,A06,441786,Meyertholen; Andrew D.,23,0,24,1
1708252488487,PHYS 2BL,A07,441788,Meyertholen; Andrew D.,23,0,24,1
1708252488487,PHYS 2BL,A08,441790,Meyertholen; Andrew D.,24,0,24,0
1708252488487,PHYS 2BL,A09,441792,Meyertholen; Andrew D.,24,0,24,0
1708252488487,PHYS 2BL,A10,441794,Meyertholen; Andrew D.,23,0,24,1
1708252488487,PHYS 2BL,A11,441796,Meyertholen; Andrew D.,22,0,24,2
1708252488487,PHYS 2BL,A12,441798,Meyertholen; Andrew D.,24,0,24,0
1708252488487,PHYS 2BL,A13,441800,Meyertholen; Andrew D.,24,0,24,0
1708252488487,PHYS 2BL,A14,441802,Meyertholen; Andrew D.,24,0,24,0
1708252488487,PHYS 2BL,A15,441804,Meyertholen; Andrew D.,23,0,24,1
1708252489021,PHYS 2C,A01,460540,Tan; Tzer Han,30,0,30,0
1708252489021,PHYS 2C,A02,460541,Tan; Tzer Han,28,0,30,2
1708252489021,PHYS 2C,A03,460542,Tan; Tzer Han,28,0,30,2
1708252489021,PHYS 2C,A04,460543,Tan; Tzer Han,28,0,30,2
1708252489021,PHYS 2C,A05,460544,Tan; Tzer Han,28,0,30,2
1708252489021,PHYS 2C,A06,460545,Tan; Tzer Han,29,0,30,1
1708252489021,PHYS 2C,A07,460553,Tan; Tzer Han,30,0,30,0
1708252489021,PHYS 2C,A08,460561,Tan; Tzer Han,30,0,30,0
1708252489021,PHYS 2C,A09,460562,Tan; Tzer Han,28,0,30,2
1708252489021,PHYS 2C,A10,460563,Tan; Tzer Han,29,0,30,1
1708252489021,PHYS 2C,A11,460567,Tan; Tzer Han,30,0,30,0
1708252489021,PHYS 2C,A12,460568,Tan; Tzer Han,28,0,30,2
1708252489547,PHYS 2CL,A01,441809,Ni; Kaixuan,25,0,28,3
1708252489547,PHYS 2CL,A02,441811,Ni; Kaixuan,27,0,28,1
1708252489547,PHYS 2CL,A03,441814,Ni; Kaixuan,23,0,28,5
1708252489547,PHYS 2CL,A04,441817,Ni; Kaixuan,28,0,28,0
1708252489547,PHYS 2CL,A05,441819,Ni; Kaixuan,26,0,28,2
1708252489547,PHYS 2CL,A06,441820,Ni; Kaixuan,27,0,28,1
1708252490079,PHYS 2D,A01,460569,Sharma; Vivek A.,24,0,25,1
1708252490079,PHYS 2D,A02,460574,Sharma; Vivek A.,24,0,25,1
1708252490079,PHYS 2D,A03,460575,Sharma; Vivek A.,25,0,25,0
1708252490607,PHYS 4B,A01,441829,Grinstein; Benjamin,34,0,38,4
1708252490607,PHYS 4B,A02,441831,Grinstein; Benjamin,30,0,32,2
1708252490607,PHYS 4B,A03,441832,Grinstein; Benjamin,30,0,30,0
1708252490607,PHYS 4B,A04,441833,Grinstein; Benjamin,30,0,30,0
1708252491133,PHYS 4E,A01,441907,Frano Pereira; Alex M,33,0,34,1
1708252491133,PHYS 4E,A02,441958,Frano Pereira; Alex M,34,0,34,0
1708252491660,PHYS 10,A01,441971,Burgasser; Adam Jonathan,118,0,120,2
1708252492186,PHYS 13,A01,441974,Wright; Shelley Adams,61,0,65,4
1708252492712,PHYS 87,A00,486898,Grinstein; Benjamin,19,0,20,1
1708252493242,PHYS 100C,A01,441978,Averitt; Richard Douglas,58,0,60,2
1708252493769,PHYS 105B,A01,441985,Green; Daniel Richard,37,0,40,3
1708252494298,PHYS 120,A01,441995,Arnold; Kam S,40,0,44,4
1708252494298,PHYS 120,A02,442011,Arnold; Kam S,41,0,44,3
1708252494824,PHYS 130A,A01,442032,Parker; Daniel E,74,0,75,1
1708252495352,PHYS 130B,A01,442056,Branson; James G,47,0,50,3
1708252495883,PHYS 139,A00,442057,Jun; Suckjoon,30,0,30,0
1708252495883,PHYS 139,B00,442059,Duarte; Javier Mauricio & Li; Aobo,42,0,50,8
1708252496410,PHYS 140A,A01,442065,Shotwell; Brian,49,0,50,1
1708252496940,PHYS 152B,A01,442067,Hirsch; Jorge Eduardo,16,0,20,4
1708252497470,PHYS 154,A01,442069,Jenkins; Elizabeth,29,0,30,1
1708252497997,PHYS 162,A01,442096,Keating; Brian,64,0,65,1
1708252498526,PHYS 170,A01,486870,Oh; Seungeun,39,0,40,1
1708252499052,PHYS 177,A00,442103,Dudko; Olga,20,0,20,0
1708252499581,PHYS 203B,A01,442132,Fogler; Michael M.,20,0,20,0
1708252500114,PHYS 210A,A01,442143,Hwa; Terence T.,20,0,20,0
1708252500640,PHYS 212C,A01,442200,Chivukula; Raja S,18,0,20,2
1708252501166,PHYS 215C,A00,442201,Intriligator; Kenneth Arthur,19,0,20,1
1708252501695,PHYS 225C,A01,442203,Flauger; Raphael M,19,0,20,1
1708252502222,PHYS 227,A00,442204,Tytler; David Robert,29,0,30,1
1708252502748,PHYS 230,A01,442206,McGreevy; John A.,20,0,20,0
1708252503278,PHYS 239,A00,442207,Goldenfeld; Nigel,20,0,20,0
1708252503278,PHYS 239,B00,442208,Duarte; Javier Mauricio & Li; Aobo,5,0,5,0
1708252503802,PHYS 244,A01,442280,Norman; Michael L,12,0,20,8
1708252504329,PHYS 250,A00,442300,Fogler; Michael M.,50,0,50,0
1708252504858,PHYS 251,A00,442307,Grinstein; Benjamin,20,0,20,0
1708252505384,PHYS 252,A00,442348,Diamond; Patrick H,10,0,10,0
1708252505912,PHYS 253,A00,442349,Theissen; Christopher Alexander,30,0,30,0
1708252506437,PHYS 254,A00,442352,Hwa; Terence T.,30,0,30,0
1708252506964,PHYS 255,A00,442423,Hwa; Terence T.,30,0,30,0
1708252507492,PHYS 258,A00,442426,Theissen; Christopher Alexander,30,0,30,0
1708252508018,PHYS 260,A00,442427,Frano Pereira; Alex M,50,0,50,0
1708252508545,PHYS 277,A00,442428,Dudko; Olga,20,0,20,0
1708252509147,POLI 5D,A01,419010,Dai; Yinlin,5,0,7,2
1708252509147,POLI 5D,A02,419020,Dai; Yinlin,7,0,7,0
1708252509147,POLI 5D,A03,419022,Dai; Yinlin,4,0,6,2
1708252509147,POLI 5D,A04,419040,Dai; Yinlin,5,0,5,0
1708252509147,POLI 5D,B01,419065,Dai; Yinlin,7,0,7,0
1708252509147,POLI 5D,B02,419068,Dai; Yinlin,7,0,7,0
1708252509147,POLI 5D,B03,419069,Dai; Yinlin,6,0,6,0
1708252509147,POLI 5D,B04,419070,Dai; Yinlin,5,0,5,0
1708252509147,POLI 5D,C01,487211,Staff,3,0,5,2
1708252510689,POLI 11D,A01,419072,Desposato; Scott,32,0,34,2
1708252510689,POLI 11D,A02,419073,Desposato; Scott,33,0,34,1
1708252510689,POLI 11D,A03,419082,Desposato; Scott,32,0,34,2
1708252510689,POLI 11D,A04,419123,Desposato; Scott,34,0,34,0
1708252510689,POLI 11D,A05,419124,Desposato; Scott,34,0,34,0
1708252510689,POLI 11D,A06,419125,Desposato; Scott,34,0,34,0
1708252511236,POLI 12D,A01,419127,Gartzke; Erik,29,0,34,5
1708252511236,POLI 12D,A02,419128,Gartzke; Erik,34,0,34,0
1708252511236,POLI 12D,A03,419129,Gartzke; Erik,34,0,34,0
1708252511236,POLI 12D,A04,419130,Gartzke; Erik,34,0,34,0
1708252511236,POLI 12D,A05,419131,Gartzke; Erik,32,0,34,2
1708252511236,POLI 12D,A06,419168,Gartzke; Erik,34,0,34,0
1708252511764,POLI 13DR,A01,477733,Draper; Matthew William,28,0,34,6
1708252511764,POLI 13DR,A02,477734,Draper; Matthew William,32,0,34,2
1708252511764,POLI 13DR,A03,477736,Draper; Matthew William,33,0,34,1
1708252511764,POLI 13DR,A04,477737,Draper; Matthew William,32,0,34,2
1708252511764,POLI 13DR,A05,477739,Draper; Matthew William,31,0,34,3
1708252511764,POLI 13DR,A06,477740,Draper; Matthew William,34,0,34,0
1708252512293,POLI 30D,A01,419179,Desposato; Scott,19,0,28,9
1708252512293,POLI 30D,A02,419180,Desposato; Scott,25,0,28,3
1708252512293,POLI 30D,A03,419181,Desposato; Scott,27,0,28,1
1708252512293,POLI 30D,A04,419182,Desposato; Scott,28,0,28,0
1708252512293,POLI 30D,A05,419187,Desposato; Scott,24,0,28,4
1708252512293,POLI 30D,A06,419189,Desposato; Scott,28,0,28,0
1708252512823,POLI 100E,A00,419191,Pitcher; Kennedy Anell,105,0,115,10
1708252513350,POLI 104P,A00,419192,Orfield; Michael Bennett,183,0,196,13
1708252513880,POLI 104U,A00,419193,Nichter; Maysa,88,0,115,27
1708252514408,POLI 108,A00,419194,Adida; Claire,293,0,295,2
1708252514937,POLI 110C,A00,419195,Soon; Valerie,47,0,50,3
1708252515468,POLI 120D,A00,419207,Hansen; Jan Eric,48,0,50,2
1708252515995,POLI 124A,A00,419209,Fortunato; David,48,0,50,2
1708252517537,POLI 131CR,A00,419211,Hoston; Germaine,41,0,50,9
1708252517537,POLI 131CR,B00,481592,Hoston; Germaine,10,0,10,0
1708252518064,POLI 136A,A00,419212,Roeder; Philip G,111,0,115,4
1708252518593,POLI 140D,A00,419213,Wong; Tak Kei,183,0,192,9
1708252519121,POLI 142D,A00,419214,Gartzke; Erik,227,0,230,3
1708252519651,POLI 145C,A00,419222,Fisk; David Lee,101,0,115,14
1708252520177,POLI 150A,A00,419225,Wong; Tak Kei,216,0,230,14
1708252520702,POLI 170A,A00,419226,Skillman; Rachel Diane,115,0,115,0
1708252521228,POLI 179,A00,419238,Staff,95,0,104,9
1708252521757,POLI 194,A00,455332,Hill; Seth J,0,0,0,0
1708252522285,POLI 194SD,A00,419248,Nichter; Maysa,999,0,999,0
1708252522813,POLI 197SD,001,419258,Nichter; Maysa,999,0,999,0
1708252523339,POLI 203B,A00,419265,Slantchev; Branislav,21,0,25,4
1708252523865,POLI 214R,A00,419275,Hoston; Germaine,23,0,25,2
1708252524391,POLI 219,A00,419289,Soon; Valerie,24,0,25,1
1708252524919,POLI 220A,A00,419299,Ferree; Karen E,21,0,25,4
1708252525446,POLI 233,A00,419333,Adida; Claire,23,0,25,2
1708252525976,POLI 243,A00,479118,Joseph; Michael F,23,0,25,2
1708252526502,POLI 251,A00,419334,Ban; Pamela M,23,0,25,2
1708252527026,POLI 257,A00,419335,Hill; Seth J,25,0,25,0
1708252527553,POLI 273,A00,419336,Mignozzetti; Umberto,16,0,25,9
1708252528079,POLI 280,A00,419337,Hafner-Burton; Emilie,18,0,25,7
1708252528620,POLI 281,A00,419338,Ban; Pamela M,21,0,25,4
1708252529145,POLI 282,A00,419339,Ferree; Karen E,19,0,25,6
1708252529673,POLI 283,A00,419340,Naoi; Megumi,23,0,25,2
1708252530200,POLI 285,A00,419341,Ingham; Sean,25,0,25,0
1708252530729,POLI 286,A00,419342,Mignozzetti; Umberto,23,0,25,2
1708252531256,POLI 288,A00,479174,Fowler; James,13,0,15,2
1708252531782,PSY 296,001,465760,Besterman; Aaron David,49,0,50,1
1708252531782,PSY 296,002,465765,Eyler; Lisa T.,49,0,50,1
1708252531782,PSY 296,003,465767,Patel; Ekta Himanshu,49,0,50,1
1708252532311,PSYC 3R,A00,419378,Pilegard; Celeste Cristine,314,0,325,11
1708252532837,PSYC 7,A00,419384,Powell; Lindsey Jane,288,0,295,7
1708252533400,PSYC 60,A01,460208,Lowe; Angela Beth,31,0,35,4
1708252533400,PSYC 60,A02,460209,Lowe; Angela Beth,28,0,35,7
1708252533400,PSYC 60,A03,460210,Lowe; Angela Beth,35,0,35,0
1708252533400,PSYC 60,A04,460211,Lowe; Angela Beth,33,0,35,2
1708252533400,PSYC 60,A05,460212,Lowe; Angela Beth,34,0,35,1
1708252533400,PSYC 60,A06,460213,Lowe; Angela Beth,35,0,35,0
1708252533400,PSYC 60,A07,460214,Lowe; Angela Beth,33,0,35,2
1708252533400,PSYC 60,B01,460215,Rose; Fred E.,35,0,35,0
1708252533400,PSYC 60,B02,460216,Rose; Fred E.,35,0,35,0
1708252533400,PSYC 60,B03,460218,Rose; Fred E.,35,0,35,0
1708252533400,PSYC 60,B04,460219,Rose; Fred E.,35,0,35,0
1708252533400,PSYC 60,B05,460220,Rose; Fred E.,32,0,35,3
1708252533400,PSYC 60,B06,460221,Rose; Fred E.,35,0,35,0
1708252533400,PSYC 60,B07,460222,Rose; Fred E.,35,0,35,0
1708252533962,PSYC 70,A01,460223,Pilegard; Celeste Cristine,29,0,35,6
1708252533962,PSYC 70,A02,460224,Pilegard; Celeste Cristine,32,0,35,3
1708252533962,PSYC 70,A03,460225,Pilegard; Celeste Cristine,34,0,35,1
1708252533962,PSYC 70,A04,460266,Pilegard; Celeste Cristine,33,0,35,2
1708252533962,PSYC 70,A05,460267,Pilegard; Celeste Cristine,35,0,35,0
1708252533962,PSYC 70,A06,460277,Pilegard; Celeste Cristine,34,0,35,1
1708252534505,PSYC 71,A01,419620,Staff,19,0,21,2
1708252534505,PSYC 71,A02,419662,Staff,20,0,21,1
1708252534505,PSYC 71,B01,419682,Geller; Emma Harlan,24,0,25,1
1708252534505,PSYC 71,B02,419732,Geller; Emma Harlan,26,0,26,0
1708252535035,PSYC 88,A00,419733,Dobkins; Karen R.,47,0,65,18
1708252535561,PSYC 100,A00,419734,Chapman; Eddie Nathaniel,388,0,410,22
1708252536089,PSYC 101,A00,419735,Walker; Caren Michelle,272,0,295,23
1708252536616,PSYC 102,A00,419779,Moranton; Nirelia Melbina-,292,0,295,3
1708252537142,PSYC 104,A00,419880,Fine; Rachel,267,0,295,28
1708252537685,PSYC 105,A00,419946,Lowe; Angela Beth,276,0,295,19
1708252538210,PSYC 111B,A01,419948,Geller; Emma Harlan,35,0,35,0
1708252538741,PSYC 116C,A01,420046,Lang; Ariel,25,0,25,0
1708252539267,PSYC 117,A01,420092,Bajic; Daniel Andrew,25,0,25,0
1708252539793,PSYC 118,A01,420095,Miller; Cory T.,37,0,45,8
1708252540323,PSYC 124,A00,420096,Chapman; Eddie Nathaniel,381,0,410,29
1708252540849,PSYC 127,A00,420097,Dickenson; Janna Alene,14,0,20,6
1708252541379,PSYC 132,A00,420121,Staff,114,0,120,6
1708252541905,PSYC 133R,A01,420172,Golden; Susan S. & Gorman; Michael R.,10,0,16,6
1708252541905,PSYC 133R,A02,420173,Golden; Susan S. & Gorman; Michael R.,16,0,16,0
1708252541905,PSYC 133R,A03,420175,Golden; Susan S. & Gorman; Michael R.,16,0,16,0
1708252541905,PSYC 133R,A04,420249,Golden; Susan S. & Gorman; Michael R.,13,0,16,3
1708252542435,PSYC 134,A00,420311,Kaye; Walter H.,296,0,300,4
1708252542964,PSYC 137,A00,420312,Lin; Chujun,292,0,295,3
1708252543508,PSYC 144,A00,420313,Wixted; John T,287,0,295,8
1708252544037,PSYC 147,A00,420315,Wong; Lauren Hitomi,120,0,146,26
1708252544562,PSYC 164,A00,420328,Kaplan; Paul,259,0,295,36
1708252545089,PSYC 172,A00,420336,Dickenson; Janna Alene,294,0,300,6
1708252545617,PSYC 178,A00,420337,Glaser; Dale,131,0,146,15
1708252546142,PSYC 179,A00,420338,Lacefield; Katharine I,256,0,328,72
1708252546670,PSYC 181,A00,420339,Anagnostaras; Stephan,333,0,350,17
1708252547195,PSYC 184,A00,420367,Wilson; Brent M,275,0,295,20
1708252547724,PSYC 188,A00,420368,Lacefield; Katharine I,234,0,300,66
1708252548251,PSYC 190,A00,420378,Barner; David A.,374,0,395,21
1708252548777,PSYC 193,B00,420626,Brashier; Nadia Marie,215,0,216,1
1708252548777,PSYC 193,C00,420643,Gremel; Christina M,33,0,35,2
1708252549311,PSYC 193L,A01,420817,Brown; Sandra A,65,0,65,0
1708252549311,PSYC 193L,B01,420830,Staff,26,0,30,4
1708252549311,PSYC 193L,C01,420832,Staff,49,0,49,0
1708252549311,PSYC 193L,D01,420834,Staff,27,0,30,3
1708252549311,PSYC 193L,E01,493996,Aron; Adam,24,0,24,0
1708252549840,PSYC 194C,A01,420905,Heyman; Gail D.,1,0,1,0
1708252550367,PSYC 205,A00,420906,Harris; Christine Renee,17,0,20,3
1708252550893,PSYC 218,A00,420907,Brady; Timothy Francis,11,0,20,9
1708252551421,PSYC 224,A00,420908,Gremel; Christina M,30,0,30,0
1708252551948,PSYC 242,A00,421469,Walker; Caren Michelle,27,0,30,3
1708252552475,PSYC 247,A00,421473,Walker; Caren Michelle,14,0,20,6
1708252553001,PSYC 270C,A00,421554,Dobkins; Karen R.,13,0,20,7
1708252553525,PSYC 272,A00,421561,Gentner; Tim,20,0,20,0
1708252554051,PSYC 274,A00,421564,McCullough; Michael E,29,0,30,1
1708252554576,PSYC 275,A00,421620,Staff,23,0,30,7
1708252555105,PSYC 276,A00,421622,McCullough; Michael E,14,0,20,6
1708252555634,PSYC 280,A00,421623,Serences; John Thomas,76,0,85,9
1708252556193,PSYC 296,001,421667,Anagnostaras; Stephan,9999,0,9999,0
1708252556193,PSYC 296,002,421773,Aron; Adam,9999,0,9999,0
1708252556193,PSYC 296,003,421794,Mukku; Dhananjaya,9999,0,9999,0
1708252556193,PSYC 296,004,421795,Barner; David A.,9998,0,9999,1
1708252556193,PSYC 296,005,421796,Schachner; Adena,9999,0,9999,0
1708252556193,PSYC 296,006,421797,Brown; Sandra A,9999,0,9999,0
1708252556193,PSYC 296,007,421798,Chapman; Eddie Nathaniel,9999,0,9999,0
1708252556193,PSYC 296,008,421799,Dickenson; Janna Alene,9999,0,9999,0
1708252556193,PSYC 296,009,421800,Dobkins; Karen R.,9998,0,9999,1
1708252556193,PSYC 296,010,421801,Fan; Judith Ellen,9999,0,9999,0
1708252556193,PSYC 296,011,421803,Ferreira; Victor,9999,0,9999,0
1708252556193,PSYC 296,012,421814,Geller; Emma Harlan,9998,0,9999,1
1708252556193,PSYC 296,013,422102,Gentner; Tim,9999,0,9999,0
1708252556193,PSYC 296,014,422103,Gorman; Michael R.,9999,0,9999,0
1708252556193,PSYC 296,015,422104,Gremel; Christina M,9999,0,9999,0
1708252556193,PSYC 296,016,422106,Harris; Christine Renee,9999,0,9999,0
1708252556193,PSYC 296,017,422107,Heyman; Gail D.,9999,0,9999,0
1708252556193,PSYC 296,018,422108,McCullough; Michael E,9999,0,9999,0
1708252556193,PSYC 296,019,422109,Mc Kenzie; Craig R.M.,9999,0,9999,0
1708252556193,PSYC 296,020,422122,Miller; Cory T.,9999,0,9999,0
1708252556193,PSYC 296,021,422123,Pashler; Harold E,9999,0,9999,0
1708252556193,PSYC 296,022,422124,Pilegard; Celeste Cristine,9999,0,9999,0
1708252556193,PSYC 296,023,422125,Powell; Lindsey Jane,9999,0,9999,0
1708252556193,PSYC 296,025,422127,Rickard; Timothy C.,9998,0,9999,1
1708252556193,PSYC 296,026,422128,Serences; John Thomas,9998,0,9999,1
1708252556193,PSYC 296,027,422130,Walker; Caren Michelle,9998,0,9999,1
1708252556193,PSYC 296,028,422132,Winkielman; Piotr,9999,0,9999,0
1708252556193,PSYC 296,029,422134,Wixted; John T,9996,0,9999,3
1708252556193,PSYC 296,030,422146,Brady; Timothy Francis,9998,0,9999,1
1708252556193,PSYC 296,031,422154,Carver; Leslie J.,9999,0,9999,0
1708252556193,PSYC 296,032,422161,Lin; Chujun,9999,0,9999,0
1708252556193,PSYC 296,033,422169,Brashier; Nadia Marie,9998,0,9999,1
1708252556193,PSYC 296,034,422177,Oesch; Nicholas W,9999,0,9999,0
1708252556719,RAD 296,001,465795,Staff,50,0,50,0
1708252556719,RAD 296,002,465796,Staff,50,0,50,0
1708252556719,RAD 296,003,465797,Staff,50,0,50,0
1708252557245,RELI 150,A00,419353,Rahimi; Babak,37,0,40,3
1708252557790,REV 87,A00,422721,Lyon; Antony J.,19,0,20,1
1708252558317,RMAS 296,001,465827,Murphy; James D,49,0,50,1
1708252558317,RMAS 296,002,465828,Staff,50,0,50,0
1708252558317,RMAS 296,003,465831,Staff,50,0,50,0
1708252558846,RMED 296,001,466791,Staff,50,0,50,0
1708252558846,RMED 296,002,466792,Staff,50,0,50,0
1708252558846,RMED 296,003,466793,Staff,50,0,50,0
1708252559376,SE 3,A01,446938,Van Den Einde; Yael Dahlia,50,0,52,2
1708252559376,SE 3,A02,446942,Van Den Einde; Yael Dahlia,49,0,52,3
1708252559376,SE 3,A03,446948,Van Den Einde; Yael Dahlia,52,0,53,1
1708252559376,SE 3,A04,446965,Van Den Einde; Yael Dahlia,53,0,53,0
1708252559904,SE 9,A01,447015,Kuester; Falko,30,0,34,4
1708252559904,SE 9,A02,447017,Kuester; Falko,33,0,33,0
1708252559904,SE 9,A03,447022,Kuester; Falko,31,0,33,2
1708252560432,SE 101B,A01,447040,Kosmatka; John B,55,0,56,1
1708252560959,SE 105,A01,447042,Qiao; Yu,118,0,120,2
1708252561489,SE 110A,A01,467467,Asaro; Robert J,56,0,56,0
1708252562015,SE 110B,A00,447045,Zhu; Qiang,122,0,125,3
1708252562544,SE 130B,A01,447049,Chadha; Mayank,92,0,100,8
1708252563070,SE 131A,A01,447059,Krysl; Petr,102,0,110,8
1708252563595,SE 132,A01,447078,Chen; Jiun-Shyan,48,0,50,2
1708252564124,SE 140B,A01,447086,Restrepo; Jose,29,0,34,5
1708252564124,SE 140B,A02,447123,Restrepo; Jose,21,0,33,12
1708252564124,SE 140B,A03,447124,Restrepo; Jose,30,0,33,3
1708252564705,SE 143B,A01,447133,Tehrani; Mehran,11,0,15,4
1708252564705,SE 143B,A02,447134,Tehrani; Mehran,12,0,15,3
1708252565236,SE 150A,A01,447136,Uang; Chia-Ming,94,0,100,6
1708252565762,SE 150B,A01,447214,Morrison; Machel Leigh,49,0,50,1
1708252566305,SE 151B,A00,447215,Shing; P. Benson,71,0,75,4
1708252566833,SE 160B,A01,467468,Kim; Hyunsun Alicia,91,0,100,9
1708252567361,SE 165,A00,447238,Farrar; Charles R.,9,0,10,1
1708252567887,SE 184,A00,447253,Hutchinson; Tara,20,0,20,0
1708252568413,SE 202,A00,447392,Kosmatka; John B,25,0,30,5
1708252568940,SE 204,A00,447482,Todd; Michael,12,0,20,8
1708252569469,SE 206,A00,447483,Conte; Joel P,30,0,30,0
1708252569996,SE 213,A00,447499,Palermo; Alessandro,17,0,30,13
1708252570525,SE 215,A00,447500,Zhu; Qiang,34,0,45,11
1708252571052,SE 222,A00,447507,Elgamal; Ahmed,30,0,30,0
1708252571578,SE 227,A00,447576,Hutchinson; Tara,20,0,25,5
1708252572103,SE 244,A00,447577,Elgamal; Ahmed,29,0,30,1
1708252572631,SE 247,A00,447580,Hutchinson; Tara,0,0,5,5
1708252573160,SE 251B,A00,447612,Qiao; Yu,15,0,25,10
1708252573690,SE 253B,A00,447613,Kim; Hyonny,28,0,30,2
1708252574220,SE 260B,A00,447614,Kim; Hyunsun Alicia,10,0,10,0
1708252574750,SE 265,A00,447615,Farrar; Charles R.,20,0,25,5
1708252575279,SE 266,A00,447616,Loh; Chin Hsiung,23,0,25,2
1708252576334,SE 280,A00,447650,Krysl; Petr,22,0,25,3
1708252576863,SE 281,A01,447658,Kuester; Falko,12,0,30,18
1708252577392,SE 290,A00,447659,Qiao; Yu,78,0,100,22
1708252577923,SE 296,001,447666,Asaro; Robert J,9999,0,9999,0
1708252577923,SE 296,002,447669,Chen; Jiun-Shyan,9999,0,9999,0
1708252577923,SE 296,003,447689,Conte; Joel P,9999,0,9999,0
1708252577923,SE 296,004,447690,Elgamal; Ahmed,9999,0,9999,0
1708252577923,SE 296,005,447728,Hutchinson; Tara,9999,0,9999,0
1708252577923,SE 296,006,447733,Jandaghi Semnani; Shabnam,9999,0,9999,0
1708252577923,SE 296,007,447734,Kim; Hyonny,9999,0,9999,0
1708252577923,SE 296,008,447737,Kim; Hyunsun Alicia,9999,0,9999,0
1708252577923,SE 296,009,447738,Kosmatka; John B,9999,0,9999,0
1708252577923,SE 296,010,447739,Krysl; Petr,9999,0,9999,0
1708252577923,SE 296,011,447740,Kuester; Falko,9999,0,9999,0
1708252577923,SE 296,012,447741,Lanza Di Scalea; Francesco,9999,0,9999,0
1708252577923,SE 296,013,447742,Loh; Kenneth J. H.,9999,0,9999,0
1708252577923,SE 296,014,447745,McCartney; John Scott,9999,0,9999,0
1708252577923,SE 296,015,447747,Morrison; Machel Leigh,9999,0,9999,0
1708252577923,SE 296,016,447749,Mosqueda; Gilberto,9999,0,9999,0
1708252577923,SE 296,017,447874,Qiao; Yu,9999,0,9999,0
1708252577923,SE 296,018,447875,Restrepo; Jose,9999,0,9999,0
1708252577923,SE 296,019,447886,Shing; P. Benson,9999,0,9999,0
1708252577923,SE 296,020,447887,Todd; Michael,9999,0,9999,0
1708252577923,SE 296,021,447888,Tomac; Ingrid,9999,0,9999,0
1708252577923,SE 296,022,447889,Tsampras; Georgios,9999,0,9999,0
1708252577923,SE 296,023,447890,Uang; Chia-Ming,9999,0,9999,0
1708252577923,SE 296,024,447931,Van Den Einde; Yael Dahlia,9999,0,9999,0
1708252577923,SE 296,025,447932,Zhu; Qiang,9999,0,9999,0
1708252577923,SE 296,026,448007,Tehrani; Mehran,9999,0,9999,0
1708252577923,SE 296,027,448008,Palermo; Alessandro,9999,0,9999,0
1708252577923,SE 296,028,492941,Farrar; Charles R.,9998,0,9999,1
1708252578451,SIO 10,A00,446025,Borsa; Adrian Antal,573,0,590,17
1708252578977,SIO 16,A00,446031,Gee; Jeffrey S,119,0,120,1
1708252579505,SIO 50,A01,446057,Cook; Geoffrey W,19,0,22,3
1708252579505,SIO 50,A02,446058,Cook; Geoffrey W,21,0,22,1
1708252580037,SIO 75,A00,446060,Norris; Richard D.,32,0,35,3
1708252580562,SIO 87,A00,479215,Feddersen; Falk & Morzfeld; Matthias,20,0,20,0
1708252580562,SIO 87,B00,489613,Cook; Geoffrey W,19,0,20,1
1708252580562,SIO 87,C00,489620,Cook; Geoffrey W,20,0,20,0
1708252581086,SIO 90,A00,446061,Staff,61,0,70,9
1708252581615,SIO 113,A01,446064,May; David Alexander,27,0,30,3
1708252582666,SIO 128,A00,446115,Bartlett; Douglas H,110,0,120,10
1708252583196,SIO 135,A01,446153,Fricker; Helen A.,16,0,17,1
1708252583196,SIO 135,A02,446156,Fricker; Helen A.,14,0,18,4
1708252583740,SIO 136,A01,446159,Kacev; David & Wegner; Nicholas Craig & Bartlett; Douglas H,31,0,33,2
1708252583740,SIO 136,A02,446160,Kacev; David & Wegner; Nicholas Craig & Bartlett; Douglas H,33,0,33,0
1708252584266,SIO 139,A00,446164,Kacev; David,66,0,70,4
1708252584792,SIO 141,A01,446173,Pomeroy; Robert S.,11,0,12,1
1708252585319,SIO 143,A01,446175,Andersson; Andreas Jerry,20,0,30,10
1708252585847,SIO 145,A01,446181,Choy; Carolyn Anela,6,0,18,12
1708252586376,SIO 152,A01,446184,Van Allen; Emily Joyce,8,0,10,2
1708252586376,SIO 152,A02,479204,Van Allen; Emily Joyce,10,0,10,0
1708252586916,SIO 153,A01,446188,Capaldi; Tomas,24,0,26,2
1708252587444,SIO 160,A00,446189,Stegman; David,21,0,25,4
1708252587973,SIO 164,A00,446193,Staff,27,0,35,8
1708252588501,SIO 173,A00,446194,Lutsko; Nicholas J.,28,0,30,2
1708252589049,SIO 174,A00,446197,Aluwihare; Lihini & Russell; Lynn M.,26,0,30,4
1708252589592,SIO 181,A01,446200,Tresguerres; Martin,18,0,25,7
1708252589592,SIO 181,A02,446201,Tresguerres; Martin,23,0,25,2
1708252589592,SIO 181,A03,446209,Tresguerres; Martin,24,0,25,1
1708252589592,SIO 181,A04,446211,Tresguerres; Martin,24,0,25,1
1708252589592,SIO 181,A05,446223,Tresguerres; Martin,24,0,25,1
1708252589592,SIO 181,A06,446236,Tresguerres; Martin,24,0,25,1
1708252590121,SIO 192,A00,479211,Gerwick; William Henry,20,0,20,0
1708252590649,SIO 194,A00,455340,Hill; Seth J,0,0,0,0
1708252591175,SIOB 262,A00,446243,Gerwick; William Henry,23,0,25,2
1708252591699,SIOB 269,A00,446244,Staff,19,0,20,1
1708252592224,SIOB 270,A01,446261,Allen; Andrew Ellis & Petrik; Colleen Mary,18,0,20,2
1708252592752,SIOB 278,A00,446273,Arcila; Dahiana K,13,0,15,2
1708252592752,SIOB 278,B00,481742,Aburto Oropeza; Marco Octavio,18,0,20,2
1708252593277,SIOB 279,A00,446286,Franks; Peter,31,0,35,4
1708252593804,SIOB 291,A00,446292,Hechinger; Ryan F.,20,0,20,0
1708252594329,SIOB 296,A00,446293,Mongiardino Koch; Nicolas,16,0,20,4
1708252594857,SIOB 297,A00,446294,Allen; Eric,66,0,70,4
1708252595384,SIOC 202B,A00,446312,Stramski; Dariusz & Gabriel; Anne Alice-Agnes,17,0,20,3
1708252595908,SIOC 203C,A01,446314,Young; William Roy,5,0,5,0
1708252596436,SIOC 207C,A00,492798,Vasconcelos; Manuela,5,0,5,0
1708252597023,SIOC 208,A00,446315,Merrifield; Mark A,16,0,20,4
1708252597551,SIOC 209,A00,478924,Werner; Bradley T.,11,0,15,4
1708252597551,SIOC 209,B00,479224,Watson-Parris; Duncan,15,0,25,10
1708252597551,SIOC 209,C00,480739,Ricke; Katharine L,24,0,24,0
1708252598081,SIOC 212B,A01,446324,Cessi; Paola,40,0,40,0
1708252598607,SIOC 217C,A00,446325,Lutsko; Nicholas J.,25,0,25,0
1708252599132,SIOC 220,A00,446326,Rudnick; Daniel Lars,13,0,15,2
1708252599661,SIOC 224,A00,446327,Eisenman; Ian,20,0,25,5
1708252600188,SIOC 228,A00,446328,Shi; Yuanyuan,1,0,10,9
1708252600713,SIOC 235,A00,446342,Xie; Shang-Ping,14,0,15,1
1708252601242,SIOC 251,A00,446343,Evan; Amato Tomas,19,0,20,1
1708252601766,SIOG 200B,A00,446344,Gabriel; Anne Alice-Agnes,9,0,10,1
1708252602307,SIOG 221,A00,446354,Parnell-Turner; Ross Ernes,29,0,30,1
1708252602837,SIOG 227B,A00,446355,Laske; Gabi & Shearer; Peter M,19,0,20,1
1708252603362,SIOG 228,A00,446356,Van Allen; Emily Joyce,7,0,20,13
1708252603889,SIOG 230,A00,446359,Constable; Catherine G,25,0,25,0
1708252604432,SIOG 232,A00,446360,Constable; Catherine G & Constable; Steven C,37,0,40,3
1708252604955,SIOG 234,A00,446361,Sandwell; David T,15,0,15,0
1708252605484,SIOG 236,A01,477658,Fricker; Helen A.,5,0,5,0
1708252605484,SIOG 236,A02,477685,Fricker; Helen A.,3,0,5,2
1708252606010,SIOG 239,A00,446362,Gabriel; Anne Alice-Agnes,19,0,20,1
1708252606010,SIOG 239,B00,481507,May; David Alexander,6,0,6,0
1708252606010,SIOG 239,C00,486863,Fialko; Yuri A.,15,0,15,0
1708252606538,SIOG 268,A00,446364,Barbeau; Katherine,12,0,15,3
1708252607062,SOCE 194,A00,455341,Hill; Seth J,0,0,0,0
1708252607588,SOCG 204,A00,446551,Ng; Kwai,0,0,8,8
1708252608114,SOCG 206,A00,446552,Alvarez; Camila Huerta,4,0,8,4
1708252608639,SOCG 214,A00,446553,Raudenbush; Danielle,3,0,8,5
1708252609168,SOCG 255B,A00,446602,Serlin; David,2,0,5,3
1708252609693,SOCG 255C,A00,446813,Gates; Kelly,3,0,5,2
1708252610220,SOCG 290,A00,446910,Thorpe; Charles Robert,0,0,10,10
1708252610220,SOCG 290,B00,446911,Goldman; Harvey Stern,1,0,10,9
1708252610220,SOCG 290,C00,446914,Lampland; Martha,5,0,10,5
1708252610749,SOCI 2,A01,446373,Rogers; Julia Ellen,28,0,30,2
1708252610749,SOCI 2,A02,446374,Rogers; Julia Ellen,29,0,30,1
1708252610749,SOCI 2,A03,446382,Rogers; Julia Ellen,29,0,30,1
1708252610749,SOCI 2,A04,446384,Rogers; Julia Ellen,30,0,30,0
1708252610749,SOCI 2,A05,446389,Rogers; Julia Ellen,30,0,30,0
1708252610749,SOCI 2,A06,446393,Rogers; Julia Ellen,29,0,30,1
1708252611274,SOCI 20,A01,446396,Calderon-Zaks; Michael Aar,33,0,34,1
1708252611274,SOCI 20,A02,446409,Calderon-Zaks; Michael Aar,34,0,34,0
1708252611805,SOCI 40,A01,446417,Raudenbush; Danielle,30,0,32,2
1708252611805,SOCI 40,A02,446419,Raudenbush; Danielle,31,0,32,1
1708252611805,SOCI 40,A03,446434,Raudenbush; Danielle,31,0,32,1
1708252611805,SOCI 40,A04,446436,Raudenbush; Danielle,28,0,32,4
1708252611805,SOCI 40,A05,446441,Raudenbush; Danielle,29,0,32,3
1708252611805,SOCI 40,A06,446445,Raudenbush; Danielle,32,0,32,0
1708252612348,SOCI 60,A01,446461,Sutton; April Marie,30,0,32,2
1708252612348,SOCI 60,A02,446468,Sutton; April Marie,30,0,32,2
1708252612348,SOCI 60,A03,446469,Sutton; April Marie,26,0,32,6
1708252612348,SOCI 60,A04,446471,Sutton; April Marie,31,0,32,1
1708252612898,SOCI 100,A01,446480,Payne; Christine Anna,28,0,30,2
1708252612898,SOCI 100,A02,446491,Payne; Christine Anna,29,0,30,1
1708252612898,SOCI 100,A03,446492,Payne; Christine Anna,28,0,30,2
1708252612898,SOCI 100,A04,446493,Payne; Christine Anna,27,0,30,3
1708252613423,SOCI 103M,A00,481672,Kilpatrick; Kevin,27,0,28,1
1708252613952,SOCI 104,A00,446494,Turner; Christena L.,28,0,30,2
1708252614476,SOCI 104Q,A00,446495,Rogers; Julia Ellen,27,0,30,3
1708252615003,SOCI 106,A00,446496,Payne; Christine Anna,25,0,30,5
1708252615534,SOCI 107,A00,446497,Staff,30,0,30,0
1708252616063,SOCI 109,A00,446498,Rona-Tas; Akos,20,0,25,5
1708252616589,SOCI 111,A00,446499,Ribas Norris; Janet Vanesa,54,0,56,2
1708252617113,SOCI 114,A00,446500,Lampland; Martha,73,0,75,2
1708252617642,SOCI 117,A01,446502,Jones; Gabrielle Anastasia,14,0,17,3
1708252617642,SOCI 117,A02,446516,Jones; Gabrielle Anastasia,17,0,17,0
1708252617642,SOCI 117,A03,458787,Jones; Gabrielle Anastasia,17,0,17,0
1708252617642,SOCI 117,A04,458835,Jones; Gabrielle Anastasia,19,0,19,0
1708252618223,SOCI 120T,A00,446518,Staff,56,0,56,0
1708252618751,SOCI 123,A00,446519,Staff,79,0,80,1
1708252619275,SOCI 125,A00,487186,Calderon-Zaks; Michael Aar,55,0,56,1
1708252619804,SOCI 126,A01,446532,Jones; Makeba,15,0,15,0
1708252619804,SOCI 126,A02,446533,Jones; Makeba,15,0,15,0
1708252619804,SOCI 126,A03,458839,Jones; Makeba,15,0,15,0
1708252619804,SOCI 126,A04,458840,Jones; Makeba,15,0,15,0
1708252620331,SOCI 133,A00,446534,Calderon-Zaks; Michael Aar,53,0,56,3
1708252620857,SOCI 135,A00,486886,Ruiz; Jonathan Joseph,55,0,56,1
1708252621384,SOCI 136,A00,486887,Ruiz; Jonathan Joseph,56,0,56,0
1708252621908,SOCI 139,A00,446535,Ribas Norris; Janet Vanesa,78,0,80,2
1708252622438,SOCI 140J,A00,446537,Estefan; Michel,75,0,100,25
1708252622968,SOCI 142,A00,477639,Crofts; Christine,43,0,50,7
1708252623494,SOCI 146,A00,446538,Summers; Valerie R.,113,0,120,7
1708252624019,SOCI 151,A00,446540,Goldman; Harvey Stern,56,0,56,0
1708252624545,SOCI 156,A00,446541,Ostovany; Khashayar,55,0,56,1
1708252625070,SOCI 157,A00,446542,Jules-Rosette; Bennetta W.,28,0,28,0
1708252625600,SOCI 159,A00,494493,Estefan; Michel,93,0,96,3
1708252626127,SOCI 161,A00,477638,Staff,45,0,45,0
1708252626657,SOCI 162,A00,477642,Staff,54,0,55,1
1708252627182,SOCI 165,A00,446543,Rona-Tas; Akos,49,0,56,7
1708252627708,SOCI 171,A00,446544,Thorpe; Charles Robert,56,0,56,0
1708252628236,SOCI 173,A00,482888,Crofts; Christine,92,0,100,8
1708252628761,SOCI 180,A00,446545,Ostovany; Khashayar,55,0,56,1
1708252629286,SOCI 183,A00,446546,Sutton; April Marie,43,0,45,2
1708252629812,SOCI 185,A00,494495,Staff,30,0,30,0
1708252630341,SOCI 188D,A00,446549,Kokinis; Troy Andreas,24,0,25,1
1708252630866,SOCI 198RA,001,446550,Ng; Kwai,30,0,30,0
1708252631393,SOMC 224C,A00,466928,Bhakta; Savita Ganapathi,160,0,160,0
1708252631924,SOMC 229,A00,466925,Hoang; Mai Phuong,160,0,160,0
1708252632451,SOMC 240,A00,466937,Coyne; Christopher John,150,0,150,0
1708252632977,SOMC 242,A00,466931,Kline; Ahnika Sarah,160,0,160,0
1708252633502,SOMC 244,A00,466939,Mandel; Jess,150,0,150,0
1708252634030,SOMC 245C,A01,466935,Noel; Geoffroy Pierre Jean,160,0,160,0
1708252634556,SOMC 246C,A00,487163,Eyler; Lisa T.,160,0,160,0
1708252635081,SOMC 247C,A50,466950,Calcutt; Nigel A,160,0,160,0
1708252635607,SOMC 248C,A00,466936,Joshi; Weena Erin,160,0,160,0
1708252636132,SOMC 255C,A00,466951,Allison; Matthew,160,0,160,0
1708252636661,SPPH 161R,A01,476600,Chambers; Christina D,99,0,100,1
1708252637187,SPPH 263B,A01,460901,Hook; Vivian Yuan-Ho,25,0,25,0
1708252637713,SPPS 200A,A00,460907,Luli; Alex J,99,0,99,0
1708252638240,SPPS 200B,A00,460928,Luli; Alex J,99,0,99,0
1708252638764,SPPS 200C,A00,460934,Luli; Alex J,95,0,99,4
1708252639291,SPPS 203,A00,460955,Painter; Nathan A.,83,0,99,16
1708252639820,SPPS 205,A01,460978,Bandeira; Nuno Filipe Cabrita,64,0,80,16
1708252640347,SPPS 209,A00,460979,Bounthavong; Mark,94,0,99,5
1708252640873,SPPS 210,001,460980,Gustafsson; Asa Birgitta,99,0,99,0
1708252641400,SPPS 211A,A00,460987,Ferguson; Fleur,85,0,99,14
1708252641926,SPPS 211B,A00,460991,Ferguson; Fleur,96,0,99,3
1708252642451,SPPS 211C,A00,460992,Ferguson; Fleur,95,0,99,4
1708252642980,SPPS 211D,A00,460993,Tsunoda; Shirley M.,99,0,99,0
1708252643506,SPPS 212C,A01,460995,Saunders; Ila Maewal,95,0,99,4
1708252644033,SPPS 213C,A00,460996,Awdishu; Linda,95,0,99,4
1708252644562,SPPS 218B,A00,460997,Mandyam; Chitra,95,0,99,4
1708252645086,SPPS 225,A01,460999,Reed; Chantal,83,0,99,16
1708252645611,SPPS 236,A00,461000,Reid; Erin G.,96,0,99,3
1708252646137,SPPS 237,A00,461002,Mimoto; Mizuho Stacy,96,0,99,3
1708252646663,SPPS 238,A00,461041,Beyhan; Sinem,96,0,99,3
1708252647190,SPPS 241,A01,461122,Tsunoda; Shirley M.,83,0,99,16
1708252647717,SPPS 249,A00,461123,Brandl; Katharina,96,0,99,3
1708252648243,SPPS 250,A00,461126,Tsunoda; Shirley M.,45,0,50,5
1708252648769,SPPS 251,A00,461127,Chen; Timothy,99,0,99,0
1708252649295,SPPS 252,A00,461128,Abdul-Mutakabbir; Jacinda,74,0,80,6
1708252649820,SPPS 254,A00,481670,Shapiro; Desiree Nicolette,77,0,80,3
1708252650344,SPPS 261,A00,461129,Chambers; Christina D,93,0,99,6
1708252650868,SPPS 278,A00,459983,Fricovsky; Eduardo Santiago,98,0,99,1
1708252651396,SPPS 280,A00,461259,Fricovsky; Eduardo Santiago,19,0,20,1
1708252651960,SPPS 283,A00,461283,Tsunoda; Shirley M.,96,0,99,3
1708252652485,SURG 261,A00,466973,Staff,50,0,50,0
1708252653019,SURG 296,001,467004,Agha Hosseini; Ava,49,0,50,1
1708252653019,SURG 296,002,467005,Hinchcliff; Katharine Moss,49,0,50,1
1708252653019,SURG 296,003,467006,Eliceiri; Brian,49,0,50,1
1708252653550,SYN 1,001,448577,Bishop; Graham,19,0,20,1
1708252653550,SYN 1,002,448578,Iatarola; Briana Marie,19,0,20,1
1708252653550,SYN 1,003,448579,Browne; Emily,20,0,20,0
1708252653550,SYN 1,004,448580,Vega; Adrian,20,0,20,0
1708252653550,SYN 1,005,448581,Browne; Emily,20,0,20,0
1708252653550,SYN 1,006,448582,Rock; Martin,20,0,20,0
1708252653550,SYN 1,007,448583,Rock; Martin,20,0,20,0
1708252653550,SYN 1,008,448584,Iatarola; Briana Marie,19,0,20,1
1708252653550,SYN 1,009,448585,Bishop; Graham,20,0,20,0
1708252653550,SYN 1,010,448586,Bishop; Graham,20,0,20,0
1708252653550,SYN 1,011,448587,Gladstein; Jill M,15,0,15,0
1708252653550,SYN 1,012,448588,Meyer; Leslie Rose,20,0,20,0
1708252653550,SYN 1,013,448589,Rosenberg; Ryan Glenn,20,0,20,0
1708252653550,SYN 1,014,448627,Rosenberg; Ryan Glenn,19,0,20,1
1708252653550,SYN 1,015,448630,Atkinson; Arthur Laird,20,0,20,0
1708252653550,SYN 1,016,448651,Hom; Kirstyn Courtney,20,0,20,0
1708252653550,SYN 1,017,448652,Difruscio; Mark,20,0,20,0
1708252653550,SYN 1,018,448669,Hom; Kirstyn Courtney,20,0,20,0
1708252653550,SYN 1,019,448674,Hom; Kirstyn Courtney,18,0,20,2
1708252653550,SYN 1,020,448675,Atkinson; Arthur Laird,20,0,20,0
1708252653550,SYN 1,021,448678,Gladstein; Jill M,15,0,15,0
1708252653550,SYN 1,022,448682,Iatarola; Briana Marie,20,0,20,0
1708252653550,SYN 1,023,448691,Birberick; Brittany Celest,20,0,20,0
1708252653550,SYN 1,024,448751,Birberick; Brittany Celest,20,0,20,0
1708252653550,SYN 1,027,448766,Deavenport; James Cary,19,0,20,1
1708252653550,SYN 1,028,448767,Meyer; Leslie Rose,20,0,20,0
1708252653550,SYN 1,029,448775,Tawater; Hanna Jean,20,0,20,0
1708252653550,SYN 1,030,448777,Tawater; Hanna Jean,20,0,20,0
1708252653550,SYN 1,031,448792,Deavenport; James Cary,20,0,20,0
1708252653550,SYN 1,032,480169,Tawater; Hanna Jean,18,0,20,2
1708252654078,SYN 1R,001,448793,Difruscio; Mark,20,0,20,0
1708252654078,SYN 1R,004,449146,Difruscio; Mark,20,0,20,0
1708252654614,SYN 100,A01,449148,Staff,11,0,15,4
1708252654614,SYN 100,A02,449149,Staff,15,0,15,0
1708252654614,SYN 100,B01,449164,Gladstein; Jill M,0,0,0,0
1708252654614,SYN 100,B02,449166,Gladstein; Jill M,0,0,0,1
1708252654614,SYN 100,C01,449244,Staff,7,0,15,8
1708252654614,SYN 100,C02,449274,Staff,13,0,15,2
1708252654614,SYN 100,D01,449278,Staff,20,0,20,0
1708252654614,SYN 100,D02,449279,Staff,20,0,20,0
1708252654614,SYN 100,E01,449281,Rock; Martin,9,0,15,6
1708252654614,SYN 100,E02,449282,Rock; Martin,14,0,15,1
1708252654614,SYN 100,F01,449304,Browne; Emily,12,0,15,3
1708252654614,SYN 100,F02,449306,Browne; Emily,14,0,15,1
1708252654614,SYN 100,I01,449390,Gormally; Brenna,0,0,0,0
1708252654614,SYN 100,I02,449391,Gormally; Brenna,0,0,0,0
1708252654614,SYN 100,J01,449401,Atkinson; Arthur Laird,11,0,15,4
1708252654614,SYN 100,J02,449402,Atkinson; Arthur Laird,14,0,15,1
1708252654614,SYN 100,K01,449404,Deavenport; James Cary,11,0,15,4
1708252654614,SYN 100,K02,449405,Deavenport; James Cary,14,0,15,1
1708252654614,SYN 100,L01,449408,Rosenberg; Ryan Glenn,10,0,15,5
1708252654614,SYN 100,L02,449420,Rosenberg; Ryan Glenn,15,0,15,0
1708252655140,SYN 150,001,450016,Vega; Adrian,19,0,19,0
1708252655140,SYN 150,003,450031,Birberick; Brittany Celest,20,0,20,0
1708252655669,SYN 150R,001,494950,Vega; Adrian,20,0,20,0
1708252656195,SYN 198,001,494388,Staff,9999,0,9999,0
1708252656725,TDAC 1,A00,450042,Walsh; Kim C.,14,0,20,6
1708252656725,TDAC 1,B00,450043,Walsh; Kim C.,11,0,20,9
1708252656725,TDAC 1,C00,450044,Walsh; Kim C.,15,0,20,5
1708252656725,TDAC 1,D00,486830,Basso; Beatrice,20,0,20,0
1708252656725,TDAC 1,E00,492912,Walsh; Kim C.,15,0,20,5
1708252656725,TDAC 1,F00,492936,Walsh; Kim C.,18,0,20,2
1708252657251,TDAC 101,A00,450895,Celik; Aysan Karagasli,18,0,20,2
1708252657780,TDAC 102,A00,450904,Walsh; Kim C.,20,0,20,0
1708252657780,TDAC 102,B00,450916,Harting; Carla Kelso,20,0,20,0
1708252658307,TDAC 108,A00,450917,Buescher; Stephen W.,18,0,20,2
1708252658836,TDAC 109,A00,450924,Blair; Kyle Adam,20,0,20,0
1708252659366,TDAC 122,A00,451025,Perry; Lamar,30,0,30,0
1708252659366,TDAC 122,B00,480845,Perry; Lamar,30,0,30,0
1708252659893,TDAC 123,A00,451026,Buescher; Stephen W.,30,0,30,0
1708252659893,TDAC 123,B00,451028,Celik; Aysan Karagasli,30,0,30,0
1708252659893,TDAC 123,C00,480851,Perry; Lamar,30,0,30,0
1708252660420,TDDE 101,A00,451030,Guirguis; Mark C,18,0,20,2
1708252660949,TDDE 112,A00,451032,Staff,20,0,20,0
1708252661473,TDDE 130,A00,451033,Guirguis; Mark C,19,0,20,1
1708252662000,TDDE 132,A00,451034,Guirguis; Mark C,20,0,20,0
1708252662528,TDDE 169A,A00,481304,Petrovich; Victoria A.,19,0,20,1
1708252663054,TDDM 1,A00,450045,Weinberg; Sadie,27,0,30,3
1708252663580,TDDM 101,A00,451067,Staff,29,0,30,1
1708252664110,TDDR 101,A00,451068,Powell; Lora,29,0,34,5
1708252664639,TDDR 102,A00,451069,Powell; Lora,19,0,20,1
1708252665166,TDDR 111,A00,451070,Castro; Robert Jess,15,0,16,1
1708252665166,TDDR 111,B00,451071,Castro; Robert Jess,15,0,16,1
1708252665695,TDDR 190,A00,451073,Perry; Lamar,1,0,1,0
1708252666225,TDGE 1,A01,450047,Salovey; Todd,20,0,20,0
1708252666225,TDGE 1,A02,450048,Salovey; Todd,20,0,20,0
1708252666225,TDGE 1,A03,450085,Salovey; Todd,18,0,20,2
1708252666225,TDGE 1,A04,450093,Salovey; Todd,20,0,20,0
1708252666225,TDGE 1,A05,450096,Salovey; Todd,19,0,20,1
1708252666225,TDGE 1,A06,450132,Salovey; Todd,16,0,20,4
1708252666751,TDGE 25,A00,450236,Harting; Carla Kelso,12,0,20,8
1708252666751,TDGE 25,B00,450240,Harting; Carla Kelso,16,0,20,4
1708252666751,TDGE 25,C00,450243,Harting; Carla Kelso,14,0,20,6
1708252666751,TDGE 25,D00,450388,Harting; Carla Kelso,16,0,20,4
1708252667277,TDGE 100,A01,451098,Salovey; Todd,24,0,25,1
1708252667277,TDGE 100,A02,451099,Salovey; Todd,24,0,25,1
1708252667807,TDGE 124,A00,451122,Fulton; Julia,168,0,200,32
1708252668331,TDGE 125,A00,480853,Havis; Allan,197,0,200,3
1708252668331,TDGE 125,B00,480886,Staff,216,0,220,4
1708252668858,TDGE 133,A00,481097,Brill; Robert L.,20,0,20,0
1708252669384,TDGE 196B,A00,493144,Barricelli; Marc Alexander,1,0,1,0
1708252669384,TDGE 196B,B00,493148,Buescher; Stephen W.,2,0,2,0
1708252669384,TDGE 196B,C00,493151,Burelle; Julie Sara Veronique,1,0,1,0
1708252669384,TDGE 196B,D00,493189,Castro; Robert Jess,2,0,2,0
1708252669384,TDGE 196B,E00,493190,Guirguis; Mark C,1,0,1,0
1708252669384,TDGE 196B,F00,493240,Iizuka; Naomi Hisako,1,0,1,0
1708252669384,TDGE 196B,G00,493241,Perry; Lamar,1,0,1,0
1708252669384,TDGE 196B,H00,493249,Powell; Lora,1,0,1,0
1708252669384,TDGE 196B,I00,493296,Stein; Deborah Isobel,6,0,6,0
1708252669910,TDGR 213C,A00,451385,Buescher; Stephen W.,10,0,10,0
1708252670439,TDGR 220A,A00,451386,Barricelli; Marc Alexander,10,0,10,0
1708252670964,TDGR 239,A00,451387,Blair; Kyle Adam,10,0,10,0
1708252671545,TDGR 240,A00,481306,Portes; Elizabeth Marie,5,0,5,0
1708252672070,TDGR 245,A00,451388,Perry; Lamar,7,0,7,0
1708252672599,TDGR 250,A00,451395,Iizuka; Naomi Hisako,8,0,10,2
1708252673124,TDGR 251,A00,451397,Iizuka; Naomi Hisako,9,0,10,1
1708252673124,TDGR 251,B00,451398,Stein; Deborah Isobel,9,0,10,1
1708252673650,TDGR 257B,A00,451399,Finch; Michael S,8,0,10,2
1708252674177,TDGR 278,A00,481307,Petrovich; Victoria A.,4,0,5,1
1708252674707,TDGR 279,A00,451400,Bokovikova; Alina V,9,0,10,1
1708252674707,TDGR 279,B00,451401,Brill; Robert L.,10,0,10,0
1708252674707,TDGR 279,C00,451402,Petrovich; Victoria A.,10,0,10,0
1708252674707,TDGR 279,D00,451403,McElver; Robert Harrison,10,0,10,0
1708252674707,TDGR 279,E00,451404,Kuhl; Christopher August,10,0,10,0
1708252675232,TDGR 286,A00,451405,Knox; Leila Elizabeth,9,0,10,1
1708252675758,TDGR 288,A00,451406,Powell; Lora,6,0,7,1
1708252676288,TDGR 292,A00,451407,Power; Jade Yukana,10,0,10,0
1708252676288,TDGR 292,B00,451408,Mehrishi; Rishika,10,0,10,0
1708252676817,TDGR 293,001,451417,Power; Jade Yukana,7,0,7,0
1708252676817,TDGR 293,002,451418,Burelle; Julie Sara Veronique,7,0,7,0
1708252676817,TDGR 293,003,451419,Yapp; Hentyle T,7,0,7,0
1708252676817,TDGR 293,005,451421,Anderson; Mysia Anyse,7,0,7,0
1708252677343,TDGR 294,001,451429,Burelle; Julie Sara Veronique,7,0,7,0
1708252677343,TDGR 294,002,451431,Power; Jade Yukana,7,0,7,0
1708252677343,TDGR 294,003,451432,Yapp; Hentyle T,7,0,7,0
1708252677868,TDGR 295,A00,451433,Barricelli; Marc Alexander,10,0,10,0
1708252678396,TDGR 296,A00,451489,Powell; Lora,6,0,7,1
1708252678396,TDGR 296,B00,451497,Porter; Lisa,6,0,7,1
1708252678922,TDHD 175,A00,451123,Jun; Grace Shin Hae,40,0,40,0
1708252679448,TDHD 176,A00,451124,Caligagan; Maria T.,40,0,40,0
1708252679972,TDHT 10,A00,450409,Power; Jade Yukana,20,0,20,0
1708252679972,TDHT 10,B00,450450,Power; Jade Yukana,19,0,20,1
1708252680498,TDHT 23,A01,450546,Salimi; Rana,24,0,24,0
1708252680498,TDHT 23,A02,450549,Salimi; Rana,22,0,24,2
1708252680498,TDHT 23,A03,450553,Salimi; Rana,24,0,24,0
1708252681025,TDHT 101,A00,451125,Anderson; Mysia Anyse,25,0,25,0
1708252681025,TDHT 101,B00,451126,Mehrishi; Rishika,23,0,25,2
1708252681550,TDHT 104,A00,451225,Basso; Beatrice,22,0,25,3
1708252682075,TDHT 109,A01,451227,Anderson; Mysia Anyse,25,0,25,0
1708252682603,TDHT 122,A00,451228,Power; Jade Yukana,21,0,25,4
1708252683128,TDMV 1,A00,450558,Caligagan; Maria T.,15,0,30,15
1708252683653,TDMV 2,A00,450627,Anabo; Cherry,24,0,30,6
1708252684178,TDMV 3,A00,450630,Arcidiacono; Kristin,37,0,40,3
1708252684708,TDMV 11,A00,481244,Fyall; DauntÉ Edward,30,0,30,0
1708252685237,TDMV 20,A00,450789,Smith; Alison D,38,0,40,2
1708252685762,TDMV 110,A00,451229,Caligagan; Maria T.,28,0,30,2
1708252686288,TDMV 111,A00,451234,Smith; Alison D,28,0,30,2
1708252686816,TDMV 120,A00,451260,Weinberg; Sadie,30,0,30,0
1708252686816,TDMV 120,B00,451261,Sammartano; Tonnie,30,0,30,0
1708252687341,TDMV 122,A00,451262,Staff,28,0,30,2
1708252687870,TDMV 123,A00,451263,Duran; Marcos Antonio,28,0,30,2
1708252688396,TDMV 130,A00,451272,Mack; Kara Shanai',30,0,30,0
1708252688924,TDMV 138,A00,451275,Jun; Grace Shin Hae,4,0,30,26
1708252689456,TDMV 140,A00,451276,Lima; Paulo Henrique,40,0,40,0
1708252689456,TDMV 140,B00,451308,Power; Jade Yukana,39,0,40,1
1708252689456,TDMV 140,C00,451371,Caligagan; Tony,40,0,40,0
1708252689456,TDMV 140,D00,451373,Corrales; Joseph Bernales,28,0,30,2
1708252689982,TDMV 141,A00,451374,Caligagan; Tony,26,0,30,4
1708252690510,TDMV 142,A00,451375,Blanco; Juan Carlos,26,0,40,14
1708252691034,TDMV 143,A00,451376,Fyall; DauntÉ Edward,39,0,40,1
1708252691564,TDMV 144,A00,451377,Anabo; Cherry,39,0,40,1
1708252692089,TDMV 149,A00,451378,Jun; Grace Shin Hae,36,0,40,4
1708252692615,TDPF 162,A00,451379,Alvarez; Ana Maria,40,0,40,0
1708252693143,TDPR 6,A01,450799,Guirguis; Mark C,50,0,50,0
1708252693143,TDPR 6,A02,450801,Guirguis; Mark C,50,0,50,0
1708252693669,TDPR 102,A00,451380,Guirguis; Mark C,20,0,20,0
1708252694195,TDPR 104,A00,451381,Powell; Lora,15,0,15,0
1708252694720,TDPW 1,A00,450808,Stein; Deborah Isobel,14,0,15,1
1708252694720,TDPW 1,B00,450864,Stein; Deborah Isobel,13,0,15,2
1708252694720,TDPW 1,C00,450865,Stein; Deborah Isobel,15,0,15,0
1708252694720,TDPW 1,D00,450868,Stein; Deborah Isobel,13,0,15,2
1708252694720,TDPW 1,E00,450874,Stein; Deborah Isobel,14,0,15,1
1708252695248,TDPW 102,A00,451382,Staff,18,0,20,2
1708252695774,TDPW 104,A00,481182,Staff,17,0,20,3
1708252696303,TDTR 10,A00,450881,Wilson; Terry A.,28,0,30,2
1708252696829,TDTR 15,A00,450882,Smith; Alison D,30,0,30,0
1708252697355,TMC 15,A00,479039,Hemans; Patricia Ann Benitez,25,0,25,0
1708252697880,TMC 87,A00,479049,Solomon; Amanda Lee Albaniel,20,0,20,0
1708252698406,UROL 296,001,467060,Anger; Jennifer Tash,49,0,50,1
1708252698406,UROL 296,002,467061,Staff,50,0,50,0
1708252698938,USP 3,A01,458852,Martin; Isaac,34,0,35,1
1708252698938,USP 3,A02,458853,Martin; Isaac,35,0,35,0
1708252698938,USP 3,A03,458861,Martin; Isaac,34,0,35,1
1708252698938,USP 3,A04,458862,Martin; Isaac,32,0,35,3
1708252699465,USP 4,A00,451772,Schwaller; Nora Louise,19,0,25,6
1708252699991,USP 5,A01,458863,Shenkman; Michael Thomas,33,0,35,2
1708252699991,USP 5,A02,458864,Shenkman; Michael Thomas,31,0,35,4
1708252700517,USP 15,A01,458931,Staff,33,0,35,2
1708252700517,USP 15,A02,459024,Staff,31,0,35,4
1708252701044,USP 25,A00,451786,Sun; Feiyang,57,0,60,3
1708252701570,USP 100,A00,451787,Moses; Kelema Lee,55,0,60,5
1708252702101,USP 108,A00,477594,Martin; Isaac,25,0,25,0
1708252702627,USP 119,A00,477595,Schwaller; Nora Louise,23,0,25,2
1708252703152,USP 124,A00,451790,Hinds; Juli Beth,62,0,70,8
1708252703681,USP 128B,A01,451910,Lewis; Leslie R,12,0,13,1
1708252704208,USP 142B,A01,451954,Lewis; Leslie R,24,0,25,1
1708252704736,USP 142C,A00,451977,Lerner; Amy M,0,0,0,0
1708252705263,USP 145,A00,451999,Yaghmaee; Saman,140,0,146,6
1708252705789,USP 150,A00,452165,Staff,44,0,50,6
1708252706315,USP 151,A00,452166,Staff,49,0,50,1
1708252706846,USP 152A,A01,459025,Weaver; Todd D,25,0,25,0
1708252706846,USP 152A,A02,459074,Weaver; Todd D,24,0,25,1
1708252707371,USP 152B,A00,452224,Moeder; Nathan L,21,0,25,4
1708252707896,USP 153,A00,452339,Shenkman; Michael Thomas,50,0,50,0
1708252708426,USP 158A,A00,452410,Sun; Feiyang,25,0,25,0
1708252708952,USP 159B,A00,452411,Gherini; Paul Pier-Carlo,6,0,8,2
1708252709479,USP 160,A00,452412,Wartell; Julie Dara,25,0,25,0
1708252710005,USP 164,A00,452413,Moses; Kelema Lee,22,0,25,3
1708252710531,USP 165C,A00,452442,Frank; Lawrence Douglas,20,0,20,0
1708252711059,USP 169,A00,452598,Bajaj; Ravi Siddharth,32,0,35,3
1708252711587,USP 170,A00,477593,Entezam; Maryam,60,0,60,0
1708252712113,USP 172,A00,452676,Peerson; Susan,19,0,25,6
1708252712640,USP 175,A00,452848,Velasco; Diego,18,0,20,2
1708252713172,USP 177A,A00,453084,Velasco; Diego,21,0,25,4
1708252713701,USP 177B,A00,453127,Peerson; Susan,22,0,25,3
1708252714227,USP 183,A00,453128,Sutton; April Marie,19,0,20,1
1708252714755,USP 188B,A00,453187,Pezzoli; Keith,30,0,30,0
1708252715280,USP 190,A00,453234,Pezzoli; Keith,0,0,0,1
1708252715808,USP 191B,A00,453240,Polat; Soydan Alihan,18,0,20,2
1708252716334,USP 193,A00,453251,Bussell; Mirle Rabinowitz,24,0,25,1
1708252716864,USP 194,A00,455342,Hill; Seth J,0,0,0,0
1708252717391,USP 265C,A00,453264,Frank; Lawrence Douglas,10,0,10,0
1708252717920,VIS 3,A01,453427,Staff,25,0,25,0
1708252717920,VIS 3,A02,453428,Staff,15,0,25,10
1708252717920,VIS 3,A03,453429,Staff,25,0,25,0
1708252717920,VIS 3,A04,453430,Staff,21,0,25,4
1708252717920,VIS 3,A05,453431,Staff,25,0,25,0
1708252717920,VIS 3,A06,453432,Staff,23,0,25,2
1708252717920,VIS 3,A07,453433,Staff,17,0,25,8
1708252717920,VIS 3,A08,453434,Staff,23,0,25,2
1708252717920,VIS 3,A09,453435,Staff,21,0,25,4
1708252717920,VIS 3,A10,453436,Staff,23,0,25,2
1708252718446,VIS 9,A00,453437,Camargo; William,116,0,146,30
1708252718971,VIS 10,A00,453438,Kiratli; Solen,189,0,200,11
1708252719498,VIS 21B,A01,453440,Shen; Kuiyi,31,0,32,1
1708252719498,VIS 21B,A02,453441,Shen; Kuiyi,31,0,32,1
1708252719498,VIS 21B,A03,453442,Shen; Kuiyi,31,0,32,1
1708252719498,VIS 21B,A04,453443,Shen; Kuiyi,32,0,32,0
1708252719498,VIS 21B,A05,453444,Shen; Kuiyi,32,0,32,0
1708252719498,VIS 21B,A06,453452,Shen; Kuiyi,32,0,32,0
1708252719498,VIS 21B,A07,453468,Shen; Kuiyi,30,0,32,2
1708252719498,VIS 21B,A08,453587,Shen; Kuiyi,32,0,32,0
1708252720028,VIS 22,A01,453589,Rose; Jordan M,32,0,32,0
1708252720028,VIS 22,A02,453590,Rose; Jordan M,32,0,32,0
1708252720028,VIS 22,A03,453615,Rose; Jordan M,31,0,32,1
1708252720028,VIS 22,A04,453616,Rose; Jordan M,32,0,32,0
1708252720028,VIS 22,A05,453617,Rose; Jordan M,30,0,32,2
1708252720028,VIS 22,A06,453618,Rose; Jordan M,30,0,32,2
1708252720028,VIS 22,A07,453620,Rose; Jordan M,32,0,32,0
1708252720028,VIS 22,A08,453621,Rose; Jordan M,32,0,32,0
1708252720028,VIS 22,A09,453635,Rose; Jordan M,32,0,32,0
1708252720028,VIS 22,A10,453636,Rose; Jordan M,32,0,32,0
1708252720556,VIS 31,A00,453637,Dominguez; Ricardo,133,0,146,13
1708252721082,VIS 41,A01,453644,D'Elena-Tweed; Jessica Erin,23,0,25,2
1708252721082,VIS 41,A02,453645,D'Elena-Tweed; Jessica Erin,22,0,25,3
1708252721082,VIS 41,A03,453646,D'Elena-Tweed; Jessica Erin,25,0,25,0
1708252721082,VIS 41,A04,453647,D'Elena-Tweed; Jessica Erin,18,0,25,7
1708252721082,VIS 41,A05,453648,D'Elena-Tweed; Jessica Erin,25,0,25,0
1708252721082,VIS 41,A06,453650,D'Elena-Tweed; Jessica Erin,24,0,25,1
1708252721613,VIS 70N,A01,453652,Garnett; Mariah J,21,0,22,1
1708252721613,VIS 70N,A02,453653,Garnett; Mariah J,21,0,22,1
1708252721613,VIS 70N,A03,453654,Garnett; Mariah J,22,0,22,0
1708252721613,VIS 70N,A04,453657,Garnett; Mariah J,22,0,22,0
1708252721613,VIS 70N,A05,453662,Garnett; Mariah J,20,0,22,2
1708252721613,VIS 70N,A06,453663,Garnett; Mariah J,22,0,22,0
1708252722140,VIS 83,A00,453664,Kester; Grant,137,0,146,9
1708252722667,VIS 101A,A00,453666,Cruz; Edwin Teddy,10,0,15,5
1708252723192,VIS 102,A00,453668,Cruz; Edwin Teddy,81,0,85,4
1708252723720,VIS 105A,A00,453669,Adler; Amy,29,0,30,1
1708252724248,VIS 105B,A00,453738,Herc-Balaszek; Malgorzata,25,0,30,5
1708252724248,VIS 105B,B00,453739,Staff,27,0,30,3
1708252724846,VIS 106A,A00,453740,Staff,22,0,25,3
1708252725373,VIS 106B,A00,453741,De Luca; Mara Julia,20,0,25,5
1708252725899,VIS 106C,A00,453746,Vangenderen; Monique Luise,11,0,15,4
1708252726425,VIS 107A,A00,453747,Gregoire; Mathieu,19,0,25,6
1708252726952,VIS 107B,A00,453748,Dean; Danielle Adobi,23,0,25,2
1708252727481,VIS 110A,A00,453749,Adler; Amy,13,0,15,2
1708252728006,VIS 110E,A00,453798,Gregoire; Mathieu,14,0,15,1
1708252728534,VIS 110F,A00,453799,Staff,15,0,15,0
1708252729062,VIS 110N,A00,453803,Dean; Danielle Adobi,15,0,15,0
1708252729588,VIS 123B,A00,453804,Gaines; Malik Julian,75,0,75,0
1708252730115,VIS 125BN,A00,453813,Welchman; John C.,75,0,75,0
1708252730641,VIS 126P,A00,453814,Wardwell; Mariana Razo,74,0,75,1
1708252731170,VIS 128E,A00,453815,Staff,75,0,75,0
1708252731696,VIS 129E,A00,453855,Shen; Kuiyi,12,0,15,3
1708252732221,VIS 131,A00,453859,Trigilio; Michael,12,0,15,3
1708252732221,VIS 131,B00,479342,Mangolte; Babette,15,0,15,0
1708252732748,VIS 133A,A00,454231,Barbosa; Erika Katrina,13,0,15,2
1708252733273,VIS 134,A00,454232,Yoldas; Pinar,59,0,75,16
1708252733798,VIS 141B,A00,454233,Stalbaum; Brett,12,0,15,3
1708252734323,VIS 145B,A00,454234,Alexander; Amy J,14,0,15,1
1708252734323,VIS 145B,B00,454235,Kiratli; Solen,8,0,15,7
1708252734852,VIS 147A,A01,454237,Stalbaum; Brett,20,0,22,2
1708252734852,VIS 147A,A02,454238,Stalbaum; Brett,18,0,22,4
1708252735383,VIS 157,A01,454240,Cartwright; Lisa,32,0,34,2
1708252735383,VIS 157,A02,454241,Cartwright; Lisa,32,0,34,2
1708252735910,VIS 159,A01,454243,Akten; Mehmet,34,0,34,0
1708252735910,VIS 159,A02,454244,Akten; Mehmet,32,0,34,2
1708252735910,VIS 159,A03,454300,Akten; Mehmet,30,0,34,4
1708252735910,VIS 159,A04,454301,Akten; Mehmet,33,0,34,1
1708252735910,VIS 159,A05,454302,Akten; Mehmet,30,0,34,4
1708252735910,VIS 159,A06,454307,Akten; Mehmet,33,0,34,1
1708252735910,VIS 159,A07,454308,Akten; Mehmet,34,0,34,0
1708252735910,VIS 159,A08,454309,Akten; Mehmet,33,0,34,1
1708252736441,VIS 160B,A00,454310,Alexander; Amy J,13,0,15,2
1708252736441,VIS 160B,B00,454311,Akten; Mehmet,14,0,15,1
1708252736441,VIS 160B,C00,454312,Stone; Patricia,12,0,15,3
1708252736968,VIS 164,A00,454313,Cross; Brian R,19,0,22,3
1708252736968,VIS 164,B00,454314,Camargo; William,22,0,22,0
1708252737495,VIS 165,A00,454315,Erdmann; Dean,22,0,22,0
1708252738021,VIS 167,A00,454316,Staff,18,0,22,4
1708252738550,VIS 169A,A00,454317,Mostajo; Lorena,21,0,22,1
1708252739077,VIS 171,A00,454318,Nakayama; Yue,21,0,22,1
1708252739602,VIS 174,A00,454319,Staff,19,0,22,3
1708252740131,VIS 177,A00,454320,Cho; Erica,21,0,22,1
1708252740657,VIS 178,A00,454321,Staff,0,0,0,0
1708252741184,VIS 179,A00,454322,Erdmann; Dean,22,0,22,0
1708252741714,VIS 180A,A00,454323,Nakayama; Yue,21,0,22,1
1708252742240,VIS 180B,A00,454341,Cross; Brian R,20,0,22,2
1708252742769,VIS 183A,A00,454342,Cho; Erica,17,0,22,5
1708252743295,VIS 185,A00,454343,Miller; Nicole L,18,0,22,4
1708252743823,VIS 190,A00,454360,Crandall; Jordan,15,0,15,0
1708252743823,VIS 190,B00,454361,D'Elena-Tweed; Jessica Erin,10,0,15,5
1708252744351,VIS 202,A00,454369,Miller; Nicole L,12,0,15,3
1708252744879,VIS 203,A00,454370,Garnett; Mariah J,8,0,15,7
1708252745405,VIS 206,A00,454376,Kester; Grant,10,0,15,5
1708252745932,VIS 208,A00,454377,Moss; Ceci,15,0,15,0
1708252746458,VIS 211,A00,454413,Segade; Alexandro Abraham,0,0,0,2
1708252746987,VIS 243,A00,454429,Rose; Jordan M,5,0,15,10
1708252747513,VIS 255,A00,454430,Welchman; John C.,8,0,15,7
1708252748042,VIS 262,A00,454431,Yoldas; Pinar,11,0,15,4
1708252748569,WCWP 10A,001,454442,Uriarte; Emma,17,0,20,3
1708252748569,WCWP 10A,002,454443,Uriarte; Emma,14,0,20,6
1708252748569,WCWP 10A,003,454479,Uriarte; Emma,19,0,20,1
1708252748569,WCWP 10A,004,454480,Staff,0,0,0,0
1708252748569,WCWP 10A,005,454484,Staff,0,0,0,0
1708252748569,WCWP 10A,006,454485,Staff,0,0,0,0
1708252748569,WCWP 10A,007,454487,Staff,0,0,0,0
1708252748569,WCWP 10A,008,454488,Susi; Natalie,14,0,20,6
1708252748569,WCWP 10A,009,454489,Staff,0,0,0,0
1708252748569,WCWP 10A,010,454490,Staff,0,0,0,0
1708252749108,WCWP 10B,001,454492,Ornelas; Tricia,20,0,20,0
1708252749108,WCWP 10B,002,454501,Ornelas; Tricia,20,0,20,0
1708252749108,WCWP 10B,003,454565,Gagnon; Jeffrey C,2,0,20,18
1708252749108,WCWP 10B,004,454604,Ornelas; Tricia,16,0,20,4
1708252749108,WCWP 10B,005,454668,Staff,16,0,16,0
1708252749108,WCWP 10B,006,454724,Staff,16,0,16,0
1708252749108,WCWP 10B,007,454725,Staff,14,0,16,2
1708252749108,WCWP 10B,008,454768,Staff,0,0,0,0
1708252749108,WCWP 10B,009,454769,Staff,0,0,0,0
1708252749108,WCWP 10B,010,454770,Staff,0,0,0,0
1708252749108,WCWP 10B,011,454771,Dhir; Simrita,16,0,20,4
1708252749108,WCWP 10B,012,454772,Dhir; Simrita,16,0,20,4
1708252749108,WCWP 10B,013,454773,Merryman; Walter,17,0,20,3
1708252749108,WCWP 10B,014,454774,Dhir; Simrita,18,0,20,2
1708252749108,WCWP 10B,015,454775,Merryman; Walter,17,0,20,3
1708252749108,WCWP 10B,016,454776,Merryman; Walter,18,0,20,2
1708252749108,WCWP 10B,017,454777,Welji; Haleema Nazir,14,0,16,2
1708252749108,WCWP 10B,018,478868,Staff,16,0,16,0
1708252749108,WCWP 10B,019,478869,Staff,0,0,0,0
1708252749108,WCWP 10B,020,478876,Staff,0,0,0,0
1708252749108,WCWP 10B,021,478877,Staff,0,0,0,0
1708252749108,WCWP 10B,022,478887,Staff,0,0,0,0
1708252749108,WCWP 10B,023,478889,Staff,16,0,16,0
1708252749108,WCWP 10B,024,478892,Staff,0,0,0,0
1708252749108,WCWP 10B,025,478907,Staff,0,0,0,0
1708252749639,WCWP 100,A00,454800,McCleary; Keith Long,20,0,20,0
1708252749639,WCWP 100,B00,454804,McCleary; Keith Long,20,0,20,0
1708252749639,WCWP 100,C00,454822,Twohig; Niall Ivan,19,0,20,1
1708252749639,WCWP 100,D00,454855,Young; Mark T,20,0,20,0
1708252749639,WCWP 100,E00,454860,Twohig; Niall Ivan,20,0,20,0
1708252749639,WCWP 100,F00,454932,Young; Mark T,20,0,20,0
1708252749639,WCWP 100,G00,454933,Young; Mark T,20,0,20,0
1708252750169,WES 207,A00,454941,Kastner; Ryan Charles,20,0,20,0
1708252750698,WES 265,A00,454942,Staff,19,0,20,1
1708252752516,AAS 10,A01,392963,Butler; Elizabeth Annette,34,0,34,0
1708252752516,AAS 10,A02,392965,Butler; Elizabeth Annette,33,0,34,1
1708252753042,AAS 170,A00,392977,Butler; Elizabeth Annette,31,0,32,1
1708252753570,AAS 198,001,479182,Childs; Dennis R.,20,0,20,0
1708252754096,AESE 261,A00,387945,Staff,33,0,33,0
1708252754624,AESE 278D,A00,387953,Staff,33,0,33,0
1708252755149,AESE 278E,A00,387954,Staff,33,0,33,0
1708252755675,AESE 279A,A00,387956,Staff,33,0,33,0
1708252756205,AIP 197P,001,494494,Goldfarb; Brian,9999,0,9999,0
1708252756730,ANAR 100,A00,387884,Shtienberg; Gilad,15,0,16,1
1708252757256,ANAR 104,A01,387886,Tamberino; Anthony Thomas,21,0,25,4
1708252757784,ANAR 111,A00,387888,Staff,36,0,36,0
1708252758312,ANAR 115,A00,387889,Shtienberg; Gilad,36,0,36,0
1708252758842,ANAR 120,A00,387890,Staff,36,0,36,0
1708252759368,ANAR 155,A00,387891,Braswell; Geoffrey E.,15,0,25,10
1708252759894,ANAR 164,A00,387892,Staff,32,0,35,3
1708252760424,ANBI 100,A00,489626,Fox; Patrick Keolu Ozer,39,0,40,1
1708252760950,ANBI 111,A00,387893,Hrvoj Mihic; Branka,37,0,40,3
1708252762002,ANBI 144,A00,387896,Wilder; Linnea Lorene,72,0,75,3
1708252762531,ANBI 149,A00,489628,Non; Amy L,0,0,0,0
1708252763062,ANBI 173,A00,387897,Wilder; Linnea Lorene,74,0,75,1
1708252763588,ANBI 174,A00,489627,Strum; Shirley C.,13,0,15,2
1708252764113,ANES 296,001,463968,Gabriel; Rodney A,49,0,50,1
1708252764113,ANES 296,002,463969,Staff,50,0,50,0
1708252764113,ANES 296,003,463970,Staff,50,0,50,0
1708252764643,ANSC 100,A00,387898,Bialecki; Jon Anthony,40,0,40,0
1708252765172,ANSC 101,A00,387900,Sloane; Julia Kathryn,34,0,40,6
1708252765701,ANSC 117,A00,387901,Martin Sandino; Amanda Maria Yoland,13,0,15,2
1708252766230,ANSC 134,A00,387902,Staff,38,0,40,2
1708252766755,ANSC 137,A00,387903,Stewart; Alexander B,80,0,80,0
1708252767281,ANSC 138,A00,387904,Parish; Steven Martin,14,0,15,1
1708252767811,ANSC 142,A00,387905,Stone; Annika Britt,34,0,40,6
1708252768337,ANSC 147,A00,387906,Stewart; Alexander B,40,0,40,0
1708252768868,ANSC 148,A00,387907,Olivas Hernandez; Olga Lid,92,0,92,0
1708252769396,ANSC 186,A00,387910,Hankins; Joseph D.,28,0,30,2
1708252769923,ANTH 2,A01,387863,Marchetto; Maria Carolina,37,0,40,3
1708252769923,ANTH 2,A02,387864,Marchetto; Maria Carolina,40,0,40,0
1708252769923,ANTH 2,A03,387865,Marchetto; Maria Carolina,36,0,40,4
1708252769923,ANTH 2,A04,387866,Marchetto; Maria Carolina,39,0,40,1
1708252770463,ANTH 3,A01,387868,Stroth; Luke Reyneri,28,0,30,2
1708252770463,ANTH 3,A02,387869,Stroth; Luke Reyneri,29,0,30,1
1708252770463,ANTH 3,A03,387870,Stroth; Luke Reyneri,30,0,30,0
1708252770463,ANTH 3,A04,387871,Stroth; Luke Reyneri,29,0,30,1
1708252770991,ANTH 10,A00,387872,Stewart; Alexander B,80,0,80,0
1708252771520,ANTH 21,A01,387874,Stone; Annika Britt,40,0,40,0
1708252771520,ANTH 21,A02,387875,Stone; Annika Britt,40,0,40,0
1708252771520,ANTH 21,A03,387876,Stone; Annika Britt,40,0,40,0
1708252771520,ANTH 21,A04,387877,Stone; Annika Britt,39,0,40,1
1708252772095,ANTH 23,A01,387879,Staff,40,0,40,0
1708252772095,ANTH 23,A02,387880,Staff,40,0,40,0
1708252772095,ANTH 23,A03,387881,Staff,40,0,40,0
1708252772095,ANTH 23,A04,387882,Staff,40,0,40,0
1708252772625,ANTH 24,A00,387883,Pedersen; David,40,0,40,0
1708252773151,ANTH 103,A00,387911,Staff,343,0,350,7
1708252773677,ANTH 105,A00,387912,Staff,73,0,75,2
1708252774202,ANTH 112,A00,387913,Staff,23,0,25,2
1708252774732,ANTH 120,A00,479486,Parish; Steven Martin,28,0,30,2
1708252775256,ANTH 128B,A01,387923,Lewis; Leslie R,12,0,12,0
1708252775781,ANTH 192,A00,387925,Varma; Saiba,20,0,20,0
1708252776305,ANTH 196C,A00,387927,Varma; Saiba,15,0,15,0
1708252776831,ANTH 212,A00,387931,Marchetto; Maria Carolina,25,0,25,0
1708252776831,ANTH 212,B00,479487,Semendeferi; Ekaterini,25,0,25,0
1708252777356,ANTH 220,A00,387932,Csordas; Thomas J.,9,0,12,3
1708252777882,ANTH 230,001,493297,Goldstein; Paul S,18,0,20,2
1708252778411,ANTH 260,A00,479223,Jenkins; Janis A.,25,0,25,0
1708252778994,ANTH 272,A00,387936,Serlin; David,5,0,5,0
1708252779520,ANTH 273,A00,387938,Gates; Kelly,5,0,5,0
1708252780049,ANTH 288,A00,387940,Braswell; Geoffrey E.,25,0,25,0
1708252780576,ANTH 295,001,493298,Algaze; Guillermo,3,0,3,0
1708252780576,ANTH 295,002,493299,Brenner; Suzanne A,3,0,3,0
1708252780576,ANTH 295,003,493300,Csordas; Thomas J.,3,0,3,0
1708252780576,ANTH 295,004,493422,Fox; Patrick Keolu Ozer,3,0,3,0
1708252780576,ANTH 295,005,493472,Gagneux; Pascal,3,0,3,0
1708252780576,ANTH 295,006,493515,Goldstein; Paul S,3,0,3,0
1708252780576,ANTH 295,007,493592,Hankins; Joseph D.,3,0,3,0
1708252780576,ANTH 295,008,493631,Jassal; Aftab,3,0,3,0
1708252780576,ANTH 295,009,493639,Jenkins; Janis A.,3,0,3,0
1708252780576,ANTH 295,010,493657,Kaiser; Bronwyn Nicole,3,0,3,0
1708252780576,ANTH 295,011,493692,Kang; Byung Chu,3,0,3,0
1708252780576,ANTH 295,012,493758,Marchetto; Maria Carolina,3,0,3,0
1708252780576,ANTH 295,013,493761,Non; Amy L,3,0,3,0
1708252780576,ANTH 295,014,493762,Pedersen; David,3,0,3,0
1708252780576,ANTH 295,015,493825,Rivera-Collazo; Isabel C,3,0,3,0
1708252780576,ANTH 295,016,493826,Varma; Saiba,3,0,3,0
1708252780576,ANTH 295,017,493828,Yeh; Rihan Wen Xin,3,0,3,0
1708252781105,ANTH 296,001,493830,Braswell; Geoffrey E.,3,0,3,0
1708252781105,ANTH 296,002,493836,Marchetto; Maria Carolina,3,0,3,0
1708252781105,ANTH 296,003,493838,Rivera-Collazo; Isabel C,3,0,3,0
1708252781105,ANTH 296,004,493840,Varma; Saiba,3,0,3,0
1708252781105,ANTH 296,005,493842,Algaze; Guillermo,3,0,3,0
1708252781105,ANTH 296,006,493845,Brenner; Suzanne A,3,0,3,0
1708252781105,ANTH 296,007,493846,Csordas; Thomas J.,3,0,3,0
1708252781105,ANTH 296,008,493907,Fox; Patrick Keolu Ozer,3,0,3,0
1708252781105,ANTH 296,009,493949,Gagneux; Pascal,3,0,3,0
1708252781105,ANTH 296,010,493960,Goldstein; Paul S,3,0,3,0
1708252781105,ANTH 296,011,493961,Hankins; Joseph D.,3,0,3,0
1708252781105,ANTH 296,012,493962,Jassal; Aftab,3,0,3,0
1708252781105,ANTH 296,013,493963,Jenkins; Janis A.,3,0,3,0
1708252781105,ANTH 296,014,493964,Kaiser; Bronwyn Nicole,3,0,3,0
1708252781105,ANTH 296,015,493965,Kang; Byung Chu,3,0,3,0
1708252781105,ANTH 296,016,493966,Levy; Thomas E,3,0,3,0
1708252781105,ANTH 296,017,493967,Non; Amy L,3,0,3,0
1708252781105,ANTH 296,018,493968,Pedersen; David,3,0,3,0
1708252781105,ANTH 296,019,493969,Postero; Nancy Grey,3,0,3,0
1708252781105,ANTH 296,020,493970,Semendeferi; Ekaterini,3,0,3,0
1708252781105,ANTH 296,021,493971,Yeh; Rihan Wen Xin,3,0,3,0
1708252781634,AUD 236,A00,480192,Harris; Jeffrey Paul,12,0,12,0
1708252782162,AUD 260,A00,480227,Spriggs; Meghan K,12,0,12,0
1708252782691,AUD 272,A00,480367,Zettner; Erika,12,0,12,0
1708252783219,AUD 275,A00,480369,Zettner; Erika,12,0,12,0
1708252783745,AUD 284,A00,480370,Zettner; Erika,12,0,12,0
1708252783745,AUD 284,B00,480372,Spriggs; Meghan K,12,0,12,0
1708252784276,AUD 291,A00,480374,Zettner; Erika,12,0,12,0
1708252784802,AUD 296,A00,480375,Zettner; Erika,12,0,12,0
1708252784802,AUD 296,B00,480376,Harris; Jeffrey Paul,12,0,12,0
1708252784802,AUD 296,C00,480377,Ryan; Allen F.,12,0,12,0
1708252785328,AWP 3,002,387672,Given; William Allan,9,0,9,0
1708252785328,AWP 3,003,387678,Staff,5,0,5,0
1708252785328,AWP 3,004,387681,Staff,0,0,0,0
1708252785328,AWP 3,007,387784,West; Geoffrey Scott,4,0,5,1
1708252785328,AWP 3,009,387786,Kolodezh; Samuel,5,0,5,0
1708252785328,AWP 3,010,387787,Gilbert; Peter W,5,0,5,0
1708252785857,AWP 4A,001,387791,Staff,12,0,12,0
1708252785857,AWP 4A,002,387792,Staff,0,0,0,0
1708252786390,AWP 4B,001,387793,Bolin; Jillian,0,0,0,0
1708252786390,AWP 4B,002,387794,Bolin; Jillian,0,0,0,0
1708252786390,AWP 4B,003,387795,Bauer; Holly Jean,0,0,0,0
1708252786390,AWP 4B,004,387796,Vaughn; Kelsey Sara,0,0,0,0
1708252786390,AWP 4B,005,387797,Vaughn; Kelsey Sara,0,0,0,0
1708252786390,AWP 4B,007,387799,Ajo; Frances Margaret,0,0,0,0
1708252786390,AWP 4B,008,387800,Ajo; Frances Margaret,0,0,0,0
1708252786390,AWP 4B,009,387801,Hall; Graham T,0,0,0,0
1708252786390,AWP 4B,010,387802,Hall; Graham T,0,0,0,0
1708252786390,AWP 4B,011,387803,Heiser; Jerrod A,0,0,0,0
1708252786390,AWP 4B,012,387804,Heiser; Jerrod A,0,0,0,0
1708252786390,AWP 4B,013,387805,Jones; William Jadie,0,0,0,0
1708252786390,AWP 4B,014,387806,Jones; William Jadie,0,0,0,0
1708252786390,AWP 4B,015,387807,Christie; Veronica Ann,0,0,0,0
1708252786390,AWP 4B,016,387808,Christie; Veronica Ann,0,0,0,0
1708252786390,AWP 4B,019,387820,Falcon; Jennifer A,0,0,0,0
1708252786390,AWP 4B,020,387821,Falcon; Jennifer A,0,0,0,0
1708252786390,AWP 4B,021,387822,Eastin; Schuyler E.,0,0,0,0
1708252786390,AWP 4B,023,387824,Coulter; Jane Elisabeth,0,0,0,0
1708252786390,AWP 4B,025,387826,O'Neil; Courtney L,0,0,0,0
1708252786390,AWP 4B,026,387827,O'Neil; Courtney L,0,0,0,0
1708252786390,AWP 4B,027,387828,Tsurska Svetina; Olena,0,0,0,0
1708252786390,AWP 4B,028,387829,Tsurska Svetina; Olena,0,0,0,0
1708252786390,AWP 4B,029,387830,Spicer; Jacqueline,0,0,0,0
1708252786390,AWP 4B,030,387831,Spicer; Jacqueline,0,0,0,0
1708252786390,AWP 4B,031,387832,Steinberg; Stacy A,0,0,0,0
1708252786390,AWP 4B,032,387833,Steinberg; Stacy A,0,0,0,0
1708252786390,AWP 4B,033,387834,Chandler; Bailee Daniele,0,0,0,0
1708252786390,AWP 4B,034,387835,Chandler; Bailee Daniele,0,0,0,0
1708252786390,AWP 4B,035,387836,Tiernan; Christa Michelle,0,0,0,0
1708252786390,AWP 4B,036,387837,Tiernan; Christa Michelle,0,0,0,0
1708252786390,AWP 4B,037,387840,Gardella; Alexander Drew,0,0,0,0
1708252786390,AWP 4B,038,387841,Gardella; Alexander Drew,0,0,0,0
1708252786390,AWP 4B,039,387857,Zimmerman; Guy,0,0,0,0
1708252786390,AWP 4B,040,387858,Zimmerman; Guy,0,0,0,0
1708252786390,AWP 4B,041,387859,Zroka; Amy Liane,0,0,0,0
1708252786390,AWP 4B,042,387860,Zroka; Amy Liane,0,0,0,0
1708252786918,BENG 87,A00,489656,Sah; Robert Lie-Yuan,20,0,20,0
1708252786918,BENG 87,B00,489657,Sah; Robert Lie-Yuan,20,0,20,0
1708252786918,BENG 87,C00,494754,Omens; Jeffrey Howard,20,0,20,0
1708252787444,BENG 100,A01,387959,Alexandrov; Ludmil B,26,0,28,2
1708252787444,BENG 100,A02,387960,Alexandrov; Ludmil B,26,0,28,2
1708252787444,BENG 100,A03,387984,Alexandrov; Ludmil B,26,0,28,2
1708252787444,BENG 100,A04,387985,Alexandrov; Ludmil B,25,0,28,3
1708252787444,BENG 100,A05,387986,Alexandrov; Ludmil B,27,0,28,1
1708252787971,BENG 102,A00,387987,Chapelin; Fanny,55,0,56,1
1708252788506,BENG 103B,A00,387993,Fraley; Stephanie I.,116,0,120,4
1708252789036,BENG 112B,A01,388053,Shi; Lingyan,26,0,30,4
1708252789036,BENG 112B,A02,388054,Shi; Lingyan,29,0,30,1
1708252789563,BENG 125,A00,388055,Hasty; Jeff M,120,0,160,40
1708252790092,BENG 133,A01,388866,Mali; Prashant Gulab Ram,36,0,40,4
1708252790621,BENG 140B,A01,388884,Cabrales; Pedro,28,0,30,2
1708252790621,BENG 140B,A02,388885,Cabrales; Pedro,30,0,30,0
1708252790621,BENG 140B,A03,388886,Cabrales; Pedro,26,0,30,4
1708252791150,BENG 160,A50,388889,Aguado; Brian Alberto,23,0,25,2
1708252791150,BENG 160,A51,388919,Aguado; Brian Alberto,25,0,25,0
1708252791150,BENG 160,A52,388920,Aguado; Brian Alberto,25,0,25,0
1708252791677,BENG 168,A01,388961,Khojah; Reem I,30,0,30,0
1708252792204,BENG 172,A50,389087,Omens; Jeffrey Howard & Cabrales; Pedro,15,0,20,5
1708252792204,BENG 172,A51,389088,Omens; Jeffrey Howard & Cabrales; Pedro,14,0,20,6
1708252792731,BENG 182,A01,389128,Bafna; Vineet,28,0,30,2
1708252793262,BENG 186A,A00,389130,Kwon; Ester Jihae,105,0,120,15
1708252793789,BENG 187A,A00,389289,Taylor Amos; Alyssa C,157,0,170,13
1708252794316,BENG 187D,A00,389290,Taylor Amos; Alyssa C,33,0,60,27
1708252794316,BENG 187D,B00,389300,Taylor Amos; Alyssa C,51,0,60,9
1708252794316,BENG 187D,C00,389302,Taylor Amos; Alyssa C,35,0,60,25
1708252794842,BENG 189,A00,389303,Contijoch; Francisco,26,0,30,4
1708252795371,BENG 193,A00,389328,Engler; Adam J.,0,0,0,0
1708252795899,BENG 196,A00,436038,Engler; Adam J.,9999,0,9999,0
1708252796430,BENG 197,A00,436081,Engler; Adam J.,9999,0,9999,0
1708252796960,BENG 203,A00,389385,Bafna; Vineet & Zhong; Sheng,20,0,20,0
1708252797486,BENG 207,A00,389386,Kwon; Ester Jihae,10,0,40,30
1708252797486,BENG 207,B00,389400,Taylor Amos; Alyssa C,8,0,30,22
1708252797486,BENG 207,C00,389432,Khojah; Reem I,20,0,40,20
1708252798013,BENG 209,A00,389456,Scholtes Acevedo; Claire,30,0,30,0
1708252798539,BENG 213,A00,389496,Palsson; Bernhard O.,16,0,20,4
1708252799594,BENG 224,A00,389515,Staff,0,0,0,0
1708252800120,BENG 226,A01,479043,Schmid-Schoenbein; Geert W,7,0,30,23
1708252800647,BENG 227,A00,389591,Fraley; Stephanie I.,55,0,120,65
1708252801173,BENG 230C,A00,389810,Mc Culloch; Andrew Douglas,43,0,90,47
1708252801698,BENG 232,A01,390161,Sah; Robert Lie-Yuan,6,0,50,44
1708252802226,BENG 233,A00,390290,Shah; Sameer B,33,0,50,17
1708252802757,BENG 234,A00,390291,Silva; Gabriel,20,0,56,36
1708252803282,BENG 235,A00,390318,Bintu; Bogdan,16,0,40,24
1708252803808,BENG 276,A00,390357,Mc Culloch; Andrew Douglas & Amaro; Rommie E,0,0,0,0
1708252804335,BENG 280C,A01,390443,McVeigh; Elliot R.,45,0,56,11
1708252804860,BENG 281,A00,390444,Kravets; Vira V.,50,0,110,60
1708252805387,BENG 283,A00,390445,Komives; Elizabeth A,4,0,4,0
1708252805914,BENG 292,A01,390623,Ross; Camille,20,0,20,0
1708252806440,BENG 294C,A00,390709,Engler; Adam J.,17,0,20,3
1708252806966,BENG 295,A00,436300,Watson; John Thomas,9999,0,9999,0
1708252807492,BGGN 205,A00,423656,Daugherty; Matthew Dorton,47,0,60,13
1708252808022,BGGN 207,A01,423703,Ross; Camille,0,0,0,0
1708252808547,BGGN 215,A00,423704,Petrie; Katherine Lynn,22,0,30,8
1708252809072,BGGN 216,A01,423855,Mueller; Liam O'Connor,37,0,50,13
1708252809602,BGGN 218,A00,423861,David; Michael,19,0,30,11
1708252810129,BGGN 223,A00,423862,Bier; Ethan,17,0,35,18
1708252810654,BGGN 230,A00,423863,Taylor; Susan S.,8,0,15,7
1708252811181,BGGN 232,A00,423864,Briggs; Steven & Troemel; Emily Ruth,25,0,30,5
1708252811711,BGGN 239,A01,424014,Kronenberg; Mitchell E.,30,0,30,0
1708252812235,BGGN 240,A01,424016,Juavinett; Ashley Lauren,0,0,6,6
1708252812764,BGGN 248,A00,424017,Halpain; Shelley,26,0,30,4
1708252813293,BGGN 249C,A00,424052,Staff,33,0,33,0
1708252813818,BGGN 250,A01,424091,Zou; Yimin,7,0,8,1
1708252814345,BGGN 252,A01,424093,Sejnowski; Terrence J,5,0,6,1
1708252814874,BGGN 255,A00,424094,Root; Cory Matthew,29,0,30,1
1708252815401,BGGN 262,A01,424096,Villa Rodriguez; Elizabeth,30,0,30,0
1708252815929,BGGN 267,A01,424099,Benna; Marcus K & Aljadeff; Johnatan,5,0,6,1
1708252816457,BGGN 270,A00,477483,Juavinett; Ashley Lauren,67,0,75,8
1708252817016,BGGN 271,001,481745,Ackerman; Susan,9998,0,9999,1
1708252817016,BGGN 271,002,481746,Akbari; Omar Sultan,9999,0,9999,0
1708252817016,BGGN 271,003,481747,Allen; Nicola J,9999,0,9999,0
1708252817016,BGGN 271,004,481748,Banegas; Matthew Patrick,9999,0,9999,0
1708252817016,BGGN 271,005,481749,Breen; Ellen C.,9998,0,9999,1
1708252817016,BGGN 271,006,481750,Briggs; Steven,9998,0,9999,1
1708252817016,BGGN 271,007,481751,Bui; Jack D,9999,0,9999,0
1708252817016,BGGN 271,008,481762,Busch; Wolfgang,9999,0,9999,0
1708252817016,BGGN 271,009,481763,Castle; Michael James,9999,0,9999,0
1708252817016,BGGN 271,010,481764,Chang; John Tzu-yu,9999,0,9999,0
1708252817016,BGGN 271,011,481765,Chen; Ju,9998,0,9999,1
1708252817016,BGGN 271,012,481766,Chen; Xu,9999,0,9999,0
1708252817016,BGGN 271,013,481767,Cheng; Christine Shiang-Ling,9999,0,9999,0
1708252817016,BGGN 271,014,481768,Cherqui; Stephanie,9999,0,9999,0
1708252817016,BGGN 271,015,481769,Cho; Yoshitake,9999,0,9999,0
1708252817016,BGGN 271,016,481770,Church; Kellie Breen,9998,0,9999,1
1708252817016,BGGN 271,017,481771,Cleland; Elsa Eleanor,9999,0,9999,0
1708252817016,BGGN 271,018,481779,Cohen; Shiran,9998,0,9999,1
1708252817016,BGGN 271,019,481814,Cook-Andersen; Heidi Leigh,9999,0,9999,0
1708252817016,BGGN 271,020,481815,Cooke; James Edward,9999,0,9999,0
1708252817016,BGGN 271,021,481816,Coufal; Nicole Gabriele,9998,0,9999,1
1708252817016,BGGN 271,022,481818,Crotty Alexander; Laura E,9999,0,9999,0
1708252817016,BGGN 271,023,481819,Daugherty; Matthew Dorton,9998,0,9999,1
1708252817016,BGGN 271,024,481820,De Guglielmo; Giordano,9998,0,9999,1
1708252817016,BGGN 271,025,481821,Doherty; Taylor Alan,9998,0,9999,1
1708252817016,BGGN 271,026,481822,Dulawa; Stephanie Carole,9999,0,9999,0
1708252817016,BGGN 271,027,481823,Esko; Jeffrey D.,9998,0,9999,1
1708252817016,BGGN 271,028,481824,Feldstein; Ariel E,9998,0,9999,1
1708252817016,BGGN 271,029,481825,Friedman; Rick Adam,9999,0,9999,0
1708252817016,BGGN 271,030,481826,Furnari; Frank,9999,0,9999,0
1708252817016,BGGN 271,031,481829,Ghosh; Pradipta,9998,0,9999,1
1708252817016,BGGN 271,032,481830,Gleeson; Joseph Gerard,9999,0,9999,0
1708252817016,BGGN 271,033,481831,Golden; Susan S.,9998,0,9999,1
1708252817016,BGGN 271,034,481832,Goren; Alon M,9998,0,9999,1
1708252817016,BGGN 271,035,481834,Gustafsson; Asa Birgitta,9999,0,9999,0
1708252817016,BGGN 271,036,481836,Hamdoun; Amr,9999,0,9999,0
1708252817016,BGGN 271,037,481837,Hao; Nan,9999,0,9999,0
1708252817016,BGGN 271,038,481840,Holway; David A.,9998,0,9999,1
1708252817016,BGGN 271,039,481841,Huffaker; Alisa,9998,0,9999,1
1708252817016,BGGN 271,040,481843,Sebat; Lilia Mikhailovna,9998,0,9999,1
1708252817016,BGGN 271,041,481889,Ideker; Trey,9999,0,9999,0
1708252817016,BGGN 271,042,481890,Jiang; Qingfei,9998,0,9999,1
1708252817016,BGGN 271,043,482311,Jin; Yishi,9999,0,9999,0
1708252817016,BGGN 271,044,482334,Joiner; William J.,9999,0,9999,0
1708252817016,BGGN 271,045,482353,Kaech; Susan Michelle,9998,0,9999,1
1708252817016,BGGN 271,046,482378,Karin; Michael,9999,0,9999,0
1708252817016,BGGN 271,047,482379,Kleinfeld; David,9999,0,9999,0
1708252817016,BGGN 271,048,482413,Koffler; Yacov,9999,0,9999,0
1708252817016,BGGN 271,049,482414,Komiyama; Takaki,9999,0,9999,0
1708252817016,BGGN 271,050,482415,Kryazhimskiy; Sergey A,9999,0,9999,0
1708252817016,BGGN 271,051,482416,Lawson; Mark Andrew,9999,0,9999,0
1708252817016,BGGN 271,052,482417,Lee; Yun Sok,9999,0,9999,0
1708252817016,BGGN 271,053,482451,Leutgeb; Stefan,9998,0,9999,1
1708252817016,BGGN 271,054,482452,Lo; Stanley M.,9999,0,9999,0
1708252817016,BGGN 271,055,482453,Lu; Pengzhe,9998,0,9999,1
1708252817016,BGGN 271,056,482454,Lykke-Andersen; Jens,9998,0,9999,1
1708252817016,BGGN 271,057,482456,McDonnell; Lisa Marie,9999,0,9999,0
1708252817016,BGGN 271,058,482461,McHugh; Colleen A,9998,0,9999,1
1708252817016,BGGN 271,059,482478,Meharena; Hiruy Sibhatu,9999,0,9999,0
1708252817016,BGGN 271,060,482497,Morris; Gerald P,9999,0,9999,0
1708252817016,BGGN 271,061,482499,Mukamel; Eran A,9998,0,9999,1
1708252817016,BGGN 271,062,482535,Muotri; Alysson,9999,0,9999,0
1708252817016,BGGN 271,063,482551,Muroyama; Andrew David,9999,0,9999,0
1708252817016,BGGN 271,064,482552,Neal; Sonya E,9999,0,9999,0
1708252817016,BGGN 271,065,482618,Nieh; James Charles,9999,0,9999,0
1708252817016,BGGN 271,066,482619,O'Donoghue; Anthony John,9999,0,9999,0
1708252817016,BGGN 271,067,482626,Pantham; Priyadarshini,9999,0,9999,0
1708252817016,BGGN 271,068,482633,Parast; Mana,9999,0,9999,0
1708252817016,BGGN 271,069,482634,Perry; Michael William,9999,0,9999,0
1708252817016,BGGN 271,070,482639,Pride; David Tevis,9999,0,9999,0
1708252817016,BGGN 271,071,482645,Pruneda-Paz; Jose L.,9999,0,9999,0
1708252817016,BGGN 271,072,482648,Rana; Tariq,9999,0,9999,0
1708252817016,BGGN 271,073,482650,Risbrough; Victoria Blythe,9999,0,9999,0
1708252817016,BGGN 271,074,482655,Rissman; Robert Andrew,9999,0,9999,0
1708252817016,BGGN 271,075,482656,Rosenfeld; Michael G,9999,0,9999,0
1708252817016,BGGN 271,076,482657,Saier; Milton H.,9999,0,9999,0
1708252817016,BGGN 271,077,482663,Sander; Maike,9999,0,9999,0
1708252817016,BGGN 271,078,482664,Schenk; Simon,9999,0,9999,0
1708252817016,BGGN 271,079,482665,Schoeneberg; Johannes,9998,0,9999,1
1708252817016,BGGN 271,080,482666,Schroeder; Julian I,9998,0,9999,1
1708252817016,BGGN 271,081,482667,Shaner; Nathan C.,9999,0,9999,0
1708252817016,BGGN 271,082,482668,Sheikh; Farah,9999,0,9999,0
1708252817016,BGGN 271,083,482669,Shurin; Jonathan,9999,0,9999,0
1708252817016,BGGN 271,084,482675,Sigurdson; Christina,9999,0,9999,0
1708252817016,BGGN 271,085,482676,Smith; David M.,9999,0,9999,0
1708252817016,BGGN 271,086,482677,Steinmetz; Nicole F,9999,0,9999,0
1708252817016,BGGN 271,087,482692,Su; Chih-Ying,9999,0,9999,0
1708252817016,BGGN 271,088,482694,Suel; Gurol Mehmet,9999,0,9999,0
1708252817016,BGGN 271,089,482695,Telese; Francesca,9999,0,9999,0
1708252817016,BGGN 271,090,482745,Thackray; Varykina G.,9999,0,9999,0
1708252817016,BGGN 271,091,482746,Towers; Christina Garlingt,9999,0,9999,0
1708252817016,BGGN 271,092,482747,Troemel; Emily Ruth,9997,0,9999,2
1708252817016,BGGN 271,093,482748,Tye; Kay M,9999,0,9999,0
1708252817016,BGGN 271,094,482749,Valdez-Jasso; Daniela,9998,0,9999,1
1708252817016,BGGN 271,095,482750,Wahlin; Karl Jonas,9997,0,9999,2
1708252817016,BGGN 271,096,482751,Welsbie; Derek,9999,0,9999,0
1708252817016,BGGN 271,097,482752,Wilkinson; Miles Frome,9999,0,9999,0
1708252817016,BGGN 271,098,482754,Yaksh; Tony L.,9999,0,9999,0
1708252817016,BGGN 271,099,482760,Yang; Jing,9999,0,9999,0
1708252817016,BGGN 271,100,482761,Yeo; Eugene Wei-Ming,9998,0,9999,1
1708252817016,BGGN 271,101,482763,Ying; Wei,9999,0,9999,0
1708252817016,BGGN 271,102,482764,Zarrinpar; Amir,9999,0,9999,0
1708252817016,BGGN 271,103,482765,Zengler; Karsten B,9999,0,9999,0
1708252817016,BGGN 271,104,482766,Zhang; Dong-Er,9999,0,9999,0
1708252817016,BGGN 271,105,482768,Zhao; Yunde,9999,0,9999,0
1708252817016,BGGN 271,106,482776,Zheng; Binhai,9999,0,9999,0
1708252817016,BGGN 271,107,482777,Zheng; Ye,9998,0,9999,1
1708252817016,BGGN 271,108,482806,Zuniga; Elina I,9999,0,9999,0
1708252817542,BGGN 273,A01,424101,Mueller; Liam O'Connor,43,0,50,7
1708252818069,BGGN 280,A00,424102,Ernst; Andreas,3,0,5,2
1708252818069,BGGN 280,C00,481361,Amaro; Rommie E,2,0,5,3
1708252818600,BGGN 281,A00,424103,Desai; Arshad & Oegema; Karen,0,0,5,5
1708252819129,BGGN 283,A00,424104,Rivera; Fabian Chavez,0,0,5,5
1708252819129,BGGN 283,B00,424105,Russell; Alistair B,4,0,5,1
1708252819129,BGGN 283,D00,424107,Wildonger; Jill Cathleen,1,0,5,4
1708252819657,BGGN 284,A00,424108,Glasgow; Stacey Marie,2,0,5,3
1708252820183,BGGN 285,A00,424109,Chisholm; Andrew D.,1,0,5,4
1708252820183,BGGN 285,B00,424110,Farley; Emma Kristen,2,0,5,3
1708252820709,BGGN 295,A00,424120,Tour; Ella,9,0,30,21
1708252821238,BGJC 204,A00,424138,Lu; Li-Fan & Chang; John Tzu-yu,9998,0,9999,1
1708252821768,BGJC 215,A00,424139,Cooke; James Edward & Lo; Stanley M.,10,0,10,0
1708252822333,BGRD 200,001,485528,Ackerman; Susan,9998,0,9999,1
1708252822333,BGRD 200,002,485529,Akbari; Omar Sultan,9999,0,9999,0
1708252822333,BGRD 200,003,485530,Allen; Eric,9999,0,9999,0
1708252822333,BGRD 200,004,485531,Allen; Nicola J,9999,0,9999,0
1708252822333,BGRD 200,005,485533,Amaro; Rommie E,9999,0,9999,0
1708252822333,BGRD 200,006,485535,Augustine; Vineet,9999,0,9999,0
1708252822333,BGRD 200,007,485536,Ayres; Janelle Samantha,9999,0,9999,0
1708252822333,BGRD 200,008,485538,Banegas; Matthew Patrick,9999,0,9999,0
1708252822333,BGRD 200,009,485539,Banghart; Matthew Ryan,9999,0,9999,0
1708252822333,BGRD 200,010,485542,Benna; Marcus K,9999,0,9999,0
1708252822333,BGRD 200,011,485543,Bennett; Eric J,9999,0,9999,0
1708252822333,BGRD 200,012,485545,Bloodgood; Brenda Laurie,9999,0,9999,0
1708252822333,BGRD 200,013,485546,Breen; Ellen C.,9998,0,9999,1
1708252822333,BGRD 200,014,485548,Briggs; Steven,9998,0,9999,1
1708252822333,BGRD 200,015,485549,Bui; Jack D,9999,0,9999,0
1708252822333,BGRD 200,016,485552,Busch; Wolfgang,9999,0,9999,0
1708252822333,BGRD 200,017,485621,Callaway; Edward M,9999,0,9999,0
1708252822333,BGRD 200,018,485622,Castle; Michael James,9999,0,9999,0
1708252822333,BGRD 200,019,485623,Chaim; Isaac,9999,0,9999,0
1708252822333,BGRD 200,020,485624,Chang; John Tzu-yu,9999,0,9999,0
1708252822333,BGRD 200,021,485625,Chen; Ju,9999,0,9999,0
1708252822333,BGRD 200,022,485626,Chen; Xu,9999,0,9999,0
1708252822333,BGRD 200,023,485627,Cheng; Christine Shiang-Ling,9999,0,9999,0
1708252822333,BGRD 200,024,485632,Cherqui; Stephanie,9999,0,9999,0
1708252822333,BGRD 200,025,485633,Cho; Yoshitake,9999,0,9999,0
1708252822333,BGRD 200,026,485634,Church; Kellie Breen,9999,0,9999,0
1708252822333,BGRD 200,027,485635,Cleland; Elsa Eleanor,9999,0,9999,0
1708252822333,BGRD 200,028,485636,Cohen; Shiran,9998,0,9999,1
1708252822333,BGRD 200,029,485639,Cook-Andersen; Heidi Leigh,9999,0,9999,0
1708252822333,BGRD 200,030,485686,Cooke; James Edward,9999,0,9999,0
1708252822333,BGRD 200,031,485688,Cooper; Kimberly Lynn,9999,0,9999,0
1708252822333,BGRD 200,032,485689,Coufal; Nicole Gabriele,9998,0,9999,1
1708252822333,BGRD 200,033,485690,Crotty Alexander; Laura E,9999,0,9999,0
1708252822333,BGRD 200,034,485691,Staff,9999,0,9999,0
1708252822333,BGRD 200,035,485692,De Guglielmo; Giordano,9999,0,9999,0
1708252822333,BGRD 200,036,485693,De Silva; Shermin,9999,0,9999,0
1708252822333,BGRD 200,037,485694,Desai; Arshad,9999,0,9999,0
1708252822333,BGRD 200,038,485695,Dickinson; Alexandra Jazz,9999,0,9999,0
1708252822333,BGRD 200,039,485717,Doherty; Taylor Alan,9998,0,9999,1
1708252822333,BGRD 200,040,485720,Dulawa; Stephanie Carole,9999,0,9999,0
1708252822333,BGRD 200,041,485721,Ecker; Joseph R,9999,0,9999,0
1708252822333,BGRD 200,042,485760,Engle; Dannielle D,9999,0,9999,0
1708252822333,BGRD 200,043,485761,Ernst; Andreas,9998,0,9999,1
1708252822333,BGRD 200,044,485766,Esko; Jeffrey D.,9998,0,9999,1
1708252822333,BGRD 200,045,485905,Evans; Ronald M,9999,0,9999,0
1708252822333,BGRD 200,046,485907,Staff,9999,0,9999,0
1708252822333,BGRD 200,047,485918,Feldstein; Ariel E,9998,0,9999,1
1708252822333,BGRD 200,048,485938,Friedman; Rick Adam,9999,0,9999,0
1708252822333,BGRD 200,049,485986,Furnari; Frank,9999,0,9999,0
1708252822333,BGRD 200,050,486018,Gage; Fred H,9999,0,9999,0
1708252822333,BGRD 200,051,486139,George; Monique Leana,9999,0,9999,0
1708252822333,BGRD 200,052,486140,Ghosh; Pradipta,9998,0,9999,1
1708252822333,BGRD 200,053,486141,Glass; Christopher,9998,0,9999,1
1708252822333,BGRD 200,054,486142,Gleeson; Joseph Gerard,9999,0,9999,0
1708252822333,BGRD 200,055,486143,Golden; Susan S.,9999,0,9999,0
1708252822333,BGRD 200,056,486144,Goldrath; Ananda,9999,0,9999,0
1708252822333,BGRD 200,057,486145,Goren; Alon M,9998,0,9999,1
1708252822333,BGRD 200,058,486146,Gustafsson; Asa Birgitta,9999,0,9999,0
1708252822333,BGRD 200,059,486164,Gutkind; Jorge Silvio,9999,0,9999,0
1708252822333,BGRD 200,060,486203,Hamdoun; Amr,9999,0,9999,0
1708252822333,BGRD 200,061,486204,Hampton; Randolph Y.,9999,0,9999,0
1708252822333,BGRD 200,062,486205,Hao; Nan,9999,0,9999,0
1708252822333,BGRD 200,063,486206,Staff,9999,0,9999,0
1708252822333,BGRD 200,064,486207,Hasty; Jeff M,9999,0,9999,0
1708252822333,BGRD 200,065,486208,Hollern; Daniel Patrick,9999,0,9999,0
1708252822333,BGRD 200,066,486209,Holway; David A.,9997,0,9999,2
1708252822333,BGRD 200,067,486214,Huffaker; Alisa,9998,0,9999,1
1708252822333,BGRD 200,068,486215,Hui; Enfu,9999,0,9999,0
1708252822333,BGRD 200,069,486216,Hwa; Terence T.,9999,0,9999,0
1708252822333,BGRD 200,070,486217,Sebat; Lilia Mikhailovna,9998,0,9999,1
1708252822333,BGRD 200,071,486218,Ideker; Trey,9999,0,9999,0
1708252822333,BGRD 200,072,486219,Jackrel; Sara,9998,0,9999,1
1708252822333,BGRD 200,073,486224,Jiang; Qingfei,9998,0,9999,1
1708252822333,BGRD 200,074,486225,Jin; Yishi,9999,0,9999,0
1708252822333,BGRD 200,075,486226,Joiner; William J.,9999,0,9999,0
1708252822333,BGRD 200,076,486227,Jun; Suckjoon,9999,0,9999,0
1708252822333,BGRD 200,077,486228,Kadonaga; James T,9998,0,9999,1
1708252822333,BGRD 200,078,486229,Kaech; Susan Michelle,9997,0,9999,2
1708252822333,BGRD 200,079,486237,Karin; Michael,9999,0,9999,0
1708252822333,BGRD 200,080,486238,Kleinfeld; David,9999,0,9999,0
1708252822333,BGRD 200,081,486239,Knight; Robin,9999,0,9999,0
1708252822333,BGRD 200,082,486335,Koffler; Yacov,9999,0,9999,0
1708252822333,BGRD 200,083,486336,Komiyama; Takaki,9999,0,9999,0
1708252822333,BGRD 200,084,486337,Kosuri; Pallav,9999,0,9999,0
1708252822333,BGRD 200,085,486353,Kryazhimskiy; Sergey A,9999,0,9999,0
1708252822333,BGRD 200,086,486354,Kurle; Carolyn M.,9999,0,9999,0
1708252822333,BGRD 200,087,486355,Law; Julie A,9999,0,9999,0
1708252822333,BGRD 200,088,486356,Lawson; Mark Andrew,9999,0,9999,0
1708252822333,BGRD 200,089,486357,Lee; Kuo Fen,9999,0,9999,0
1708252822333,BGRD 200,090,486376,Lee; Yun Sok,9999,0,9999,0
1708252822333,BGRD 200,091,486413,Leutgeb; Jill K.,9999,0,9999,0
1708252822333,BGRD 200,092,486414,Leutgeb; Stefan,9998,0,9999,1
1708252822333,BGRD 200,093,486415,Lim; Byungkook,9999,0,9999,0
1708252822333,BGRD 200,094,486419,Lo; Stanley M.,9999,0,9999,0
1708252822333,BGRD 200,095,486420,Looger; Loren Lee,9999,0,9999,0
1708252822333,BGRD 200,096,486422,Lovett-Barron; Matthew Rod,9999,0,9999,0
1708252822333,BGRD 200,097,486423,Lu; Li-Fan,9998,0,9999,1
1708252822333,BGRD 200,098,486424,Lu; Pengzhe,9998,0,9999,1
1708252822333,BGRD 200,099,486425,Lykke-Andersen; Jens,9998,0,9999,1
1708252822333,BGRD 200,100,486426,Lyumkis; Dmitry Evgenievich,9999,0,9999,0
1708252822333,BGRD 200,101,486427,Madigan; Cressida Ariana,9999,0,9999,0
1708252822333,BGRD 200,102,486428,Staff,9999,0,9999,0
1708252822333,BGRD 200,103,486429,Mayfield; Stephen P.,9998,0,9999,1
1708252822333,BGRD 200,104,486430,McDonnell; Lisa Marie,9999,0,9999,0
1708252822333,BGRD 200,105,486620,McHugh; Colleen A,9998,0,9999,1
1708252822333,BGRD 200,106,486621,Meharena; Hiruy Sibhatu,9999,0,9999,0
1708252822333,BGRD 200,107,486622,Staff,9999,0,9999,0
1708252822333,BGRD 200,108,486681,Morris; Gerald P,9999,0,9999,0
1708252822333,BGRD 200,109,486682,Mukamel; Eran A,9998,0,9999,1
1708252822333,BGRD 200,110,486683,Muotri; Alysson,9999,0,9999,0
1708252822333,BGRD 200,111,486684,Muroyama; Andrew David,9999,0,9999,0
1708252822333,BGRD 200,112,486687,Murre; Cornelis,9999,0,9999,0
1708252822333,BGRD 200,113,486691,Neal; Sonya E,9999,0,9999,0
1708252822333,BGRD 200,114,486692,Nieh; James Charles,9998,0,9999,1
1708252822333,BGRD 200,115,486693,Nimmerjahn; Axel,9999,0,9999,0
1708252822333,BGRD 200,116,486694,Nizet; Victor F.,9999,0,9999,0
1708252822333,BGRD 200,117,486695,O'Donoghue; Anthony John,9999,0,9999,0
1708252822333,BGRD 200,118,486706,Oegema; Karen,9999,0,9999,0
1708252822333,BGRD 200,119,486708,O'Shea; Clodagh,9999,0,9999,0
1708252822333,BGRD 200,120,486709,Pantham; Priyadarshini,9999,0,9999,0
1708252822333,BGRD 200,121,486715,Parast; Mana,9999,0,9999,0
1708252822333,BGRD 200,122,486716,Pasquinelli; Amy,9998,0,9999,1
1708252822333,BGRD 200,123,486718,Pekkurnaz Banghart; Gulcin,9999,0,9999,0
1708252822333,BGRD 200,124,486720,Perry; Michael William,9999,0,9999,0
1708252822333,BGRD 200,125,486721,Pfaff; Samuel,9999,0,9999,0
1708252822333,BGRD 200,126,486723,Pogliano; Joseph,9999,0,9999,0
1708252822333,BGRD 200,127,486724,Pogliano; Kit J.,9999,0,9999,0
1708252822333,BGRD 200,128,486727,Pride; David Tevis,9999,0,9999,0
1708252822333,BGRD 200,129,486728,Pruneda-Paz; Jose L.,9999,0,9999,0
1708252822333,BGRD 200,130,486733,Staff,9999,0,9999,0
1708252822333,BGRD 200,131,486734,Rana; Tariq,9999,0,9999,0
1708252822333,BGRD 200,132,486736,Reck-Peterson; Samara L,9999,0,9999,0
1708252822333,BGRD 200,133,486738,Rennison; Diana,9999,0,9999,0
1708252822333,BGRD 200,134,486741,Rifkin; Scott,9999,0,9999,0
1708252822333,BGRD 200,135,486743,Risbrough; Victoria Blythe,9999,0,9999,0
1708252822333,BGRD 200,136,486749,Rissman; Robert Andrew,9999,0,9999,0
1708252822333,BGRD 200,137,486750,Rivera; Fabian Chavez,9999,0,9999,0
1708252822333,BGRD 200,138,486753,Root; Cory Matthew,9999,0,9999,0
1708252822333,BGRD 200,139,486760,Rosenfeld; Michael G,9998,0,9999,1
1708252822333,BGRD 200,140,486763,Russell; Alistair B,9999,0,9999,0
1708252822333,BGRD 200,141,486766,Saier; Milton H.,9999,0,9999,0
1708252822333,BGRD 200,142,486768,Sander; Maike,9999,0,9999,0
1708252822333,BGRD 200,143,486770,Saphire; Erica Ollmann,9999,0,9999,0
1708252822333,BGRD 200,144,486771,Schenk; Simon,9999,0,9999,0
1708252822333,BGRD 200,145,486774,Schoeneberg; Johannes,9999,0,9999,0
1708252822333,BGRD 200,146,486777,Schroeder; Julian I,9998,0,9999,1
1708252822333,BGRD 200,147,486783,Shah; Sameer B,9999,0,9999,0
1708252822333,BGRD 200,148,486784,Shaner; Nathan C.,9999,0,9999,0
1708252822333,BGRD 200,149,486785,Shaw; Reuben,9999,0,9999,0
1708252822333,BGRD 200,150,486786,Sheikh; Farah,9999,0,9999,0
1708252822333,BGRD 200,151,486787,Staff,9999,0,9999,0
1708252822333,BGRD 200,152,486788,Signer; Robert,9999,0,9999,0
1708252822333,BGRD 200,153,486789,Sigurdson; Christina,9999,0,9999,0
1708252822333,BGRD 200,154,486790,Smith; David M.,9999,0,9999,0
1708252822333,BGRD 200,155,486791,Soncin; Francesca,9999,0,9999,0
1708252822333,BGRD 200,156,486792,Steinmetz; Nicole F,9999,0,9999,0
1708252822333,BGRD 200,157,486793,Su; Chih-Ying,9999,0,9999,0
1708252822333,BGRD 200,158,486794,Suel; Gurol Mehmet,9999,0,9999,0
1708252822333,BGRD 200,159,486795,Sun; Xin,9999,0,9999,0
1708252822333,BGRD 200,160,486796,Telese; Francesca,9999,0,9999,0
1708252822333,BGRD 200,161,486797,Thackray; Varykina G.,9999,0,9999,0
1708252822333,BGRD 200,162,486798,Towers; Christina Garlingt,9999,0,9999,0
1708252822333,BGRD 200,163,486799,Traver; David,9999,0,9999,0
1708252822333,BGRD 200,164,486800,Troemel; Emily Ruth,9998,0,9999,1
1708252822333,BGRD 200,165,486801,Tye; Kay M,9999,0,9999,0
1708252822333,BGRD 200,166,486802,Valdez-Jasso; Daniela,9998,0,9999,1
1708252822333,BGRD 200,167,486803,Vijayanand; Pandurangan,9999,0,9999,0
1708252822333,BGRD 200,168,486804,Villa Rodriguez; Elizabeth,9999,0,9999,0
1708252822333,BGRD 200,169,486805,Wahlin; Karl Jonas,9997,0,9999,2
1708252822333,BGRD 200,170,486806,Wang; Jean Yin Jen,9999,0,9999,0
1708252822333,BGRD 200,171,486807,Welsbie; Derek,9999,0,9999,0
1708252822333,BGRD 200,172,486808,Wildonger; Jill Cathleen,9998,0,9999,1
1708252822333,BGRD 200,173,486809,Wilkinson; Miles Frome,9999,0,9999,0
1708252822333,BGRD 200,174,486810,Winzeler; Elizabeth A,9999,0,9999,0
1708252822333,BGRD 200,175,486811,Yaksh; Tony L.,9999,0,9999,0
1708252822333,BGRD 200,176,486812,Yang; Jing,9999,0,9999,0
1708252822333,BGRD 200,177,486813,Staff,9999,0,9999,0
1708252822333,BGRD 200,178,486814,Yeo; Eugene Wei-Ming,9998,0,9999,1
1708252822333,BGRD 200,179,486815,Ying; Wei,9999,0,9999,0
1708252822333,BGRD 200,180,486816,Zarrinpar; Amir,9999,0,9999,0
1708252822333,BGRD 200,181,486817,Zengler; Karsten B,9999,0,9999,0
1708252822333,BGRD 200,182,486818,Zhang; Dong-Er,9999,0,9999,0
1708252822333,BGRD 200,183,486819,Zhao; Yunde,9999,0,9999,0
1708252822333,BGRD 200,184,486820,Zheng; Binhai,9999,0,9999,0
1708252822333,BGRD 200,185,486821,Zheng; Ye,9998,0,9999,1
1708252822333,BGRD 200,186,486822,Zuniga; Elina I,9999,0,9999,0
1708252822858,BGSE 200,A00,424140,Tour; Ella & Petrie; Katherine Lynn,9995,0,9999,4
1708252823383,BGSE 205,A00,424177,Bennett; Eric J,49,0,50,1
1708252823383,BGSE 205,B00,424179,Bennett; Eric J,48,0,50,2
1708252823383,BGSE 205,C00,424182,Bennett; Eric J,47,0,50,3
1708252823383,BGSE 205,D00,424184,Bennett; Eric J,46,0,50,4
1708252823383,BGSE 205,E00,424185,Bennett; Eric J,50,0,50,0
1708252823910,BIBC 100,A01,425401,Corbett; Kevin Daniel,150,0,158,8
1708252823910,BIBC 100,B01,477769,Amaro; Rommie E,156,0,158,2
1708252824437,BIBC 102,A01,425425,Bozinovic; Goran,255,0,256,1
1708252824437,BIBC 102,B01,425440,Hampton; Randolph Y.,250,0,256,6
1708252824437,BIBC 102,C01,486849,Flagg; Matthew Paul,61,0,120,59
1708252824966,BIBC 103,A01,425476,Grossman; Emily N,17,0,24,7
1708252824966,BIBC 103,A02,425509,Grossman; Emily N,21,0,24,3
1708252824966,BIBC 103,A03,425530,Grossman; Emily N,18,0,24,6
1708252824966,BIBC 103,A04,425536,Grossman; Emily N,22,0,24,2
1708252824966,BIBC 103,B01,425538,Boumechache; Miyyada,20,0,24,4
1708252824966,BIBC 103,B02,425539,Boumechache; Miyyada,24,0,24,0
1708252824966,BIBC 103,B03,425548,Boumechache; Miyyada,24,0,24,0
1708252824966,BIBC 103,B04,425549,Boumechache; Miyyada,24,0,24,0
1708252825493,BIBC 120,A01,425592,Coleman; Aaron B.,242,0,256,14
1708252826025,BIBC 194,A00,425609,Ernst; Andreas,21,0,27,6
1708252826025,BIBC 194,B00,477632,Saier; Milton H.,26,0,27,1
1708252826025,BIBC 194,C00,481360,Amaro; Rommie E,23,0,27,4
1708252826025,BIBC 194,D00,486852,Flagg; Matthew Paul,21,0,32,11
1708252826554,BICD 100,A01,470377,Troemel; Emily Ruth,127,0,128,1
1708252826554,BICD 100,A02,470378,Troemel; Emily Ruth,126,0,128,2
1708252826554,BICD 100,B01,470409,Reinagel; Pam,59,0,64,5
1708252826554,BICD 100,B02,470413,Reinagel; Pam,62,0,64,2
1708252826554,BICD 100,B03,470464,Reinagel; Pam,64,0,64,0
1708252826554,BICD 100,B04,470468,Reinagel; Pam,63,0,64,1
1708252826554,BICD 100,C01,470469,Beyhan; Sinem,51,0,64,13
1708252826554,BICD 100,C02,470605,Beyhan; Sinem,58,0,64,6
1708252826554,BICD 100,C03,470606,Beyhan; Sinem,60,0,64,4
1708252826554,BICD 100,C04,470607,Beyhan; Sinem,63,0,64,1
1708252826554,BICD 100,D01,477465,Nguyen; Vu Quang,158,0,160,2
1708252827081,BICD 100R,A01,425674,Smith; Laurie,29,0,34,5
1708252827081,BICD 100R,A02,425675,Smith; Laurie,30,0,34,4
1708252827081,BICD 100R,A03,425676,Smith; Laurie,30,0,34,4
1708252827608,BICD 104,A01,425696,Greenspan; Ralph J.,60,0,64,4
1708252828135,BICD 110,A01,470608,Muroyama; Andrew David,264,0,275,11
1708252828135,BICD 110,B01,425721,Ernst; Andreas,245,0,275,30
1708252828661,BICD 112,A01,458177,Cooper; Kimberly Lynn & Traver; David,10,0,32,22
1708252828661,BICD 112,A02,458180,Cooper; Kimberly Lynn & Traver; David,28,0,32,4
1708252829192,BICD 123,A01,425725,Zhao; Yunde,24,0,32,8
1708252829721,BICD 140,A01,425728,Lu; Li-Fan,227,0,240,13
1708252830247,BICD 158,A01,425730,Bier; Ethan,136,0,145,9
1708252830778,BICD 194,A00,425731,Desai; Arshad & Oegema; Karen,18,0,27,9
1708252830778,BICD 194,B00,481735,Wilhelm; James E.,29,0,32,3
1708252831310,BIEB 121,A00,425732,Butler; Shannon Rhey,21,0,32,11
1708252831310,BIEB 121,B00,425733,Butler; Shannon Rhey,24,0,32,8
1708252831838,BIEB 130,A01,425735,Kurle; Carolyn M.,243,0,295,52
1708252832421,BIEB 146,A01,425737,Petrie; Katherine Lynn,365,0,395,30
1708252832949,BIEB 148,A01,470637,Rose; Noah Hartmann,59,0,63,4
1708252832949,BIEB 148,A02,470638,Rose; Noah Hartmann,61,0,63,2
1708252833478,BIEB 154,A01,458184,Stockwell; Sarah R,29,0,30,1
1708252833478,BIEB 154,A02,458186,Stockwell; Sarah R,29,0,30,1
1708252834002,BIEB 176,A01,425741,De Silva; Shermin,56,0,64,8
1708252834530,BIEB 182,A01,458194,Roy; Kaustuv,25,0,32,7
1708252834530,BIEB 182,A02,458215,Roy; Kaustuv,31,0,32,1
1708252835057,BILD 1,A01,424267,Patrick; Gentry,249,0,250,1
1708252835057,BILD 1,B01,424272,Burg; Michael,231,0,250,19
1708252835057,BILD 1,C01,424293,Pickett; Brooke Elizabeth,245,0,250,5
1708252835057,BILD 1,D01,458292,Gonzalez Gamboa; Ivonne,48,0,50,2
1708252835057,BILD 1,D02,458295,Gonzalez Gamboa; Ivonne,50,0,50,0
1708252835057,BILD 1,D03,458296,Gonzalez Gamboa; Ivonne,50,0,50,0
1708252835057,BILD 1,D04,458297,Gonzalez Gamboa; Ivonne,49,0,50,1
1708252835057,BILD 1,D05,458303,Gonzalez Gamboa; Ivonne,50,0,50,0
1708252835585,BILD 2,A01,458304,Reyes Gonzalez; Catalina,53,0,56,3
1708252835585,BILD 2,A02,458307,Reyes Gonzalez; Catalina,55,0,56,1
1708252835585,BILD 2,A03,458313,Reyes Gonzalez; Catalina,55,0,56,1
1708252835585,BILD 2,A04,458320,Reyes Gonzalez; Catalina,56,0,56,0
1708252835585,BILD 2,B01,458324,Reyes Gonzalez; Catalina,47,0,56,9
1708252835585,BILD 2,B02,458327,Reyes Gonzalez; Catalina,54,0,56,2
1708252835585,BILD 2,B03,458339,Reyes Gonzalez; Catalina,56,0,56,0
1708252835585,BILD 2,B04,458340,Reyes Gonzalez; Catalina,56,0,56,0
1708252835585,BILD 2,C01,458387,Park; Ji Young,44,0,49,5
1708252835585,BILD 2,C02,458544,Park; Ji Young,46,0,49,3
1708252835585,BILD 2,C03,458557,Park; Ji Young,47,0,49,2
1708252835585,BILD 2,C04,458563,Park; Ji Young,46,0,49,3
1708252836113,BILD 3,A01,424312,Hammond; LaTisha Marie,331,0,350,19
1708252836113,BILD 3,B01,470107,Stockwell; Sarah R,66,0,70,4
1708252836113,BILD 3,B02,470110,Stockwell; Sarah R,70,0,70,0
1708252836113,BILD 3,B03,470116,Stockwell; Sarah R,70,0,70,0
1708252836113,BILD 3,B04,470123,Stockwell; Sarah R,67,0,70,3
1708252836113,BILD 3,B05,470150,Stockwell; Sarah R,70,0,70,0
1708252836113,BILD 3,C01,470159,Cooper; Kimberly Lynn,67,0,70,3
1708252836113,BILD 3,C02,470160,Cooper; Kimberly Lynn,69,0,70,1
1708252836113,BILD 3,C03,470164,Cooper; Kimberly Lynn,70,0,70,0
1708252836113,BILD 3,C04,470165,Cooper; Kimberly Lynn,69,0,70,1
1708252836113,BILD 3,C05,470374,Cooper; Kimberly Lynn,68,0,70,2
1708252836647,BILD 4,A01,424318,Staff,22,0,24,2
1708252836647,BILD 4,A02,424324,Staff,24,0,24,0
1708252836647,BILD 4,A03,424325,Staff,24,0,24,0
1708252836647,BILD 4,A04,424326,Staff,22,0,24,2
1708252836647,BILD 4,A05,424327,Staff,24,0,24,0
1708252836647,BILD 4,A06,424330,Staff,24,0,24,0
1708252836647,BILD 4,A07,424331,Staff,24,0,24,0
1708252836647,BILD 4,A08,424342,Staff,24,0,24,0
1708252836647,BILD 4,B01,424462,Pickett; Brooke Elizabeth,23,0,24,1
1708252836647,BILD 4,B02,424466,Pickett; Brooke Elizabeth,24,0,24,0
1708252836647,BILD 4,B03,424469,Pickett; Brooke Elizabeth,23,0,24,1
1708252836647,BILD 4,B04,424470,Pickett; Brooke Elizabeth,22,0,24,2
1708252836647,BILD 4,B05,424700,Pickett; Brooke Elizabeth,23,0,24,1
1708252836647,BILD 4,B06,424723,Pickett; Brooke Elizabeth,24,0,24,0
1708252836647,BILD 4,B07,424730,Pickett; Brooke Elizabeth,24,0,24,0
1708252836647,BILD 4,B08,424929,Pickett; Brooke Elizabeth,22,0,24,2
1708252836647,BILD 4,C01,424947,Gonzalez Gamboa; Ivonne,22,0,24,2
1708252836647,BILD 4,C02,424951,Gonzalez Gamboa; Ivonne,23,0,24,1
1708252836647,BILD 4,C03,424991,Gonzalez Gamboa; Ivonne,23,0,24,1
1708252836647,BILD 4,C04,424993,Gonzalez Gamboa; Ivonne,24,0,24,0
1708252836647,BILD 4,C05,424994,Gonzalez Gamboa; Ivonne,24,0,24,0
1708252836647,BILD 4,C06,425209,Gonzalez Gamboa; Ivonne,24,0,24,0
1708252836647,BILD 4,C07,425233,Gonzalez Gamboa; Ivonne,24,0,24,0
1708252836647,BILD 4,C08,425247,Gonzalez Gamboa; Ivonne,24,0,24,0
1708252837177,BILD 60,A01,425326,Hammond; LaTisha Marie,62,0,64,2
1708252837704,BILD 83,A00,425347,Pogliano; Joseph,25,0,30,5
1708252838230,BILD 87,A00,425368,Saier; Milton H.,20,0,20,0
1708252838761,BIMM 100,A01,425744,Cooper; Andrew Michael,303,0,320,17
1708252838761,BIMM 100,B01,425746,Cooper; Andrew Michael,315,0,320,5
1708252839291,BIMM 101,A01,425748,McDonnell; Lisa Marie,8,0,24,16
1708252839291,BIMM 101,A02,425749,McDonnell; Lisa Marie,23,0,24,1
1708252839291,BIMM 101,B01,425751,Day; Christopher D,22,0,24,2
1708252839291,BIMM 101,B02,425752,Day; Christopher D,24,0,24,0
1708252839291,BIMM 101,B03,425753,Day; Christopher D,22,0,24,2
1708252839291,BIMM 101,B04,425754,Day; Christopher D,24,0,24,0
1708252839291,BIMM 101,C01,425756,Rusert; Jessica Marie,16,0,24,8
1708252839291,BIMM 101,C02,425757,Rusert; Jessica Marie,23,0,24,1
1708252839291,BIMM 101,C03,425758,Rusert; Jessica Marie,23,0,24,1
1708252839291,BIMM 101,C04,425759,Rusert; Jessica Marie,23,0,24,1
1708252839824,BIMM 110,A01,425764,Niwa; Maho,55,0,56,1
1708252839824,BIMM 110,A02,425765,Niwa; Maho,56,0,56,0
1708252839824,BIMM 110,A03,425766,Niwa; Maho,56,0,56,0
1708252839824,BIMM 110,A04,425767,Niwa; Maho,55,0,56,1
1708252840351,BIMM 116R,A01,425771,Golden; Susan S. & Gorman; Michael R.,55,0,72,17
1708252840351,BIMM 116R,A02,425772,Golden; Susan S. & Gorman; Michael R.,53,0,72,19
1708252840351,BIMM 116R,A03,425773,Golden; Susan S. & Gorman; Michael R.,66,0,72,6
1708252840351,BIMM 116R,A04,425774,Golden; Susan S. & Gorman; Michael R.,70,0,72,2
1708252840881,BIMM 118,A01,425779,David; Michael,83,0,96,13
1708252841408,BIMM 120,A01,425792,Pirino; Giorgia,203,0,216,13
1708252841408,BIMM 120,B01,470639,Saier; Milton H.,201,0,216,15
1708252841934,BIMM 121,A01,425830,Gustafson-Brown; Cindy,18,0,24,6
1708252841934,BIMM 121,A02,425831,Gustafson-Brown; Cindy,21,0,24,3
1708252841934,BIMM 121,A03,425832,Gustafson-Brown; Cindy,24,0,24,0
1708252841934,BIMM 121,A04,425833,Gustafson-Brown; Cindy,23,0,24,1
1708252841934,BIMM 121,B01,425835,Pirino; Giorgia,17,0,24,7
1708252841934,BIMM 121,B02,425836,Pirino; Giorgia,24,0,24,0
1708252841934,BIMM 121,C01,425838,Park; Ji Young,6,0,24,18
1708252841934,BIMM 121,C02,425839,Park; Ji Young,20,0,24,4
1708252842464,BIMM 134,A01,425841,Burg; Michael,393,0,416,23
1708252842990,BIMM 143,A01,425843,Grant; Barry J,17,0,40,23
1708252842990,BIMM 143,B01,425845,Bozinovic; Goran,33,0,40,7
1708252843517,BIMM 182,A01,455012,Bafna; Vineet,28,0,50,22
1708252844046,BIMM 194,A00,425847,Rivera; Fabian Chavez,24,0,27,3
1708252844046,BIMM 194,B00,425868,Russell; Alistair B,16,0,27,11
1708252844046,BIMM 194,D00,425870,Wildonger; Jill Cathleen,14,0,27,13
1708252844571,BIOM 202,A00,390710,Corbett; Kevin Daniel,93,0,100,7
1708252845097,BIOM 219,A00,390713,Ross; Camille,0,0,0,7
1708252845624,BIOM 231,A00,455099,Furnari; Frank,0,0,0,0
1708252845624,BIOM 231,B00,455100,Lopez Ramirez; Miguel Alej,0,0,0,0
1708252846149,BIOM 242,A00,390714,Hamilton; Bruce Alan,20,0,20,0
1708252846681,BIOM 246,A00,492784,Gordts; Philip & Varki; Ajit P & Lewis; Amanda Lark & Godula; Kamil & Gagneux; Pascal & Esko; Jeffrey D. & Bode; Lars,0,0,0,0
1708252847209,BIOM 252,A00,390715,Ayyagari; Radha,27,0,28,1
1708252847736,BIOM 254,A00,390718,Corbett; Kevin Daniel,14,0,20,6
1708252848263,BIOM 272,A00,390722,Hangauer; Matthew John,16,0,20,4
1708252848792,BIOM 274,A00,390725,Sun; Bryan Kee-Hong,7,0,15,8
1708252849320,BIOM 283,A00,390728,Komives; Elizabeth A,2,0,2,0
1708252849849,BIOM 285,A00,390730,Gaulton; Kyle J,10,0,20,10
1708252850375,BIOM 295,A00,455083,Brown; Joan Heller,0,0,0,0
1708252850908,BIPN 100,A01,425872,Augustine; Vineet,240,0,245,5
1708252850908,BIPN 100,B01,425874,George; Monique Leana,240,0,245,5
1708252850908,BIPN 100,C01,458640,Maita; Isabella Vincenza,44,0,49,5
1708252850908,BIPN 100,C02,458646,Maita; Isabella Vincenza,48,0,49,1
1708252850908,BIPN 100,C03,458714,Maita; Isabella Vincenza,48,0,49,1
1708252850908,BIPN 100,C04,458716,Maita; Isabella Vincenza,48,0,49,1
1708252850908,BIPN 100,C05,458717,Maita; Isabella Vincenza,46,0,49,3
1708252851435,BIPN 105,A01,425877,Armour; Jon Christopher,12,0,21,9
1708252851435,BIPN 105,A02,425878,Armour; Jon Christopher,21,0,21,0
1708252851435,BIPN 105,A03,425879,Armour; Jon Christopher,10,0,21,11
1708252851435,BIPN 105,A04,425880,Armour; Jon Christopher,20,0,21,1
1708252851962,BIPN 120,A01,425882,Cooke; James Edward,371,0,395,24
1708252852492,BIPN 140,A01,425884,Hibbs; Ryan E.,183,0,192,9
1708252853019,BIPN 144,A01,425886,Zou; Yimin,153,0,158,5
1708252853546,BIPN 145,A01,425888,Maita; Isabella Vincenza,41,0,42,1
1708252853546,BIPN 145,B01,425918,Marino; Marc J,37,0,42,5
1708252853546,BIPN 145,B02,425954,Marino; Marc J,40,0,42,2
1708252854072,BIPN 147,A01,426086,Sejnowski; Terrence J,53,0,64,11
1708252854599,BIPN 152,A01,426112,Halpain; Shelley,97,0,128,31
1708252855129,BIPN 162,A01,426120,Juavinett; Ashley Lauren,17,0,30,13
1708252855658,BIPN 164,A01,455010,Benna; Marcus K & Aljadeff; Johnatan,120,0,120,0
1708252856186,BIPN 194,A00,426122,Glasgow; Stacey Marie,20,0,27,7
1708252856712,BISP 170,A00,426158,French; Kathleen Ann,26,0,30,4
1708252857236,BISP 182,A00,426168,Pogliano; Joseph,9999,0,9999,0
1708252857765,BISP 194,A00,426240,Chisholm; Andrew D.,11,0,27,16
1708252857765,BISP 194,B00,426241,Farley; Emma Kristen,25,0,27,2
1708252858291,BNFO 281,A00,427175,Gaasterland; Theresa,85,0,100,15
1708252858819,BNFO 283,A00,427211,Carter; Hannah Kathryn & Chavez; Alejandro,39,0,50,11
1708252858819,BNFO 283,B00,480483,Amariuta-Bartell; Tiffany & Dorrestein; Pieter,21,0,30,9
1708252859349,BNFO 294,B01,427269,Ross; Camille,47,0,50,3
1708252859886,CAT 3,A01,396994,Glaser; Amelia,15,0,15,0
1708252859886,CAT 3,A02,396995,Glaser; Amelia,15,0,15,0
1708252859886,CAT 3,A03,396996,Glaser; Amelia,7,0,15,8
1708252859886,CAT 3,A04,396997,Glaser; Amelia,12,0,15,3
1708252859886,CAT 3,A05,397004,Glaser; Amelia,15,0,15,0
1708252859886,CAT 3,A06,397039,Glaser; Amelia,11,0,15,4
1708252859886,CAT 3,A07,397040,Glaser; Amelia,13,0,15,2
1708252859886,CAT 3,A08,397084,Glaser; Amelia,15,0,15,0
1708252859886,CAT 3,A09,397269,Glaser; Amelia,13,0,15,2
1708252859886,CAT 3,A10,397270,Glaser; Amelia,0,0,15,15
1708252859886,CAT 3,A11,397271,Glaser; Amelia,9,0,15,6
1708252859886,CAT 3,A12,397272,Glaser; Amelia,12,0,15,3
1708252859886,CAT 3,A13,397273,Glaser; Amelia,15,0,15,0
1708252859886,CAT 3,A14,397274,Glaser; Amelia,14,0,15,1
1708252859886,CAT 3,B01,397276,Porter; Lisa,15,0,15,0
1708252859886,CAT 3,B02,397277,Porter; Lisa,15,0,15,0
1708252859886,CAT 3,B03,397278,Porter; Lisa,14,0,15,1
1708252859886,CAT 3,B04,397279,Porter; Lisa,15,0,15,0
1708252859886,CAT 3,B06,397281,Porter; Lisa,15,0,15,0
1708252859886,CAT 3,B07,397291,Porter; Lisa,15,0,15,0
1708252859886,CAT 3,B09,397293,Porter; Lisa,15,0,15,0
1708252859886,CAT 3,B10,397294,Porter; Lisa,15,0,15,0
1708252859886,CAT 3,B11,397295,Porter; Lisa,12,0,15,3
1708252859886,CAT 3,B12,397296,Porter; Lisa,14,0,15,1
1708252859886,CAT 3,B13,397297,Porter; Lisa,11,0,15,4
1708252859886,CAT 3,B14,397298,Porter; Lisa,15,0,15,0
1708252859886,CAT 3,B15,397299,Porter; Lisa,15,0,15,0
1708252859886,CAT 3,B16,397300,Porter; Lisa,15,0,15,0
1708252859886,CAT 3,C01,397302,Marchisotto; Jennifer Anne,13,0,15,2
1708252859886,CAT 3,C02,397308,Marchisotto; Jennifer Anne,9,0,15,6
1708252859886,CAT 3,C03,397309,Marchisotto; Jennifer Anne,9,0,15,6
1708252859886,CAT 3,C04,397315,Marchisotto; Jennifer Anne,11,0,15,4
1708252859886,CAT 3,C05,397316,Marchisotto; Jennifer Anne,14,0,15,1
1708252859886,CAT 3,C06,397322,Marchisotto; Jennifer Anne,15,0,15,0
1708252859886,CAT 3,C07,397323,Marchisotto; Jennifer Anne,15,0,15,0
1708252859886,CAT 3,C08,397329,Marchisotto; Jennifer Anne,15,0,15,0
1708252859886,CAT 3,C09,397333,Marchisotto; Jennifer Anne,15,0,15,0
1708252859886,CAT 3,C10,397336,Marchisotto; Jennifer Anne,15,0,15,0
1708252859886,CAT 3,C11,397354,Marchisotto; Jennifer Anne,13,0,15,2
1708252859886,CAT 3,C12,397357,Marchisotto; Jennifer Anne,15,0,15,0
1708252859886,CAT 3,C13,397364,Marchisotto; Jennifer Anne,14,0,15,1
1708252859886,CAT 3,C14,397367,Marchisotto; Jennifer Anne,14,0,15,1
1708252859886,CAT 3,C15,397369,Marchisotto; Jennifer Anne,15,0,15,0
1708252859886,CAT 3,C16,397373,Marchisotto; Jennifer Anne,15,0,15,0
1708252859886,CAT 3,C17,397374,Marchisotto; Jennifer Anne,15,0,15,0
1708252859886,CAT 3,C18,397380,Marchisotto; Jennifer Anne,14,0,15,1
1708252859886,CAT 3,D02,397405,Rahimi; Babak,13,0,15,2
1708252859886,CAT 3,D03,397408,Rahimi; Babak,14,0,15,1
1708252859886,CAT 3,D04,397415,Rahimi; Babak,15,0,15,0
1708252859886,CAT 3,D05,397416,Rahimi; Babak,15,0,15,0
1708252859886,CAT 3,D06,397422,Rahimi; Babak,15,0,15,0
1708252859886,CAT 3,D07,397426,Rahimi; Babak,14,0,15,1
1708252859886,CAT 3,D09,397447,Rahimi; Babak,11,0,15,4
1708252859886,CAT 3,D10,397450,Rahimi; Babak,13,0,15,2
1708252859886,CAT 3,D11,397625,Rahimi; Babak,13,0,15,2
1708252859886,CAT 3,D12,397630,Rahimi; Babak,15,0,15,0
1708252859886,CAT 3,D13,397631,Rahimi; Babak,14,0,15,1
1708252859886,CAT 3,D14,397635,Rahimi; Babak,14,0,15,1
1708252860414,CAT 3CE,A01,397642,Bronstein; Phoebe Malan,25,0,25,0
1708252860944,CAT 87,A00,397645,Bronstein; Phoebe Malan,19,0,20,1
1708252861470,CAT 90,A00,480731,Bronstein; Phoebe Malan,20,0,20,0
1708252861998,CAT 124,A01,397662,Knight; Amy,5,0,5,0
1708252861998,CAT 124,A02,397722,Knight; Amy,5,0,5,0
1708252861998,CAT 124,A03,397726,Knight; Amy,5,0,5,0
1708252861998,CAT 124,A04,397829,Knight; Amy,4,0,5,1
1708252862536,CAT 125,001,397832,Popko; Elizabeth Ashley,20,0,20,0
1708252862536,CAT 125,002,397833,Delaville; Romain,20,0,20,0
1708252862536,CAT 125,003,397834,Marchisotto; Jennifer Anne,18,0,20,2
1708252862536,CAT 125,004,397835,Bigham; David Joseph,20,0,20,0
1708252862536,CAT 125,005,397836,Bigham; David Joseph,19,0,20,1
1708252862536,CAT 125,006,397837,Bigham; David Joseph,16,0,20,4
1708252862536,CAT 125,007,397838,Vanderschuit; Maya Alysia,20,0,20,0
1708252862536,CAT 125,008,397839,Vanderschuit; Maya Alysia,20,0,20,0
1708252862536,CAT 125,009,397840,Vanderschuit; Maya Alysia,20,0,20,0
1708252862536,CAT 125,010,397841,Morales; Celeste Georgianna,15,0,16,1
1708252862536,CAT 125,011,397842,Morales; Celeste Georgianna,16,0,16,0
1708252862536,CAT 125,012,397881,Morales; Celeste Georgianna,19,0,20,1
1708252862536,CAT 125,013,397954,Rose; Becca Rae,18,0,20,2
1708252862536,CAT 125,014,397956,Rose; Becca Rae,20,0,20,0
1708252862536,CAT 125,015,397998,Rose; Becca Rae,19,0,20,1
1708252862536,CAT 125,016,397999,Tosun; Adriana,20,0,20,0
1708252862536,CAT 125,017,398001,Tosun; Adriana,20,0,20,0
1708252862536,CAT 125,018,398009,Irwin; Matthew Joseph,19,0,20,1
1708252862536,CAT 125,019,398010,Irwin; Matthew Joseph,18,0,20,2
1708252862536,CAT 125,020,398014,Irwin; Matthew Joseph,20,0,20,0
1708252863067,CAT 125R,A00,398015,Smith; Lauryn Alissa,19,0,20,1
1708252863067,CAT 125R,B00,398016,Smith; Lauryn Alissa,17,0,20,3
1708252863067,CAT 125R,C00,398017,Smith; Lauryn Alissa,19,0,20,1
1708252863067,CAT 125R,D00,398019,Tosun; Adriana,19,0,20,1
1708252863067,CAT 125R,E00,398020,Hyland; Tina Mae,12,0,20,8
1708252863067,CAT 125R,F00,398027,Hyland; Tina Mae,18,0,20,2
1708252863067,CAT 125R,G00,398028,Hyland; Tina Mae,18,0,20,2
1708252863597,CCE 1,A01,396087,Kenley Grounds; Nicole,40,0,40,0
1708252863597,CCE 1,B01,396142,Quijada; David,39,0,40,1
1708252863597,CCE 1,C01,396159,Bigley; Michele Heather,39,0,40,1
1708252863597,CCE 1,D01,396164,Bigley; Michele Heather,40,0,40,0
1708252863597,CCE 1,E01,396166,Lee; Kassandra,40,0,40,0
1708252863597,CCE 1,F01,396168,Lee; Kassandra,40,0,40,0
1708252863597,CCE 1,G01,396170,Staff,40,0,40,0
1708252863597,CCE 1,H01,396172,Staff,40,0,40,0
1708252864128,CENG 101B,A00,392993,Chen; Shaochen,44,0,45,1
1708252864659,CENG 101C,A00,392997,Li; Yanran,148,0,150,2
1708252865192,CENG 113,A00,393000,Chen; Zheng,69,0,70,1
1708252865192,CENG 113,B00,393001,Li; Wan-Lu,69,0,70,1
1708252865720,CENG 124B,A00,393036,Powell; Alyssa & Russ; Benjamin Edward,113,0,120,7
1708252866244,CENG 157,A00,393220,Opatkiewicz; Justin Paul,50,0,57,7
1708252866775,CENG 160,A00,393231,Powell; Alyssa,70,0,80,10
1708252867302,CENG 170,A01,393238,Drews; Aaron,27,0,30,3
1708252867828,CENG 175,A00,393239,Steinmetz; Nicole F,34,0,35,1
1708252868357,CENG 176B,A01,393285,Opatkiewicz; Justin Paul,46,0,52,6
1708252868357,CENG 176B,B01,393629,Zhang; Liangfang,40,0,49,9
1708252868883,CENG 205,A00,393681,Jahed Motlagh; Zeinab,53,0,60,7
1708252869409,CENG 257,A00,393682,Opatkiewicz; Justin Paul,10,0,13,3
1708252869938,CGS 87,A00,489609,Wesling; Megan E.,20,0,20,0
1708252870464,CGS 100B,A00,396181,Whitley; Leila Marie,28,0,30,2
1708252870993,CGS 109,A00,396194,Whitley; Leila Marie,19,0,20,1
1708252871519,CGS 112,A00,396220,Martin Sandino; Amanda Maria Yoland,22,0,25,3
1708252872044,CGS 114,A00,396223,Steelman; Katherine Wallis,14,0,16,2
1708252872570,CGS 116,A00,396295,Staff,19,0,20,1
1708252873095,CGS 117,A00,396306,Martin Sandino; Amanda Maria Yoland,14,0,15,1
1708252873621,CGS 118,A00,396314,Hankins; Joseph D.,28,0,29,1
1708252874147,CGS 128,A00,396366,Whitley; Leila Marie,14,0,15,1
1708252874673,CGS 137,A00,396865,Martin Sandino; Amanda Maria Yoland,16,0,19,3
1708252875204,CGS 150,A00,396901,Taylor-Garcia; Daphne,18,0,18,0
1708252875734,CGS 196B,A00,396904,Lo; Stanley M.,7,0,7,0
1708252875734,CGS 196B,B00,396973,Brenner; Suzanne A,7,0,7,0
1708252875734,CGS 196B,C00,396985,Jones; Makeba,7,0,7,0
1708252876264,CGS 198,001,396987,Anderson; Patrick W.,0,0,0,0
1708252876264,CGS 198,002,396988,Anderson; Patrick W.,0,0,0,0
1708252876264,CGS 198,003,396989,Anderson; Patrick W.,0,0,0,0
1708252876264,CGS 198,004,396990,Anderson; Patrick W.,0,0,0,0
1708252876790,CGS 200,A00,396991,Perez; Roy,0,0,0,3
1708252877323,CHEM 6A,A01,459563,Deshmukh; Lalit,40,0,40,0
1708252877323,CHEM 6A,A02,459564,Deshmukh; Lalit,35,0,40,5
1708252877323,CHEM 6A,A03,459565,Deshmukh; Lalit,31,0,40,9
1708252877323,CHEM 6A,A04,459566,Deshmukh; Lalit,30,0,38,8
1708252877323,CHEM 6A,A05,459567,Deshmukh; Lalit,40,0,40,0
1708252877323,CHEM 6A,A06,459568,Deshmukh; Lalit,37,0,40,3
1708252877323,CHEM 6A,A07,459569,Deshmukh; Lalit,37,0,40,3
1708252877323,CHEM 6A,A08,459570,Deshmukh; Lalit,0,0,0,0
1708252877852,CHEM 6B,A01,467314,Ortony; Julia Helen,39,0,40,1
1708252877852,CHEM 6B,A02,467322,Ortony; Julia Helen,32,0,40,8
1708252877852,CHEM 6B,A03,467323,Ortony; Julia Helen,40,0,40,0
1708252877852,CHEM 6B,A04,467325,Ortony; Julia Helen,31,0,40,9
1708252877852,CHEM 6B,A05,467326,Ortony; Julia Helen,39,0,40,1
1708252877852,CHEM 6B,A06,467346,Ortony; Julia Helen,40,0,40,0
1708252877852,CHEM 6B,B01,467360,Hopkins; Patrycja Anna,35,0,40,5
1708252877852,CHEM 6B,B02,467363,Hopkins; Patrycja Anna,38,0,40,2
1708252877852,CHEM 6B,B03,467364,Hopkins; Patrycja Anna,35,0,40,5
1708252877852,CHEM 6B,B04,467380,Hopkins; Patrycja Anna,40,0,40,0
1708252877852,CHEM 6B,B05,467381,Hopkins; Patrycja Anna,40,0,40,0
1708252877852,CHEM 6B,B06,467382,Hopkins; Patrycja Anna,39,0,40,1
1708252878387,CHEM 6C,A01,468994,Ternansky; Robert J.,39,0,40,1
1708252878387,CHEM 6C,A02,469054,Ternansky; Robert J.,38,0,40,2
1708252878387,CHEM 6C,A03,469065,Ternansky; Robert J.,39,0,40,1
1708252878387,CHEM 6C,A04,469069,Ternansky; Robert J.,40,0,40,0
1708252878387,CHEM 6C,A05,469080,Ternansky; Robert J.,40,0,40,0
1708252878387,CHEM 6C,B01,469318,Ternansky; Robert J.,39,0,40,1
1708252878387,CHEM 6C,B02,469319,Ternansky; Robert J.,40,0,40,0
1708252878387,CHEM 6C,B03,469320,Ternansky; Robert J.,39,0,40,1
1708252878387,CHEM 6C,B04,469321,Ternansky; Robert J.,40,0,40,0
1708252878387,CHEM 6C,B05,469322,Ternansky; Robert J.,40,0,40,0
1708252878387,CHEM 6C,C01,469323,Schurmeier; Kimberly,38,0,40,2
1708252878387,CHEM 6C,C02,469324,Schurmeier; Kimberly,36,0,40,4
1708252878387,CHEM 6C,C03,469325,Schurmeier; Kimberly,38,0,40,2
1708252878387,CHEM 6C,C04,469326,Schurmeier; Kimberly,36,0,40,4
1708252878387,CHEM 6C,C05,469327,Schurmeier; Kimberly,40,0,40,0
1708252878387,CHEM 6C,D01,460183,Schurmeier; Kimberly,39,0,40,1
1708252878387,CHEM 6C,D02,460184,Schurmeier; Kimberly,32,0,40,8
1708252878387,CHEM 6C,D03,460185,Schurmeier; Kimberly,26,0,40,14
1708252878387,CHEM 6C,D04,460186,Schurmeier; Kimberly,38,0,40,2
1708252878387,CHEM 6C,D05,460187,Schurmeier; Kimberly,40,0,40,0
1708252878387,CHEM 6C,E01,460188,Stallings; Dontarie M,24,0,40,16
1708252878387,CHEM 6C,E02,460190,Stallings; Dontarie M,25,0,40,15
1708252878387,CHEM 6C,E03,460191,Stallings; Dontarie M,3,0,20,17
1708252878387,CHEM 6C,E04,460192,Stallings; Dontarie M,36,0,40,4
1708252878387,CHEM 6C,E05,460193,Stallings; Dontarie M,37,0,40,3
1708252878917,CHEM 6CH,A01,459630,Tezcan; Faik,40,0,40,0
1708252879457,CHEM 7L,A01,393998,Jazzar; Rodolphe,0,0,0,3
1708252879457,CHEM 7L,A02,393999,Jazzar; Rodolphe,10,0,24,14
1708252879457,CHEM 7L,A03,394000,Jazzar; Rodolphe,21,0,24,3
1708252879457,CHEM 7L,A04,394001,Jazzar; Rodolphe,22,0,24,2
1708252879457,CHEM 7L,A05,394002,Jazzar; Rodolphe,18,0,24,6
1708252879457,CHEM 7L,A06,394003,Jazzar; Rodolphe,22,0,24,2
1708252879457,CHEM 7L,A07,394004,Jazzar; Rodolphe,18,0,21,3
1708252879457,CHEM 7L,A08,394005,Jazzar; Rodolphe,0,0,0,0
1708252879457,CHEM 7L,A09,394006,Jazzar; Rodolphe,20,0,24,4
1708252879457,CHEM 7L,A10,394007,Jazzar; Rodolphe,24,0,24,0
1708252879457,CHEM 7L,B01,394009,Jazzar; Rodolphe,0,0,0,1
1708252879457,CHEM 7L,B02,394010,Jazzar; Rodolphe,1,0,6,5
1708252879457,CHEM 7L,B03,394011,Jazzar; Rodolphe,15,0,24,9
1708252879457,CHEM 7L,B04,394012,Jazzar; Rodolphe,18,0,21,3
1708252879457,CHEM 7L,B05,394013,Jazzar; Rodolphe,0,0,0,0
1708252879457,CHEM 7L,B06,394014,Jazzar; Rodolphe,15,0,24,9
1708252879457,CHEM 7L,B07,394015,Jazzar; Rodolphe,18,0,24,6
1708252879457,CHEM 7L,B08,394016,Jazzar; Rodolphe,23,0,24,1
1708252879457,CHEM 7L,B09,394017,Jazzar; Rodolphe,24,0,24,0
1708252879457,CHEM 7L,B10,394018,Jazzar; Rodolphe,24,0,24,0
1708252879457,CHEM 7L,C01,394020,Staff,0,0,0,0
1708252879457,CHEM 7L,C02,394021,Staff,21,0,24,3
1708252879457,CHEM 7L,C03,394022,Staff,23,0,24,1
1708252879457,CHEM 7L,C04,394023,Staff,24,0,24,0
1708252879457,CHEM 7L,C05,394024,Staff,0,0,0,0
1708252879457,CHEM 7L,C06,394025,Staff,20,0,24,4
1708252879457,CHEM 7L,C07,394026,Staff,22,0,24,2
1708252879457,CHEM 7L,C08,394027,Staff,23,0,24,1
1708252879457,CHEM 7L,C09,394028,Staff,24,0,24,0
1708252879457,CHEM 7L,C10,394029,Staff,23,0,24,1
1708252879986,CHEM 11,A01,459661,Staff,42,0,44,2
1708252879986,CHEM 11,A02,459664,Staff,44,0,44,0
1708252879986,CHEM 11,A03,459702,Staff,42,0,44,2
1708252879986,CHEM 11,A04,459707,Staff,44,0,44,0
1708252879986,CHEM 11,A05,459708,Staff,43,0,44,1
1708252879986,CHEM 11,A06,459711,Staff,41,0,44,3
1708252880520,CHEM 40A,A01,459576,Albizati; Kim F.,36,0,40,4
1708252880520,CHEM 40A,A02,459577,Albizati; Kim F.,33,0,40,7
1708252880520,CHEM 40A,A03,459578,Albizati; Kim F.,37,0,40,3
1708252880520,CHEM 40A,A04,459579,Albizati; Kim F.,38,0,40,2
1708252880520,CHEM 40A,A05,459580,Albizati; Kim F.,40,0,40,0
1708252880520,CHEM 40A,A06,459581,Albizati; Kim F.,37,0,40,3
1708252880520,CHEM 40A,A07,459582,Albizati; Kim F.,38,0,40,2
1708252880520,CHEM 40A,A08,459588,Albizati; Kim F.,39,0,40,1
1708252881046,CHEM 40B,A01,467442,Weizman; Haim,29,0,40,11
1708252881046,CHEM 40B,A02,467443,Weizman; Haim,33,0,40,7
1708252881046,CHEM 40B,A03,467444,Weizman; Haim,39,0,40,1
1708252881046,CHEM 40B,A04,467445,Weizman; Haim,38,0,40,2
1708252881046,CHEM 40B,A05,467446,Weizman; Haim,39,0,40,1
1708252881046,CHEM 40B,A06,467447,Weizman; Haim,37,0,40,3
1708252881046,CHEM 40B,A07,467448,Weizman; Haim,31,0,40,9
1708252881046,CHEM 40B,A08,467449,Weizman; Haim,40,0,40,0
1708252881046,CHEM 40B,B01,467383,Molinski; Tadeusz,40,0,40,0
1708252881046,CHEM 40B,B02,467384,Molinski; Tadeusz,40,0,40,0
1708252881046,CHEM 40B,B03,467385,Molinski; Tadeusz,40,0,40,0
1708252881046,CHEM 40B,B04,467399,Molinski; Tadeusz,40,0,40,0
1708252881046,CHEM 40B,B05,467400,Molinski; Tadeusz,40,0,40,0
1708252881046,CHEM 40B,B06,467401,Molinski; Tadeusz,40,0,40,0
1708252881046,CHEM 40B,B07,467402,Molinski; Tadeusz,40,0,40,0
1708252881046,CHEM 40B,B08,467404,Molinski; Tadeusz,39,0,40,1
1708252881573,CHEM 41B,A01,459571,Klosterman; Jeremy K,40,0,40,0
1708252881573,CHEM 41B,A02,459572,Klosterman; Jeremy K,36,0,37,1
1708252881573,CHEM 41B,A03,459573,Klosterman; Jeremy K,40,0,40,0
1708252882099,CHEM 41C,A01,459589,Tor; Yitzhak,40,0,40,0
1708252882099,CHEM 41C,A02,459624,Tor; Yitzhak,38,0,40,2
1708252882099,CHEM 41C,A03,459625,Tor; Yitzhak,40,0,40,0
1708252882099,CHEM 41C,A04,459626,Tor; Yitzhak,40,0,40,0
1708252882099,CHEM 41C,A05,459627,Tor; Yitzhak,29,0,29,0
1708252882099,CHEM 41C,A06,459628,Tor; Yitzhak,38,0,40,2
1708252882099,CHEM 41C,A07,459629,Tor; Yitzhak,40,0,40,0
1708252882638,CHEM 43A,A01,394068,Lam; Tin Yiu,12,0,24,12
1708252882638,CHEM 43A,A02,394088,Lam; Tin Yiu,23,0,24,1
1708252882638,CHEM 43A,A03,394092,Lam; Tin Yiu,23,0,24,1
1708252882638,CHEM 43A,A04,394093,Lam; Tin Yiu,21,0,24,3
1708252882638,CHEM 43A,A05,394094,Lam; Tin Yiu,23,0,24,1
1708252882638,CHEM 43A,A06,394096,Lam; Tin Yiu,15,0,24,9
1708252882638,CHEM 43A,A07,394115,Lam; Tin Yiu,20,0,24,4
1708252882638,CHEM 43A,A08,394116,Lam; Tin Yiu,22,0,24,2
1708252882638,CHEM 43A,A09,394117,Lam; Tin Yiu,22,0,24,2
1708252882638,CHEM 43A,A10,394118,Lam; Tin Yiu,20,0,24,4
1708252882638,CHEM 43A,A11,394119,Lam; Tin Yiu,8,0,13,5
1708252882638,CHEM 43A,A12,394120,Lam; Tin Yiu,24,0,24,0
1708252882638,CHEM 43A,A13,394132,Lam; Tin Yiu,24,0,24,0
1708252882638,CHEM 43A,B01,394134,Lam; Tin Yiu,24,0,24,0
1708252882638,CHEM 43A,B02,394135,Lam; Tin Yiu,16,0,24,8
1708252882638,CHEM 43A,B03,394136,Lam; Tin Yiu,13,0,24,11
1708252882638,CHEM 43A,B04,394137,Lam; Tin Yiu,17,0,24,7
1708252882638,CHEM 43A,B05,394138,Lam; Tin Yiu,20,0,24,4
1708252882638,CHEM 43A,B06,394139,Lam; Tin Yiu,19,0,24,5
1708252882638,CHEM 43A,B07,394140,Lam; Tin Yiu,20,0,24,4
1708252882638,CHEM 43A,B08,394141,Lam; Tin Yiu,24,0,24,0
1708252882638,CHEM 43A,B09,394142,Lam; Tin Yiu,20,0,24,4
1708252882638,CHEM 43A,B10,394143,Lam; Tin Yiu,24,0,24,0
1708252882638,CHEM 43A,B11,394145,Lam; Tin Yiu,22,0,24,2
1708252882638,CHEM 43A,B12,394146,Lam; Tin Yiu,23,0,24,1
1708252883163,CHEM 96,A00,394159,Bussey; Thomas J,24,0,25,1
1708252883695,CHEM 100A,A01,394161,Li; Shaowei,16,0,22,6
1708252883695,CHEM 100A,A02,394162,Li; Shaowei,20,0,24,4
1708252883695,CHEM 100A,A03,394163,Li; Shaowei,22,0,24,2
1708252883695,CHEM 100A,A04,394164,Li; Shaowei,24,0,24,0
1708252883695,CHEM 100A,A05,394165,Li; Shaowei,24,0,24,0
1708252883695,CHEM 100A,A06,394166,Li; Shaowei,20,0,22,2
1708252884221,CHEM 100B,A01,394175,Pomeroy; Robert S.,19,0,25,6
1708252884747,CHEM 105A,A01,394177,Young; Mark,31,0,39,8
1708252884747,CHEM 105A,B01,394179,Young; Mark,0,0,0,0
1708252885273,CHEM 108,A01,394181,Staff,14,0,20,6
1708252885273,CHEM 108,A02,394182,Staff,23,0,24,1
1708252885273,CHEM 108,B01,394184,Staff,4,0,20,16
1708252885273,CHEM 108,B02,394185,Staff,23,0,24,1
1708252885857,CHEM 109,A01,394187,Piercy; Marc Anthony,17,0,20,3
1708252885857,CHEM 109,A02,394188,Piercy; Marc Anthony,22,0,24,2
1708252885857,CHEM 109,B01,394193,Piercy; Marc Anthony,12,0,20,8
1708252885857,CHEM 109,B02,394194,Piercy; Marc Anthony,23,0,24,1
1708252886387,CHEM 111,A00,394195,Thiemens; Mark H,97,0,100,3
1708252886917,CHEM 114B,A01,459574,Piercy; Marc Anthony,39,0,45,6
1708252886917,CHEM 114B,A02,459575,Piercy; Marc Anthony,40,0,45,5
1708252887444,CHEM 114C,A01,467286,Komives; Elizabeth A,32,0,44,12
1708252887444,CHEM 114C,A02,467287,Komives; Elizabeth A,42,0,44,2
1708252887444,CHEM 114C,A03,467290,Komives; Elizabeth A,42,0,44,2
1708252887444,CHEM 114C,A04,467295,Komives; Elizabeth A,43,0,44,1
1708252887970,CHEM 114D,A00,394198,Ghosh; Gourisankar,29,0,30,1
1708252888517,CHEM 118,A01,459788,Donoghue; Daniel J.,37,0,40,3
1708252888517,CHEM 118,A02,459800,Donoghue; Daniel J.,37,0,40,3
1708252888517,CHEM 118,A03,459807,Donoghue; Daniel J.,36,0,40,4
1708252888517,CHEM 118,A04,459809,Donoghue; Daniel J.,38,0,40,2
1708252888517,CHEM 118,A05,459811,Donoghue; Daniel J.,37,0,40,3
1708252888517,CHEM 118,A06,459826,Donoghue; Daniel J.,39,0,40,1
1708252889044,CHEM 119,A01,467427,Joseph; Simpson,35,0,40,5
1708252889044,CHEM 119,A02,467441,Joseph; Simpson,0,0,0,0
1708252889576,CHEM 120B,A01,467450,Griffith; Kent,37,0,40,3
1708252889576,CHEM 120B,A02,467451,Griffith; Kent,34,0,40,6
1708252889576,CHEM 120B,A03,467452,Griffith; Kent,35,0,40,5
1708252890103,CHEM 123,A00,394211,Schimpf; Alina M,0,0,0,1
1708252890631,CHEM 125,A00,394217,Tezcan; Faik,18,0,20,2
1708252891163,CHEM 126A,A01,459715,Yong; Haiwang,39,0,40,1
1708252891163,CHEM 126A,A02,459725,Yong; Haiwang,36,0,40,4
1708252891690,CHEM 126B,A01,467405,Tauber; Michael,36,0,40,4
1708252891690,CHEM 126B,A02,467406,Tauber; Michael,39,0,40,1
1708252891690,CHEM 126B,A03,467426,Tauber; Michael,39,0,40,1
1708252892220,CHEM 132,A01,460181,Galperin; Michael,42,0,45,3
1708252892220,CHEM 132,A02,460182,Galperin; Michael,37,0,45,8
1708252892746,CHEM 135,A01,394222,Tauber; Michael,15,0,15,0
1708252893272,CHEM 143B,A01,394229,Klosterman; Jeremy K,16,0,24,8
1708252893272,CHEM 143B,A02,394230,Klosterman; Jeremy K,21,0,24,3
1708252893800,CHEM 156,A00,394231,Romero; Erik Anthony,30,0,30,0
1708252894327,CHEM 157,A00,394232,Tor; Yitzhak,74,0,80,6
1708252894854,CHEM 165,A01,460194,Herzik; Mark Anthony,21,0,25,4
1708252895385,CHEM 167,A01,467296,Deshmukh; Lalit,39,0,40,1
1708252895385,CHEM 167,A02,467297,Deshmukh; Lalit,33,0,40,7
1708252895385,CHEM 167,A03,467298,Deshmukh; Lalit,37,0,40,3
1708252895385,CHEM 167,A04,467312,Deshmukh; Lalit,37,0,40,3
1708252895910,CHEM 173,A00,394284,Young; Mark,48,0,50,2
1708252896436,CHEM 174,A01,455015,Pomeroy; Robert S.,45,0,50,5
1708252896966,CHEM 186,A00,477716,Paesani; Francesco & Gilson; Michael K.,6,0,12,6
1708252897492,CHEM 188,A00,394294,Bussey; Thomas J,19,0,20,1
1708252898018,CHEM 214,A00,394336,Ghosh; Gourisankar,12,0,20,8
1708252898548,CHEM 217,A00,394341,Joseph; Simpson,25,0,30,5
1708252899076,CHEM 221,A00,394425,Taylor; Susan S.,10,0,20,10
1708252899601,CHEM 225,A00,394429,Tezcan; Faik,4,0,10,6
1708252900130,CHEM 227,A00,394430,Schimpf; Alina M,26,0,30,4
1708252900655,CHEM 229,A00,394431,Stauber; Julia Megan,13,0,20,7
1708252901183,CHEM 235,A01,394433,Tauber; Michael,20,0,20,0
1708252901708,CHEM 236,A00,394434,Kummel; Andrew C,14,0,15,1
1708252902233,CHEM 241,A00,394435,Pokorski; Jonathan Kyle,14,0,15,1
1708252902757,CHEM 250,A00,394436,Weizman; Haim,0,0,0,16
1708252903286,CHEM 256,A00,394437,Romero; Erik Anthony,15,0,20,5
1708252903811,CHEM 257,A00,394438,Tor; Yitzhak,23,0,30,7
1708252904337,CHEM 265,A01,460195,Herzik; Mark Anthony,13,0,20,7
1708252904867,CHEM 273,A00,394440,Young; Mark,13,0,20,7
1708252905398,CHEM 276,A00,394441,Mc Culloch; Andrew Douglas & Amaro; Rommie E,0,0,0,0
1708252905925,CHEM 283,A00,394443,Komives; Elizabeth A,2,0,4,2
1708252906451,CHEM 286,A00,477693,Paesani; Francesco & Gilson; Michael K.,26,0,34,8
1708252906978,CHEM 291,A00,394446,Komives; Elizabeth A,20,0,20,0
1708252907504,CHEM 294,A00,394447,Romero; Erik Anthony,50,0,50,0
1708252908034,CHIN 10CD,A01,394453,Liu; Mingming,17,0,17,0
1708252908034,CHIN 10CD,A02,394457,Liu; Mingming,18,0,18,0
1708252908560,CHIN 10CM,A01,394465,Chen; Pei-Chia,11,0,12,1
1708252908560,CHIN 10CM,A02,394466,Chen; Pei-Chia,12,0,12,0
1708252908560,CHIN 10CM,B01,394468,Liu; Mingming,11,0,13,2
1708252908560,CHIN 10CM,B02,394469,Liu; Mingming,13,0,13,0
1708252909090,CHIN 10CN,A01,394581,Xu; Li,14,0,14,0
1708252909090,CHIN 10CN,A02,394582,Xu; Li,14,0,14,0
1708252909090,CHIN 10CN,B01,394585,Xu; Li,14,0,14,0
1708252909090,CHIN 10CN,B02,394586,Xu; Li,13,0,14,1
1708252909620,CHIN 20CD,A01,394591,Wang; Xiao,11,0,12,1
1708252909620,CHIN 20CD,A02,394592,Wang; Xiao,11,0,12,1
1708252910163,CHIN 20CN,A01,394597,Anderson; Qin-Hong,7,0,8,1
1708252910163,CHIN 20CN,A02,394599,Anderson; Qin-Hong,8,0,8,0
1708252910163,CHIN 20CN,B01,394601,Anderson; Qin-Hong,14,0,15,1
1708252910689,CHIN 100CM,A00,394602,Anderson; Qin-Hong,19,0,20,1
1708252911218,CHIN 100CN,A00,394603,Chen; Pei-Chia,24,0,24,0
1708252911747,CHIN 169B,A00,394623,Wang; Xiao,19,0,20,1
1708252912276,CLAS 87,A00,394669,Herbst; Matthew,19,0,20,1
1708252912802,CLAS 121R,A01,394671,Herbst; Matthew,11,0,12,1
1708252912802,CLAS 121R,B01,486854,Herbst; Matthew,8,0,8,0
1708252913329,CLIN 294C,A00,476856,Wierenga; Christina E & Banks; Sarah Jane,20,0,20,0
1708252913875,CLIN 296,001,476768,Brookman; Lauren Irene,94,0,100,6
1708252913875,CLIN 296,002,476855,Brookman; Lauren Irene,10,0,10,0
1708252914419,CLRE 238R,A00,394675,Mehta; Ravindra L.,9998,0,9999,1
1708252914949,CLRE 254,A00,394678,Vaida; Florin,9999,0,9999,0
1708252915474,CLRE 256,A00,394685,Morris; Sheldon,9999,0,9999,0
1708252916000,CLRE 258,A00,394692,Mehta; Ravindra L.,9999,0,9999,0
1708252916525,CLRE 260,A00,394693,Cuomo; Raphael Eduardo,9999,0,9999,0
1708252917055,CLRE 264,A00,394696,Mehta; Ravindra L.,9999,0,9999,0
1708252917596,CLRE 267,A00,394703,Vaida; Florin,9999,0,9999,0
1708252918123,CLRE 297,001,394705,Cuomo; Raphael Eduardo,9999,0,9999,0
1708252918655,CMM 246,A00,492783,Gordts; Philip & Varki; Ajit P & Lewis; Amanda Lark & Godula; Kamil & Gagneux; Pascal & Esko; Jeffrey D. & Bode; Lars,9,0,10,1
1708252919185,CMM 250,A00,492943,Willert; Karl Heinrich,31,0,40,9
1708252919711,COGR 200B,A00,395746,Jack; Caroline Sarah,2,0,5,3
1708252920239,COGR 225B,A00,395750,Serlin; David,1,0,5,4
1708252920766,COGR 225C,A00,395753,Gates; Kelly,1,0,5,4
1708252921293,COGR 275,A00,395943,Goldfarb; Brian,6,0,10,4
1708252921293,COGR 275,B00,396046,Fattal; Alexander Leor,4,0,10,6
1708252921293,COGR 275,C00,396047,Kidman; Shawna F,4,0,10,6
1708252921822,COGR 280,A00,396048,Ahn; Patricia Jeehyun,6,0,10,4
1708252922349,COGS 1,A01,407484,Boyle; Mary E. T.,52,0,60,8
1708252922349,COGS 1,A02,407498,Boyle; Mary E. T.,54,0,60,6
1708252922349,COGS 1,A03,407504,Boyle; Mary E. T.,59,0,60,1
1708252922349,COGS 1,A04,407512,Boyle; Mary E. T.,57,0,60,3
1708252922349,COGS 1,A05,407513,Boyle; Mary E. T.,60,0,60,0
1708252922349,COGS 1,A06,407514,Boyle; Mary E. T.,58,0,60,2
1708252922349,COGS 1,A07,407515,Boyle; Mary E. T.,57,0,57,0
1708252922881,COGS 9,A01,407520,Shannon; Kyle Michael,54,0,60,6
1708252922881,COGS 9,A02,407521,Shannon; Kyle Michael,60,0,60,0
1708252922881,COGS 9,A03,407522,Shannon; Kyle Michael,59,0,60,1
1708252922881,COGS 9,A04,407524,Shannon; Kyle Michael,57,0,60,3
1708252922881,COGS 9,A05,407525,Shannon; Kyle Michael,59,0,60,1
1708252923407,COGS 10,A01,407527,Morgan; Eric,45,0,50,5
1708252923407,COGS 10,A02,407530,Morgan; Eric,46,0,50,4
1708252923407,COGS 10,A03,407531,Morgan; Eric,46,0,50,4
1708252923407,COGS 10,A04,407532,Morgan; Eric,47,0,50,3
1708252923407,COGS 10,A05,407534,Morgan; Eric,47,0,50,3
1708252923407,COGS 10,A06,407539,Morgan; Eric,50,0,50,0
1708252923407,COGS 10,A07,407628,Morgan; Eric,50,0,50,0
1708252923935,COGS 11,A01,407699,Boroditsky; Lera,179,0,180,1
1708252924463,COGS 12,A00,407702,Boroditsky; Lera,75,0,75,0
1708252926025,COGS 14A,A01,407706,Barrera; Steven James,51,0,57,6
1708252926025,COGS 14A,A02,407707,Barrera; Steven James,54,0,57,3
1708252926025,COGS 14A,A03,407712,Barrera; Steven James,0,0,0,1
1708252926025,COGS 14A,A04,407715,Barrera; Steven James,57,0,57,0
1708252926025,COGS 14A,A05,407717,Barrera; Steven James,55,0,56,1
1708252926025,COGS 14A,A06,407718,Barrera; Steven James,52,0,55,3
1708252926025,COGS 14A,A07,407720,Barrera; Steven James,49,0,55,6
1708252926568,COGS 14B,A01,407723,Hoffman; Drew Ellen,52,0,57,5
1708252926568,COGS 14B,A02,407726,Hoffman; Drew Ellen,48,0,55,7
1708252926568,COGS 14B,A03,407727,Hoffman; Drew Ellen,52,0,55,3
1708252926568,COGS 14B,A04,407729,Hoffman; Drew Ellen,52,0,55,3
1708252926568,COGS 14B,A05,407730,Hoffman; Drew Ellen,50,0,55,5
1708252927095,COGS 17,A01,407733,Johnson; Christine M.,50,0,50,0
1708252927095,COGS 17,A02,407734,Johnson; Christine M.,48,0,50,2
1708252927095,COGS 17,A03,407735,Johnson; Christine M.,46,0,50,4
1708252927095,COGS 17,A04,407740,Johnson; Christine M.,47,0,50,3
1708252927095,COGS 17,A05,407745,Johnson; Christine M.,48,0,50,2
1708252927095,COGS 17,A06,407824,Johnson; Christine M.,48,0,50,2
1708252927095,COGS 17,A07,407878,Johnson; Christine M.,50,0,55,5
1708252927095,COGS 17,A08,408015,Johnson; Christine M.,52,0,55,3
1708252927637,COGS 18,A01,408118,Ellis; Shannon Elizabeth,27,0,35,8
1708252927637,COGS 18,A02,408119,Ellis; Shannon Elizabeth,31,0,35,4
1708252927637,COGS 18,A03,408120,Ellis; Shannon Elizabeth,23,0,35,12
1708252927637,COGS 18,A04,408136,Ellis; Shannon Elizabeth,33,0,35,2
1708252927637,COGS 18,A05,408141,Ellis; Shannon Elizabeth,35,0,35,0
1708252927637,COGS 18,A06,408143,Ellis; Shannon Elizabeth,34,0,35,1
1708252927637,COGS 18,A07,408144,Ellis; Shannon Elizabeth,35,0,35,0
1708252927637,COGS 18,A08,408145,Ellis; Shannon Elizabeth,34,0,35,1
1708252927637,COGS 18,A09,408146,Ellis; Shannon Elizabeth,35,0,35,0
1708252927637,COGS 18,B01,408148,Ellis; Shannon Elizabeth,30,0,32,2
1708252927637,COGS 18,B02,408149,Ellis; Shannon Elizabeth,26,0,32,6
1708252927637,COGS 18,B03,408151,Ellis; Shannon Elizabeth,27,0,33,6
1708252927637,COGS 18,B04,408154,Ellis; Shannon Elizabeth,32,0,33,1
1708252927637,COGS 18,B05,408163,Ellis; Shannon Elizabeth,29,0,33,4
1708252927637,COGS 18,B06,408176,Ellis; Shannon Elizabeth,33,0,33,0
1708252927637,COGS 18,B07,408177,Ellis; Shannon Elizabeth,31,0,33,2
1708252927637,COGS 18,B08,408178,Ellis; Shannon Elizabeth,32,0,33,1
1708252927637,COGS 18,B09,408195,Ellis; Shannon Elizabeth,31,0,33,2
1708252928166,COGS 87,A00,408196,Deak; Gedeon O.,20,0,20,0
1708252928166,COGS 87,B00,479478,Fleischer; Jason G,20,0,20,0
1708252928709,COGS 100,A01,408262,Allen; Michael Gordon,54,0,56,2
1708252928709,COGS 100,A02,408263,Allen; Michael Gordon,52,0,56,4
1708252928709,COGS 100,A03,408264,Allen; Michael Gordon,55,0,56,1
1708252928709,COGS 100,A04,408265,Allen; Michael Gordon,56,0,56,0
1708252928709,COGS 100,A05,408266,Allen; Michael Gordon,56,0,56,0
1708252928709,COGS 100,A06,408349,Allen; Michael Gordon,55,0,56,1
1708252929235,COGS 101A,A01,408352,Morgan; Eric,60,0,60,0
1708252929235,COGS 101A,A02,408353,Morgan; Eric,58,0,60,2
1708252929235,COGS 101A,A03,408354,Morgan; Eric,57,0,60,3
1708252929235,COGS 101A,A04,408355,Morgan; Eric,59,0,60,1
1708252929778,COGS 101B,A01,408373,Barrera; Steven James,47,0,50,3
1708252929778,COGS 101B,A02,408380,Barrera; Steven James,46,0,50,4
1708252929778,COGS 101B,A03,408384,Barrera; Steven James,38,0,50,12
1708252929778,COGS 101B,A04,408385,Barrera; Steven James,37,0,50,13
1708252930308,COGS 101C,A01,408387,Trott; Sean Thomas,48,0,50,2
1708252930308,COGS 101C,A02,408388,Trott; Sean Thomas,43,0,50,7
1708252930308,COGS 101C,A03,408389,Trott; Sean Thomas,45,0,50,5
1708252930839,COGS 107A,A01,408396,Boyle; Mary E. T.,54,0,56,2
1708252930839,COGS 107A,A02,408397,Boyle; Mary E. T.,54,0,56,2
1708252930839,COGS 107A,A03,408399,Boyle; Mary E. T.,51,0,56,5
1708252930839,COGS 107A,A04,408409,Boyle; Mary E. T.,50,0,56,6
1708252930839,COGS 107A,A05,408410,Boyle; Mary E. T.,51,0,56,5
1708252930839,COGS 107A,A06,408411,Boyle; Mary E. T.,55,0,56,1
1708252931369,COGS 107B,A01,408413,Mooshagian; Eric Frederick,46,0,50,4
1708252931369,COGS 107B,A02,408414,Mooshagian; Eric Frederick,43,0,50,7
1708252931369,COGS 107B,A03,408428,Mooshagian; Eric Frederick,43,0,50,7
1708252931369,COGS 107B,A04,408434,Mooshagian; Eric Frederick,46,0,50,4
1708252931369,COGS 107B,A05,408435,Mooshagian; Eric Frederick,50,0,50,0
1708252931369,COGS 107B,A06,408446,Mooshagian; Eric Frederick,49,0,50,1
1708252931896,COGS 107C,A01,408500,Chiba; Andrea,51,0,60,9
1708252931896,COGS 107C,A02,408519,Chiba; Andrea,55,0,60,5
1708252931896,COGS 107C,A03,408524,Chiba; Andrea,56,0,60,4
1708252932420,COGS 108,A01,408532,Fleischer; Jason G,45,0,60,15
1708252932420,COGS 108,A02,408543,Fleischer; Jason G,58,0,60,2
1708252932420,COGS 108,A03,408544,Fleischer; Jason G,59,0,60,1
1708252932420,COGS 108,A04,408552,Fleischer; Jason G,32,0,60,28
1708252932420,COGS 108,A05,408554,Fleischer; Jason G,47,0,60,13
1708252932420,COGS 108,A06,408574,Fleischer; Jason G,43,0,60,17
1708252932420,COGS 108,A07,408576,Fleischer; Jason G,56,0,60,4
1708252932952,COGS 112,A01,408682,Hoffman; Drew Ellen,32,0,50,18
1708252932952,COGS 112,A02,408683,Hoffman; Drew Ellen,38,0,50,12
1708252932952,COGS 112,A03,408684,Hoffman; Drew Ellen,48,0,60,12
1708252933481,COGS 122,A01,408695,Dow; Steven P,21,0,50,29
1708252934006,COGS 125,A00,408697,Klemmer; Scott R,36,0,50,14
1708252934547,COGS 126,A01,408787,Hollan; James D.,44,0,50,6
1708252935073,COGS 138,A01,408866,Khosla; Meenakshi,71,0,75,4
1708252936618,COGS 142,A01,408868,Rossano; Federico,49,0,50,1
1708252937174,COGS 144,A01,408950,Rossano; Federico,48,0,50,2
1708252937702,COGS 155,A01,408993,Staff,49,0,50,1
1708252938226,COGS 157,A00,408994,Creel; Sarah,0,0,0,0
1708252938757,COGS 160,A00,409031,Deak; Gedeon O.,20,0,20,0
1708252939286,COGS 175,A01,409035,Rill; Bryan,67,0,75,8
1708252939815,COGS 178,A00,409274,Jernigan; Terry Lynne,68,0,70,2
1708252940342,COGS 179,A00,409278,Staff,40,0,40,0
1708252940873,COGS 184,A01,409317,Johnson; Christine M.,42,0,50,8
1708252941469,COGS 185,A01,409476,Tu; Zhuowen,33,0,50,17
1708252941469,COGS 185,A02,409525,Tu; Zhuowen,45,0,50,5
1708252941997,COGS 188,A01,409527,Fleischer; Jason G,44,0,75,31
1708252942528,COGS 190C,001,409528,Chiba; Andrea,9999,0,9999,0
1708252942528,COGS 190C,002,409530,Fleischer; Jason G,9999,0,9999,0
1708252942528,COGS 190C,003,409531,Boyle; Mary E. T.,9999,0,9999,0
1708252942528,COGS 190C,004,409532,Nitz; Douglas A.,9999,0,9999,0
1708252942528,COGS 190C,005,409535,Rangel; Lara M,9999,0,9999,0
1708252942528,COGS 190C,006,409536,Rossano; Federico,9999,0,9999,0
1708252942528,COGS 190C,007,409537,Deak; Gedeon O.,9999,0,9999,0
1708252942528,COGS 190C,008,409538,Trott; Sean Thomas,9999,0,9999,0
1708252942528,COGS 190C,009,409540,Creel; Sarah,9999,0,9999,0
1708252942528,COGS 190C,010,409541,Voytek; Bradley Thomas,9999,0,9999,0
1708252942528,COGS 190C,011,409542,Greene; Deanna Jacquelyn,9999,0,9999,0
1708252942528,COGS 190C,012,409543,Ellis; Shannon Elizabeth,9999,0,9999,0
1708252942528,COGS 190C,013,409546,Kirsh; David Joel,9999,0,9999,0
1708252943053,COGS 190D,A00,409547,Voytek; Bradley Thomas,20,0,20,0
1708252943579,COGS 194,A00,409548,Hill; Seth J,9999,0,9999,0
1708252944104,COGS 200,A01,406697,Creel; Sarah,0,0,0,0
1708252944631,COGS 205,A00,406698,Chiba; Andrea,20,0,20,0
1708252945157,COGS 209,A00,406699,Mukamel; Eran A,41,0,68,27
1708252945683,COGS 210C,001,406700,Kirsh; David Joel,9999,0,9999,0
1708252945683,COGS 210C,002,406701,Greene; Deanna Jacquelyn,9998,0,9999,1
1708252945683,COGS 210C,003,406702,Xia; Haijun,9999,0,9999,0
1708252945683,COGS 210C,004,406703,Nitz; Douglas A.,9998,0,9999,1
1708252945683,COGS 210C,005,406710,Hollan; James D.,9999,0,9999,0
1708252945683,COGS 210C,006,406713,De Sa; Virginia,9999,0,9999,0
1708252945683,COGS 210C,007,406714,Rossano; Federico,9999,0,9999,0
1708252945683,COGS 210C,008,406740,Kiyonaga; Anastasia,9999,0,9999,0
1708252945683,COGS 210C,009,406745,Guo; Philip J,9998,0,9999,1
1708252945683,COGS 210C,010,406746,Dow; Steven P,9999,0,9999,0
1708252945683,COGS 210C,011,406747,Bergen; Benjamin,9999,0,9999,0
1708252945683,COGS 210C,012,406758,Coulson; Seana M,9999,0,9999,0
1708252946213,COGS 211C,A00,406763,Coulson; Seana M,17,0,20,3
1708252946739,COGS 229,A00,406788,Hollan; James D. & Xia; Haijun,4,0,10,6
1708252947267,COGS 238,A00,406789,Bergen; Benjamin,17,0,20,3
1708252947793,COGS 278,A00,406794,Jernigan; Terry Lynne,18,0,20,2
1708252948322,COMM 10,A01,394711,Schmidt; Thomas Rainer,20,0,24,4
1708252948322,COMM 10,A02,394714,Schmidt; Thomas Rainer,24,0,24,0
1708252948322,COMM 10,A03,394716,Schmidt; Thomas Rainer,24,0,24,0
1708252948322,COMM 10,A04,394717,Schmidt; Thomas Rainer,22,0,24,2
1708252948322,COMM 10,A05,394731,Schmidt; Thomas Rainer,24,0,24,0
1708252948322,COMM 10,A06,394733,Schmidt; Thomas Rainer,24,0,24,0
1708252948322,COMM 10,A07,394740,Schmidt; Thomas Rainer,24,0,24,0
1708252948322,COMM 10,A08,394741,Schmidt; Thomas Rainer,24,0,24,0
1708252948322,COMM 10,A09,394751,Schmidt; Thomas Rainer,23,0,24,1
1708252948322,COMM 10,A10,394779,Schmidt; Thomas Rainer,24,0,24,0
1708252948322,COMM 10,A11,394809,Schmidt; Thomas Rainer,24,0,24,0
1708252948322,COMM 10,A12,394811,Schmidt; Thomas Rainer,24,0,24,0
1708252948322,COMM 10,A13,394818,Schmidt; Thomas Rainer,24,0,24,0
1708252948322,COMM 10,A14,394825,Schmidt; Thomas Rainer,23,0,24,1
1708252948322,COMM 10,A15,394828,Schmidt; Thomas Rainer,24,0,24,0
1708252948322,COMM 10,A16,394829,Schmidt; Thomas Rainer,0,0,0,0
1708252948322,COMM 10,A17,486828,Schmidt; Thomas Rainer,20,0,21,1
1708252948851,COMM 20,A01,394834,McKenna; Denise,69,0,70,1
1708252949377,COMM 80,A01,394849,Campbell; Robert Harold,120,0,120,0
1708252949908,COMM 100C,A01,394957,Kidman; Shawna F,24,0,25,1
1708252949908,COMM 100C,A02,394972,Kidman; Shawna F,25,0,25,0
1708252949908,COMM 100C,A03,394977,Kidman; Shawna F,22,0,25,3
1708252949908,COMM 100C,A04,394981,Kidman; Shawna F,25,0,25,0
1708252949908,COMM 100C,A05,394985,Kidman; Shawna F,24,0,25,1
1708252949908,COMM 100C,A06,394989,Kidman; Shawna F,23,0,25,2
1708252949908,COMM 100C,A07,394993,Kidman; Shawna F,24,0,25,1
1708252949908,COMM 100C,A08,394997,Kidman; Shawna F,23,0,25,2
1708252949908,COMM 100C,A09,394999,Kidman; Shawna F,25,0,25,0
1708252949908,COMM 100C,A10,395018,Kidman; Shawna F,25,0,25,0
1708252949908,COMM 100C,A11,395041,Kidman; Shawna F,24,0,25,1
1708252949908,COMM 100C,A12,395080,Kidman; Shawna F,24,0,25,1
1708252950435,COMM 101,A01,395135,Halm; Gavin Patrick,15,0,15,0
1708252950435,COMM 101,A02,395252,Halm; Gavin Patrick,15,0,15,0
1708252950435,COMM 101,A03,395253,Halm; Gavin Patrick,15,0,15,0
1708252950435,COMM 101,A04,395263,Halm; Gavin Patrick,15,0,15,0
1708252950960,COMM 101D,A00,395264,Martinico; Daniel J,13,0,16,3
1708252951489,COMM 101K,A00,395266,Ahn; Patricia Jeehyun,16,0,18,2
1708252952015,COMM 101N,A00,395267,Martinico; Daniel J,16,0,16,0
1708252952541,COMM 102C,A01,395270,Campion; Camille E,5,0,6,1
1708252952541,COMM 102C,A02,395271,Campion; Camille E,6,0,6,0
1708252952541,COMM 102C,A03,395272,Campion; Camille E,5,0,6,1
1708252953071,COMM 102M,A01,395285,Davis; Zeinabu I.,9,0,10,1
1708252953071,COMM 102M,A02,395288,Davis; Zeinabu I.,8,0,10,2
1708252953597,COMM 103D,A00,395343,Gates; Kelly,34,0,35,1
1708252954123,COMM 107,A00,395461,Serlin; David,33,0,35,2
1708252954652,COMM 109D,A00,395462,Halm; Gavin Patrick,72,0,75,3
1708252955178,COMM 110G,A00,395481,Whitworth-Smith; Andrew C,32,0,35,3
1708252955707,COMM 110M,A00,395482,Harb; Anthony Joseph,34,0,35,1
1708252956233,COMM 111A,A00,487217,Pavon Aramburu; Maria Laur,34,0,35,1
1708252956763,COMM 113T,A00,395516,Fields; Gary,35,0,35,0
1708252957288,COMM 114A,A00,395517,Zilberg; Elana,32,0,35,3
1708252957812,COMM 114B,A00,395523,Zilberg; Elana,19,0,20,1
1708252958341,COMM 114E,A00,487218,Pavon Aramburu; Maria Laur,34,0,35,1
1708252958865,COMM 114W,A00,395524,Walkover; Lillian B,17,0,18,1
1708252959391,COMM 126,A00,479341,Staff,26,0,30,4
1708252959918,COMM 132,A00,481491,Rojo Solis; Juan Jose,0,0,0,0
1708252960444,COMM 134,A00,395578,Abuelhiga; Soraya Jill,28,0,30,2
1708252960968,COMM 143,A00,395579,Rojo Solis; Juan Jose,28,0,30,2
1708252961496,COMM 146,A00,395584,Jack; Caroline Sarah,29,0,30,1
1708252962022,COMM 168,A00,395592,Harb; Anthony Joseph,29,0,30,1
1708252962551,COMM 170,A00,395608,Pavon Aramburu; Maria Laur,30,0,30,0
1708252963077,COMM 173,A00,395609,Alac; Morana,29,0,30,1
1708252963602,COMM 174,A00,395679,Alac; Morana,30,0,30,0
1708252964131,COMM 190,A00,395682,Abuelhiga; Soraya Jill,19,0,23,4
1708252964131,COMM 190,B00,395696,Staff,21,0,23,2
1708252964131,COMM 190,C00,395697,Fattal; Alexander Leor,22,0,23,1
1708252964658,CSE 8A,A50,459200,Miranda; Gregory Joseph,34,0,35,1
1708252964658,CSE 8A,A51,459205,Miranda; Gregory Joseph,34,0,35,1
1708252964658,CSE 8A,A52,459206,Miranda; Gregory Joseph,34,0,35,1
1708252964658,CSE 8A,A53,459212,Miranda; Gregory Joseph,34,0,35,1
1708252964658,CSE 8A,A54,459213,Miranda; Gregory Joseph,34,0,35,1
1708252964658,CSE 8A,A55,459232,Miranda; Gregory Joseph,34,0,35,1
1708252965184,CSE 11,A01,470735,Ochoa; Benjamin Lawrence,180,0,195,15
1708252965715,CSE 12,A01,470744,Cao; Yingjun,189,0,200,11
1708252965715,CSE 12,B01,470752,Miranda; Gregory Joseph,71,0,100,29
1708252965715,CSE 12,B02,470760,Miranda; Gregory Joseph,93,0,100,7
1708252966242,CSE 15L,A01,410174,Solares; Edwin A,6,0,10,4
1708252966242,CSE 15L,B01,410215,Solares; Edwin A,7,0,10,3
1708252966242,CSE 15L,C01,410305,Solares; Edwin A,3,0,10,7
1708252966242,CSE 15L,D01,410400,Solares; Edwin A,1,0,10,9
1708252966773,CSE 20,A01,470765,Minnes Kemp; Mor Mia,145,0,150,5
1708252967302,CSE 21,A01,470776,Jones; Miles E,68,0,73,5
1708252967302,CSE 21,A02,482889,Jones; Miles E,68,0,72,4
1708252967830,CSE 29,A01,494014,Soosai Raj; Adalbert Geral,48,0,50,2
1708252967830,CSE 29,A02,494016,Soosai Raj; Adalbert Geral,40,0,50,10
1708252967830,CSE 29,B01,494018,Shalev; Aaron D,16,0,20,4
1708252968362,CSE 30,A01,470784,Cao; Yingjun,141,0,150,9
1708252968362,CSE 30,B01,467469,Muller; P Keith,98,0,120,22
1708252968887,CSE 87,A00,410528,Moshiri; Niema,20,0,20,0
1708252969411,CSE 90,A00,486885,Minnes Kemp; Mor Mia,0,0,0,0
1708252969940,CSE 91,A00,486872,Minnes Kemp; Mor Mia,0,0,0,0
1708252969940,CSE 91,B00,486873,Minnes Kemp; Mor Mia,0,0,0,0
1708252970466,CSE 95,A00,410529,Minnes Kemp; Mor Mia,50,0,50,0
1708252970997,CSE 100,A01,470792,Sahoo; Debashis,54,0,70,16
1708252971524,CSE 100R,A01,410556,Moshiri; Niema,1,0,40,39
1708252972050,CSE 101,A01,470797,Jones; Miles E,14,0,44,30
1708252972050,CSE 101,A02,482892,Jones; Miles E,32,0,43,11
1708252972576,CSE 105,A01,470800,Micciancio; Daniele,85,0,98,13
1708252973106,CSE 107,A01,467479,Bellare; Mihir,141,0,146,5
1708252973631,CSE 109,A01,459538,Shang; Jingbo,0,0,25,25
1708252974163,CSE 110,A50,459395,Powell; Thomas Allan,49,0,50,1
1708252974163,CSE 110,A51,459512,Powell; Thomas Allan,37,0,50,13
1708252974163,CSE 110,A52,459513,Powell; Thomas Allan,46,0,50,4
1708252974163,CSE 110,A53,459514,Powell; Thomas Allan,48,0,50,2
1708252974163,CSE 110,A54,459515,Powell; Thomas Allan,47,0,50,3
1708252974163,CSE 110,A55,459516,Powell; Thomas Allan,45,0,50,5
1708252974163,CSE 110,A56,459517,Powell; Thomas Allan,47,0,48,1
1708252974695,CSE 112,A50,459518,Powell; Thomas Allan,132,0,146,14
1708252975223,CSE 120,A01,470808,Zhou; Yuan-Yuan,167,0,200,33
1708252975752,CSE 125,A00,410564,Voelker; Geoffrey M.,30,0,30,0
1708252976277,CSE 127,A01,467484,Fernandes; Earlence T,175,0,196,21
1708252976802,CSE 130,A01,467485,Polikarpova; Nadezhda,176,0,192,16
1708252977327,CSE 131,A01,459522,Ding; Yufei,36,0,50,14
1708252977852,CSE 132B,A01,470816,Deutsch; Alin Bernard,60,0,70,10
1708252978378,CSE 140,A01,410606,Orailoglu; Alex,99,0,100,1
1708252978378,CSE 140,B01,410622,Eldon; John,130,0,146,16
1708252978909,CSE 140L,A01,410655,Orailoglu; Alex,98,0,100,2
1708252978909,CSE 140L,B01,410658,Eldon; John,123,0,146,23
1708252979436,CSE 141,A01,467486,Zhao; Jishen,173,0,196,23
1708252979965,CSE 141L,A01,410685,Eldon; John,162,0,196,34
1708252980490,CSE 145,A01,410713,Kastner; Ryan Charles,25,0,25,0
1708252981015,CSE 150B,A01,470824,Gao; Sicun,310,0,362,52
1708252981540,CSE 156,A01,467487,Nakashole; Ndapandula,138,0,192,54
1708252982068,CSE 165,A01,410757,Weibel; Nadir & Schulze; Jurgen P.,40,0,50,10
1708252982598,CSE 168,A01,410759,Ramamoorthi; Ravi,24,0,25,1
1708252982598,CSE 168,A02,410761,Ramamoorthi; Ravi,24,0,25,1
1708252983123,CSE 175,A01,410764,Kumar; Rakesh,48,0,50,2
1708252983649,CSE 182,A01,455011,Bafna; Vineet,47,0,50,3
1708252984174,CSE 185,A01,410895,Gymrek; Melissa Ann,41,0,57,16
1708252984174,CSE 185,A02,479240,Gymrek; Melissa Ann,53,0,58,5
1708252984701,CSE 190,A00,410982,Grier; Daniel T,48,0,50,2
1708252984701,CSE 190,B00,410983,Riek; Laurel D,50,0,50,0
1708252984701,CSE 190,C00,410984,Staff,36,0,50,14
1708252984701,CSE 190,D00,481666,Saha; Barna & Impagliazzo; Russell,27,0,28,1
1708252985227,CSE 203A,A00,410985,Saha; Barna & Impagliazzo; Russell,0,0,0,0
1708252985752,CSE 209A,A00,410986,Grier; Daniel T,0,0,0,0
1708252986277,CSE 209B,A00,410987,Bellare; Mihir,0,0,0,0
1708252986803,CSE 217,A01,459553,Weibel; Nadir,0,0,0,0
1708252987331,CSE 218,A00,410989,Griswold; William G.,0,0,0,0
1708252987856,CSE 219,A00,410990,Hollan; James D. & Xia; Haijun,0,0,0,0
1708252988386,CSE 224,A01,470832,Snoeren; Alex C.,0,0,0,0
1708252988913,CSE 229A,A00,410993,Shalev; Aaron D,0,0,0,0
1708252989440,CSE 229C,A00,410994,Fernandes; Earlence T,0,0,0,0
1708252989966,CSE 231,A01,467488,Jhala; Ranjit,0,0,0,0
1708252990492,CSE 233,A00,410996,Vianu; Victor Dan,0,0,0,0
1708252991017,CSE 237D,A00,410998,Kastner; Ryan Charles,0,0,0,0
1708252991546,CSE 239A,A00,410999,Vianu; Victor Dan,0,0,0,0
1708252992072,CSE 239B,A00,411000,Coblenz; Michael J,0,0,0,0
1708252992598,CSE 240A,A00,411001,Chin; Bryan W.,0,0,0,0
1708252993125,CSE 252D,A00,411004,Chandraker; Manmohan Krishna,0,0,0,0
1708252993650,CSE 256,A00,411005,Nakashole; Ndapandula,0,0,0,0
1708252994181,CSE 260,A01,467491,Chin; Bryan W.,0,0,0,0
1708252994759,CSE 276B,A00,411007,Riek; Laurel D,0,0,0,0
1708252995288,CSE 276F,A01,459554,Su; Hao,0,0,0,0
1708252995814,CSE 283,A00,411009,Bafna; Vineet & Zhong; Sheng,0,0,0,0
1708252996340,CSE 290,A00,411010,Gao; Sicun,0,0,0,0
1708252996340,CSE 290,B00,411011,Chern; Albert Ren-Haur,0,0,0,0
1708252996340,CSE 290,C00,411012,Swanson; Steven James,0,0,0,0
1708252996340,CSE 290,E00,411013,Su; Hao,0,0,0,0
1708252996340,CSE 290,F00,411014,Riek; Laurel D,0,0,0,0
1708252996340,CSE 290,G00,411015,Gymrek; Melissa Ann,0,0,0,0
1708252996340,CSE 290,H00,479239,Dasgupta; Sanjoy & Gymrek; Melissa Ann,0,0,0,0
1708252996340,CSE 290,I00,481669,Bafna; Vineet,0,0,0,0
1708252996340,CSE 290,J00,494949,Paturi; Ramamohan,0,0,0,0
1708252996877,CSE 291,A00,411016,Li; Tzumao,0,0,0,0
1708252996877,CSE 291,B00,411017,Heninger; Nadia A,0,0,0,0
1708252996877,CSE 291,C00,411114,Chern; Albert Ren-Haur,0,0,0,0
1708252996877,CSE 291,D00,411115,Zhang; Yiying,0,0,0,0
1708252996877,CSE 291,E00,411116,Cheng; Chung Kuan,0,0,0,0
1708252996877,CSE 291,G00,411118,Lerner; Sorin,0,0,0,0
1708252996877,CSE 291,I00,481509,Shang; Jingbo,0,0,0,0
1708252996877,CSE 291,J00,494844,Savage; Stefan & Stefan; Deian,50,0,50,0
1708252997407,CSE 293,001,487239,Bafna; Vineet,9999,0,9999,0
1708252997407,CSE 293,002,487240,Bellare; Mihir,9999,0,9999,0
1708252997407,CSE 293,003,487241,Berg-Kirkpatrick; Taylor D,9999,0,9999,0
1708252997407,CSE 293,004,487242,Chandraker; Manmohan Krishna,9999,0,9999,0
1708252997407,CSE 293,005,487243,Cheng; Chung Kuan,9999,0,9999,0
1708252997407,CSE 293,006,487244,Christensen; Henrik I,9999,0,9999,0
1708252997407,CSE 293,007,487245,Coblenz; Michael J,9999,0,9999,0
1708252997407,CSE 293,008,487363,Cottrell; Garrison W,9999,0,9999,0
1708252997407,CSE 293,009,487366,Deutsch; Alin Bernard,9999,0,9999,0
1708252997407,CSE 293,010,487433,Esmaeilzadeh; Hadi,9999,0,9999,0
1708252997407,CSE 293,011,487434,Freund; Yoav,9999,0,9999,0
1708252997407,CSE 293,012,487455,Griswold; William G.,9999,0,9999,0
1708252997407,CSE 293,013,487469,Gymrek; Melissa Ann,9999,0,9999,0
1708252997407,CSE 293,014,487470,Heninger; Nadia A,9999,0,9999,0
1708252997407,CSE 293,015,487471,Impagliazzo; Russell,9999,0,9999,0
1708252997407,CSE 293,016,487472,Jhala; Ranjit,9999,0,9999,0
1708252997407,CSE 293,017,487473,Kahng; Andrew Byun,9999,0,9999,0
1708252997407,CSE 293,018,487474,Kane; Daniel Mertz,9999,0,9999,0
1708252997407,CSE 293,019,487475,Kriegman; David J,9999,0,9999,0
1708252997407,CSE 293,020,487476,Kumar; Arun Kumar,9999,0,9999,0
1708252997407,CSE 293,021,487477,Lerner; Sorin,9999,0,9999,0
1708252997407,CSE 293,022,487478,Lovett; Shachar,9999,0,9999,0
1708252997407,CSE 293,023,487520,McAuley; Julian John,9999,0,9999,0
1708252997407,CSE 293,024,487522,Micciancio; Daniele,9999,0,9999,0
1708252997407,CSE 293,025,487577,Orailoglu; Alex,9999,0,9999,0
1708252997407,CSE 293,026,487586,Pannuto; Patrick William,9999,0,9999,0
1708252997407,CSE 293,027,487598,Paturi; Ramamohan,9999,0,9999,0
1708252997407,CSE 293,028,487604,Polikarpova; Nadezhda,9999,0,9999,0
1708252997407,CSE 293,029,487609,Politz; Joseph Gibbs,9999,0,9999,0
1708252997407,CSE 293,030,487642,Porter; George M,9999,0,9999,0
1708252997407,CSE 293,031,487665,Porter; Leonard Emerson,9999,0,9999,0
1708252997407,CSE 293,032,487689,Ramamoorthi; Ravi,9999,0,9999,0
1708252997407,CSE 293,033,487698,Riek; Laurel D,9999,0,9999,0
1708252997407,CSE 293,034,487712,Sahoo; Debashis,9999,0,9999,0
1708252997407,CSE 293,035,487721,Saul; Lawrence,9999,0,9999,0
1708252997407,CSE 293,036,487735,Savage; Stefan,9999,0,9999,0
1708252997407,CSE 293,037,487744,Schulze; Jurgen P.,9999,0,9999,0
1708252997407,CSE 293,038,487758,Snoeren; Alex C.,9999,0,9999,0
1708252997407,CSE 293,039,487767,Shang; Jingbo,9999,0,9999,0
1708252997407,CSE 293,040,487790,Stefan; Deian,9999,0,9999,0
1708252997407,CSE 293,041,487817,Su; Hao,9999,0,9999,0
1708252997407,CSE 293,042,487827,Swanson; Steven James,9999,0,9999,0
1708252997407,CSE 293,043,487830,Tullsen; Dean Michael,9999,0,9999,0
1708252997407,CSE 293,044,487837,Vaccaro; Kristen Marie,9999,0,9999,0
1708252997407,CSE 293,045,487838,Voelker; Geoffrey M.,9999,0,9999,0
1708252997407,CSE 293,046,487842,Zhao; Jishen,9999,0,9999,0
1708252997407,CSE 293,047,487847,Zhou; Yuan-Yuan,9999,0,9999,0
1708252997407,CSE 293,048,487852,Gao; Sicun,9999,0,9999,0
1708252997407,CSE 293,049,487853,Weibel; Nadir,9999,0,9999,0
1708252997407,CSE 293,050,487854,Gupta; Rajesh K.,9999,0,9999,0
1708252997407,CSE 293,051,487855,Soosai Raj; Adalbert Geral,9999,0,9999,0
1708252997407,CSE 293,052,494373,Zhang; Hao,9999,0,9999,0
1708252997933,CSE 294,A00,411124,Voelker; Geoffrey M.,15,0,15,0
1708252998472,CSS 100,A01,396053,Trott; Sean Thomas,43,0,50,7
1708252998998,CSS 120,A01,479237,Mignozzetti; Umberto,47,0,50,3
1708252998998,CSS 120,A02,479238,Mignozzetti; Umberto,50,0,50,0
1708252999527,CSS 209,A00,396054,Styler; William Francis,21,0,35,14
1708253000056,CSS 296,001,396055,Mignozzetti; Umberto,0,0,0,1
1708253000056,CSS 296,002,396056,Styler; William Francis,0,0,0,1
1708253000056,CSS 296,003,396057,Broz; James Lawrence,0,0,0,2
1708253000056,CSS 296,004,396058,Elliott; Graham,0,0,0,5
1708253000056,CSS 296,005,396059,Sun; Feiyang,0,0,0,0
1708253000056,CSS 296,006,396060,Dewaard; Andrew Michael,0,0,0,0
1708253000583,DDPM 210,A00,400652,Ma; Joseph David,36,0,36,0
1708253001108,DDPM 211,A00,400653,Ma; Joseph David,36,0,36,0
1708253001650,DDPM 214,A00,400720,Ma; Joseph David,36,0,36,0
1708253002180,DERM 296,001,464131,Staff,50,0,50,0
1708253002180,DERM 296,002,464178,Staff,50,0,50,0
1708253002180,DERM 296,003,464181,Staff,50,0,50,0
1708253002743,DOC 3,A01,399409,Strom; Megan C.,0,0,0,0
1708253002743,DOC 3,A02,399414,Strom; Megan C.,0,0,0,0
1708253002743,DOC 3,A03,399432,Strom; Megan C.,0,0,0,0
1708253002743,DOC 3,A04,399461,Strom; Megan C.,0,0,0,0
1708253002743,DOC 3,A05,399470,Strom; Megan C.,0,0,0,0
1708253002743,DOC 3,A06,399476,Strom; Megan C.,0,0,0,0
1708253002743,DOC 3,A07,399547,Strom; Megan C.,0,0,0,0
1708253002743,DOC 3,A08,399548,Strom; Megan C.,0,0,0,0
1708253002743,DOC 3,A09,399675,Strom; Megan C.,0,0,0,0
1708253002743,DOC 3,A10,399687,Strom; Megan C.,0,0,0,0
1708253002743,DOC 3,A11,399704,Strom; Megan C.,0,0,0,0
1708253002743,DOC 3,A12,399707,Strom; Megan C.,0,0,0,0
1708253002743,DOC 3,A13,399714,Strom; Megan C.,0,0,0,0
1708253002743,DOC 3,A14,399721,Strom; Megan C.,0,0,0,0
1708253002743,DOC 3,A15,399765,Strom; Megan C.,0,0,0,0
1708253002743,DOC 3,A16,399766,Strom; Megan C.,0,0,0,0
1708253002743,DOC 3,B01,399786,Strom; Megan C.,0,0,0,0
1708253002743,DOC 3,B02,399787,Strom; Megan C.,0,0,0,0
1708253002743,DOC 3,B03,399788,Strom; Megan C.,0,0,0,0
1708253002743,DOC 3,B04,399845,Strom; Megan C.,0,0,0,0
1708253002743,DOC 3,B05,399846,Strom; Megan C.,0,0,0,0
1708253002743,DOC 3,B06,399895,Strom; Megan C.,0,0,0,0
1708253002743,DOC 3,B07,399916,Strom; Megan C.,0,0,0,0
1708253002743,DOC 3,B08,400073,Strom; Megan C.,0,0,0,0
1708253002743,DOC 3,B09,400074,Strom; Megan C.,0,0,0,0
1708253002743,DOC 3,B10,400076,Strom; Megan C.,0,0,0,0
1708253002743,DOC 3,B11,400077,Strom; Megan C.,0,0,0,0
1708253002743,DOC 3,B12,400078,Strom; Megan C.,0,0,0,0
1708253002743,DOC 3,B13,400079,Strom; Megan C.,0,0,0,0
1708253002743,DOC 3,B14,400080,Strom; Megan C.,0,0,0,0
1708253002743,DOC 3,B15,400081,Strom; Megan C.,0,0,0,0
1708253002743,DOC 3,B16,400082,Strom; Megan C.,0,0,0,0
1708253002743,DOC 3,C01,400084,Chapman; Dillon,0,0,0,0
1708253002743,DOC 3,C02,400085,Chapman; Dillon,0,0,0,0
1708253002743,DOC 3,C03,400086,Chapman; Dillon,0,0,0,0
1708253002743,DOC 3,C04,400087,Chapman; Dillon,0,0,0,0
1708253002743,DOC 3,C05,400113,Chapman; Dillon,0,0,0,0
1708253002743,DOC 3,C06,400114,Chapman; Dillon,0,0,0,0
1708253002743,DOC 3,C07,400117,Chapman; Dillon,0,0,0,0
1708253002743,DOC 3,C08,400118,Chapman; Dillon,0,0,0,0
1708253002743,DOC 3,C09,400119,Chapman; Dillon,0,0,0,0
1708253002743,DOC 3,C10,400121,Chapman; Dillon,0,0,0,0
1708253002743,DOC 3,C11,400122,Chapman; Dillon,0,0,0,0
1708253002743,DOC 3,C12,400126,Chapman; Dillon,0,0,0,0
1708253002743,DOC 3,C13,400157,Chapman; Dillon,0,0,0,0
1708253002743,DOC 3,C14,400240,Chapman; Dillon,0,0,0,0
1708253002743,DOC 3,C15,400241,Chapman; Dillon,0,0,0,0
1708253002743,DOC 3,C16,400242,Chapman; Dillon,0,0,0,0
1708253002743,DOC 3,D01,400253,Chapman; Dillon,0,0,0,0
1708253002743,DOC 3,D02,400294,Chapman; Dillon,0,0,0,0
1708253002743,DOC 3,D03,400295,Chapman; Dillon,0,0,0,0
1708253002743,DOC 3,D04,400430,Chapman; Dillon,0,0,0,0
1708253002743,DOC 3,D05,400438,Chapman; Dillon,0,0,0,0
1708253002743,DOC 3,D06,400439,Chapman; Dillon,0,0,0,0
1708253002743,DOC 3,D07,400441,Chapman; Dillon,0,0,0,0
1708253002743,DOC 3,D08,400442,Chapman; Dillon,0,0,0,0
1708253002743,DOC 3,D09,400443,Chapman; Dillon,0,0,0,0
1708253002743,DOC 3,D10,400445,Chapman; Dillon,0,0,0,0
1708253002743,DOC 3,D11,400446,Chapman; Dillon,0,0,0,0
1708253002743,DOC 3,D12,400447,Chapman; Dillon,0,0,0,0
1708253002743,DOC 3,D13,400448,Chapman; Dillon,0,0,0,0
1708253002743,DOC 3,D14,400646,Chapman; Dillon,0,0,0,0
1708253002743,DOC 3,D15,400647,Chapman; Dillon,0,0,0,0
1708253002743,DOC 3,D16,400648,Chapman; Dillon,0,0,0,0
1708253003276,DOC 100D,A00,400649,Pass; Natalye Joann,22,0,25,3
1708253003276,DOC 100D,B00,400650,Pass; Natalye Joann,25,0,25,0
1708253003805,DSC 10,A01,398041,Tiefenbruck; Janine LoBue,142,0,147,5
1708253003805,DSC 10,B01,398180,Tiefenbruck; Janine LoBue,144,0,147,3
1708253003805,DSC 10,C01,398400,Tiefenbruck; Janine LoBue,143,0,147,4
1708253004334,DSC 20,A01,398415,Langlois; Marina,200,0,200,0
1708253004876,DSC 30,A01,398436,Langlois; Marina,156,0,158,2
1708253004876,DSC 30,B01,398439,Langlois; Marina,144,0,150,6
1708253005405,DSC 40A,A01,398441,Rampure; Suraj,123,0,125,2
1708253005405,DSC 40A,B01,398443,Rampure; Suraj,125,0,125,0
1708253005931,DSC 40B,A01,398445,Staff,150,0,150,0
1708253006472,DSC 80,A01,398470,Lau; Samuel Ethan,70,0,70,0
1708253006472,DSC 80,B01,398541,Lau; Samuel Ethan,68,0,70,2
1708253007002,DSC 95,A01,398650,Rampure; Suraj,50,0,50,0
1708253007529,DSC 100,A01,398683,Salimi; Babak,147,0,150,3
1708253008055,DSC 102,A01,398708,Jin; Haojian,145,0,150,5
1708253008584,DSC 106,A01,398711,Wilber; Jared Dane,146,0,149,3
1708253009129,DSC 140A,A01,398724,Eldridge; Justin Matthew,98,0,100,2
1708253009129,DSC 140A,B01,479346,Ustun; Tevfik Berk,50,0,50,0
1708253009655,DSC 140B,A01,398726,Weng; Tsui-Wei (lily),144,0,150,6
1708253010187,DSC 190,A01,398738,Silberman; Jack,20,0,20,0
1708253010187,DSC 190,B01,479475,Ustun; Tevfik Berk,29,0,30,1
1708253010187,DSC 190,C01,481341,Rahman; Tauhidur,50,0,50,0
1708253010711,DSC 197,001,494360,Eldridge; Justin Matthew,9999,0,9999,0
1708253011241,DSC 214,A00,477322,Staff,21,0,60,39
1708253011767,DSC 231,A01,398863,Gupta; Rajesh K.,60,0,60,0
1708253012300,DSC 232R,A01,487133,Solares; Edwin A,39,0,60,21
1708253012826,DSC 240,A00,398957,Belkin; Mikhail,74,0,90,16
1708253013880,DSC 243,A00,398958,Ma; Yian,59,0,60,1
1708253014409,DSC 245,A00,398959,Huang; Biwei,41,0,60,19
1708253014933,DSC 253,A00,398960,Shang; Jingbo,0,0,30,30
1708253015459,DSC 258R,A01,398962,Shang; Jingbo,43,0,60,17
1708253016003,DSC 267R,A01,398964,Staff,56,0,60,4
1708253016531,DSC 291,A00,398965,Belkin; Mikhail,90,0,90,0
1708253016531,DSC 291,B00,398966,Weng; Tsui-Wei (lily),90,0,90,0
1708253016531,DSC 291,C00,398997,Staff,60,0,60,0
1708253016531,DSC 291,D00,398998,Zhang; Hao,40,0,40,0
1708253016531,DSC 291,E00,477386,Staff,50,0,50,0
1708253017296,DSC 293,A00,477388,Ustun; Tevfik Berk,9989,0,9999,10
1708253017820,DSC 295,A00,480826,Danks; David J,30,0,40,10
1708253018345,DSE 220,A00,398034,Dasgupta; Sanjoy,20,0,20,0
1708253018874,DSE 230,A00,398035,Nguyen; Mai Huong,20,0,20,0
1708253019415,DSE 260B,A00,398037,Altintas De Callaf; Ilkay,20,0,20,0
1708253019942,DSGN 1,A01,408210,Klemmer; Scott R,46,0,50,4
1708253019942,DSGN 1,A02,408245,Klemmer; Scott R,47,0,50,3
1708253020471,DSGN 119,A00,407467,Hollan; James D. & Xia; Haijun,76,0,90,14
1708253020997,DSGN 160,A00,494371,Aronoff-Spencer; Eliah Sea,15,0,20,5
1708253021525,DSGN 219,A00,474323,Hollan; James D. & Xia; Haijun,15,0,15,0
1708253022052,ECE 5,A01,428645,Morris; Karcher William,21,0,24,3
1708253022052,ECE 5,A02,428646,Morris; Karcher William,24,0,24,0
1708253022052,ECE 5,A03,428647,Morris; Karcher William,24,0,24,0
1708253022052,ECE 5,A04,428648,Morris; Karcher William,24,0,24,0
1708253022578,ECE 15,A01,428650,Sahay; Rajeev,119,0,120,1
1708253023108,ECE 16,A01,428652,Wang; Edward Jay,22,0,30,8
1708253023638,ECE 17,A01,428654,Sahay; Rajeev,48,0,60,12
1708253024165,ECE 25,A50,428657,Dey; Sujit,30,0,30,0
1708253024165,ECE 25,A51,428658,Dey; Sujit,30,0,30,0
1708253024694,ECE 30,A50,428674,Mir Arabbaygi; Siavash,27,0,30,3
1708253024694,ECE 30,A51,428675,Mir Arabbaygi; Siavash,28,0,30,2
1708253024694,ECE 30,A52,428676,Mir Arabbaygi; Siavash,28,0,30,2
1708253024694,ECE 30,A53,428679,Mir Arabbaygi; Siavash,29,0,30,1
1708253024694,ECE 30,A54,428680,Mir Arabbaygi; Siavash,30,0,30,0
1708253025240,ECE 35,A50,428684,Taur; Yuan,29,0,30,1
1708253025240,ECE 35,A51,428685,Taur; Yuan,30,0,30,0
1708253025240,ECE 35,A52,428686,Taur; Yuan,30,0,30,0
1708253025240,ECE 35,A53,428687,Taur; Yuan,29,0,30,1
1708253025767,ECE 45,A01,428689,Zeger; Kenneth A.,137,0,150,13
1708253026299,ECE 65,A50,428701,Baghdadchi; Saharnaz,28,0,30,2
1708253026299,ECE 65,A51,428742,Baghdadchi; Saharnaz,29,0,30,1
1708253026299,ECE 65,A52,428743,Baghdadchi; Saharnaz,30,0,30,0
1708253026299,ECE 65,A53,428754,Baghdadchi; Saharnaz,26,0,30,4
1708253026299,ECE 65,A54,428796,Baghdadchi; Saharnaz,30,0,30,0
1708253026299,ECE 65,A55,428797,Baghdadchi; Saharnaz,29,0,30,1
1708253026299,ECE 65,A56,428803,Baghdadchi; Saharnaz,30,0,30,0
1708253026828,ECE 100,A01,428978,Baghdadchi; Saharnaz,29,0,30,1
1708253026828,ECE 100,A02,428988,Baghdadchi; Saharnaz,30,0,30,0
1708253026828,ECE 100,A03,428989,Baghdadchi; Saharnaz,29,0,30,1
1708253026828,ECE 100,A04,429008,Baghdadchi; Saharnaz,29,0,30,1
1708253027353,ECE 101,A01,429017,Bharadia; Dinesh,57,0,60,3
1708253027353,ECE 101,A02,429019,Bharadia; Dinesh,60,0,60,0
1708253027880,ECE 103,A01,429027,Kuzum; Duygu,74,0,75,1
1708253028410,ECE 107,A01,429055,Fullerton; Eric E,73,0,75,2
1708253028936,ECE 108,A01,429068,Kang; Mingu,53,0,60,7
1708253029465,ECE 109,A01,429085,Orlitsky; Alon,98,0,100,2
1708253029465,ECE 109,A02,429098,Orlitsky; Alon,96,0,100,4
1708253029990,ECE 111,A01,429132,Turakhia; Yatish Girish,173,0,180,7
1708253030517,ECE 115,A01,429314,Yip; Michael,22,0,26,4
1708253031045,ECE 123,A01,429327,Sievenpiper; Daniel F.,56,0,60,4
1708253031576,ECE 125B,A50,429397,Esmaili; Gholamreza,23,0,24,1
1708253031576,ECE 125B,A51,429627,Esmaili; Gholamreza,23,0,24,1
1708253032104,ECE 134,A00,429630,Ng; Tse Nga,50,0,50,0
1708253032646,ECE 136L,A01,429634,Dayeh; Shadi Ahmad,3,0,5,2
1708253032646,ECE 136L,A02,429636,Dayeh; Shadi Ahmad,3,0,5,2
1708253032646,ECE 136L,A03,429637,Dayeh; Shadi Ahmad,5,0,5,0
1708253032646,ECE 136L,A04,429641,Dayeh; Shadi Ahmad,5,0,5,0
1708253033172,ECE 139,A00,429642,Nomura; Kenji,17,0,20,3
1708253033701,ECE 140B,A01,455349,Khoshabeh; Ramsin & Gessner; Richard K.,19,0,24,5
1708253033701,ECE 140B,A02,455351,Khoshabeh; Ramsin & Gessner; Richard K.,23,0,24,1
1708253033701,ECE 140B,A03,455354,Khoshabeh; Ramsin & Gessner; Richard K.,21,0,22,1
1708253034226,ECE 141B,A01,455355,Gessner; Richard K.,48,0,50,2
1708253034753,ECE 148,A01,492803,Silberman; Jack,0,0,0,0
1708253035283,ECE 153,A01,429655,Naghizadeh Ardabili; Parin,94,0,100,6
1708253035809,ECE 157A,A01,429657,Bharadia; Dinesh,22,0,25,3
1708253036335,ECE 158B,A01,429659,Zhang; Xinyu,14,0,20,6
1708253036864,ECE 161C,A00,429660,Cosman; Pamela C.,58,0,60,2
1708253037390,ECE 163,A00,429664,Hsueh; Tzu-Chien,95,0,100,5
1708253037932,ECE 165,A51,429672,Mercier; Patrick Philip,20,0,30,10
1708253037932,ECE 165,A52,429673,Mercier; Patrick Philip,22,0,30,8
1708253037932,ECE 165,A53,429674,Mercier; Patrick Philip,30,0,30,0
1708253037932,ECE 165,A54,429675,Mercier; Patrick Philip,30,0,30,0
1708253038459,ECE 171A,A01,429813,Zheng; Yang,96,0,100,4
1708253039001,ECE 175B,A01,429886,Xie; Pengtao,72,0,75,3
1708253039531,ECE 183,A01,430023,Mookherjea; Shayan,26,0,30,4
1708253040057,ECE 185,A01,430025,Papen; George C.,19,0,20,1
1708253040586,ECE 191,A00,430039,Zhang; Xinyu,30,0,30,0
1708253041110,ECE 196,A00,430040,Morris; Karcher William,18,0,24,6
1708253041110,ECE 196,B00,430045,Morris; Karcher William,23,0,24,1
1708253041638,ECE 198,001,430052,Nguyen; Truong Quang,9999,0,9999,0
1708253042250,ECE 200,001,438659,Atanasov; Nikolay A.,9999,0,9999,0
1708253042250,ECE 200,002,438660,Bharadia; Dinesh,9999,0,9999,0
1708253042250,ECE 200,003,438668,Cheng; Chung Kuan,9999,0,9999,0
1708253042250,ECE 200,004,438845,Cosman; Pamela C.,9999,0,9999,0
1708253042250,ECE 200,005,438846,Dayeh; Shadi Ahmad,9999,0,9999,0
1708253042250,ECE 200,006,438847,Fainman; Yeshaiahu,9999,0,9999,0
1708253042250,ECE 200,007,438848,Ford; Joseph Earl,9999,0,9999,0
1708253042250,ECE 200,008,438849,Franceschetti; Massimo,9999,0,9999,0
1708253042250,ECE 200,009,438850,Fullerton; Eric E,9999,0,9999,0
1708253042250,ECE 200,010,438851,Galton; Ian A,9999,0,9999,0
1708253042250,ECE 200,011,438852,Gilja; Vikash,9999,0,9999,0
1708253042250,ECE 200,012,438853,Hall; Drew A.,9999,0,9999,0
1708253042250,ECE 200,013,438854,Hsueh; Tzu-Chien,9999,0,9999,0
1708253042250,ECE 200,014,438855,Javidi; Tara,9999,0,9999,0
1708253042250,ECE 200,015,438865,Kahng; Andrew Byun,9999,0,9999,0
1708253042250,ECE 200,016,438866,Kim; Young-Han,9999,0,9999,0
1708253042250,ECE 200,017,438876,Koushanfar; Farinaz,9999,0,9999,0
1708253042250,ECE 200,018,438877,Kuzum; Duygu,9999,0,9999,0
1708253042250,ECE 200,019,438934,Le; Hanh-Phuc,9999,0,9999,0
1708253042250,ECE 200,020,438954,Lin; Bill,9999,0,9999,0
1708253042250,ECE 200,021,438955,Liu; Zhaowei,9999,0,9999,0
1708253042250,ECE 200,022,438957,Lo; Yu-Hwa,9999,0,9999,0
1708253042250,ECE 200,023,439086,Lomakin; Vitaliy,9999,0,9999,0
1708253042250,ECE 200,024,439087,Mercier; Patrick Philip,9999,0,9999,0
1708253042250,ECE 200,025,439088,Meyer; Florian,9999,0,9999,0
1708253042250,ECE 200,026,439090,Milstein; Laurence B.,9999,0,9999,0
1708253042250,ECE 200,027,439208,Mir Arabbaygi; Siavash,9999,0,9999,0
1708253042250,ECE 200,028,439209,Mookherjea; Shayan,9999,0,9999,0
1708253042250,ECE 200,029,439210,Morris; Karcher William,9999,0,9999,0
1708253042250,ECE 200,030,439211,Ng; Tse Nga,9999,0,9999,0
1708253042250,ECE 200,031,439219,Nguyen; Truong Quang,9999,0,9999,0
1708253042250,ECE 200,032,439220,Nomura; Kenji,9999,0,9999,0
1708253042250,ECE 200,033,439221,Orlitsky; Alon,9999,0,9999,0
1708253042250,ECE 200,034,439222,Pal; Piya,9999,0,9999,0
1708253042250,ECE 200,035,439223,Papen; George C.,9999,0,9999,0
1708253042250,ECE 200,036,439224,Radic; Stojan,9999,0,9999,0
1708253042250,ECE 200,037,439225,Rao; Bhaskar D.,9999,0,9999,0
1708253042250,ECE 200,038,439227,Rao; Ramesh R,9999,0,9999,0
1708253042250,ECE 200,039,439231,Rebeiz; Gabriel,9999,0,9999,0
1708253042250,ECE 200,040,439232,Sanford; John R,9999,0,9999,0
1708253042250,ECE 200,041,439302,Siegel; Paul H.,9999,0,9999,0
1708253042250,ECE 200,042,439303,Sievenpiper; Daniel F.,9999,0,9999,0
1708253042250,ECE 200,043,439305,Sworder; David D.,9999,0,9999,0
1708253042250,ECE 200,044,439306,Taur; Yuan,9999,0,9999,0
1708253042250,ECE 200,045,439419,Touri; Behrouz,9999,0,9999,0
1708253042250,ECE 200,046,439425,Trivedi; Mohan M.,9999,0,9999,0
1708253042250,ECE 200,047,439538,Vasconcelos; Nuno,9999,0,9999,0
1708253042250,ECE 200,048,439546,Wang; Xiaolong,9999,0,9999,0
1708253042250,ECE 200,049,439549,Xie; Pengtao,9999,0,9999,0
1708253042250,ECE 200,050,439551,Yip; Michael,9999,0,9999,0
1708253042250,ECE 200,051,439553,Zeger; Kenneth A.,9999,0,9999,0
1708253042250,ECE 200,052,439554,Zhang; Xinyu,9999,0,9999,0
1708253042250,ECE 200,053,439555,Zheng; Yang,9999,0,9999,0
1708253042250,ECE 200,054,439557,Turakhia; Yatish Girish,9999,0,9999,0
1708253042250,ECE 200,055,439558,Kang; Mingu,9999,0,9999,0
1708253042250,ECE 200,056,439560,Shi; Yuanyuan,9999,0,9999,0
1708253042250,ECE 200,057,439564,Wang; Edward Jay,9999,0,9999,0
1708253042250,ECE 200,058,439565,Antipa; Nicholas A,9999,0,9999,0
1708253042250,ECE 200,059,439566,Zheng; Yang,9999,0,9999,0
1708253042250,ECE 200,060,492991,Yu; Paul K L,9999,0,9999,0
1708253042250,ECE 200,061,492992,Ndao; Abdoulaye,9999,0,9999,0
1708253042250,ECE 200,062,493019,Naghizadeh Ardabili; Parin,9999,0,9999,0
1708253042250,ECE 200,063,493033,Sahay; Rajeev,9999,0,9999,0
1708253042780,ECE 208,A00,430053,Mir Arabbaygi; Siavash,0,0,0,0
1708253043306,ECE 212CN,A00,430054,Liu; Zhaowei,0,0,0,0
1708253043835,ECE 222C,A00,430055,Lomakin; Vitaliy,0,0,0,0
1708253044362,ECE 227,A00,430057,Franceschetti; Massimo,0,0,0,0
1708253044889,ECE 228,A00,430078,Shi; Yuanyuan,0,0,0,0
1708253045415,ECE 230C,A00,430079,Yu; Paul K L,0,0,0,0
1708253045946,ECE 235,A00,430081,Taur; Yuan,0,0,0,0
1708253046474,ECE 236B,A00,430082,Lo; Yu-Hwa,0,0,0,0
1708253047001,ECE 240C,A00,430083,Mookherjea; Shayan,0,0,0,0
1708253047527,ECE 250,A00,430115,Touri; Behrouz,0,0,0,0
1708253048056,ECE 251B,A00,430166,Vasconcelos; Manuela,0,0,0,0
1708253048650,ECE 258B,A00,430167,Milstein; Laurence B.,0,0,0,0
1708253049179,ECE 260C,A00,430168,Eldon; John,0,0,0,0
1708253049706,ECE 264B,A00,430169,Galton; Ian A,0,0,0,0
1708253050233,ECE 265B,A00,430170,Gudem; Prasad S.S.,0,0,0,0
1708253050996,ECE 266,A01,430273,Hall; Drew A.,0,0,0,0
1708253051521,ECE 271C,A00,430283,Vasconcelos; Nuno,0,0,0,0
1708253052049,ECE 272A,A01,430340,Poveda Fonseca; Jorge,0,0,0,0
1708253052576,ECE 273,A00,430352,Wang; Jun-Kun,0,0,0,0
1708253053102,ECE 276B,A00,430353,Atanasov; Nikolay A.,0,0,0,0
1708253053631,ECE 284,A00,430385,Wang; Edward,0,0,0,0
1708253054158,ECE 285,A00,430386,Wang; Xiaolong,0,0,0,0
1708253054158,ECE 285,B00,430387,Antipa; Nicholas A,0,0,0,0
1708253054685,ECON 1,A01,409576,Crane; Meredith Helen,87,0,100,13
1708253054685,ECON 1,A02,409577,Crane; Meredith Helen,96,0,100,4
1708253054685,ECON 1,A03,409578,Crane; Meredith Helen,97,0,100,3
1708253055216,ECON 2,A01,409580,Candido; Maria Teresa,70,0,75,5
1708253055742,ECON 3,A01,409582,Crane; Meredith Helen,109,0,120,11
1708253055742,ECON 3,A02,409583,Crane; Meredith Helen,114,0,115,1
1708253055742,ECON 3,A03,409584,Crane; Meredith Helen,110,0,115,5
1708253056288,ECON 4,A01,409586,Levkoff; Steven B.,88,0,92,4
1708253056288,ECON 4,A02,409587,Levkoff; Steven B.,89,0,90,1
1708253056836,ECON 5,A01,409589,Dai; Yinlin,53,0,58,5
1708253056836,ECON 5,A02,409590,Dai; Yinlin,56,0,58,2
1708253056836,ECON 5,A03,409591,Dai; Yinlin,54,0,54,0
1708253056836,ECON 5,A04,409593,Dai; Yinlin,55,0,55,0
1708253056836,ECON 5,B01,409595,Dai; Yinlin,57,0,58,1
1708253056836,ECON 5,B02,409596,Dai; Yinlin,49,0,49,0
1708253056836,ECON 5,B03,409597,Dai; Yinlin,59,0,59,0
1708253056836,ECON 5,B04,409598,Dai; Yinlin,55,0,55,0
1708253056836,ECON 5,C01,487209,Staff,40,0,45,5
1708253057384,ECON 100A,A01,409600,Famulari; Melissa,94,0,100,6
1708253057384,ECON 100A,A02,409601,Famulari; Melissa,98,0,100,2
1708253057384,ECON 100A,A03,409604,Famulari; Melissa,98,0,100,2
1708253057384,ECON 100A,B01,409610,Famulari; Melissa,76,0,80,4
1708253057910,ECON 100AH,A00,409612,Famulari; Melissa,19,0,20,1
1708253058453,ECON 100B,A01,409614,Grigoryan; Aram,109,0,120,11
1708253058453,ECON 100B,A02,409616,Grigoryan; Aram,117,0,120,3
1708253058453,ECON 100B,B01,409626,Grigoryan; Aram,47,0,50,3
1708253058453,ECON 100B,B02,409627,Grigoryan; Aram,49,0,50,1
1708253058984,ECON 100C,A01,409629,Levkoff; Steven B.,143,0,146,3
1708253058984,ECON 100C,B01,409632,Levkoff; Steven B.,143,0,146,3
1708253059510,ECON 106,A00,409633,Bowen; T. Renee,90,0,90,0
1708253060036,ECON 109T,A00,409634,Trevino; Isabel,18,0,20,2
1708253060563,ECON 110A,A01,409637,Staff,68,0,75,7
1708253061093,ECON 110B,A01,409663,Herreno Lopera; Juan,119,0,125,6
1708253061093,ECON 110B,A02,409682,Herreno Lopera; Juan,125,0,125,0
1708253061093,ECON 110B,B01,409734,Herreno Lopera; Juan,99,0,100,1
1708253061636,ECON 120A,A01,409739,Candido; Maria Teresa,84,0,90,6
1708253061636,ECON 120A,A02,409740,Candido; Maria Teresa,87,0,90,3
1708253061636,ECON 120A,B01,409742,Candido; Maria Teresa,85,0,90,5
1708253061636,ECON 120A,B02,409743,Candido; Maria Teresa,90,0,90,0
1708253062178,ECON 120B,A01,409748,Ma; Xinwei,128,0,130,2
1708253062178,ECON 120B,A02,409754,Ma; Xinwei,128,0,130,2
1708253062178,ECON 120B,B01,409756,Ma; Xinwei,25,0,40,15
1708253062709,ECON 120C,A01,409758,Sun; Yixiao,141,0,146,5
1708253062709,ECON 120C,B01,409762,Sun; Yixiao,144,0,146,2
1708253063236,ECON 129,A00,409763,Eckert; Fabian Paul,44,0,50,6
1708253063760,ECON 134,A00,409764,Gelber; Alexander Michael,45,0,50,5
1708253063760,ECON 134,B00,409765,Gelber; Alexander Michael,49,0,50,1
1708253064289,ECON 137,A00,409766,Niehaus; Paul,19,0,20,1
1708253064817,ECON 142,A00,409767,Trevino; Isabel,39,0,40,1
1708253064817,ECON 142,B00,409768,Trevino; Isabel,38,0,40,2
1708253065344,ECON 164,A00,409771,Muralidharan; Karthik,118,0,120,2
1708253065870,ECON 172A,A01,409773,Newhouse; Herbert S,67,0,75,8
1708253066399,ECON 172B,A01,409775,Newhouse; Herbert S,74,0,75,1
1708253066399,ECON 172B,B01,409777,Newhouse; Herbert S,71,0,75,4
1708253067451,ECON 191A,A00,409780,Cullen; Julie,20,0,20,0
1708253067977,ECON 200C,A00,409782,Du; Songzi,34,0,35,1
1708253068507,ECON 210C,A00,409784,Herreno Lopera; Juan & Wieland; Johannes Friedrich,35,0,35,0
1708253069031,ECON 220C,A00,409785,Sun; Yixiao,35,0,35,0
1708253069560,ECON 220F,A00,409786,Carson; Richard T,27,0,30,3
1708253070085,ECON 221,A00,409787,Zhu; Ying,25,0,25,0
1708253070614,ECON 241,A00,409788,Muralidharan; Karthik,18,0,20,2
1708253071141,ECON 243,A00,409789,Niehaus; Paul,18,0,20,2
1708253071668,ECON 248,A00,409790,Eckert; Fabian Paul,18,0,20,2
1708253072193,ECON 250C,A00,409791,Arnold; David Hall & Betts; Julian,25,0,25,0
1708253072720,ECON 268,A00,409792,Jacobsen; Mark,24,0,25,1
1708253073249,ECON 281,A00,409793,Meckel; Katherine Hunter,19,0,20,1
1708253073249,ECON 281,B00,409794,Herreno Lopera; Juan & Wieland; Johannes Friedrich,19,0,20,1
1708253073249,ECON 281,C00,477854,Herreno Lopera; Juan & Wieland; Johannes Friedrich,18,0,20,2
1708253073773,ECON 285,A00,409795,Eckert; Fabian Paul,20,0,20,0
1708253074300,ECON 286,A00,409796,Ma; Xinwei,15,0,15,0
1708253074300,ECON 286,B00,409797,Hamilton; James D.,15,0,15,0
1708253074300,ECON 286,C00,409798,Grigoryan; Aram,15,0,15,0
1708253074300,ECON 286,D00,409799,Niehaus; Paul,15,0,15,0
1708253074826,ECON 296,A00,409800,Eckert; Fabian Paul,20,0,20,0
1708253075353,EDS 31,A00,409801,Bussey; Thomas J,9,0,10,1
1708253075883,EDS 38,A01,409803,Chung; Luz Marina,25,0,25,0
1708253076410,EDS 39,A01,409805,Heinzman; Erica M.,24,0,25,1
1708253076939,EDS 102,A01,409807,Ambo; Theresa Jean,37,0,45,8
1708253077468,EDS 110R,A01,409809,Staff,42,0,50,8
1708253077468,EDS 110R,B01,481358,Staff,20,0,20,0
1708253077995,EDS 111,A00,479044,Wishard Guerra; Alison G.,56,0,60,4
1708253078525,EDS 117,A01,409818,Jones; Gabrielle Anastasia,21,0,23,2
1708253078525,EDS 117,A02,409819,Jones; Gabrielle Anastasia,23,0,23,0
1708253078525,EDS 117,A03,409820,Jones; Gabrielle Anastasia,22,0,23,1
1708253078525,EDS 117,A04,409821,Jones; Gabrielle Anastasia,21,0,21,0
1708253079051,EDS 118,A00,409828,Warstadt; Melissa Fawn,46,0,50,4
1708253079580,EDS 123,A00,409831,Bussey; Thomas J,10,0,10,0
1708253080112,EDS 124AR,A00,419352,Simon; Elizabeth A,81,0,100,19
1708253080112,EDS 124AR,B00,419377,Simon; Elizabeth A,97,0,100,3
1708253080112,EDS 124AR,C00,481485,Simon; Elizabeth A,25,0,25,0
1708253080112,EDS 124AR,D00,481490,Simon; Elizabeth A,25,0,25,0
1708253080638,EDS 124BR,A00,409838,Eguchi; Emi,52,0,75,23
1708253080638,EDS 124BR,B00,481363,Eguchi; Emi,25,0,25,0
1708253081164,EDS 125,A00,409839,Aragon; Maria Jose,48,0,50,2
1708253081695,EDS 126,A01,409843,Jones; Makeba,19,0,25,6
1708253081695,EDS 126,A02,409844,Jones; Makeba,25,0,25,0
1708253081695,EDS 126,A03,409846,Jones; Makeba,25,0,25,0
1708253081695,EDS 126,A04,409847,Jones; Makeba,25,0,25,0
1708253082221,EDS 128B,A01,409851,Pappas; Elizabeth,49,0,50,1
1708253082750,EDS 129C,A01,409906,Millstone; Rachel Diana,44,0,50,6
1708253083276,EDS 130,A01,409954,Mendez; Kathrina Mendoza,14,0,15,1
1708253083276,EDS 130,A02,409955,Mendez; Kathrina Mendoza,24,0,25,1
1708253083276,EDS 130,A03,409956,Mendez; Kathrina Mendoza,20,0,20,0
1708253083803,EDS 133,A01,409961,Bintliff; Amy S.V.,15,0,20,5
1708253083803,EDS 133,A02,409962,Bintliff; Amy S.V.,20,0,20,0
1708253083803,EDS 133,A03,489636,Bintliff; Amy S.V.,15,0,15,0
1708253084332,EDS 136,A01,409964,Chung; Luz Marina,30,0,30,0
1708253084332,EDS 136,A02,409977,Chung; Luz Marina,30,0,30,0
1708253084861,EDS 139,A00,479197,Millstone; Rachel Diana,42,0,50,8
1708253084861,EDS 139,B00,479198,Pappas; Elizabeth,49,0,50,1
1708253084861,EDS 139,C00,479199,Mendez; Kathrina Mendoza,58,0,60,2
1708253084861,EDS 139,D00,479200,Bintliff; Amy S.V.,56,0,60,4
1708253084861,EDS 139,E00,479201,Chung; Luz Marina,59,0,60,1
1708253084861,EDS 139,F00,479202,Bintliff; Amy S.V.,15,0,15,0
1708253084861,EDS 139,G00,479203,Mamas; Christoforos,27,0,30,3
1708253084861,EDS 139,H00,493997,Choi; Bailey Miyeon,28,0,30,2
1708253085386,EDS 141,A00,409979,Mamas; Christoforos,38,0,40,2
1708253085915,EDS 145,A01,409989,Choi; Bailey Miyeon,13,0,15,2
1708253085915,EDS 145,A02,409990,Choi; Bailey Miyeon,15,0,15,0
1708253086441,EDS 180,A00,409991,Chapman; Thandeka K,30,0,30,0
1708253086441,EDS 180,B00,409992,Ambo; Theresa Jean,24,0,25,1
1708253086441,EDS 180,C00,409993,Jones; Gabrielle Anastasia,20,0,20,0
1708253086441,EDS 180,D00,409994,Phuong; Andrew,24,0,24,0
1708253086966,EDS 198,001,487216,Eguchi; Emi,20,0,20,0
1708253087494,EDS 205B,A00,409995,Staff,40,0,45,5
1708253087494,EDS 205B,B00,409997,Staff,42,0,45,3
1708253088036,EDS 232,A00,409999,Hopkins; Megan Beth,9,0,12,3
1708253088565,EDS 255,A00,410001,Phuong; Andrew,14,0,15,1
1708253089093,EDS 257,A00,410003,Datnow; Amanda Lee,14,0,15,1
1708253089623,EDS 282,A00,479192,Daly; Alan J.,16,0,16,0
1708253090151,EDS 287B,A00,479193,Daly; Alan J.,16,0,16,0
1708253090680,EDS 288A,A00,410005,Staff,18,0,18,0
1708253091205,EDS 288C,A00,410007,Staff,18,0,18,0
1708253091731,EDS 289B,A01,410009,Daly; Alan J.,18,0,18,0
1708253092257,EDS 290,A00,410010,Black; Alison Michelle,30,0,30,0
1708253092257,EDS 290,B00,410012,Choi; Bailey Miyeon,29,0,30,1
1708253092257,EDS 290,C00,479205,Heinzman; Erica M.,0,0,0,0
1708253092786,EDS 291B,A01,479195,Daly; Alan J.,16,0,16,0
1708253093311,EDS 293B,A01,410016,Staff,18,0,18,0
1708253093839,EDS 294B,A00,479196,Burrell; Sade Renee,16,0,16,0
1708253094382,EDS 296,001,478927,Ambo; Theresa Jean,0,0,0,0
1708253094382,EDS 296,002,478935,Aragon; Maria Jose,0,0,0,1
1708253094382,EDS 296,003,478936,Chapman; Thandeka K,0,0,0,0
1708253094382,EDS 296,004,478942,Bintliff; Amy S.V.,0,0,0,0
1708253094382,EDS 296,005,478943,Clarke; Sherice Nicole,0,0,0,0
1708253094382,EDS 296,006,478967,Cohen; Shana R,0,0,0,1
1708253094382,EDS 296,007,478968,Datnow; Amanda Lee,0,0,0,0
1708253094382,EDS 296,008,478969,Daly; Alan J.,0,0,0,0
1708253094382,EDS 296,009,478970,Eguchi; Emi,0,0,0,0
1708253094382,EDS 296,010,478971,Fine; Sarah,0,0,0,0
1708253094382,EDS 296,011,478972,Jones; Gabrielle Anastasia,0,0,0,0
1708253094382,EDS 296,012,479020,Jones; Makeba,0,0,0,0
1708253094382,EDS 296,013,479021,Halter; Christopher P.,0,0,0,0
1708253094382,EDS 296,014,479027,Hofstetter; Carolyn,0,0,0,0
1708253094382,EDS 296,015,479028,Hopkins; Megan Beth,0,0,0,0
1708253094382,EDS 296,016,479034,Mamas; Christoforos,0,0,0,0
1708253094382,EDS 296,017,479035,Pollock; Mica,0,0,0,0
1708253094382,EDS 296,018,479036,Wishard Guerra; Alison G.,0,0,0,0
1708253094382,EDS 296,019,494549,Phuong; Andrew,0,0,0,0
1708253094909,EMED 296,001,464428,Singh; Sukhdeep,49,0,50,1
1708253094909,EMED 296,002,464438,Subramony; Rachna,49,0,50,1
1708253094909,EMED 296,003,464490,Staff,50,0,50,0
1708253095437,ENG 10,A00,399006,Evdokimenko; Ekaterina,30,0,30,0
1708253095964,ENG 100D,A00,399084,Ngo; Anh-Thu T.,33,0,50,17
1708253096490,ENG 100DR,A00,479230,Ngo; Anh-Thu T.,29,0,40,11
1708253097021,ENG 100L,A00,399163,Kleissl; Jan,6,0,6,0
1708253097021,ENG 100L,B00,399217,Bratton; Maryann,8,0,8,0
1708253097021,ENG 100L,C00,399218,Yu; Paul K L,8,0,8,0
1708253097021,ENG 100L,D00,399257,Bratton; Maryann,6,0,6,0
1708253097021,ENG 100L,E00,399258,de Oliveira; Mauricio,9,0,10,1
1708253097021,ENG 100L,F00,399314,Bratton; Maryann,7,0,7,0
1708253097021,ENG 100L,G00,399394,Boyle; Mary E. T.,14,0,15,1
1708253097553,ENVR 102,A00,400777,Daly; Heather Marie,19,0,20,1
1708253097553,ENVR 102,B00,400778,Montejo; Carolina,24,0,25,1
1708253097553,ENVR 102,C00,400791,Staff,23,0,25,2
1708253098099,ENVR 140,A01,400813,Siapno; Jacqueline A,12,0,15,3
1708253098099,ENVR 140,A02,400870,Siapno; Jacqueline A,15,0,15,0
1708253098099,ENVR 140,A03,400889,Siapno; Jacqueline A,15,0,15,0
1708253098099,ENVR 140,A04,400890,Siapno; Jacqueline A,15,0,15,0
1708253098628,ENVR 144,A01,400929,Herbst; Matthew,20,0,20,0
1708253099154,ERC 20,A00,400722,Evans; Ivan T,30,0,30,0
1708253099686,ESYS 103,A01,400931,Lerner; Amy M,32,0,34,2
1708253099686,ESYS 103,A02,400934,Lerner; Amy M,34,0,34,0
1708253099686,ESYS 103,A03,400938,Lerner; Amy M,28,0,34,6
1708253099686,ESYS 103,A04,400939,Lerner; Amy M,33,0,34,1
1708253099686,ESYS 103,A05,400940,Lerner; Amy M,34,0,34,0
1708253099686,ESYS 103,A06,400941,Lerner; Amy M,33,0,34,1
1708253100213,ESYS 187C,A01,400945,Hetherington; Elizabeth Dorsey,28,0,40,12
1708253100213,ESYS 187C,A02,400946,Hetherington; Elizabeth Dorsey,39,0,40,1
1708253100746,ETHN 3R,A01,400948,Streeby; Shelley,21,0,25,4
1708253100746,ETHN 3R,A02,401220,Streeby; Shelley,24,0,25,1
1708253100746,ETHN 3R,A03,401231,Streeby; Shelley,22,0,25,3
1708253100746,ETHN 3R,A04,401236,Streeby; Shelley,23,0,25,2
1708253100746,ETHN 3R,A05,401241,Streeby; Shelley,21,0,25,4
1708253100746,ETHN 3R,A06,401311,Streeby; Shelley,21,0,25,4
1708253100746,ETHN 3R,A07,401318,Streeby; Shelley,25,0,25,0
1708253100746,ETHN 3R,A08,401319,Streeby; Shelley,25,0,25,0
1708253100746,ETHN 3R,A09,401397,Streeby; Shelley,25,0,25,0
1708253100746,ETHN 3R,A10,401398,Streeby; Shelley,25,0,25,0
1708253100746,ETHN 3R,A11,401399,Streeby; Shelley,24,0,25,1
1708253100746,ETHN 3R,A12,401518,Streeby; Shelley,25,0,25,0
1708253100746,ETHN 3R,A13,401551,Streeby; Shelley,24,0,25,1
1708253100746,ETHN 3R,A14,401552,Streeby; Shelley,23,0,25,2
1708253101275,ETHN 30,A01,401554,Fuste; Jose Ignacio,24,0,25,1
1708253101275,ETHN 30,A02,401555,Fuste; Jose Ignacio,25,0,25,0
1708253101275,ETHN 30,A03,401556,Fuste; Jose Ignacio,25,0,25,0
1708253101275,ETHN 30,A04,401557,Fuste; Jose Ignacio,25,0,25,0
1708253101805,ETHN 100C,A00,401558,Museus; Samuel David,36,0,40,4
1708253102386,ETHN 101TV,A01,401560,Marez; Curtis F.,21,0,25,4
1708253102386,ETHN 101TV,A02,401564,Marez; Curtis F.,25,0,25,0
1708253102915,ETHN 108,A00,401584,Hankins; Sarah E.,25,0,29,4
1708253103443,ETHN 113A,A00,401657,Werner; Bradley T.,15,0,15,0
1708253103968,ETHN 114B,A00,401724,Frank; Ross H.,19,0,20,1
1708253104498,ETHN 120D,A01,401848,Alvarez; Luis A,8,0,10,2
1708253104498,ETHN 120D,A02,401853,Alvarez; Luis A,10,0,10,0
1708253105026,ETHN 125R,A00,401858,Sasaki; Christen T,39,0,50,11
1708253105554,ETHN 126,A00,401865,Tran; Ly Thi Hai,39,0,40,1
1708253106079,ETHN 127,A00,401866,Martin Sandino; Amanda Maria Yoland,24,0,25,1
1708253106608,ETHN 137,A00,401867,Martin Sandino; Amanda Maria Yoland,19,0,19,0
1708253107134,ETHN 139,A00,401992,Perreira; Christopher Michael,25,0,25,0
1708253107662,ETHN 143,A00,402059,Marez; Curtis F.,39,0,40,1
1708253108192,ETHN 144M,A00,402060,Jolivette; Andrew J,62,0,65,3
1708253108718,ETHN 150,A00,402158,Taylor-Garcia; Daphne,16,0,18,2
1708253109243,ETHN 153,A00,402160,Martinez-Matsuda; Veronica,24,0,25,1
1708253109772,ETHN 179,A00,402165,Richards; Stephanie F,23,0,25,2
1708253110298,ETHN 183,A00,402217,Steelman; Katherine Wallis,16,0,16,0
1708253110824,ETHN 186,A00,402313,Perez; Roy,15,0,15,0
1708253111350,ETHN 189,A00,479226,Museus; Samuel David,29,0,30,1
1708253111880,ETHN 196H,A00,402314,Espiritu; Yen,0,0,0,0
1708253111880,ETHN 196H,B00,402325,Perreira; Christopher Michael,0,0,0,0
1708253111880,ETHN 196H,C00,402344,Perez; Roy,0,0,0,0
1708253111880,ETHN 196H,D00,402345,Streeby; Shelley,0,0,0,0
1708253111880,ETHN 196H,E00,402346,Taylor-Garcia; Daphne,0,0,0,0
1708253112405,ETHN 200C,A00,402358,Fuste; Jose Ignacio,19,0,20,1
1708253112934,ETHN 230,A00,402359,Streeby; Shelley,16,0,20,4
1708253113462,ETHN 291,A00,402363,Perreira; Christopher Michael,16,0,20,4
1708253113989,EXPR 100,A00,477778,Staff,9999,0,9999,0
1708253114517,EXPR 105,A00,477779,Staff,9999,0,9999,0
1708253115044,EXPR 201,A00,477780,Staff,9999,0,9999,0
1708253115573,EXPR 205,A00,477781,Staff,9999,0,9999,0
1708253116099,FILM 87,A00,402794,Rahimi; Babak,19,0,20,1
1708253116099,FILM 87,B00,402796,Rahimi; Babak,20,0,20,0
1708253116099,FILM 87,C00,402821,Havis; Allan,19,0,20,1
1708253116625,FMPH 95,A00,481734,Larsen; Britta Ann,0,0,0,2
1708253117152,FMPH 101,A00,404648,Tan; Gene Brian,31,0,40,9
1708253117679,FMPH 102,A01,404692,Rana; Brinda Kanti,25,0,28,3
1708253117679,FMPH 102,A02,404714,Rana; Brinda Kanti,28,0,28,0
1708253117679,FMPH 102,B01,404739,Rana; Brinda Kanti,26,0,28,2
1708253117679,FMPH 102,B02,404746,Rana; Brinda Kanti,28,0,28,0
1708253118213,FMPH 110,A00,404747,Campbell; Chadwick Karl,52,0,55,3
1708253118213,FMPH 110,B00,404789,Zoumas-Morse; Christine E.,24,0,30,6
1708253118739,FMPH 120,A00,404792,Nguyen-Grozavu; France T.,48,0,60,12
1708253119269,FMPH 130,A00,404859,Gould; Carlos Francisco,49,0,55,6
1708253119269,FMPH 130,B00,479047,Ciborowski; Haley Minae,52,0,55,3
1708253119797,FMPH 155,A00,404864,Fielding-Miller; Rebecca,65,0,65,0
1708253120324,FMPH 161,A00,404865,Zoumas-Morse; Christine E.,27,0,35,8
1708253120853,FMPH 191,A00,404866,Eikey; Elizabeth Victoria,35,0,35,0
1708253121382,FMPH 194,A00,404938,Larsen; Britta Ann,0,0,0,0
1708253121382,FMPH 194,B00,404939,Marquez; Becky,0,0,0,0
1708253121382,FMPH 194,C00,404949,Nguyen-Grozavu; France T.,0,0,0,0
1708253121382,FMPH 194,D00,404950,Stone; Matthew David,0,0,0,0
1708253121382,FMPH 194,E00,404958,White; Anne Elizabeth Clar,0,0,0,0
1708253121382,FMPH 194,F00,404969,Zoumas-Morse; Christine E.,0,0,0,0
1708253121907,FMPH 223,A00,404977,Vaida; Florin,7,0,26,19
1708253122433,FMPH 225,A00,404978,Zou; Jingjing,0,0,0,0
1708253122964,FMPH 291,A00,404992,Salem; Rany Mansour,15,0,15,0
1708253122964,FMPH 291,C00,405005,Schwartzman; Armin,0,0,0,11
1708253122964,FMPH 291,D00,479113,Shadyab; Aladdin Hassan,0,0,0,0
1708253122964,FMPH 291,E00,479114,Shadyab; Aladdin Hassan,0,0,0,0
1708253122964,FMPH 291,F00,479115,Wynn; Adriane Michelle,0,0,0,3
1708253122964,FMPH 291,G00,479116,Xu; Ronghui,0,0,0,10
1708253122964,FMPH 291,H00,479119,Vaida; Florin,0,0,0,2
1708253123494,FPM 258C,A00,405129,Chen; Brian Hwa-Yang,11,0,15,4
1708253124021,FPM 259C,A00,405130,Nguyen; Annie Lu & Araneta; Maria Rosario Gorrez,4,0,5,1
1708253124550,FPM 278,A00,405131,Strong; David R,13,0,15,2
1708253125076,FPM 280C,A01,405133,Banegas; Matthew Patrick,10,0,10,0
1708253125603,FPM 296,001,464651,Johnson; Michelle Lee,49,0,50,1
1708253125603,FPM 296,002,464652,Staff,50,0,50,0
1708253125603,FPM 296,003,464653,Staff,50,0,50,0
1708253126134,FPM 297,001,479175,Vaida; Florin,9999,0,9999,0
1708253126134,FPM 297,002,494007,Strong; David R,9999,0,9999,0
1708253126134,FPM 297,003,494364,Bazzi; Angela Robertson,9999,0,9999,0
1708253126662,GLBH 20,A00,405134,Elwardani; Nile Regina,143,0,146,3
1708253127193,GLBH 100,A00,405135,Bhavsar; Radhika,68,0,70,2
1708253127193,GLBH 100,B00,477773,Villarino; Margarita,39,0,44,5
1708253127193,GLBH 100,C00,477855,Jenkins; Janis A.,20,0,20,0
1708253127193,GLBH 100,D00,481337,Mishra; Jyoti,40,0,40,0
1708253127719,GLBH 101,A00,405136,Sloane; Julia Kathryn,40,0,40,0
1708253128246,GLBH 107,A00,405137,Wilson; Brenda K,63,0,70,7
1708253128776,GLBH 111,A01,486865,Burgos; Jose L.,0,0,0,0
1708253128776,GLBH 111,B01,486867,Burgos; Jose L.,0,0,0,0
1708253129305,GLBH 114W,A00,405138,Walkover; Lillian B,17,0,17,0
1708253129834,GLBH 118,A00,405140,Wilson; Brenda K,31,0,32,1
1708253130359,GLBH 147,A00,405141,Stewart; Alexander B,40,0,40,0
1708253130889,GLBH 148,A00,405142,Olivas Hernandez; Olga Lid,93,0,100,7
1708253131414,GLBH 150B,A00,486855,Sanchez; Giselle,0,0,0,0
1708253131941,GLBH 181,A00,405154,Burgos; Jose L.,211,0,216,5
1708253132471,GLBH 215,A00,479241,Walkover; Lillian B,18,0,18,0
1708253133000,GLBH 260,A00,480722,Elwardani; Nile Regina,18,0,18,0
1708253133525,GSS 20,A00,405155,Siapno; Jacqueline A,25,0,30,5
1708253134051,GSS 25,A00,405156,Batarseh; Amanda Alicia,24,0,30,6
1708253134580,HDS 1,A01,405160,Reese; Clarissa Jane,25,0,25,0
1708253134580,HDS 1,A02,405168,Reese; Clarissa Jane,25,0,25,0
1708253134580,HDS 1,A03,405169,Reese; Clarissa Jane,22,0,25,3
1708253134580,HDS 1,A04,405170,Reese; Clarissa Jane,24,0,25,1
1708253134580,HDS 1,A05,405171,Reese; Clarissa Jane,23,0,25,2
1708253134580,HDS 1,A06,405172,Reese; Clarissa Jane,24,0,25,1
1708253134580,HDS 1,A07,405173,Reese; Clarissa Jane,24,0,25,1
1708253135106,HDS 60,A01,405175,Warstadt; Melissa Fawn,34,0,35,1
1708253135106,HDS 60,A02,405176,Warstadt; Melissa Fawn,33,0,35,2
1708253135634,HDS 95,A00,405177,Staff,38,0,40,2
1708253136157,HDS 120,A00,405178,Staff,0,0,0,0
1708253136748,HDS 122,A00,405179,Rodriguez; Victoria Calip,64,0,75,11
1708253137276,HDS 150,A00,405180,Staff,20,0,20,0
1708253137276,HDS 150,B00,405181,Staff,20,0,20,0
1708253137276,HDS 150,C00,405182,Staff,20,0,20,0
1708253137802,HDS 181,A01,405185,Bjorklund; Peter,30,0,30,0
1708253138330,HDS 191,A01,405187,Reese; Clarissa Jane,40,0,40,0
1708253138330,HDS 191,B01,405194,Staff,25,0,25,0
1708253138856,HIAF 113,A00,403736,Prestholdt; Jeremy,74,0,75,1
1708253139382,HIAF 114,A00,403738,Gyamfi; Bright,49,0,50,1
1708253139912,HIEA 132,A00,403740,Kletzer; Benjamin Nathan,25,0,30,5
1708253140438,HIEA 154,A00,403741,Henry; Todd A.,62,0,64,2
1708253140965,HIEU 139,A00,403742,Strasser; Ulrike,52,0,56,4
1708253141494,HIEU 171,A00,403743,Hansen; Jan Eric,62,0,64,2
1708253142023,HIEU 176,A00,403744,Hertz; Deborah,14,0,15,1
1708253142549,HIEU 183,A00,403800,Gallant; Thomas W.,15,0,15,0
1708253143079,HIEU 276,A00,403862,Hertz; Deborah,0,0,0,0
1708253143607,HIGL 127,A00,403802,Ivey; James Alexander,56,0,56,0
1708253144137,HIGR 201,A00,494372,Pineda De Avila; Nydia,9,0,10,1
1708253144664,HIGR 205,A00,403863,Strasser; Ulrike,11,0,15,4
1708253145195,HIGR 217C,A00,403864,Lu; Weijing,9,0,10,1
1708253145722,HIGR 239,A00,403865,Serlin; David,4,0,5,1
1708253146249,HIGR 240,A00,403875,Gates; Kelly,2,0,5,3
1708253146780,HILA 101,A00,403818,LeNeave; Kimiko Nicole,62,0,64,2
1708253147306,HILA 119,A00,403819,Kozameh; Sara J,47,0,50,3
1708253147833,HILA 144,A00,403821,Kozameh; Sara J,50,0,50,0
1708253148363,HILD 2C,A01,402843,Hendrickson; Gerald M.,31,0,32,1
1708253148363,HILD 2C,A02,403030,Hendrickson; Gerald M.,31,0,32,1
1708253148363,HILD 2C,A03,403042,Hendrickson; Gerald M.,32,0,32,0
1708253148363,HILD 2C,A04,403048,Hendrickson; Gerald M.,30,0,32,2
1708253148363,HILD 2C,A05,403049,Hendrickson; Gerald M.,32,0,32,0
1708253148363,HILD 2C,A06,403098,Hendrickson; Gerald M.,32,0,32,0
1708253148890,HILD 7C,A01,403501,Bermudez; Rosie Cano,27,0,32,5
1708253148890,HILD 7C,A02,403513,Bermudez; Rosie Cano,30,0,32,2
1708253148890,HILD 7C,A03,403570,Bermudez; Rosie Cano,32,0,32,0
1708253148890,HILD 7C,A04,403572,Bermudez; Rosie Cano,32,0,32,0
1708253148890,HILD 7C,A05,403587,Bermudez; Rosie Cano,32,0,32,0
1708253148890,HILD 7C,A06,403588,Bermudez; Rosie Cano,32,0,32,0
1708253148890,HILD 7C,A07,403589,Bermudez; Rosie Cano,29,0,32,3
1708253148890,HILD 7C,A08,403590,Bermudez; Rosie Cano,32,0,32,0
1708253148890,HILD 7C,A09,403601,Bermudez; Rosie Cano,30,0,32,2
1708253148890,HILD 7C,A10,403602,Bermudez; Rosie Cano,32,0,32,0
1708253148890,HILD 7C,A11,403603,Bermudez; Rosie Cano,32,0,32,0
1708253148890,HILD 7C,A12,403604,Bermudez; Rosie Cano,32,0,32,0
1708253149422,HILD 12,A01,403607,Henry; Todd A.,32,0,32,0
1708253149422,HILD 12,A02,403608,Henry; Todd A.,31,0,32,1
1708253149422,HILD 12,A03,403609,Henry; Todd A.,32,0,32,0
1708253149422,HILD 12,A04,403699,Henry; Todd A.,32,0,32,0
1708253149422,HILD 12,A05,403700,Henry; Todd A.,32,0,32,0
1708253149422,HILD 12,A06,403701,Henry; Todd A.,32,0,32,0
1708253149951,HILD 30,A01,403703,Soleiman; Matthew Teymour,29,0,32,3
1708253149951,HILD 30,A02,403704,Soleiman; Matthew Teymour,30,0,32,2
1708253150477,HINE 118,A00,403822,Kayali; Hasan,50,0,50,0
1708253151002,HISC 119,A00,403823,Golan; Tal,26,0,30,4
1708253151533,HISC 123,A00,403839,Pineda De Avila; Nydia,44,0,50,6
1708253152060,HITO 87,A00,403707,Patterson; Patrick H.,15,0,15,0
1708253152060,HITO 87,B00,403709,Patterson; Patrick H.,15,0,15,0
1708253152060,HITO 87,C00,403735,Schneewind; Sarah,15,0,15,0
1708253152586,HITO 100,B00,403841,Klann; Mary Cameron,24,0,25,1
1708253153116,HITO 170,A00,403842,Watts; Edward J.,8,0,10,2
1708253153641,HITO 193,A00,455333,Hill; Seth J,0,0,0,0
1708253154170,HIUS 114A,A00,403843,Lewandoski; Julia Mavis,52,0,56,4
1708253154698,HIUS 120D,A01,403854,Alvarez; Luis A,8,0,10,2
1708253154698,HIUS 120D,A02,403855,Alvarez; Luis A,10,0,10,0
1708253155224,HIUS 136,A00,403857,Martinez-Matsuda; Veronica,21,0,25,4
1708253155804,HIUS 144,A00,403858,Martinez-Matsuda; Veronica,55,0,56,1
1708253155804,HIUS 144,B00,403859,Vandevelde; Kenneth Joseph,54,0,56,2
1708253155804,HIUS 144,C00,403860,Klann; Mary Cameron,52,0,56,4
1708253155804,HIUS 144,D00,403861,Lewandoski; Julia Mavis,55,0,56,1
1708253156355,HUM 2,A01,422723,Watts; Edward J.,16,0,16,0
1708253156355,HUM 2,A02,422735,Watts; Edward J.,15,0,16,1
1708253156355,HUM 2,A03,422736,Watts; Edward J.,15,0,16,1
1708253156355,HUM 2,A04,422737,Watts; Edward J.,16,0,16,0
1708253156355,HUM 2,A05,422738,Watts; Edward J.,15,0,16,1
1708253156355,HUM 2,A06,422760,Watts; Edward J.,15,0,16,1
1708253156355,HUM 2,A07,422778,Watts; Edward J.,16,0,16,0
1708253156355,HUM 2,A08,422793,Watts; Edward J.,16,0,16,0
1708253156355,HUM 2,A09,422794,Watts; Edward J.,16,0,16,0
1708253156355,HUM 2,A10,422795,Watts; Edward J.,16,0,16,0
1708253156355,HUM 2,B01,422805,Markman; Kristina,13,0,16,3
1708253156355,HUM 2,B02,422806,Markman; Kristina,14,0,16,2
1708253156355,HUM 2,B03,422807,Markman; Kristina,14,0,16,2
1708253156355,HUM 2,B04,422808,Markman; Kristina,16,0,16,0
1708253156355,HUM 2,B05,422809,Markman; Kristina,16,0,16,0
1708253156355,HUM 2,B06,422842,Markman; Kristina,16,0,16,0
1708253156355,HUM 2,B07,422843,Markman; Kristina,15,0,16,1
1708253156355,HUM 2,B08,422848,Markman; Kristina,16,0,16,0
1708253156355,HUM 2,B09,422850,Markman; Kristina,15,0,16,1
1708253156355,HUM 2,B10,422851,Markman; Kristina,12,0,16,4
1708253156355,HUM 2,B11,422852,Markman; Kristina,15,0,16,1
1708253156355,HUM 2,B12,422853,Markman; Kristina,16,0,16,0
1708253156355,HUM 2,C01,422855,Rodriguez; Bretton Sigfred,15,0,16,1
1708253156355,HUM 2,C02,422856,Rodriguez; Bretton Sigfred,16,0,16,0
1708253156355,HUM 2,C03,422859,Rodriguez; Bretton Sigfred,15,0,16,1
1708253156355,HUM 2,C04,423106,Rodriguez; Bretton Sigfred,12,0,16,4
1708253156355,HUM 2,C05,423107,Rodriguez; Bretton Sigfred,15,0,16,1
1708253156355,HUM 2,C06,423108,Rodriguez; Bretton Sigfred,14,0,16,2
1708253156355,HUM 2,C07,423109,Rodriguez; Bretton Sigfred,15,0,16,1
1708253156355,HUM 2,C08,423110,Rodriguez; Bretton Sigfred,15,0,16,1
1708253156355,HUM 2,C09,423133,Rodriguez; Bretton Sigfred,14,0,16,2
1708253156355,HUM 2,C10,423134,Rodriguez; Bretton Sigfred,14,0,16,2
1708253156355,HUM 2,C11,423135,Rodriguez; Bretton Sigfred,16,0,16,0
1708253156355,HUM 2,C12,423136,Rodriguez; Bretton Sigfred,15,0,16,1
1708253156355,HUM 2,C13,423137,Rodriguez; Bretton Sigfred,16,0,16,0
1708253156355,HUM 2,C14,423138,Rodriguez; Bretton Sigfred,16,0,16,0
1708253156355,HUM 2,D01,423140,West; Geoffrey Scott,13,0,16,3
1708253156355,HUM 2,D02,423141,West; Geoffrey Scott,15,0,16,1
1708253156355,HUM 2,D03,423142,West; Geoffrey Scott,15,0,16,1
1708253156355,HUM 2,D04,423143,West; Geoffrey Scott,14,0,16,2
1708253156355,HUM 2,D05,423144,West; Geoffrey Scott,16,0,16,0
1708253156355,HUM 2,D06,423145,West; Geoffrey Scott,16,0,16,0
1708253156355,HUM 2,D07,423146,West; Geoffrey Scott,16,0,16,0
1708253156355,HUM 2,D08,423158,West; Geoffrey Scott,16,0,16,0
1708253156355,HUM 2,D09,423169,West; Geoffrey Scott,16,0,16,0
1708253156355,HUM 2,D10,423174,West; Geoffrey Scott,16,0,16,0
1708253156355,HUM 2,D11,423175,West; Geoffrey Scott,16,0,16,0
1708253156355,HUM 2,D12,423179,West; Geoffrey Scott,15,0,16,1
1708253156355,HUM 2,D13,423188,West; Geoffrey Scott,15,0,16,1
1708253156355,HUM 2,D14,423204,West; Geoffrey Scott,16,0,16,0
1708253156884,HUM 5,A01,423221,Lyon; Antony J.,26,0,30,4
1708253156884,HUM 5,A02,423232,Lyon; Antony J.,24,0,30,6
1708253156884,HUM 5,A03,423237,Lyon; Antony J.,18,0,30,12
1708253156884,HUM 5,A04,423240,Lyon; Antony J.,25,0,30,5
1708253156884,HUM 5,A05,423242,Lyon; Antony J.,28,0,30,2
1708253156884,HUM 5,A06,423244,Lyon; Antony J.,23,0,30,7
1708253156884,HUM 5,A07,423247,Lyon; Antony J.,27,0,30,3
1708253156884,HUM 5,A08,423254,Lyon; Antony J.,27,0,30,3
1708253156884,HUM 5,B01,423286,Patterson; Patrick H.,28,0,30,2
1708253156884,HUM 5,B02,423291,Patterson; Patrick H.,29,0,30,1
1708253156884,HUM 5,B03,423294,Patterson; Patrick H.,28,0,30,2
1708253156884,HUM 5,B04,423297,Patterson; Patrick H.,29,0,30,1
1708253156884,HUM 5,B05,423313,Patterson; Patrick H.,30,0,30,0
1708253156884,HUM 5,B06,423318,Patterson; Patrick H.,30,0,30,0
1708253156884,HUM 5,B07,423362,Patterson; Patrick H.,29,0,30,1
1708253156884,HUM 5,B08,423363,Patterson; Patrick H.,29,0,30,1
1708253156884,HUM 5,C01,423365,Caldwell; Michael Alan,23,0,30,7
1708253156884,HUM 5,C02,423474,Caldwell; Michael Alan,24,0,30,6
1708253156884,HUM 5,C03,423528,Caldwell; Michael Alan,30,0,30,0
1708253156884,HUM 5,C04,423529,Caldwell; Michael Alan,27,0,30,3
1708253156884,HUM 5,C05,423545,Caldwell; Michael Alan,30,0,30,0
1708253156884,HUM 5,C06,423546,Caldwell; Michael Alan,30,0,30,0
1708253156884,HUM 5,C07,423547,Caldwell; Michael Alan,29,0,30,1
1708253156884,HUM 5,C08,423548,Caldwell; Michael Alan,28,0,30,2
1708253157415,INTL 101,A01,404350,Day; Joel Keith,23,0,25,2
1708253157415,INTL 101,A02,404356,Day; Joel Keith,25,0,25,0
1708253157415,INTL 101,A03,404357,Day; Joel Keith,24,0,25,1
1708253157415,INTL 101,A04,404360,Day; Joel Keith,25,0,25,0
1708253157947,INTL 102,A01,404375,Fisk; David Lee,25,0,25,0
1708253157947,INTL 102,A02,404376,Fisk; David Lee,22,0,25,3
1708253157947,INTL 102,A03,404377,Fisk; David Lee,20,0,25,5
1708253157947,INTL 102,A04,404381,Fisk; David Lee,25,0,25,0
1708253158487,INTL 190,A00,404396,Samphantharak; Krislert,24,0,25,1
1708253158487,INTL 190,B00,404402,McIntosh; Justin Daniel,24,0,25,1
1708253158487,INTL 190,C00,404403,Vos; Stacie N.,24,0,25,1
1708253158487,INTL 190,D00,404404,Nadkarni; Vidya,24,0,25,1
1708253158487,INTL 190,E00,404407,Scott; Jeffrey F,25,0,25,0
1708253158487,INTL 190,F00,404409,Auerbach; Bradford C,25,0,25,0
1708253158487,INTL 190,G00,404442,Auerbach; Bradford C,25,0,25,0
1708253158487,INTL 190,H00,404465,Segui; Alan S,25,0,25,0
1708253158487,INTL 190,I00,404481,Segui; Alan S,25,0,25,0
1708253159037,JAPN 10C,A01,403881,Iwamoto; Naoki,15,0,15,0
1708253159037,JAPN 10C,B01,403884,McKee; Mayumi Mochizuki,15,0,15,0
1708253159037,JAPN 10C,C01,403887,Sato; Kyoko,10,0,10,0
1708253159037,JAPN 10C,C02,403888,Sato; Kyoko,10,0,10,0
1708253159037,JAPN 10C,D01,403890,Inada; Minori,8,0,10,2
1708253159037,JAPN 10C,D02,403891,Inada; Minori,10,0,10,0
1708253159037,JAPN 10C,E01,403893,Sato; Kyoko,10,0,10,0
1708253159037,JAPN 10C,E02,403894,Sato; Kyoko,10,0,10,0
1708253159037,JAPN 10C,F01,403896,McKee; Mayumi Mochizuki,10,0,10,0
1708253159037,JAPN 10C,F02,403897,McKee; Mayumi Mochizuki,10,0,10,0
1708253159037,JAPN 10C,G01,403899,Homma; Kunihiko,10,0,10,0
1708253159037,JAPN 10C,G02,403900,Homma; Kunihiko,10,0,10,0
1708253159037,JAPN 10C,H01,403902,Maruyama; Rie,10,0,10,0
1708253159037,JAPN 10C,H02,403903,Maruyama; Rie,9,0,10,1
1708253159037,JAPN 10C,I01,403905,Inada; Minori,10,0,10,0
1708253159037,JAPN 10C,I02,403906,Inada; Minori,9,0,10,1
1708253159037,JAPN 10C,J01,403915,Iwamoto; Naoki,10,0,10,0
1708253159037,JAPN 10C,J02,403916,Iwamoto; Naoki,9,0,10,1
1708253159037,JAPN 10C,K01,403918,Ross; Kayoko F,10,0,10,0
1708253159037,JAPN 10C,K02,403928,Ross; Kayoko F,10,0,10,0
1708253159037,JAPN 10C,L01,403935,Homma; Kunihiko,9,0,10,1
1708253159037,JAPN 10C,L02,403936,Homma; Kunihiko,10,0,10,0
1708253159037,JAPN 10C,M02,403939,Kamioka; Sachiko,13,0,15,2
1708253159037,JAPN 10C,N01,479041,Iwamoto; Naoki,15,0,15,0
1708253159567,JAPN 10CR,A01,403982,Inada; Minori,12,0,12,0
1708253159567,JAPN 10CR,A02,403983,Inada; Minori,12,0,12,0
1708253160093,JAPN 20C,A01,403988,Homma; Kunihiko,10,0,12,2
1708253160093,JAPN 20C,B02,404029,Kamioka; Sachiko,10,0,12,2
1708253160093,JAPN 20C,C01,404033,Takeda; Izumi,8,0,12,4
1708253160093,JAPN 20C,D02,404114,Kamioka; Sachiko,11,0,12,1
1708253160093,JAPN 20C,E01,404135,Simpson; Junko Tokuda,12,0,12,0
1708253160623,JAPN 130C,A01,404144,Maruyama; Rie,9,0,9,0
1708253160623,JAPN 130C,A02,404145,Maruyama; Rie,9,0,9,0
1708253160623,JAPN 130C,B01,404147,Simpson; Junko Tokuda,8,0,9,1
1708253160623,JAPN 130C,B02,404148,Simpson; Junko Tokuda,9,0,9,0
1708253161149,JAPN 135C,A00,404176,Ross; Kayoko F,16,0,16,0
1708253161149,JAPN 135C,B00,404253,Takeda; Izumi,14,0,16,2
1708253161680,JAPN 140C,A00,404255,Sato; Kyoko,18,0,20,2
1708253162207,JAPN 150C,A00,404258,McKee; Mayumi Mochizuki,14,0,14,0
1708253162733,JAPN 190,A00,404260,Miyao; Daisuke,17,0,20,3
1708253163263,JAPN 196B,001,487237,Turner; Christena L.,9999,0,9999,0
1708253163792,JWSP 3,A01,404485,Shuster; Alana,20,0,20,0
1708253164322,LATI 10,A01,405201,Kennemore; Amy Michelle,27,0,30,3
1708253164322,LATI 10,A02,405202,Kennemore; Amy Michelle,27,0,30,3
1708253164322,LATI 10,A03,405208,Kennemore; Amy Michelle,28,0,30,2
1708253164850,LATI 50,A01,405214,Kokinis; Troy Andreas,34,0,35,1
1708253164850,LATI 50,A02,405215,Kokinis; Troy Andreas,34,0,35,1
1708253165376,LATI 130,A01,482880,Alvarez; Camila Huerta,29,0,30,1
1708253165902,LATI 160,A01,477482,Kokinis; Troy Andreas,30,0,30,0
1708253166432,LATI 180,A00,405221,Kennemore; Amy Michelle,28,0,30,2
1708253166432,LATI 180,B00,405222,Mostajo; Lorena,30,0,30,0
1708253166958,LIAB 1C,A00,405278,Saab; Dima,13,0,14,1
1708253166958,LIAB 1C,B00,405279,Saab; Dima,11,0,14,3
1708253167490,LIAB 1CX,A00,405281,Akjeje; Abdelhak,19,0,20,1
1708253167490,LIAB 1CX,B00,405291,Akjeje; Abdelhak,20,0,20,0
1708253168016,LIAB 1F,A00,482814,El Cheddadi; Youniss,14,0,14,0
1708253168547,LIDS 19,001,492979,Goodall; Grant Todd,9999,0,9999,0
1708253168547,LIDS 19,002,492980,Goodall; Grant Todd,9999,0,9999,0
1708253168547,LIDS 19,003,492981,Goodall; Grant Todd,9999,0,9999,0
1708253168547,LIDS 19,004,492982,Goodall; Grant Todd,9999,0,9999,0
1708253168547,LIDS 19,005,492983,Goodall; Grant Todd,9999,0,9999,0
1708253168547,LIDS 19,006,492984,Goodall; Grant Todd,9999,0,9999,0
1708253168547,LIDS 19,007,492985,Goodall; Grant Todd,9999,0,9999,0
1708253168547,LIDS 19,008,492986,Goodall; Grant Todd,9999,0,9999,0
1708253168547,LIDS 19,009,492987,Goodall; Grant Todd,9999,0,9999,0
1708253168547,LIDS 19,010,492988,Goodall; Grant Todd,9999,0,9999,0
1708253168547,LIDS 19,011,492989,Goodall; Grant Todd,9999,0,9999,0
1708253168547,LIDS 19,012,492990,Goodall; Grant Todd,9999,0,9999,0
1708253169073,LIFR 1A,A00,405299,Van Moer; Vinciane G,13,0,14,1
1708253169073,LIFR 1A,B00,405300,Van Moer; Vinciane G,13,0,14,1
1708253169073,LIFR 1A,C00,405301,Van Moer; Vinciane G,13,0,14,1
1708253169073,LIFR 1A,D00,405307,Van Moer; Vinciane G,14,0,14,0
1708253169604,LIFR 1AX,A00,405308,Van Moer; Vinciane G,27,0,28,1
1708253169604,LIFR 1AX,B00,405309,Van Moer; Vinciane G,27,0,28,1
1708253170131,LIFR 1C,A00,405310,Van Moer; Vinciane G,14,0,14,0
1708253170131,LIFR 1C,B00,405311,Van Moer; Vinciane G,12,0,14,2
1708253170131,LIFR 1C,C00,405325,Van Moer; Vinciane G,13,0,14,1
1708253170131,LIFR 1C,D00,405326,Van Moer; Vinciane G,11,0,14,3
1708253170657,LIFR 1CX,A00,405332,Van Moer; Vinciane G,25,0,28,3
1708253170657,LIFR 1CX,B00,405333,Van Moer; Vinciane G,27,0,28,1
1708253171184,LIFR 1D,A00,405334,Van Moer; Vinciane G,13,0,14,1
1708253171184,LIFR 1D,B00,405335,Van Moer; Vinciane G,13,0,14,1
1708253171184,LIFR 1D,C00,405336,Van Moer; Vinciane G,13,0,14,1
1708253171184,LIFR 1D,D00,405337,Van Moer; Vinciane G,13,0,14,1
1708253171715,LIFR 1DX,A00,405338,Van Moer; Vinciane G,25,0,28,3
1708253171715,LIFR 1DX,B00,405394,Van Moer; Vinciane G,27,0,28,1
1708253172239,LIFR 11,001,405395,Goodall; Grant Todd,999,0,999,0
1708253172769,LIGM 1C,A00,405398,Fischer-Grunski; Eva K,12,0,14,2
1708253172769,LIGM 1C,B00,405400,Fischer-Grunski; Eva K,13,0,14,1
1708253172769,LIGM 1C,C00,405403,Fischer-Grunski; Eva K,13,0,14,1
1708253172769,LIGM 1C,D00,405404,Fischer-Grunski; Eva K,13,0,14,1
1708253173296,LIGM 1CX,A00,405407,Fischer-Grunski; Eva K,27,0,28,1
1708253173296,LIGM 1CX,B00,405408,Fischer-Grunski; Eva K,26,0,28,2
1708253173825,LIGM 11,001,405464,Goodall; Grant Todd,999,0,999,0
1708253174351,LIGN 8,A00,411133,McIntosh; Justin Daniel,232,0,240,8
1708253174877,LIGN 17,A00,411141,Kehler; Andrew Scott,287,0,300,13
1708253175402,LIGN 101,A01,411144,Staff,28,0,30,2
1708253175402,LIGN 101,A02,411147,Staff,29,0,30,1
1708253175402,LIGN 101,A03,411154,Staff,27,0,30,3
1708253175402,LIGN 101,A04,411163,Staff,29,0,30,1
1708253175928,LIGN 120,A01,411165,Ackerman; Farrell,28,0,30,2
1708253175928,LIGN 120,A02,411177,Ackerman; Farrell,23,0,27,4
1708253176460,LIGN 130,A01,411223,Staff,29,0,30,1
1708253176460,LIGN 130,A02,411231,Staff,30,0,30,0
1708253176460,LIGN 130,A03,411232,Staff,29,0,30,1
1708253176986,LIGN 141,A00,411276,Rose; Sharon,37,0,40,3
1708253177512,LIGN 144,A00,411277,Lott; Margaret S.,22,0,24,2
1708253178044,LIGN 148,A00,411278,Mayberry; Rachel,71,0,75,4
1708253178570,LIGN 165,A00,411279,Bergen; Leon,41,0,70,29
1708253179095,LIGN 168,A01,411281,Styler; William Francis,65,0,70,5
1708253179630,LIGN 175,A00,482816,Rodriguez Aispuro; Alejandro,35,0,40,5
1708253180157,LIGN 230,A00,411293,Caponigro; Ivano,19,0,20,1
1708253180686,LIGN 238,A00,411308,Bergen; Benjamin,20,0,20,0
1708253181212,LIGN 252,A00,411309,Bergen; Leon,28,0,30,2
1708253181739,LIGN 256,A00,411310,Nakashole; Ndapandula,0,0,5,5
1708253182270,LIGN 272,A00,482887,Kluender; Robert,10,0,10,0
1708253182804,LIHL 112P,A00,405228,Pagkalinawan; Leticia Cant,27,0,28,1
1708253183331,LIHL 114P,A00,405229,Nguyen; Hoan Thi,26,0,28,2
1708253183857,LIHL 117P,A00,405256,Sadegholvad; Elham,27,0,28,1
1708253184385,LIHL 118,A00,405257,Chen; Areana Yen,28,0,28,0
1708253184915,LIHL 124P,A00,405262,Nguyen; Hoan Thi,28,0,28,0
1708253185443,LIHL 132P,A00,405263,Pagkalinawan; Leticia Cant,28,0,28,0
1708253185969,LIHL 134P,A00,405269,Nguyen; Hoan Thi,28,0,28,0
1708253186494,LIHL 138,A00,405270,Chen; Areana Yen,27,0,28,1
1708253187023,LIIT 1C,A00,405465,Carnelos; Chiara,12,0,14,2
1708253187023,LIIT 1C,B00,405466,Carnelos; Chiara,14,0,14,0
1708253187549,LIIT 1CX,A00,405594,Carnelos; Chiara,28,0,28,0
1708253188080,LIPO 1C,A00,405595,Paladini; Denise,13,0,14,1
1708253188080,LIPO 1C,B00,405596,Paladini; Denise,14,0,14,0
1708253188605,LIPO 1CX,A00,405597,De Abreu; Cassia,28,0,28,0
1708253189135,LISL 1A,C00,405600,Lott; Margaret S.,13,0,14,1
1708253189135,LISL 1A,D00,405601,Lott; Margaret S.,10,0,14,4
1708253189135,LISL 1A,E00,405602,Lott; Margaret S.,13,0,14,1
1708253189135,LISL 1A,F00,405603,Lott; Margaret S.,13,0,14,1
1708253189663,LISL 1AR,A00,480605,Lott; Margaret S.,13,0,15,2
1708253189663,LISL 1AR,B00,480606,Lott; Margaret S.,14,0,15,1
1708253190192,LISL 1AX,A00,405754,Lott; Margaret S.,26,0,28,2
1708253190192,LISL 1AX,B00,405755,Lott; Margaret S.,23,0,28,5
1708253190720,LISL 1C,A00,405776,Lott; Margaret S.,13,0,14,1
1708253190720,LISL 1C,B00,405779,Lott; Margaret S.,14,0,14,0
1708253190720,LISL 1C,C00,405785,Lott; Margaret S.,14,0,14,0
1708253190720,LISL 1C,D00,405787,Lott; Margaret S.,9,0,14,5
1708253190720,LISL 1C,E00,405827,Lott; Margaret S.,12,0,14,2
1708253190720,LISL 1C,F00,405830,Lott; Margaret S.,13,0,14,1
1708253191249,LISL 1CX,A00,405844,Lott; Margaret S.,25,0,28,3
1708253191249,LISL 1CX,B00,405848,Lott; Margaret S.,25,0,28,3
1708253191249,LISL 1CX,C00,405849,Lott; Margaret S.,28,0,28,0
1708253191774,LISL 1D,A00,405850,Lott; Margaret S.,8,0,14,6
1708253191774,LISL 1D,B00,405851,Lott; Margaret S.,13,0,14,1
1708253191774,LISL 1D,C00,405852,Lott; Margaret S.,10,0,14,4
1708253192300,LISL 1DX,A00,405854,Lott; Margaret S.,17,0,22,5
1708253192300,LISL 1DX,B00,405855,Lott; Margaret S.,18,0,22,4
1708253192831,LISP 1A,001,405856,Munoz Sanchez; Alicia,11,0,14,3
1708253192831,LISP 1A,002,405857,Munoz Sanchez; Alicia,13,0,14,1
1708253192831,LISP 1A,003,405858,Munoz Sanchez; Alicia,14,0,14,0
1708253192831,LISP 1A,004,405861,Munoz Sanchez; Alicia,14,0,14,0
1708253193358,LISP 1AX,001,405862,Munoz Sanchez; Alicia,28,0,28,0
1708253193358,LISP 1AX,002,405863,Munoz Sanchez; Alicia,25,0,28,3
1708253193892,LISP 1C,001,405864,Munoz Sanchez; Alicia,13,0,14,1
1708253193892,LISP 1C,002,405865,Munoz Sanchez; Alicia,12,0,14,2
1708253193892,LISP 1C,003,405879,Munoz Sanchez; Alicia,12,0,14,2
1708253193892,LISP 1C,004,405880,Munoz Sanchez; Alicia,13,0,14,1
1708253193892,LISP 1C,005,405881,Munoz Sanchez; Alicia,12,0,14,2
1708253193892,LISP 1C,006,405882,Munoz Sanchez; Alicia,12,0,14,2
1708253193892,LISP 1C,007,405904,Munoz Sanchez; Alicia,14,0,14,0
1708253193892,LISP 1C,008,405905,Munoz Sanchez; Alicia,14,0,14,0
1708253193892,LISP 1C,009,405908,Munoz Sanchez; Alicia,14,0,14,0
1708253193892,LISP 1C,010,405917,Munoz Sanchez; Alicia,13,0,14,1
1708253194418,LISP 1CX,001,405922,Munoz Sanchez; Alicia,24,0,28,4
1708253194418,LISP 1CX,002,405990,Munoz Sanchez; Alicia,26,0,28,2
1708253194418,LISP 1CX,003,406007,Munoz Sanchez; Alicia,27,0,28,1
1708253194418,LISP 1CX,004,406008,Munoz Sanchez; Alicia,25,0,28,3
1708253194418,LISP 1CX,005,406015,Munoz Sanchez; Alicia,26,0,28,2
1708253194948,LISP 1D,001,406016,Munoz Sanchez; Alicia,12,0,14,2
1708253194948,LISP 1D,002,406017,Munoz Sanchez; Alicia,13,0,14,1
1708253194948,LISP 1D,003,406018,Munoz Sanchez; Alicia,14,0,14,0
1708253194948,LISP 1D,004,406019,Munoz Sanchez; Alicia,11,0,14,3
1708253194948,LISP 1D,005,406020,Munoz Sanchez; Alicia,13,0,14,1
1708253194948,LISP 1D,006,406021,Munoz Sanchez; Alicia,10,0,14,4
1708253194948,LISP 1D,007,406022,Munoz Sanchez; Alicia,12,0,14,2
1708253194948,LISP 1D,008,406023,Munoz Sanchez; Alicia,13,0,14,1
1708253194948,LISP 1D,009,406024,Munoz Sanchez; Alicia,11,0,14,3
1708253194948,LISP 1D,010,406025,Munoz Sanchez; Alicia,12,0,14,2
1708253194948,LISP 1D,011,406026,Munoz Sanchez; Alicia,13,0,14,1
1708253194948,LISP 1D,012,406027,Munoz Sanchez; Alicia,13,0,14,1
1708253194948,LISP 1D,013,406028,Munoz Sanchez; Alicia,12,0,14,2
1708253194948,LISP 1D,014,406029,Munoz Sanchez; Alicia,12,0,14,2
1708253194948,LISP 1D,015,406030,Munoz Sanchez; Alicia,10,0,14,4
1708253194948,LISP 1D,016,406031,Munoz Sanchez; Alicia,14,0,14,0
1708253194948,LISP 1D,017,406032,Munoz Sanchez; Alicia,14,0,14,0
1708253194948,LISP 1D,018,406033,Munoz Sanchez; Alicia,12,0,14,2
1708253194948,LISP 1D,019,406034,Munoz Sanchez; Alicia,13,0,14,1
1708253194948,LISP 1D,020,406035,Munoz Sanchez; Alicia,14,0,14,0
1708253194948,LISP 1D,021,406036,Munoz Sanchez; Alicia,13,0,14,1
1708253194948,LISP 1D,022,406037,Munoz Sanchez; Alicia,14,0,14,0
1708253194948,LISP 1D,023,406038,Munoz Sanchez; Alicia,14,0,14,0
1708253194948,LISP 1D,024,406039,Munoz Sanchez; Alicia,13,0,14,1
1708253195486,LISP 1DX,001,406040,Munoz Sanchez; Alicia,28,0,28,0
1708253195486,LISP 1DX,002,406041,Munoz Sanchez; Alicia,27,0,28,1
1708253195486,LISP 1DX,003,406127,Munoz Sanchez; Alicia,24,0,28,4
1708253195486,LISP 1DX,004,406128,Munoz Sanchez; Alicia,17,0,28,11
1708253195486,LISP 1DX,005,406418,Munoz Sanchez; Alicia,24,0,28,4
1708253195486,LISP 1DX,006,406536,Munoz Sanchez; Alicia,27,0,28,1
1708253195486,LISP 1DX,007,406561,Munoz Sanchez; Alicia,23,0,28,5
1708253195486,LISP 1DX,008,406576,Munoz Sanchez; Alicia,25,0,28,3
1708253195486,LISP 1DX,009,406679,Munoz Sanchez; Alicia,28,0,28,0
1708253195486,LISP 1DX,010,406691,Munoz Sanchez; Alicia,26,0,28,2
1708253195486,LISP 1DX,011,406692,Munoz Sanchez; Alicia,28,0,28,0
1708253195486,LISP 1DX,012,406693,Munoz Sanchez; Alicia,28,0,28,0
1708253196012,LISP 17,001,406694,Munoz Sanchez; Alicia,18,0,20,2
1708253196537,LISP 18,001,406695,Munoz Sanchez; Alicia,20,0,20,0
1708253197066,LTAM 105,A00,412520,Ruiz; Ariana,28,0,40,12
1708253197592,LTCH 101,A00,479214,Zhu; Ping,39,0,40,1
1708253198119,LTCS 87,A00,492906,Nguyen; Hoang Tan,20,0,20,0
1708253198119,LTCS 87,B00,492907,Nguyen; Hoang Tan,20,0,20,0
1708253198648,LTCS 150,A00,412543,Liao; Ping H,39,0,40,1
1708253199174,LTCS 225,A00,412819,Mendoza; Andrea,14,0,15,1
1708253199699,LTCS 250,A00,412821,Lee; Jin-Kyung,15,0,15,0
1708253200226,LTEA 110B,A00,412548,Liao; Ping H,60,0,60,0
1708253200751,LTEA 120A,A00,479216,Zhu; Ping,36,0,40,4
1708253201279,LTEA 120C,A00,412552,Fiss; Geraldine Anna,295,0,300,5
1708253201805,LTEA 132,A00,412561,Mendoza; Andrea,51,0,60,9
1708253202330,LTEA 141,A00,412565,Lee; Jin-Kyung,37,0,40,3
1708253202860,LTEN 23,A01,411317,Vijay; Ameeth Varma,24,0,25,1
1708253202860,LTEN 23,A02,411318,Vijay; Ameeth Varma,24,0,25,1
1708253202860,LTEN 23,A03,411371,Vijay; Ameeth Varma,25,0,25,0
1708253202860,LTEN 23,A04,411375,Vijay; Ameeth Varma,24,0,25,1
1708253203388,LTEN 28,A01,411632,Blanco; John D,25,0,25,0
1708253203388,LTEN 28,A02,411697,Blanco; John D,25,0,25,0
1708253203388,LTEN 28,A03,411698,Blanco; John D,25,0,25,0
1708253203388,LTEN 28,A04,411709,Blanco; John D,25,0,25,0
1708253203388,LTEN 28,A05,411719,Blanco; John D,25,0,25,0
1708253203388,LTEN 28,A06,411744,Blanco; John D,25,0,25,0
1708253203388,LTEN 28,A07,411780,Blanco; John D,25,0,25,0
1708253203388,LTEN 28,A08,411820,Blanco; John D,25,0,25,0
1708253203917,LTEN 110,A00,486891,Vitkus; Daniel J.,38,0,40,2
1708253204443,LTEN 144,A00,412570,Vijay; Ameeth Varma,39,0,40,1
1708253204970,LTEN 180,A00,412581,Perreira; Christopher Michael,18,0,25,7
1708253205501,LTEN 181,A00,412582,Mukherjee; Silpa,55,0,60,5
1708253206027,LTEN 245,A00,412824,Johnson; Sara E.,13,0,15,2
1708253206553,LTEN 259,A00,412825,Streeby; Shelley,13,0,15,2
1708253207079,LTEU 111,A00,412588,Kontje; Todd Curtis,38,0,40,2
1708253207606,LTEU 140,A00,480172,De Marchi Gherini; Adriana,36,0,37,1
1708253208130,LTEU 141,A00,412592,Cohen; Alain J. J.,40,0,40,0
1708253208657,LTFR 2A,A01,411996,Ploye; Catherine,25,0,25,0
1708253209252,LTFR 2C,A00,411997,Ploye; Catherine,24,0,25,1
1708253209783,LTFR 142,A00,412597,Zhiri; Oumelbanine,20,0,20,0
1708253210311,LTGK 3,A00,412001,Murray; Kourtney Kristine,30,0,30,0
1708253210836,LTGM 2C,A00,412002,Fischer-Grunski; Eva K,25,0,25,0
1708253211368,LTKO 1C,A01,412029,Cho; Hye Jin,24,0,25,1
1708253211368,LTKO 1C,B01,412164,Cho; Hye Jin,23,0,25,2
1708253211368,LTKO 1C,C01,412168,Cho; Hye Jin,25,0,25,0
1708253211368,LTKO 1C,D01,412353,Yim; Nancy,24,0,25,1
1708253211368,LTKO 1C,E01,412372,Yim; Nancy,25,0,25,0
1708253211894,LTKO 2C,A01,412374,Yim; Nancy,21,0,25,4
1708253212420,LTKO 130P,A00,412601,Lee; Jeyseon,25,0,25,0
1708253213965,LTKO 135,A00,412606,Lee; Jeyseon,25,0,25,0
1708253214493,LTLA 3,A00,412375,Murray; Kourtney Kristine,36,0,40,4
1708253215038,LTRU 1C,A01,412491,Wells; Patricia Rebecca,24,0,25,1
1708253215566,LTRU 104A,A01,412614,Wells; Patricia Rebecca,20,0,20,0
1708253216094,LTSP 2A,A01,412493,Lampell; Toni,24,0,25,1
1708253216621,LTSP 2B,A01,412497,Lampell; Toni,22,0,25,3
1708253216621,LTSP 2B,B01,479218,Lampell; Toni,24,0,25,1
1708253217146,LTSP 2C,A01,412499,Mastromartino; Alexandra L,23,0,25,2
1708253217671,LTSP 2D,A00,412500,Dominguez; Noelia,24,0,25,1
1708253218200,LTSP 2E,A00,412501,Mastromartino; Alexandra L,24,0,25,1
1708253218200,LTSP 2E,B00,412502,Mastromartino; Alexandra L,25,0,25,0
1708253218727,LTSP 87,A00,479212,Bessett; Ryan Matthew,20,0,20,0
1708253219272,LTSP 100B,A00,412619,Dominguez; Noelia,25,0,25,0
1708253219272,LTSP 100B,B00,412623,Dominguez; Noelia,24,0,25,1
1708253219798,LTSP 116,A00,412628,Blanco; John D,28,0,30,2
1708253220324,LTSP 135A,A00,412631,Parra; Max,27,0,30,3
1708253221868,LTSP 174,A00,479213,Staff,28,0,30,2
1708253222396,LTTH 115,A00,412632,Kontje; Todd Curtis,35,0,40,5
1708253222922,LTTH 210C,A00,412826,Batarseh; Amanda Alicia,14,0,15,1
1708253223449,LTTH 255,A00,412827,Ali; Mohammad Kazim,13,0,15,2
1708253223978,LTTH 260,A00,412828,Kim; Joo Ok,30,0,30,0
1708253224520,LTWL 19C,A00,412503,Kelting; Edward William,40,0,40,0
1708253225049,LTWL 101,A00,412633,Kelting; Edward William,39,0,40,1
1708253225575,LTWL 114,A00,412656,Fiss; Geraldine Anna,60,0,60,0
1708253226100,LTWL 123,A00,412674,Lampert-Weissig; Lisa,31,0,40,9
1708253226630,LTWL 172,A00,412729,De Marchi Gherini; Adriana,37,0,40,3
1708253227156,LTWL 183,A00,412731,Cohen; Alain J. J.,38,0,40,2
1708253227682,LTWL 184,A00,479219,Mukherjee; Silpa,38,0,40,2
1708253228209,LTWL 194A,A00,489635,Vijay; Ameeth Varma,27,0,31,4
1708253228738,LTWR 8A,A01,412505,Springer; Anna Joy,24,0,25,1
1708253228738,LTWR 8A,A02,412506,Springer; Anna Joy,24,0,25,1
1708253228738,LTWR 8A,A03,412507,Springer; Anna Joy,25,0,25,0
1708253228738,LTWR 8A,A04,412508,Springer; Anna Joy,23,0,25,2
1708253229278,LTWR 8C,A01,412511,Forbes; Camille,23,0,25,2
1708253229278,LTWR 8C,A02,412512,Forbes; Camille,25,0,25,0
1708253229278,LTWR 8C,A03,412514,Forbes; Camille,25,0,25,0
1708253229278,LTWR 8C,A04,412519,Forbes; Camille,24,0,25,1
1708253229805,LTWR 100,A00,412734,Forbes; Camille,7,0,15,8
1708253230329,LTWR 113,A00,412816,Carroll; Amy Sara,28,0,30,2
1708253230855,LTWR 114,A00,412817,Springer; Anna Joy,23,0,30,7
1708253231398,LTWR 126,A00,412818,Hoang; Lily Kim,25,0,30,5
1708253231923,LTWR 215,A00,412880,Carroll; Amy Sara,19,0,20,1
1708253232492,MAE 3,A01,435606,Qi; Huihui,16,0,20,4
1708253232492,MAE 3,A02,435607,Qi; Huihui,15,0,20,5
1708253232492,MAE 3,A03,435608,Qi; Huihui,19,0,20,1
1708253232492,MAE 3,B01,435618,Delson; Nathan Joseph & Mullin; Jennifer S,20,0,20,0
1708253232492,MAE 3,B02,435626,Delson; Nathan Joseph & Mullin; Jennifer S,20,0,20,0
1708253232492,MAE 3,B03,435666,Delson; Nathan Joseph & Mullin; Jennifer S,20,0,20,0
1708253232492,MAE 3,B04,435679,Delson; Nathan Joseph & Mullin; Jennifer S,20,0,20,0
1708253232492,MAE 3,B05,494545,Delson; Nathan Joseph & Mullin; Jennifer S,20,0,20,0
1708253233023,MAE 8,A01,435688,Pham; Hieu Tan,197,0,200,3
1708253233549,MAE 30B,A00,435689,Lubarda; Marko,128,0,130,2
1708253233549,MAE 30B,B00,435701,Ghazinejad; Maziar,117,0,130,13
1708253234094,MAE 101B,A00,435702,Saintillan; David,146,0,150,4
1708253234094,MAE 101B,B00,435703,Nomura; Keiko K.,138,0,146,8
1708253234636,MAE 101C,A00,435704,Sadeghizadeh; Zahra,53,0,65,12
1708253235161,MAE 101D,A00,435705,Chen; Renkun,14,0,20,6
1708253235687,MAE 105,A00,435706,Becker; Janet Maria,115,0,120,5
1708253236245,MAE 107,A00,435707,Lindsey; Stephanie,48,0,50,2
1708253236245,MAE 107,B00,435708,Davidson; Michael R,55,0,60,5
1708253236771,MAE 119,A00,435710,Hidalgo-Gonzalez; Patricia,100,0,120,20
1708253237299,MAE 120,A00,435722,Arefiev; Alexey,49,0,65,16
1708253237826,MAE 125,A00,435723,Kleissl; Jan,60,0,65,5
1708253238354,MAE 131A,A00,435724,Qi; Huihui,119,0,125,6
1708253238354,MAE 131A,B00,435725,Meyers; Marc,123,0,125,2
1708253238900,MAE 143B,A00,435726,Morimoto; Tania,114,0,120,6
1708253238900,MAE 143B,B00,435727,Herbert; Sylvia Lee,117,0,120,3
1708253238900,MAE 143B,C00,435728,Diagne; Mamadou Lamine,108,0,120,12
1708253239431,MAE 145,A00,435729,Martinez; Sonia,41,0,60,19
1708253239957,MAE 148,A01,492802,Silberman; Jack,14,0,24,10
1708253240482,MAE 150,A00,435730,Pham; Hieu Tan,52,0,60,8
1708253241010,MAE 152,A00,435731,Llewellyn Smith; Stefan G.,14,0,14,0
1708253241010,MAE 152,B00,435747,Llewellyn Smith; Stefan G.,12,0,14,2
1708253241010,MAE 152,C00,435748,Llewellyn Smith; Stefan G.,12,0,14,2
1708253241010,MAE 152,D00,435749,Llewellyn Smith; Stefan G.,8,0,14,6
1708253241010,MAE 152,E00,435750,Llewellyn Smith; Stefan G.,13,0,14,1
1708253241538,MAE 155B,A01,435752,Hwang; John T,36,0,50,14
1708253241538,MAE 155B,B01,435768,Anderson; Mark Ronald,27,0,50,23
1708253241538,MAE 155B,C01,494006,Saha; Abhishek,0,0,0,0
1708253242064,MAE 156B,A01,435770,Tustaniwskyj; Jerry I,33,0,40,7
1708253242064,MAE 156B,B01,435772,Ghazinejad; Maziar,35,0,40,5
1708253242064,MAE 156B,C01,435774,Delson; Nathan Joseph,38,0,40,2
1708253242064,MAE 156B,D01,435776,Saha; Abhishek,31,0,40,9
1708253242591,MAE 166,A00,435777,Fullerton; Eric E,44,0,50,6
1708253243139,MAE 170,A01,435779,Lubarda; Marko,30,0,32,2
1708253243139,MAE 170,A02,435780,Lubarda; Marko,27,0,32,5
1708253243139,MAE 170,A03,435781,Lubarda; Marko,32,0,32,0
1708253243139,MAE 170,A04,435782,Lubarda; Marko,31,0,32,1
1708253243139,MAE 170,A05,435783,Lubarda; Marko,29,0,32,3
1708253243139,MAE 170,A06,435784,Lubarda; Marko,30,0,32,2
1708253243139,MAE 170,B01,435786,Evdokimenko; Ekaterina,23,0,24,1
1708253243139,MAE 170,B02,435787,Evdokimenko; Ekaterina,20,0,24,4
1708253243139,MAE 170,B03,435788,Evdokimenko; Ekaterina,23,0,24,1
1708253243139,MAE 170,B04,435789,Evdokimenko; Ekaterina,23,0,24,1
1708253243139,MAE 170,B05,435790,Evdokimenko; Ekaterina,19,0,24,5
1708253243139,MAE 170,B06,435791,Evdokimenko; Ekaterina,23,0,24,1
1708253243664,MAE 180,A00,479477,Sadeghizadeh; Zahra,55,0,60,5
1708253244207,MAE 184,A00,435792,Anderson; Mark Ronald,7,0,50,43
1708253244740,MAE 190,A00,435793,Beg; Farhat N.,17,0,20,3
1708253244740,MAE 190,B00,479209,Gerardo; Hortense Flotilde,12,0,15,3
1708253245268,MAE 202,A00,435794,Bandaru; Prabhakar,32,0,70,38
1708253245793,MAE 205,A00,435804,Hwang; John T & Tynan; George Robert & Seshadri; Kalyanasundaram & Rangamani; Padmini & Bandaru; Prabhakar,9990,0,9999,9
1708253246323,MAE 207,A00,435805,Beg; Farhat N.,9,0,10,1
1708253246323,MAE 207,B00,435815,Campbell; Edward Michael,6,0,10,4
1708253246323,MAE 207,C00,477499,Gerardo; Hortense Flotilde,6,0,30,24
1708253246848,MAE 209,A00,435816,Scholtes Acevedo; Claire,25,0,30,5
1708253247374,MAE 210C,A00,435817,Becker; Janet Maria,22,0,30,8
1708253247902,MAE 211,A00,435818,Seshadri; Kalyanasundaram,20,0,30,10
1708253248427,MAE 214A,A00,435819,Sarkar; Sutanu,27,0,35,8
1708253248953,MAE 217C,A00,435820,Marinoni; Alessandro,10,0,10,0
1708253249482,MAE 221C,A00,435821,Seshadri; Kalyanasundaram,9,0,15,6
1708253250008,MAE 221D,A00,435822,Poulikakos; Lisa Voula,23,0,30,7
1708253250534,MAE 224A,A00,435823,Pawlak; Geno Ronald,5,0,10,5
1708253251060,MAE 227,A00,435824,Hidalgo-Gonzalez; Patricia,21,0,35,14
1708253251587,MAE 231A,A00,435825,Boechler; Nicholas Sebastia,14,0,30,16
1708253252118,MAE 240,A00,435826,Rosengren; Aaron,19,0,30,11
1708253252645,MAE 242,A00,435827,Martinez; Sonia,0,0,45,45
1708253253186,MAE 249,A00,435842,Tolley; Michael Thomas,0,0,35,35
1708253253714,MAE 253,A00,435891,Staff,24,0,25,1
1708253254240,MAE 256,A00,435949,Coimbra; Carlos F.,6,0,10,4
1708253254766,MAE 263,A00,435987,Rangamani; Padmini,10,0,10,0
1708253255296,MAE 266,A00,435988,Evdokimenko; Ekaterina,7,0,30,23
1708253255821,MAE 271C,A00,435990,Arzt; Eduard,10,0,10,0
1708253256346,MAE 281B,A00,435991,Cortes; Jorge,9,0,25,16
1708253256874,MAE 288A,A00,435998,McEneaney; William Michael,6,0,40,34
1708253257400,MAE 288B,A00,435999,Bitmead; Robert R.,41,0,45,4
1708253257926,MAE 290C,A00,436008,Schmidt; Oliver,26,0,30,4
1708253258452,MAE 294C,A01,436010,Young; William Roy,19,0,20,1
1708253258997,MATH 2,A01,431271,Staff,31,0,35,4
1708253258997,MATH 2,B01,431273,Staff,29,0,35,6
1708253258997,MATH 2,C01,431275,Staff,31,0,35,4
1708253259529,MATH 3C,A01,431277,Safii; Soheil,12,0,15,3
1708253259529,MATH 3C,A02,431278,Safii; Soheil,12,0,15,3
1708253259529,MATH 3C,A03,431279,Safii; Soheil,12,0,15,3
1708253259529,MATH 3C,A04,431280,Safii; Soheil,15,0,15,0
1708253259529,MATH 3C,A05,431281,Safii; Soheil,14,0,15,1
1708253259529,MATH 3C,A06,431282,Safii; Soheil,15,0,15,0
1708253260088,MATH 10A,A01,431284,Bowers; Adam R.,20,0,30,10
1708253260088,MATH 10A,A02,431285,Bowers; Adam R.,18,0,30,12
1708253260088,MATH 10A,A03,431369,Bowers; Adam R.,28,0,30,2
1708253260088,MATH 10A,A04,431395,Bowers; Adam R.,27,0,30,3
1708253260088,MATH 10A,A05,431450,Bowers; Adam R.,28,0,30,2
1708253260088,MATH 10A,A06,431508,Bowers; Adam R.,30,0,30,0
1708253260088,MATH 10A,B01,431572,Kowalenko; Ethan J,24,0,30,6
1708253260088,MATH 10A,B02,431573,Kowalenko; Ethan J,29,0,30,1
1708253260088,MATH 10A,B03,431574,Kowalenko; Ethan J,30,0,30,0
1708253260088,MATH 10A,B04,431576,Kowalenko; Ethan J,30,0,30,0
1708253260088,MATH 10A,B05,431577,Kowalenko; Ethan J,30,0,30,0
1708253260088,MATH 10A,B06,431583,Kowalenko; Ethan J,30,0,30,0
1708253260663,MATH 10B,A01,431595,Habib; Yousaf,29,0,36,7
1708253260663,MATH 10B,A02,431597,Habib; Yousaf,35,0,36,1
1708253260663,MATH 10B,A03,431669,Habib; Yousaf,37,0,37,0
1708253260663,MATH 10B,A04,431670,Habib; Yousaf,36,0,37,1
1708253260663,MATH 10B,A05,431671,Habib; Yousaf,70,0,70,0
1708253260663,MATH 10B,B01,431673,Habib; Yousaf,25,0,33,8
1708253260663,MATH 10B,B02,431712,Habib; Yousaf,33,0,33,0
1708253260663,MATH 10B,B03,431713,Habib; Yousaf,33,0,33,0
1708253260663,MATH 10B,B04,431714,Habib; Yousaf,33,0,33,0
1708253260663,MATH 10B,B05,431715,Habib; Yousaf,60,0,60,0
1708253260663,MATH 10B,C01,431717,Bach; Quang Tran,57,0,60,3
1708253260663,MATH 10B,C02,431718,Bach; Quang Tran,18,0,34,16
1708253260663,MATH 10B,C03,431719,Bach; Quang Tran,34,0,34,0
1708253260663,MATH 10B,C04,431720,Bach; Quang Tran,33,0,34,1
1708253260663,MATH 10B,C05,431721,Bach; Quang Tran,32,0,34,2
1708253260663,MATH 10B,D01,431723,Staff,28,0,34,6
1708253260663,MATH 10B,D02,431724,Staff,34,0,34,0
1708253260663,MATH 10B,D03,431725,Staff,34,0,34,0
1708253260663,MATH 10B,D04,431726,Staff,34,0,34,0
1708253260663,MATH 10B,D05,431727,Staff,57,0,60,3
1708253261221,MATH 10C,A01,431741,Staff,94,0,96,2
1708253261221,MATH 10C,A02,431742,Staff,39,0,40,1
1708253261221,MATH 10C,B01,431744,Staff,95,0,96,1
1708253261221,MATH 10C,B02,431746,Staff,27,0,40,13
1708253261221,MATH 10C,C01,431748,Pardo Guerra; Sebastian,30,0,40,10
1708253261221,MATH 10C,C02,431885,Pardo Guerra; Sebastian,40,0,40,0
1708253261221,MATH 10C,C03,431895,Pardo Guerra; Sebastian,32,0,33,1
1708253261221,MATH 10C,C04,431896,Pardo Guerra; Sebastian,32,0,32,0
1708253261768,MATH 11,A01,431933,Rava; Denise,82,0,100,18
1708253261768,MATH 11,A02,431960,Rava; Denise,66,0,70,4
1708253261768,MATH 11,A03,431971,Rava; Denise,39,0,40,1
1708253261768,MATH 11,B01,432053,Staff,99,0,100,1
1708253261768,MATH 11,B02,432064,Staff,37,0,45,8
1708253261768,MATH 11,B03,432073,Staff,44,0,45,1
1708253262315,MATH 18,A01,432082,Mackall; Eoin Travis,65,0,70,5
1708253262315,MATH 18,A02,432086,Mackall; Eoin Travis,68,0,70,2
1708253262315,MATH 18,B01,432089,Suk; Andrew Hoon,39,0,40,1
1708253262315,MATH 18,B02,432090,Suk; Andrew Hoon,35,0,40,5
1708253262315,MATH 18,B03,432091,Suk; Andrew Hoon,33,0,40,7
1708253262315,MATH 18,B04,432092,Suk; Andrew Hoon,30,0,40,10
1708253262315,MATH 18,B05,432093,Suk; Andrew Hoon,34,0,35,1
1708253262315,MATH 18,B06,432094,Suk; Andrew Hoon,33,0,35,2
1708253262315,MATH 18,B07,432095,Suk; Andrew Hoon,98,0,100,2
1708253262315,MATH 18,B08,432096,Suk; Andrew Hoon,100,0,100,0
1708253262315,MATH 18,B09,432097,Suk; Andrew Hoon,98,0,100,2
1708253262315,MATH 18,B10,432098,Suk; Andrew Hoon,69,0,70,1
1708253262841,MATH 20A,A01,432101,Briones; Jor-el Thomas Caparas,30,0,40,10
1708253262841,MATH 20A,A02,432102,Briones; Jor-el Thomas Caparas,98,0,100,2
1708253262841,MATH 20A,B01,432104,Briones; Jor-el Thomas Caparas,99,0,100,1
1708253262841,MATH 20A,B02,432105,Briones; Jor-el Thomas Caparas,40,0,40,0
1708253263368,MATH 20B,A01,432107,Quarfoot; David James,33,0,35,2
1708253263368,MATH 20B,A02,432108,Quarfoot; David James,18,0,35,17
1708253263368,MATH 20B,A03,432109,Quarfoot; David James,32,0,35,3
1708253263368,MATH 20B,A04,432110,Quarfoot; David James,34,0,35,1
1708253263368,MATH 20B,A05,432331,Quarfoot; David James,26,0,32,6
1708253263368,MATH 20B,A06,432411,Quarfoot; David James,31,0,32,1
1708253263368,MATH 20B,B01,432413,Mackall; Eoin Travis,62,0,65,3
1708253263368,MATH 20B,B02,432443,Mackall; Eoin Travis,65,0,65,0
1708253263368,MATH 20B,B03,432444,Mackall; Eoin Travis,60,0,60,0
1708253263368,MATH 20B,B04,432471,Mackall; Eoin Travis,60,0,60,0
1708253263918,MATH 20C,A01,432473,Ohm; Ko Woon,26,0,38,12
1708253263918,MATH 20C,A02,432474,Ohm; Ko Woon,36,0,38,2
1708253263918,MATH 20C,A03,432475,Ohm; Ko Woon,34,0,37,3
1708253263918,MATH 20C,A04,432546,Ohm; Ko Woon,36,0,37,1
1708253263918,MATH 20C,A05,432550,Ohm; Ko Woon,88,0,90,2
1708253263918,MATH 20C,B01,432568,Ohm; Ko Woon,43,0,45,2
1708253263918,MATH 20C,B02,432594,Ohm; Ko Woon,40,0,45,5
1708253263918,MATH 20C,B03,432609,Ohm; Ko Woon,85,0,90,5
1708253263918,MATH 20C,C01,432613,Cheng; Hsiao-Bing,67,0,70,3
1708253263918,MATH 20C,C02,432614,Cheng; Hsiao-Bing,68,0,70,2
1708253263918,MATH 20C,C03,432615,Cheng; Hsiao-Bing,70,0,70,0
1708253263918,MATH 20C,D01,432617,Cheng; Hsiao-Bing,69,0,70,1
1708253263918,MATH 20C,D02,432618,Cheng; Hsiao-Bing,68,0,70,2
1708253263918,MATH 20C,D03,432619,Cheng; Hsiao-Bing,70,0,70,0
1708253264461,MATH 20D,A01,432622,Hammock; Frances H,58,0,60,2
1708253264461,MATH 20D,A02,432623,Hammock; Frances H,58,0,60,2
1708253264461,MATH 20D,A03,432658,Hammock; Frances H,35,0,35,0
1708253264461,MATH 20D,A04,432660,Hammock; Frances H,35,0,35,0
1708253264461,MATH 20D,B01,432702,Hammock; Frances H,66,0,70,4
1708253264461,MATH 20D,B02,432703,Hammock; Frances H,70,0,70,0
1708253264461,MATH 20D,B03,432766,Hammock; Frances H,30,0,30,0
1708253264461,MATH 20D,B04,432782,Hammock; Frances H,20,0,30,10
1708253264461,MATH 20D,C01,432811,Sheng; Hongyi,60,0,60,0
1708253264461,MATH 20D,C02,432931,Sheng; Hongyi,60,0,60,0
1708253264461,MATH 20D,C03,432945,Sheng; Hongyi,28,0,30,2
1708253264461,MATH 20D,C04,432949,Sheng; Hongyi,30,0,30,0
1708253265043,MATH 20E,A01,433007,Eggers; John Dietrich,70,0,80,10
1708253265043,MATH 20E,A02,433070,Eggers; John Dietrich,77,0,80,3
1708253265043,MATH 20E,A03,433079,Eggers; John Dietrich,32,0,35,3
1708253265043,MATH 20E,B01,433092,Staff,86,0,90,4
1708253265043,MATH 20E,B02,433093,Staff,90,0,90,0
1708253265043,MATH 20E,C01,433237,Bach; Quang Tran,52,0,60,8
1708253265043,MATH 20E,C02,433238,Bach; Quang Tran,69,0,70,1
1708253265043,MATH 20E,C03,433239,Bach; Quang Tran,70,0,70,0
1708253265572,MATH 31CH,A01,433241,Rabin; Jeffrey Mark,35,0,35,0
1708253266099,MATH 95,A00,433242,Stevens; Laura Jeanne,30,0,30,0
1708253266630,MATH 100C,A01,433244,Pollack; Aaron,31,0,35,4
1708253266630,MATH 100C,A02,433245,Pollack; Aaron,35,0,35,0
1708253267158,MATH 102,A01,433298,Ophir; Amit,29,0,30,1
1708253267158,MATH 102,A02,433369,Ophir; Amit,30,0,30,0
1708253267158,MATH 102,A03,433373,Ophir; Amit,30,0,30,0
1708253267158,MATH 102,A04,433374,Ophir; Amit,29,0,30,1
1708253267158,MATH 102,B01,433572,Zhang; Ming,28,0,30,2
1708253267158,MATH 102,B02,433732,Zhang; Ming,30,0,30,0
1708253267158,MATH 102,B03,433733,Zhang; Ming,30,0,30,0
1708253267158,MATH 102,B04,433734,Zhang; Ming,29,0,30,1
1708253267685,MATH 103B,A01,433793,Lu; Yunze,23,0,30,7
1708253267685,MATH 103B,A02,433795,Lu; Yunze,30,0,30,0
1708253267685,MATH 103B,A03,433830,Lu; Yunze,28,0,30,2
1708253267685,MATH 103B,B01,433845,Lahiri; Aranya,24,0,30,6
1708253267685,MATH 103B,B02,433846,Lahiri; Aranya,28,0,30,2
1708253267685,MATH 103B,B03,433847,Lahiri; Aranya,27,0,30,3
1708253268222,MATH 109,A01,433849,Aycock; Jon Merrill,6,0,10,4
1708253268222,MATH 109,A02,433850,Aycock; Jon Merrill,9,0,10,1
1708253268222,MATH 109,B01,433852,Klevdal; Christian Sleek,10,0,10,0
1708253268222,MATH 109,B02,433859,Klevdal; Christian Sleek,10,0,10,0
1708253268222,MATH 109,C01,433861,Treuer; John N,5,0,10,5
1708253268222,MATH 109,C02,433862,Treuer; John N,10,0,10,0
1708253268222,MATH 109,D01,433864,Treuer; John N,8,0,10,2
1708253268222,MATH 109,D02,433865,Treuer; John N,8,0,10,2
1708253268222,MATH 109,E01,433868,Sheng; Hongyi,10,0,10,0
1708253268222,MATH 109,E02,433869,Sheng; Hongyi,19,0,20,1
1708253268748,MATH 110,A01,433871,Pillai; Mohandas K,24,0,35,11
1708253268748,MATH 110,A02,433872,Pillai; Mohandas K,33,0,35,2
1708253269274,MATH 112B,A01,480683,Komarova; Natalia,27,0,27,0
1708253269802,MATH 120B,A01,433885,Xiao; Ming,32,0,35,3
1708253269802,MATH 120B,A02,433886,Xiao; Ming,34,0,35,1
1708253270326,MATH 121B,A01,433888,Stevens; Laura Jeanne,29,0,30,1
1708253270852,MATH 140B,A01,433890,Seward; Brandon M.,31,0,35,4
1708253270852,MATH 140B,A02,433891,Seward; Brandon M.,35,0,35,0
1708253271394,MATH 140C,A01,433895,Spolaor; Luca,32,0,35,3
1708253271394,MATH 140C,A02,433896,Spolaor; Luca,35,0,35,0
1708253271922,MATH 142B,A01,433966,Eggers; John Dietrich,25,0,35,10
1708253271922,MATH 142B,A02,434063,Eggers; John Dietrich,32,0,35,3
1708253271922,MATH 142B,B01,434071,Sanchez; Anthony,32,0,35,3
1708253271922,MATH 142B,B02,434083,Sanchez; Anthony,34,0,35,1
1708253271922,MATH 142B,C01,434094,Kunnawalkam Elayavalli; Sr,31,0,35,4
1708253271922,MATH 142B,C02,434095,Kunnawalkam Elayavalli; Sr,34,0,35,1
1708253272448,MATH 144,A01,434097,Cloninger; Alexander,30,0,30,0
1708253272975,MATH 150B,A01,434104,Parise; Davide,33,0,35,2
1708253273499,MATH 152,A01,434107,Grier; Daniel T,20,0,40,20
1708253274030,MATH 154,A01,434109,Wesley; William J,31,0,35,4
1708253274030,MATH 154,A02,434119,Wesley; William J,35,0,35,0
1708253274030,MATH 154,A03,434120,Wesley; William J,35,0,35,0
1708253274030,MATH 154,A04,434121,Wesley; William J,34,0,35,1
1708253274030,MATH 154,B01,434126,Aliabadi Sr.; Mohsen,26,0,35,9
1708253274030,MATH 154,B02,434127,Aliabadi Sr.; Mohsen,34,0,35,1
1708253274030,MATH 154,B03,434138,Aliabadi Sr.; Mohsen,35,0,35,0
1708253274030,MATH 154,B04,434139,Aliabadi Sr.; Mohsen,35,0,35,0
1708253274556,MATH 163,A01,434144,Bowers; Adam R.,0,0,5,5
1708253275089,MATH 170A,A01,434148,Nag; Panchali,36,0,36,0
1708253275089,MATH 170A,A02,434149,Nag; Panchali,36,0,36,0
1708253275089,MATH 170A,A03,434150,Nag; Panchali,36,0,37,1
1708253275089,MATH 170A,A04,434151,Nag; Panchali,36,0,36,0
1708253275614,MATH 170B,A01,434155,Huang; Lei,31,0,35,4
1708253275614,MATH 170B,A02,434160,Huang; Lei,35,0,35,0
1708253275614,MATH 170B,A03,434161,Huang; Lei,35,0,35,0
1708253275614,MATH 170B,A04,434162,Huang; Lei,35,0,35,0
1708253276139,MATH 170C,A01,434176,Leok; Melvin,30,0,35,5
1708253276139,MATH 170C,A02,434300,Leok; Melvin,34,0,35,1
1708253276669,MATH 171B,A01,434576,Nie; Jiawang,24,0,35,11
1708253276669,MATH 171B,A02,434583,Nie; Jiawang,35,0,35,0
1708253276669,MATH 171B,A03,434584,Nie; Jiawang,35,0,35,0
1708253276669,MATH 171B,A04,434609,Nie; Jiawang,35,0,35,0
1708253277195,MATH 180A,A01,434638,Gartland; Christopher John,29,0,30,1
1708253277195,MATH 180A,A02,434821,Gartland; Christopher John,28,0,30,2
1708253277195,MATH 180A,A03,434833,Gartland; Christopher John,24,0,30,6
1708253277195,MATH 180A,A04,434839,Gartland; Christopher John,30,0,30,0
1708253277195,MATH 180A,A05,434843,Gartland; Christopher John,30,0,30,0
1708253277195,MATH 180A,A06,434895,Gartland; Christopher John,30,0,30,0
1708253277721,MATH 180B,A01,435085,Gartland; Christopher John,30,0,35,5
1708253277721,MATH 180B,A02,435086,Gartland; Christopher John,35,0,35,0
1708253277721,MATH 180B,A03,435087,Gartland; Christopher John,34,0,35,1
1708253277721,MATH 180B,A04,435088,Gartland; Christopher John,35,0,35,0
1708253278251,MATH 180C,A01,435090,Carfagnini; Marco,29,0,35,6
1708253278251,MATH 180C,A02,435091,Carfagnini; Marco,35,0,35,0
1708253278251,MATH 180C,A03,435092,Carfagnini; Marco,32,0,35,3
1708253278251,MATH 180C,A04,435113,Carfagnini; Marco,35,0,35,0
1708253278779,MATH 181A,A01,435279,Zhang; Danna,30,0,35,5
1708253278779,MATH 181A,A02,435300,Zhang; Danna,35,0,35,0
1708253278779,MATH 181A,A03,435301,Zhang; Danna,21,0,35,14
1708253278779,MATH 181A,A04,435302,Zhang; Danna,31,0,35,4
1708253279303,MATH 181B,A01,435315,Rava; Denise,33,0,35,2
1708253279303,MATH 181B,A02,435316,Rava; Denise,32,0,35,3
1708253279303,MATH 181B,A03,435317,Rava; Denise,33,0,35,2
1708253279303,MATH 181B,A04,435318,Rava; Denise,35,0,35,0
1708253279829,MATH 183,A01,435320,Quarfoot; David James,26,0,35,9
1708253279829,MATH 183,A02,435321,Quarfoot; David James,35,0,35,0
1708253279829,MATH 183,A03,435322,Quarfoot; David James,32,0,35,3
1708253279829,MATH 183,A04,435323,Quarfoot; David James,34,0,35,1
1708253279829,MATH 183,A05,435327,Quarfoot; David James,34,0,35,1
1708253279829,MATH 183,A06,435329,Quarfoot; David James,33,0,35,2
1708253280354,MATH 184,A01,435337,Verstraete; Jacques Allan,32,0,35,3
1708253280354,MATH 184,A02,435338,Verstraete; Jacques Allan,35,0,35,0
1708253280354,MATH 184,A03,435339,Verstraete; Jacques Allan,34,0,35,1
1708253280354,MATH 184,A04,435347,Verstraete; Jacques Allan,30,0,35,5
1708253280884,MATH 185,A01,435432,Arias-Castro; Ery,15,0,30,15
1708253280884,MATH 185,A02,435436,Arias-Castro; Ery,30,0,30,0
1708253280884,MATH 185,A03,435437,Arias-Castro; Ery,30,0,30,0
1708253280884,MATH 185,A04,435438,Arias-Castro; Ery,30,0,30,0
1708253281414,MATH 187A,A01,435443,Agrawal; Shishir,15,0,30,15
1708253281414,MATH 187A,A02,435444,Agrawal; Shishir,30,0,30,0
1708253281414,MATH 187A,A03,435503,Agrawal; Shishir,28,0,30,2
1708253281414,MATH 187A,A04,435507,Agrawal; Shishir,30,0,30,0
1708253281414,MATH 187A,A05,435554,Agrawal; Shishir,22,0,30,8
1708253281414,MATH 187A,A06,435558,Agrawal; Shishir,28,0,30,2
1708253281944,MATH 187B,A01,435570,Bucur; Alina Ioana,24,0,35,11
1708253281944,MATH 187B,A02,435571,Bucur; Alina Ioana,35,0,35,0
1708253282473,MATH 188,A01,435573,Kunnawalkam Elayavalli; Sr,35,0,35,0
1708253283005,MATH 189,A01,435577,Vishwanath; Siddharth,0,0,10,10
1708253283005,MATH 189,A02,435594,Vishwanath; Siddharth,0,0,10,10
1708253283005,MATH 189,A03,435595,Vishwanath; Siddharth,0,0,10,10
1708253283005,MATH 189,A04,435596,Vishwanath; Siddharth,0,0,10,10
1708253283005,MATH 189,A05,480706,Vishwanath; Siddharth,2,0,10,8
1708253283005,MATH 189,A06,481362,Vishwanath; Siddharth,6,0,10,4
1708253283531,MATH 200C,A00,430388,Bucur; Alina Ioana,15,0,15,0
1708253284057,MATH 202C,A00,430389,Rhoades; Brendon Patrick,15,0,15,0
1708253284582,MATH 203C,A00,430390,Izadi; Elham,15,0,15,0
1708253285110,MATH 204C,A00,430391,Sorensen; Claus M,15,0,15,0
1708253285636,MATH 208,A00,430392,Izadi; Elham,8,0,10,2
1708253286161,MATH 209,A00,430393,Pollack; Aaron,10,0,10,0
1708253286690,MATH 211A,A00,430394,Salehi Golsefidy; Alireza,10,0,10,0
1708253287216,MATH 211B,A00,430395,Seward; Brandon M.,10,0,10,0
1708253287741,MATH 212B,A01,480692,Komarova; Natalia,5,0,5,0
1708253288266,MATH 216C,A00,430429,Saab; Rayan,13,0,15,2
1708253288796,MATH 217,A00,430430,Li; Bo,13,0,15,2
1708253289320,MATH 218,A00,430431,Li; Bo,8,0,10,2
1708253289845,MATH 220C,A00,430432,Xiao; Ming,15,0,15,0
1708253290372,MATH 240C,A00,430433,Ebenfelt; Peter F,14,0,15,1
1708253290899,MATH 241B,A00,430434,Ioana; Adrian,14,0,15,1
1708253291426,MATH 243,A00,430435,Kunnawalkam Elayavalli; Sr,9,0,10,1
1708253291955,MATH 248,A00,430436,Bejenaru; Ioan,9,0,10,1
1708253292483,MATH 251C,A00,430437,Wenzl; Hans G,15,0,15,0
1708253293012,MATH 258,A00,430438,Spolaor; Luca,10,0,10,0
1708253293541,MATH 261C,A00,430439,Manners; Frederick,14,0,15,1
1708253294069,MATH 262A,A00,430440,Warnke; Lutz Peter,14,0,15,1
1708253294597,MATH 268,A00,430441,Buss; Samuel R,10,0,10,0
1708253295126,MATH 269,A00,430442,Rhoades; Brendon Patrick & Warnke; Lutz Peter,10,0,10,0
1708253295651,MATH 270C,A00,430445,Cheng; Li-Tien,15,0,15,0
1708253296177,MATH 273B,A00,430452,Zhu; Yuhua,15,0,15,0
1708253296706,MATH 276,A00,430458,Mc Culloch; Andrew Douglas & Amaro; Rommie E,0,0,0,0
1708253297231,MATH 277A,A00,430464,Dumitriu; Ioana,14,0,15,1
1708253297759,MATH 278A,A00,430470,Cheng; Li-Tien,9,0,10,1
1708253298283,MATH 278B,A00,430471,Cloninger; Alexander,10,0,10,0
1708253298808,MATH 278C,A00,430472,Nie; Jiawang,9,0,10,1
1708253299334,MATH 280C,A00,430485,Schweinsberg; Jason,13,0,15,2
1708253299863,MATH 281C,A00,430496,Arias-Castro; Ery,8,0,15,7
1708253300390,MATH 284,A00,430503,Xu; Ronghui,11,0,15,4
1708253300916,MATH 287C,A00,430520,Zhang; Danna,14,0,15,1
1708253301444,MATH 288,A00,430527,Carfagnini; Marco,9,0,10,1
1708253301970,MATH 289A,A00,430541,Novak; Jonathan I,14,0,15,1
1708253302500,MATH 290C,A00,430548,Roberts; Justin Deritter,13,0,15,2
1708253303029,MATH 292,A00,430660,Lu; Yunze,10,0,10,0
1708253303554,MATH 294,A00,430678,Fitzsimmons; Patrick J,11,0,15,4
1708253304080,MATH 295,A00,430692,Bejenaru; Ioan,15,0,15,0
1708253304609,MATH 297,001,430721,Gamst; Anthony Collins,0,0,0,0
1708253305139,MATS 200,A00,414457,Graeve; Olivia A,9995,0,9999,4
1708253305668,MATS 201C,A00,414465,Arzt; Eduard,38,0,50,12
1708253306194,MATS 236,A00,414466,Staff,17,0,20,3
1708253306720,MATS 252,A00,414467,Evdokimenko; Ekaterina,42,0,45,3
1708253307244,MATS 261B,A00,414468,Qiao; Yu,17,0,25,8
1708253307773,MATS 295,A00,414469,Graeve; Olivia A,9999,0,9999,0
1708253307773,MATS 295,B00,478858,Kummel; Andrew C,9999,0,9999,0
1708253308299,MCWP 40,001,414476,Montejo; Carolina,19,0,20,1
1708253308299,MCWP 40,004,414480,Wastal; Carrie King,13,0,15,2
1708253308299,MCWP 40,005,414481,Wastal; Carrie King,10,0,15,5
1708253308299,MCWP 40,006,414482,Wastal; Carrie King,12,0,15,3
1708253308299,MCWP 40,007,414483,Wastal; Carrie King,13,0,15,2
1708253308299,MCWP 40,008,414484,Wastal; Carrie King,15,0,15,0
1708253308299,MCWP 40,009,414487,Wastal; Carrie King,12,0,15,3
1708253308299,MCWP 40,014,414505,Staff,20,0,20,0
1708253308299,MCWP 40,015,494362,Wastal; Carrie King,14,0,15,1
1708253308835,MCWP 50,002,414534,Bartulis; Jason Michael,20,0,20,0
1708253308835,MCWP 50,003,414536,Bartulis; Jason Michael,20,0,20,0
1708253308835,MCWP 50,004,414538,Krone; Jarret,16,0,20,4
1708253308835,MCWP 50,005,414539,Krone; Jarret,19,0,20,1
1708253308835,MCWP 50,006,414540,Smith; Haydee Marie,16,0,20,4
1708253308835,MCWP 50,007,414544,Compas; Sean Matthew,14,0,20,6
1708253308835,MCWP 50,008,414549,Redela; Pamela Morgan,20,0,20,0
1708253308835,MCWP 50,011,414557,Carter; Andrea L,16,0,20,4
1708253308835,MCWP 50,012,414592,Silva; Kelly B,20,0,20,0
1708253308835,MCWP 50,013,414593,Silva; Kelly B,19,0,20,1
1708253308835,MCWP 50,014,414594,Carter; Andrea L,20,0,20,0
1708253308835,MCWP 50,016,414596,Morshed; Michael James,14,0,20,6
1708253308835,MCWP 50,017,414598,Morshed; Michael James,17,0,20,3
1708253308835,MCWP 50,019,414601,Redela; Pamela Morgan,17,0,20,3
1708253308835,MCWP 50,020,414606,Carter; Jennifer A,20,0,20,0
1708253308835,MCWP 50,021,414607,Carter; Jennifer A,19,0,20,1
1708253308835,MCWP 50,022,414649,Compas; Sean Matthew,11,0,20,9
1708253308835,MCWP 50,023,414650,Smith; Haydee Marie,20,0,20,0
1708253308835,MCWP 50,024,414651,Nies; Laurie Elizabeth,19,0,20,1
1708253308835,MCWP 50,025,414655,Nies; Laurie Elizabeth,18,0,20,2
1708253308835,MCWP 50,026,414656,Pham; Vincent Minhduc,19,0,20,1
1708253308835,MCWP 50,027,414657,Pham; Vincent Minhduc,20,0,20,0
1708253308835,MCWP 50,028,414668,Morshed; Michael James,16,0,20,4
1708253308835,MCWP 50,029,414669,Morshed; Michael James,19,0,20,1
1708253309361,MCWP 50R,A00,486838,Miller; Elizabeth Deen,19,0,20,1
1708253309361,MCWP 50R,B00,486843,Miller; Elizabeth Deen,16,0,20,4
1708253309361,MCWP 50R,C00,486844,Miller; Elizabeth Deen,19,0,20,1
1708253309888,MCWP 125,A00,414670,Wilson; Marion E.,20,0,20,0
1708253309888,MCWP 125,B00,414674,Guillen; Melinda,20,0,20,0
1708253309888,MCWP 125,C00,414678,Guillen; Melinda,20,0,20,0
1708253309888,MCWP 125,D00,414682,Guillen; Melinda,20,0,20,0
1708253310413,MED 231,A00,476440,Hurst; Samantha,7,0,7,0
1708253310945,MED 246,A00,492785,Gordts; Philip & Varki; Ajit P & Lewis; Amanda Lark & Godula; Kamil & Gagneux; Pascal & Esko; Jeffrey D. & Bode; Lars,10,0,10,0
1708253311475,MED 262,A00,492942,Koola; Jejo David,28,0,30,2
1708253312001,MED 267,A01,492789,Hogarth; Michael Andrew,25,0,30,5
1708253312575,MED 275,A00,464684,Liu; George Yenhsi,10,0,10,0
1708253313103,MED 276,A00,492786,Sitapati; Amy,23,0,25,2
1708253313633,MED 278,A00,492787,Carter; Hannah Kathryn & Mesirov; Jill P. & Curtius; Kathleen Mary,20,0,20,0
1708253314159,MED 296,001,464685,Chi; Neil C.,48,0,50,2
1708253314159,MED 296,002,464686,Hong; Kimberly N,49,0,50,1
1708253314159,MED 296,003,464687,Staff,50,0,50,0
1708253314686,MGT 3,A00,442429,Wagner; Timothy Ryan,95,0,98,3
1708253315212,MGT 4,A01,442443,Levkoff; Steven B.,0,0,5,5
1708253315212,MGT 4,A02,442444,Levkoff; Steven B.,4,0,5,1
1708253315739,MGT 5,A00,442446,Molloie Jr.; William H,184,0,196,12
1708253316268,MGT 12,A00,442447,Lindenberger; Wade Douglas,83,0,100,17
1708253316268,MGT 12,B00,442448,Lindenberger; Wade Douglas,71,0,100,29
1708253316268,MGT 12,C00,442449,Pecore; Joseph P.,88,0,100,12
1708253316796,MGT 16,A00,442452,Buchanan; Harold G,97,0,100,3
1708253316796,MGT 16,B00,442459,Buchanan; Harold G,92,0,100,8
1708253316796,MGT 16,C00,442461,Campbell; Robert Harold,113,0,120,7
1708253316796,MGT 16,D00,442475,Campbell; Robert Harold,118,0,120,2
1708253317323,MGT 18,A00,442477,McKay; Michael J,98,0,98,0
1708253317323,MGT 18,B00,442491,McKay; Michael J,96,0,98,2
1708253317323,MGT 18,C00,442493,McKay; Michael J,98,0,98,0
1708253317323,MGT 18,D00,442503,Chamberlain; Travis Dean,98,0,98,0
1708253317853,MGT 45,A00,442508,Pecore; Joseph P.,146,0,150,4
1708253317853,MGT 45,B00,442510,Pecore; Joseph P.,142,0,150,8
1708253318437,MGT 71,A00,442524,Lee; Hyun Seok,77,0,98,21
1708253318967,MGT 71R,A00,442526,Phiroz; Zal Navroze,77,0,98,21
1708253319493,MGT 100,A00,442541,Wilbur; Kenneth C,82,0,98,16
1708253319493,MGT 100,B00,442542,Wilbur; Kenneth C,89,0,98,9
1708253320037,MGT 103,A00,442543,Eberhard; Craig A,98,0,98,0
1708253320037,MGT 103,B00,442544,Eberhard; Craig A,95,0,98,3
1708253320037,MGT 103,C00,442545,Ehrich; Kristine R,90,0,98,8
1708253320037,MGT 103,D00,442547,Ehrich; Kristine R,96,0,98,2
1708253320037,MGT 103,E00,442548,Ehrich; Kristine R,97,0,98,1
1708253320037,MGT 103,F00,442549,Demill; Burritt,92,0,98,6
1708253320037,MGT 103,G00,442550,Bates; Kenneth Walter,97,0,98,1
1708253320564,MGT 105,A00,442558,Bates; Kenneth Walter,86,0,98,12
1708253321091,MGT 106,A00,442560,Eberhard; Craig A,95,0,98,3
1708253321617,MGT 109,A00,442574,Campbell; Colin Leslie,90,0,98,8
1708253322146,MGT 112,A00,442576,Somasundaram; Tyagarajan,96,0,98,2
1708253322146,MGT 112,B00,442590,Somasundaram; Tyagarajan,94,0,98,4
1708253322146,MGT 112,C00,442592,Zimmermann; Carsten,87,0,98,11
1708253322673,MGT 119,A00,442602,Staff,97,0,98,1
1708253322673,MGT 119,B00,442603,Anderson; Jon Marcus,96,0,98,2
1708253323200,MGT 121B,A00,442606,Klaas; Jeffrey David,94,0,98,4
1708253323726,MGT 128R,A00,442607,Krishnan; Viswanathan,84,0,98,14
1708253324253,MGT 131A,A00,442608,Houskeeper; Robert,148,0,150,2
1708253324796,MGT 131B,A00,442609,Houskeeper; Robert,100,0,100,0
1708253325325,MGT 132,A00,442610,Blakley; Bruce,97,0,98,1
1708253325856,MGT 137,A00,442611,Lindenberger; Wade Douglas,86,0,98,12
1708253326383,MGT 147,A00,442612,Anderson; John Charles,32,0,40,8
1708253326912,MGT 151R,A00,442613,Phiroz; Zal Navroze,92,0,98,6
1708253327441,MGT 153,A00,442650,Perols; Johan Lars,55,0,80,25
1708253327972,MGT 162,A00,442652,Demill; Burritt,81,0,98,17
1708253327972,MGT 162,B00,442654,Demill; Burritt,88,0,98,10
1708253327972,MGT 162,C00,442776,Staff,95,0,98,3
1708253327972,MGT 162,D00,442778,Staff,96,0,98,2
1708253328503,MGT 164,A00,442780,McKay; Mary A,97,0,98,1
1708253328503,MGT 164,B00,442849,McKay; Mary A,96,0,98,2
1708253328503,MGT 164,C00,442917,McKay; Mary A,97,0,98,1
1708253328503,MGT 164,D00,442949,Meyer; Alison Bloomfield,90,0,98,8
1708253329029,MGT 166,A00,443017,Moran; Cathleen L.,95,0,98,3
1708253329029,MGT 166,B00,443045,Moran; Cathleen L.,97,0,98,1
1708253329029,MGT 166,C00,443046,Moran; Cathleen L.,98,0,98,0
1708253329555,MGT 167,A00,443047,Klaas; Jeffrey David,93,0,98,5
1708253330084,MGT 171R,A00,443048,Phiroz; Zal Navroze,86,0,98,12
1708253330609,MGT 172,A00,443049,Hedges; Kathleen & Royal; Rebecca,116,0,120,4
1708253330609,MGT 172,B00,443050,Hedges; Kathleen,95,0,98,3
1708253330609,MGT 172,C00,443051,Zimmermann; Carsten,96,0,98,2
1708253331138,MGT 173,A00,443052,Hayes; Sherry Lorine,92,0,100,8
1708253331683,MGT 175,A00,443053,Gopal; Christopher S.,98,0,98,0
1708253332208,MGT 180,A00,443055,Bliss; Barbara Ann,139,0,150,11
1708253332208,MGT 180,B00,443069,Bliss; Barbara Ann,145,0,150,5
1708253332737,MGT 181,A00,443120,Buchanan; Harold G,147,0,150,3
1708253333266,MGT 183,A00,443121,Banerjee; Snehal,88,0,98,10
1708253333795,MGT 185,A00,443122,Dunn; Louis Jean,90,0,98,8
1708253334324,MGT 187,A00,443133,Dunn; Louis Jean,95,0,100,5
1708253334854,MGT 189,A00,443134,Avenancio-Leon; Carlos,98,0,98,0
1708253335382,MGT 227,A00,479242,Serra Garcia; Marta,19,0,20,1
1708253335908,MGT 259,A00,443135,Oveis; Christopher S,19,0,20,1
1708253336450,MGT 296,001,481416,Gneezy; Ayelet,3,0,3,0
1708253336450,MGT 296,002,481420,Amir; On,3,0,3,0
1708253336450,MGT 296,003,481466,Amir; On & Karmarkar; Uma R,3,0,3,0
1708253336450,MGT 296,004,481468,Liu; Jun,3,0,3,0
1708253336450,MGT 296,005,481469,Misra; Kanishka,3,0,3,0
1708253336450,MGT 296,006,481470,Erat; Sanjiv,3,0,3,0
1708253336450,MGT 296,007,481473,Timmermann; Allan,3,0,3,0
1708253336450,MGT 296,008,481474,Smith; Pamela Karen,3,0,3,0
1708253336450,MGT 296,009,481477,Zhang; Zhe,3,0,3,0
1708253336450,MGT 296,010,481478,Oveis; Christopher S,3,0,3,0
1708253336450,MGT 296,011,481479,Amir; On & Gneezy; Ayelet,3,0,3,0
1708253336450,MGT 296,012,481481,Wilbur; Kenneth C,3,0,3,0
1708253337080,MMW 13,A01,412918,Chang; Edmond Yi-Teh,15,0,16,1
1708253337080,MMW 13,A02,412928,Chang; Edmond Yi-Teh,16,0,16,0
1708253337080,MMW 13,A03,413017,Chang; Edmond Yi-Teh,16,0,16,0
1708253337080,MMW 13,A04,413018,Chang; Edmond Yi-Teh,16,0,16,0
1708253337080,MMW 13,A05,413019,Chang; Edmond Yi-Teh,15,0,16,1
1708253337080,MMW 13,A06,413020,Chang; Edmond Yi-Teh,16,0,16,0
1708253337080,MMW 13,A07,413021,Chang; Edmond Yi-Teh,15,0,16,1
1708253337080,MMW 13,A08,413023,Chang; Edmond Yi-Teh,16,0,16,0
1708253337080,MMW 13,A09,413024,Chang; Edmond Yi-Teh,16,0,16,0
1708253337080,MMW 13,A10,413025,Chang; Edmond Yi-Teh,16,0,16,0
1708253337080,MMW 13,A11,413026,Chang; Edmond Yi-Teh,16,0,16,0
1708253337080,MMW 13,A12,413027,Chang; Edmond Yi-Teh,16,0,16,0
1708253337080,MMW 13,A13,413028,Chang; Edmond Yi-Teh,0,0,0,0
1708253337080,MMW 13,A14,413029,Chang; Edmond Yi-Teh,0,0,0,0
1708253337080,MMW 13,A15,413030,Chang; Edmond Yi-Teh,14,0,16,2
1708253337080,MMW 13,A16,413031,Chang; Edmond Yi-Teh,15,0,16,1
1708253337080,MMW 13,A17,413032,Chang; Edmond Yi-Teh,16,0,16,0
1708253337080,MMW 13,A18,413034,Chang; Edmond Yi-Teh,14,0,16,2
1708253337080,MMW 13,A19,413035,Chang; Edmond Yi-Teh,16,0,16,0
1708253337080,MMW 13,A20,413036,Chang; Edmond Yi-Teh,16,0,16,0
1708253337080,MMW 13,A21,413037,Chang; Edmond Yi-Teh,0,0,0,0
1708253337080,MMW 13,A22,413038,Chang; Edmond Yi-Teh,0,0,0,0
1708253337080,MMW 13,B01,413290,Zhiri; Oumelbanine,15,0,16,1
1708253337080,MMW 13,B02,413291,Zhiri; Oumelbanine,15,0,16,1
1708253337080,MMW 13,B03,413308,Zhiri; Oumelbanine,14,0,16,2
1708253337080,MMW 13,B04,413322,Zhiri; Oumelbanine,14,0,16,2
1708253337080,MMW 13,B05,413343,Zhiri; Oumelbanine,12,0,16,4
1708253337080,MMW 13,B06,413344,Zhiri; Oumelbanine,14,0,16,2
1708253337080,MMW 13,B07,413524,Zhiri; Oumelbanine,16,0,16,0
1708253337080,MMW 13,B08,413584,Zhiri; Oumelbanine,16,0,16,0
1708253337080,MMW 13,B09,413588,Zhiri; Oumelbanine,15,0,16,1
1708253337080,MMW 13,B10,413590,Zhiri; Oumelbanine,16,0,16,0
1708253337080,MMW 13,B11,413779,Zhiri; Oumelbanine,12,0,16,4
1708253337080,MMW 13,B12,413780,Zhiri; Oumelbanine,9,0,16,7
1708253337080,MMW 13,B13,413781,Zhiri; Oumelbanine,0,0,0,0
1708253337080,MMW 13,B14,413782,Zhiri; Oumelbanine,0,0,0,0
1708253337080,MMW 13,B15,413808,Zhiri; Oumelbanine,16,0,16,0
1708253337080,MMW 13,B16,413815,Zhiri; Oumelbanine,15,0,16,1
1708253337080,MMW 13,B17,413816,Zhiri; Oumelbanine,15,0,16,1
1708253337080,MMW 13,B18,413817,Zhiri; Oumelbanine,12,0,16,4
1708253337080,MMW 13,B19,413822,Zhiri; Oumelbanine,16,0,16,0
1708253337080,MMW 13,B20,413823,Zhiri; Oumelbanine,14,0,16,2
1708253337080,MMW 13,B21,413825,Zhiri; Oumelbanine,0,0,0,0
1708253337080,MMW 13,B22,413826,Zhiri; Oumelbanine,0,0,0,0
1708253337080,MMW 13,B23,413827,Zhiri; Oumelbanine,16,0,16,0
1708253337080,MMW 13,B24,413834,Zhiri; Oumelbanine,15,0,16,1
1708253337080,MMW 13,C01,413859,Vitkus; Daniel J.,16,0,16,0
1708253337080,MMW 13,C02,413860,Vitkus; Daniel J.,16,0,16,0
1708253337080,MMW 13,C04,413868,Vitkus; Daniel J.,0,0,0,0
1708253337080,MMW 13,C05,413869,Vitkus; Daniel J.,16,0,16,0
1708253337080,MMW 13,C06,413871,Vitkus; Daniel J.,16,0,16,0
1708253337080,MMW 13,C07,413886,Vitkus; Daniel J.,16,0,16,0
1708253337080,MMW 13,C08,413908,Vitkus; Daniel J.,16,0,16,0
1708253337080,MMW 13,C09,413930,Vitkus; Daniel J.,16,0,16,0
1708253337080,MMW 13,C10,413952,Vitkus; Daniel J.,15,0,16,1
1708253337080,MMW 13,C11,413972,Vitkus; Daniel J.,16,0,16,0
1708253337080,MMW 13,C12,413991,Vitkus; Daniel J.,16,0,16,0
1708253337080,MMW 13,C13,414007,Vitkus; Daniel J.,0,0,0,0
1708253337080,MMW 13,C14,414017,Vitkus; Daniel J.,0,0,0,0
1708253337080,MMW 13,C15,414030,Vitkus; Daniel J.,16,0,16,0
1708253337080,MMW 13,C16,414032,Vitkus; Daniel J.,16,0,16,0
1708253337080,MMW 13,C17,414033,Vitkus; Daniel J.,15,0,16,1
1708253337080,MMW 13,C18,414034,Vitkus; Daniel J.,16,0,16,0
1708253337080,MMW 13,C19,414041,Vitkus; Daniel J.,16,0,16,0
1708253337080,MMW 13,C20,414056,Vitkus; Daniel J.,16,0,16,0
1708253337080,MMW 13,C21,414057,Vitkus; Daniel J.,15,0,16,1
1708253337080,MMW 13,C22,414059,Vitkus; Daniel J.,16,0,16,0
1708253337647,MMW 15,A01,414065,Chang; Edmond Yi-Teh,28,0,28,0
1708253337647,MMW 15,A02,414067,Chang; Edmond Yi-Teh,27,0,28,1
1708253337647,MMW 15,A03,414092,Chang; Edmond Yi-Teh,26,0,28,2
1708253337647,MMW 15,A04,414104,Chang; Edmond Yi-Teh,28,0,28,0
1708253337647,MMW 15,A05,414121,Chang; Edmond Yi-Teh,0,0,0,0
1708253337647,MMW 15,A06,414122,Chang; Edmond Yi-Teh,0,0,0,0
1708253337647,MMW 15,A07,414123,Chang; Edmond Yi-Teh,27,0,28,1
1708253337647,MMW 15,A08,414124,Chang; Edmond Yi-Teh,28,0,28,0
1708253337647,MMW 15,A09,414125,Chang; Edmond Yi-Teh,0,0,0,0
1708253337647,MMW 15,A10,414130,Chang; Edmond Yi-Teh,0,0,0,0
1708253337647,MMW 15,B01,414132,Radcliff; Pamela B.,27,0,28,1
1708253337647,MMW 15,B02,414134,Radcliff; Pamela B.,27,0,28,1
1708253337647,MMW 15,B03,414135,Radcliff; Pamela B.,26,0,28,2
1708253337647,MMW 15,B04,414136,Radcliff; Pamela B.,27,0,28,1
1708253337647,MMW 15,B05,414137,Radcliff; Pamela B.,28,0,28,0
1708253337647,MMW 15,B06,414138,Radcliff; Pamela B.,27,0,28,1
1708253337647,MMW 15,B07,414140,Radcliff; Pamela B.,26,0,28,2
1708253337647,MMW 15,B08,414141,Radcliff; Pamela B.,28,0,28,0
1708253337647,MMW 15,C01,414143,Prestholdt; Jeremy,0,0,0,0
1708253337647,MMW 15,C02,414144,Prestholdt; Jeremy,0,0,0,0
1708253337647,MMW 15,C03,414145,Prestholdt; Jeremy,24,0,28,4
1708253337647,MMW 15,C04,414147,Prestholdt; Jeremy,17,0,28,11
1708253337647,MMW 15,C05,414148,Prestholdt; Jeremy,28,0,28,0
1708253337647,MMW 15,C06,414149,Prestholdt; Jeremy,26,0,28,2
1708253337647,MMW 15,C07,414152,Prestholdt; Jeremy,25,0,28,3
1708253337647,MMW 15,C08,414153,Prestholdt; Jeremy,23,0,28,5
1708253338174,MSED 295,A00,477850,Rabin; Jeffrey Mark,5,0,5,0
1708253338174,MSED 295,B00,477852,Lo; Stanley M.,5,0,5,0
1708253338700,MSED 296C,A00,477853,Staff,14,0,15,1
1708253339227,MUS 1C,A01,416488,Ishov; Alexander Alexandrovich,24,0,25,1
1708253339227,MUS 1C,A02,416502,Ishov; Alexander Alexandrovich,25,0,25,0
1708253339227,MUS 1C,A03,416519,Ishov; Alexander Alexandrovich,25,0,25,0
1708253339227,MUS 1C,A04,416520,Ishov; Alexander Alexandrovich,25,0,25,0
1708253339227,MUS 1C,A05,416521,Ishov; Alexander Alexandrovich,25,0,25,0
1708253339753,MUS 2C,A01,416523,Richards; Stephanie F,30,0,30,0
1708253340277,MUS 2CK,A00,416524,Ohnishi; Takae,15,0,15,0
1708253340277,MUS 2CK,B00,416547,Ohnishi; Takae,15,0,15,0
1708253340807,MUS 2JK,A00,416548,Kenyatta; Kamau,15,0,15,0
1708253341336,MUS 4,A01,416562,Staff,25,0,25,0
1708253341336,MUS 4,A02,416634,Staff,24,0,25,1
1708253341336,MUS 4,A03,416644,Staff,25,0,25,0
1708253341336,MUS 4,A04,416659,Staff,24,0,25,1
1708253341336,MUS 4,A05,416667,Staff,25,0,25,0
1708253341336,MUS 4,A06,416757,Staff,25,0,25,0
1708253341336,MUS 4,A07,416830,Staff,25,0,25,0
1708253341336,MUS 4,A08,416953,Staff,23,0,25,2
1708253341336,MUS 4,A09,417005,Staff,25,0,25,0
1708253341336,MUS 4,A10,417007,Staff,24,0,25,1
1708253341864,MUS 7,A01,417048,Staff,23,0,24,1
1708253341864,MUS 7,A02,417102,Staff,23,0,24,1
1708253341864,MUS 7,A03,417103,Staff,23,0,24,1
1708253341864,MUS 7,A04,417114,Staff,22,0,24,2
1708253342398,MUS 8,A01,417119,Staff,14,0,20,6
1708253342398,MUS 8,A02,417163,Staff,16,0,20,4
1708253342398,MUS 8,A03,417164,Staff,16,0,20,4
1708253342398,MUS 8,A04,417165,Staff,17,0,20,3
1708253342398,MUS 8,A05,417194,Staff,18,0,20,2
1708253342398,MUS 8,A06,417198,Staff,20,0,20,0
1708253342925,MUS 11,A01,417201,Terrazas Perez; Wilfrido D,21,0,25,4
1708253342925,MUS 11,A02,417219,Terrazas Perez; Wilfrido D,23,0,25,2
1708253342925,MUS 11,A03,417220,Terrazas Perez; Wilfrido D,25,0,25,0
1708253342925,MUS 11,A04,417222,Terrazas Perez; Wilfrido D,25,0,25,0
1708253342925,MUS 11,A05,417223,Terrazas Perez; Wilfrido D,24,0,25,1
1708253342925,MUS 11,A06,417295,Terrazas Perez; Wilfrido D,23,0,25,2
1708253342925,MUS 11,A07,417297,Terrazas Perez; Wilfrido D,24,0,25,1
1708253342925,MUS 11,A08,417298,Terrazas Perez; Wilfrido D,25,0,25,0
1708253343452,MUS 12,A01,417300,Guy; Nancy,25,0,25,0
1708253343452,MUS 12,A02,417301,Guy; Nancy,25,0,25,0
1708253343452,MUS 12,A03,417302,Guy; Nancy,25,0,25,0
1708253343452,MUS 12,A04,417303,Guy; Nancy,25,0,25,0
1708253343996,MUS 13,A01,417305,Leslie Santana; Myrta,25,0,25,0
1708253343996,MUS 13,A02,417306,Leslie Santana; Myrta,25,0,25,0
1708253343996,MUS 13,A03,417307,Leslie Santana; Myrta,25,0,25,0
1708253343996,MUS 13,A04,417308,Leslie Santana; Myrta,25,0,25,0
1708253344538,MUS 15,A01,417327,Schaffer; Max Benjamin,18,0,20,2
1708253344538,MUS 15,A02,417331,Schaffer; Max Benjamin,19,0,20,1
1708253344538,MUS 15,A03,417358,Schaffer; Max Benjamin,19,0,20,1
1708253344538,MUS 15,A04,417359,Schaffer; Max Benjamin,17,0,20,3
1708253344538,MUS 15,A05,417360,Schaffer; Max Benjamin,20,0,20,0
1708253344538,MUS 15,A06,417370,Schaffer; Max Benjamin,20,0,20,0
1708253344538,MUS 15,A07,417371,Schaffer; Max Benjamin,17,0,20,3
1708253344538,MUS 15,A08,417372,Schaffer; Max Benjamin,18,0,20,2
1708253344538,MUS 15,A09,417378,Schaffer; Max Benjamin,19,0,20,1
1708253344538,MUS 15,A10,417379,Schaffer; Max Benjamin,19,0,20,1
1708253345069,MUS 17,A01,417381,Staff,22,0,25,3
1708253345069,MUS 17,A02,417406,Staff,24,0,25,1
1708253345069,MUS 17,A03,417420,Staff,24,0,25,1
1708253345069,MUS 17,A04,417594,Staff,24,0,25,1
1708253345069,MUS 17,A05,417595,Staff,25,0,25,0
1708253345069,MUS 17,A06,417605,Staff,21,0,25,4
1708253345069,MUS 17,A07,417606,Staff,25,0,25,0
1708253345069,MUS 17,A08,417627,Staff,25,0,25,0
1708253345069,MUS 17,A09,417628,Staff,21,0,25,4
1708253345069,MUS 17,A10,417629,Staff,24,0,25,1
1708253345069,MUS 17,A11,417630,Staff,25,0,25,0
1708253345069,MUS 17,A12,417631,Staff,24,0,25,1
1708253345069,MUS 17,A13,417632,Staff,25,0,25,0
1708253345069,MUS 17,A14,417633,Staff,25,0,25,0
1708253345601,MUS 32,001,418855,Dresser; Mark Stuart,10,0,10,0
1708253345601,MUS 32,002,418856,Kenyatta; Kamau,9,0,10,1
1708253345601,MUS 32,003,418864,Curtis; Charles Rector,10,0,10,0
1708253345601,MUS 32,004,418865,Carlstrom; Mitchell Kraig,9,0,10,1
1708253345601,MUS 32,005,418868,Terrazas Perez; Wilfrido D,10,0,10,0
1708253345601,MUS 32,006,418869,Ohnishi; Takae,10,0,10,0
1708253345601,MUS 32,007,418872,Burr; Anthony I,10,0,10,0
1708253345601,MUS 32,008,418873,Carlson; Erik Norman,10,0,10,0
1708253345601,MUS 32,009,418874,Blair; Kyle Adam,10,0,10,0
1708253345601,MUS 32,010,418875,Richards; Stephanie F,10,0,10,0
1708253346128,MUS 32V,A00,417634,Narucki; Susan M,10,0,10,0
1708253346128,MUS 32V,B00,417635,Staff,10,0,10,0
1708253346653,MUS 32VM,A00,417636,Staff,15,0,15,0
1708253347194,MUS 33C,A00,417637,Taylor; Alexander Lawther,20,0,20,0
1708253347721,MUS 43,A00,417647,Burr; Anthony I,83,0,90,7
1708253348248,MUS 95D,A00,417919,Staff,40,0,40,0
1708253348774,MUS 95E,A00,417933,Henson; Matthew Alexander,55,0,55,0
1708253349299,MUS 95G,A00,417935,Anderson; Kenneth,387,0,395,8
1708253349299,MUS 95G,B00,417937,Anderson; Kenneth,394,0,395,1
1708253349826,MUS 95JC,A00,417939,Kenyatta; Kamau,30,0,30,0
1708253350351,MUS 95L,A00,417940,Jones; Michael David,50,0,50,0
1708253350880,MUS 95W,A00,417946,Seshadri; Kartik,29,0,30,1
1708253350880,MUS 95W,B00,417948,Seshadri; Kartik,30,0,30,0
1708253351405,MUS 101C,A01,417951,Burr; Anthony I,33,0,35,2
1708253351930,MUS 103C,A00,417952,Davis; Anthony Curtis,14,0,15,1
1708253352457,MUS 103F,A00,417959,Obermueller; Karola,1,0,1,0
1708253352983,MUS 113,A00,418015,Narucki; Susan M,13,0,15,2
1708253353512,MUS 120C,A01,418032,Leslie Santana; Myrta,25,0,25,0
1708253354038,MUS 127,A00,418037,Richards; Stephanie F,92,0,100,8
1708253354568,MUS 130,A00,418047,Ohnishi; Takae,30,0,30,0
1708253355111,MUS 131,A00,418065,Roberts; Matana,30,0,30,0
1708253355669,MUS 132,001,418883,Dresser; Mark Stuart,10,0,10,0
1708253355669,MUS 132,002,418885,Kenyatta; Kamau,10,0,10,0
1708253355669,MUS 132,003,418886,Curtis; Charles Rector,10,0,10,0
1708253355669,MUS 132,004,418887,Carlstrom; Mitchell Kraig,10,0,10,0
1708253355669,MUS 132,005,418888,Jones; Michael David,10,0,10,0
1708253355669,MUS 132,006,418889,Terrazas Perez; Wilfrido D,10,0,10,0
1708253355669,MUS 132,007,418893,Ohnishi; Takae,10,0,10,0
1708253355669,MUS 132,008,418894,Burr; Anthony I,10,0,10,0
1708253355669,MUS 132,009,418896,Carlson; Erik Norman,10,0,10,0
1708253355669,MUS 132,010,418900,Blair; Kyle Adam,10,0,10,0
1708253355669,MUS 132,011,418932,Richards; Stephanie F,10,0,10,0
1708253355669,MUS 132,012,418933,Nourai; Keyarash,10,0,10,0
1708253356198,MUS 132R,A00,418067,Burr; Anthony I,5,0,5,0
1708253356198,MUS 132R,B00,418078,Jones; Michael David,5,0,5,0
1708253356724,MUS 132V,A00,418092,Narucki; Susan M,15,0,15,0
1708253356724,MUS 132V,B00,418096,Staff,15,0,15,0
1708253357249,MUS 134,A00,418098,Staff,40,0,40,0
1708253357778,MUS 137C,A00,418109,Kenyatta; Kamau,25,0,25,0
1708253358302,MUS 143,A00,418123,Burr; Anthony I,33,0,40,7
1708253358828,MUS 150,A00,418127,Davis; Anthony Curtis,28,0,30,2
1708253359356,MUS 151,A00,418129,Hankins; Sarah E.,20,0,30,10
1708253359883,MUS 160B,A00,418172,Staff,11,0,15,4
1708253359883,MUS 160B,B00,418175,Dubnov; Shlomo,14,0,15,1
1708253360411,MUS 172,A01,418178,Staff,36,0,40,4
1708253360937,MUS 174C,A00,418179,Erbe; Tom,24,0,27,3
1708253361464,MUS 175,A00,418247,Smyth; Tamara R.,28,0,30,2
1708253361992,MUS 177,A00,418265,Erbe; Tom,11,0,15,4
1708253362515,MUS 201A,A00,418267,Narucki; Susan M,15,0,15,0
1708253362515,MUS 201A,B00,418268,Dresser; Mark Stuart,13,0,15,2
1708253363042,MUS 203C,A00,418269,Lou; Michelle Siulai,15,0,15,0
1708253363571,MUS 203D,A00,418272,Davis; Anthony Curtis,4,0,5,1
1708253363571,MUS 203D,B00,418275,Obermueller; Karola,5,0,5,0
1708253363571,MUS 203D,C00,418277,Liang; Lei,5,0,5,0
1708253363571,MUS 203D,D00,418323,Lou; Michelle Siulai,5,0,5,0
1708253364096,MUS 204,A00,418324,Obermueller; Karola,24,0,25,1
1708253364625,MUS 205,A00,418325,Cimini; Amy Marie,22,0,25,3
1708253365153,MUS 206,A00,418326,Liang; Lei,13,0,15,2
1708253365153,MUS 206,B00,418327,Roberts; Matana,13,0,15,2
1708253365680,MUS 215C,A00,418328,Cimini; Amy Marie,14,0,15,1
1708253366206,MUS 232,001,418937,Dresser; Mark Stuart,9,0,10,1
1708253366206,MUS 232,002,418969,Kenyatta; Kamau,10,0,10,0
1708253366206,MUS 232,003,418971,Curtis; Charles Rector,10,0,10,0
1708253366206,MUS 232,004,418974,Terrazas Perez; Wilfrido D,10,0,10,0
1708253366206,MUS 232,005,418979,Ohnishi; Takae,10,0,10,0
1708253366206,MUS 232,006,418980,Burr; Anthony I,10,0,10,0
1708253366206,MUS 232,007,418981,Carlson; Erik Norman,10,0,10,0
1708253366206,MUS 232,008,418982,Richards; Stephanie F,10,0,10,0
1708253366206,MUS 232,009,418985,Narucki; Susan M,10,0,10,0
1708253366734,MUS 234,A00,418329,Staff,15,0,15,0
1708253367259,MUS 245,A00,418330,Carlson; Erik Norman,14,0,15,1
1708253367784,MUS 267,A00,418331,Erbe; Tom,15,0,15,0
1708253368310,MUS 270B,A00,418332,Staff,15,0,15,0
1708253368838,MUS 270D,A00,479231,Smyth; Tamara R.,15,0,15,0
1708253369364,NANO 103,A00,414714,Jahed Motlagh; Zeinab,40,0,40,0
1708253369893,NANO 108,A00,414740,Lubarda; Vlado,70,0,70,0
1708253370418,NANO 112,A01,414825,Vazquez Mena; Oscar,70,0,70,0
1708253370948,NANO 115L,A01,414830,Yang; Kesong,37,0,38,1
1708253370948,NANO 115L,B01,414832,Xu; Sheng,35,0,38,3
1708253371474,NANO 120B,A01,414835,Vecchio; Kenneth S,33,0,35,2
1708253371474,NANO 120B,B01,414841,Fenning; David,30,0,35,5
1708253372069,NANO 156,A00,414843,Fullerton; Eric E,24,0,30,6
1708253372621,NANO 158,A00,414844,Luo; Jian,29,0,30,1
1708253373151,NANO 175,A00,414850,Steinmetz; Nicole F,30,0,35,5
1708253373677,NANO 200,A00,414852,Jahed Motlagh; Zeinab,118,0,120,2
1708253374203,NANO 241,A00,414854,Pokorski; Jonathan Kyle,18,0,25,7
1708253374727,NANO 262,A00,414858,Wang; Joseph,50,0,50,0
1708253375257,NANO 271,A00,414862,Cubukcu; Ertugrul,22,0,25,3
1708253375783,NANO 272,A00,414877,Xu; Sheng,42,0,50,8
1708253376308,NANO 279,A00,414878,Liu; Ping,32,0,40,8
1708253376835,NANO 282,A00,414879,Steinmetz; Nicole F,30,0,30,0
1708253377362,NEU 200C,A00,455013,Staff,0,0,0,1
1708253377892,NEU 276,A01,479489,Staff,35,0,36,1
1708253378421,NEU 277,A00,479492,Risbrough; Victoria Blythe,0,0,0,0
1708253378948,NEU 296,001,464921,Evans; Sean Jeffrey,48,0,50,2
1708253378948,NEU 296,002,464922,Staff,50,0,50,0
1708253378948,NEU 296,003,464925,Staff,50,0,50,0
1708253379474,NEUG 221,A00,479490,Zheng; Binhai,15,0,15,0
1708253379999,NEUG 280,A00,479491,Chen; Xu,0,0,0,0
1708253380525,NEUG 296,A00,479493,Bloodgood; Brenda Laurie,9998,0,9999,1
1708253381055,OPTH 296,001,465054,Baxter; Sally Liu,49,0,50,1
1708253381055,OPTH 296,002,465068,Afshari; Natalie,49,0,50,1
1708253381055,OPTH 296,003,465074,Staff,50,0,50,0
1708253381580,ORTH 296,A00,465104,Staff,50,0,50,0
1708253381580,ORTH 296,001,465111,Staff,50,0,50,0
1708253381580,ORTH 296,002,465120,Staff,50,0,50,0
1708253382109,PATH 224,A01,494386,Ross; Camille,11,0,12,1
1708253382635,PATH 296,001,465373,Calcutt; Nigel A,49,0,50,1
1708253382635,PATH 296,002,465374,Staff,50,0,50,0
1708253382635,PATH 296,003,465375,Staff,50,0,50,0
1708253383163,PEDS 296,001,465527,Weiss; Katherine Jean,49,0,50,1
1708253383163,PEDS 296,002,465528,Staff,50,0,50,0
1708253383163,PEDS 296,003,465529,Staff,50,0,50,0
1708253383693,PH 196BH,A01,405158,Binkin; Nancy Jeanne,20,0,20,0
1708253384219,PHAR 219,A00,415016,Ross; Camille,1,0,1,0
1708253384748,PHAR 231,A00,415017,Furnari; Frank,20,0,20,0
1708253384748,PHAR 231,B00,415018,Lopez Ramirez; Miguel Alej,20,0,20,0
1708253385278,PHAR 276,A00,415020,Mc Culloch; Andrew Douglas & Amaro; Rommie E,1,0,1,0
1708253385804,PHAR 295,A00,415022,Brown; Joan Heller,15,0,15,0
1708253386334,PHIL 1,A00,415023,Harrell; Maralee Mae,58,0,60,2
1708253386860,PHIL 10,A01,415026,Grush; Rick Scott,40,0,44,4
1708253386860,PHIL 10,A02,415028,Grush; Rick Scott,42,0,44,2
1708253386860,PHIL 10,A03,415029,Grush; Rick Scott,0,0,0,0
1708253386860,PHIL 10,A04,415031,Grush; Rick Scott,0,0,0,0
1708253386860,PHIL 10,A05,415113,Grush; Rick Scott,43,0,44,1
1708253386860,PHIL 10,A06,415114,Grush; Rick Scott,43,0,44,1
1708253386860,PHIL 10,A07,415116,Grush; Rick Scott,44,0,44,0
1708253386860,PHIL 10,A08,415118,Grush; Rick Scott,43,0,44,1
1708253387395,PHIL 12,A01,415120,McKenzie; Kerry V.,28,0,30,2
1708253387395,PHIL 12,A02,415136,McKenzie; Kerry V.,30,0,30,0
1708253387395,PHIL 12,A03,415137,McKenzie; Kerry V.,27,0,30,3
1708253387395,PHIL 12,A04,415142,McKenzie; Kerry V.,30,0,30,0
1708253387922,PHIL 13,A01,415165,Brink; David O.,25,0,25,0
1708253387922,PHIL 13,A02,415179,Brink; David O.,22,0,25,3
1708253387922,PHIL 13,A03,415185,Brink; David O.,24,0,25,1
1708253387922,PHIL 13,A04,415201,Brink; David O.,25,0,25,0
1708253387922,PHIL 13,A05,415204,Brink; David O.,25,0,25,0
1708253387922,PHIL 13,A06,415220,Brink; David O.,25,0,25,0
1708253388451,PHIL 15,A01,415250,Fulkerson; Matthew Todd,26,0,30,4
1708253388451,PHIL 15,A02,415281,Fulkerson; Matthew Todd,29,0,30,1
1708253388995,PHIL 27,A01,415293,Brandt; Reuven A,20,0,25,5
1708253388995,PHIL 27,A02,415296,Brandt; Reuven A,0,0,0,0
1708253388995,PHIL 27,A03,415332,Brandt; Reuven A,22,0,25,3
1708253388995,PHIL 27,A04,415333,Brandt; Reuven A,22,0,25,3
1708253388995,PHIL 27,A05,415342,Brandt; Reuven A,20,0,25,5
1708253388995,PHIL 27,A06,415384,Brandt; Reuven A,24,0,25,1
1708253388995,PHIL 27,A07,415385,Brandt; Reuven A,25,0,25,0
1708253388995,PHIL 27,A08,415391,Brandt; Reuven A,0,0,0,0
1708253388995,PHIL 27,A09,415406,Brandt; Reuven A,0,0,0,0
1708253388995,PHIL 27,A10,415407,Brandt; Reuven A,0,0,0,0
1708253389522,PHIL 28,A01,415412,Lamey; Andy M.,24,0,25,1
1708253389522,PHIL 28,A02,415470,Lamey; Andy M.,20,0,25,5
1708253389522,PHIL 28,A03,415474,Lamey; Andy M.,0,0,0,0
1708253389522,PHIL 28,A04,415475,Lamey; Andy M.,22,0,25,3
1708253389522,PHIL 28,A05,415487,Lamey; Andy M.,24,0,25,1
1708253389522,PHIL 28,A06,415506,Lamey; Andy M.,21,0,25,4
1708253389522,PHIL 28,A07,415507,Lamey; Andy M.,25,0,25,0
1708253389522,PHIL 28,A08,415508,Lamey; Andy M.,24,0,25,1
1708253389522,PHIL 28,A09,415509,Lamey; Andy M.,25,0,25,0
1708253389522,PHIL 28,A10,415510,Lamey; Andy M.,0,0,0,0
1708253390051,PHIL 33,A01,415521,Hardimon; Michael O.,35,0,35,0
1708253390051,PHIL 33,A02,415522,Hardimon; Michael O.,35,0,35,0
1708253390577,PHIL 60,A00,415523,Marechal; Patricia,55,0,60,5
1708253391106,PHIL 102,A00,415524,Johnson; Monte,37,0,40,3
1708253391633,PHIL 106,A00,415544,Watkins; Eric,40,0,40,0
1708253392160,PHIL 112,A00,415545,Watkins; Eric,34,0,40,6
1708253392687,PHIL 115,A00,415548,Nelkin; Dana Kay,20,0,20,0
1708253393213,PHIL 120,A00,415549,Carr; Jennifer Rose,64,0,65,1
1708253393739,PHIL 134,A00,415552,Carr; Jennifer Rose,40,0,40,0
1708253394284,PHIL 150,A00,415553,Cohen; Jonathan David,38,0,40,2
1708253394813,PHIL 171,A00,415561,Brink; David O.,39,0,40,1
1708253395339,PHIL 172,A00,415563,Lamey; Andy M.,40,0,40,0
1708253395865,PHIL 174,A01,415576,Danks; David J,21,0,25,4
1708253395865,PHIL 174,A02,415582,Danks; David J,22,0,25,3
1708253395865,PHIL 174,A03,415583,Danks; David J,24,0,25,1
1708253395865,PHIL 174,A04,415584,Danks; David J,25,0,25,0
1708253396395,PHIL 175,A00,415585,Shields; Christopher John,40,0,40,0
1708253396921,PHIL 181,A00,415601,Tolley; Clinton,34,0,40,6
1708253397448,PHIL 209B,A00,415655,Serlin; David,4,0,5,1
1708253397975,PHIL 209C,A00,415658,Gates; Kelly,5,0,5,0
1708253398505,PHIL 210,A00,415659,Marechal; Patricia,20,0,20,0
1708253399030,PHIL 230,A00,415661,Grush; Rick Scott,20,0,20,0
1708253399556,PHIL 232,A00,415662,Sher; Gila,20,0,20,0
1708253400085,PHIL 260,A00,415675,Bazargan-Forward; Saba,20,0,20,0
1708253400611,PHIL 277,A00,479176,Tolley; Clinton,9,0,10,1
1708253401139,PHIL 285,A00,415685,Kovaka; Karenc,20,0,20,0
1708253401667,PHIL 287,A00,415697,Marechal; Patricia,5,0,5,0
1708253402211,PHIL 290,001,415701,Nelkin; Dana Kay,9999,0,9999,0
1708253402211,PHIL 290,002,415721,Bazargan-Forward; Saba,9999,0,9999,0
1708253402211,PHIL 290,003,415731,Brandt; Reuven A,9999,0,9999,0
1708253402211,PHIL 290,004,415743,Brink; David O.,9999,0,9999,0
1708253402211,PHIL 290,005,415747,Callender; Craig Adam,9999,0,9999,0
1708253402211,PHIL 290,006,415779,Carr; Jennifer Rose,9999,0,9999,0
1708253402211,PHIL 290,007,415780,Cartwright; Nancy D.,9999,0,9999,0
1708253402211,PHIL 290,008,415781,Cohen; Jonathan David,9999,0,9999,0
1708253402211,PHIL 290,009,415782,Danks; David J,9999,0,9999,0
1708253402211,PHIL 290,010,415783,Fulkerson; Matthew Todd,9999,0,9999,0
1708253402211,PHIL 290,011,415784,Grush; Rick Scott,9999,0,9999,0
1708253402211,PHIL 290,012,415785,Hardimon; Michael O.,9999,0,9999,0
1708253402211,PHIL 290,013,415786,Harrell; Maralee Mae,9999,0,9999,0
1708253402211,PHIL 290,014,415787,Johnson; Monte,9999,0,9999,0
1708253402211,PHIL 290,015,415788,Kovaka; Karenc,9999,0,9999,0
1708253402211,PHIL 290,016,415789,Lamey; Andy M.,9999,0,9999,0
1708253402211,PHIL 290,017,415790,Marechal; Patricia,9999,0,9999,0
1708253402211,PHIL 290,018,415791,McKenzie; Kerry V.,9999,0,9999,0
1708253402211,PHIL 290,019,415792,Rickless; Samuel Charles,9999,0,9999,0
1708253402211,PHIL 290,020,415793,Sher; Gila,9999,0,9999,0
1708253402211,PHIL 290,021,415794,Shields; Christopher John,9999,0,9999,0
1708253402211,PHIL 290,022,415805,Tolley; Clinton,9999,0,9999,0
1708253402211,PHIL 290,023,415806,Vargas; Manuel Rogelio,9999,0,9999,0
1708253402211,PHIL 290,024,415807,Watkins; Eric,9999,0,9999,0
1708253402211,PHIL 290,025,415815,Chen; Keming,9999,0,9999,0
1708253402759,PHIL 295,001,415816,Bazargan-Forward; Saba,9999,0,9999,0
1708253402759,PHIL 295,002,415857,Brandt; Reuven A,9999,0,9999,0
1708253402759,PHIL 295,003,415858,Brink; David O.,9999,0,9999,0
1708253402759,PHIL 295,004,415877,Callender; Craig Adam,9999,0,9999,0
1708253402759,PHIL 295,005,415878,Carr; Jennifer Rose,9999,0,9999,0
1708253402759,PHIL 295,006,415884,Cartwright; Nancy D.,9999,0,9999,0
1708253402759,PHIL 295,007,415885,Chen; Keming,9999,0,9999,0
1708253402759,PHIL 295,008,415891,Cohen; Jonathan David,9999,0,9999,0
1708253402759,PHIL 295,009,415892,Danks; David J,9999,0,9999,0
1708253402759,PHIL 295,010,415937,Fulkerson; Matthew Todd,9999,0,9999,0
1708253402759,PHIL 295,011,415940,Grush; Rick Scott,9999,0,9999,0
1708253402759,PHIL 295,012,415945,Hardimon; Michael O.,9999,0,9999,0
1708253402759,PHIL 295,013,415946,Harrell; Maralee Mae,9999,0,9999,0
1708253402759,PHIL 295,014,415953,Johnson; Monte,9999,0,9999,0
1708253402759,PHIL 295,015,415954,Kovaka; Karenc,9999,0,9999,0
1708253402759,PHIL 295,016,415957,Lamey; Andy M.,9999,0,9999,0
1708253402759,PHIL 295,017,415958,Marechal; Patricia,9999,0,9999,0
1708253402759,PHIL 295,018,415959,McKenzie; Kerry V.,9999,0,9999,0
1708253402759,PHIL 295,019,415960,Nelkin; Dana Kay,9999,0,9999,0
1708253402759,PHIL 295,020,415961,Rickless; Samuel Charles,9999,0,9999,0
1708253402759,PHIL 295,021,415987,Sher; Gila,9999,0,9999,0
1708253402759,PHIL 295,022,416027,Shields; Christopher John,9999,0,9999,0
1708253402759,PHIL 295,023,416030,Tolley; Clinton,9999,0,9999,0
1708253402759,PHIL 295,024,416033,Vargas; Manuel Rogelio,9999,0,9999,0
1708253402759,PHIL 295,025,416034,Watkins; Eric,9999,0,9999,0
1708253403289,PHYA 224,A00,442106,Sandstrom; Karin Marie,30,0,30,0
1708253403815,PHYS 1A,A00,441607,Gilbert; Dylan Paul,346,0,362,16
1708253404359,PHYS 1AL,001,441608,Arlett; Jessica Lynn & Yagil; Avi,30,0,30,0
1708253404359,PHYS 1AL,002,441609,Arlett; Jessica Lynn & Yagil; Avi,28,0,30,2
1708253404359,PHYS 1AL,003,441610,Arlett; Jessica Lynn & Yagil; Avi,26,0,30,4
1708253404359,PHYS 1AL,004,441611,Arlett; Jessica Lynn & Yagil; Avi,29,0,30,1
1708253404359,PHYS 1AL,005,441612,Arlett; Jessica Lynn & Yagil; Avi,28,0,30,2
1708253404359,PHYS 1AL,006,441616,Arlett; Jessica Lynn & Yagil; Avi,28,0,30,2
1708253404359,PHYS 1AL,007,441618,Arlett; Jessica Lynn & Yagil; Avi,26,0,30,4
1708253404359,PHYS 1AL,008,441620,Arlett; Jessica Lynn & Yagil; Avi,29,0,30,1
1708253404359,PHYS 1AL,009,441623,Arlett; Jessica Lynn & Yagil; Avi,29,0,30,1
1708253404359,PHYS 1AL,010,441625,Arlett; Jessica Lynn & Yagil; Avi,29,0,30,1
1708253404359,PHYS 1AL,011,441626,Arlett; Jessica Lynn & Yagil; Avi,29,0,30,1
1708253404359,PHYS 1AL,012,441627,Arlett; Jessica Lynn & Yagil; Avi,29,0,30,1
1708253404885,PHYS 1B,A00,441630,Groisman; Alexander,351,0,362,11
1708253405433,PHYS 1BL,001,441632,Arlett; Jessica Lynn & Yagil; Avi,28,0,30,2
1708253405433,PHYS 1BL,002,441634,Arlett; Jessica Lynn & Yagil; Avi,29,0,30,1
1708253405433,PHYS 1BL,003,441636,Arlett; Jessica Lynn & Yagil; Avi,29,0,30,1
1708253405433,PHYS 1BL,004,441637,Arlett; Jessica Lynn & Yagil; Avi,29,0,30,1
1708253405433,PHYS 1BL,005,441639,Arlett; Jessica Lynn & Yagil; Avi,29,0,30,1
1708253405433,PHYS 1BL,006,441641,Arlett; Jessica Lynn & Yagil; Avi,26,0,30,4
1708253405433,PHYS 1BL,007,441642,Arlett; Jessica Lynn & Yagil; Avi,23,0,30,7
1708253405433,PHYS 1BL,008,441643,Arlett; Jessica Lynn & Yagil; Avi,30,0,30,0
1708253405433,PHYS 1BL,009,441646,Arlett; Jessica Lynn & Yagil; Avi,29,0,30,1
1708253405433,PHYS 1BL,010,441648,Arlett; Jessica Lynn & Yagil; Avi,29,0,30,1
1708253405433,PHYS 1BL,011,441652,Arlett; Jessica Lynn & Yagil; Avi,29,0,30,1
1708253405433,PHYS 1BL,012,441654,Arlett; Jessica Lynn & Yagil; Avi,30,0,30,0
1708253405964,PHYS 1C,A00,441658,Popmintchev; Tenio,587,0,600,13
1708253405964,PHYS 1C,B00,441662,Popmintchev; Tenio,558,0,600,42
1708253406536,PHYS 1CL,001,441664,Arlett; Jessica Lynn & Yagil; Avi,29,0,30,1
1708253406536,PHYS 1CL,002,441665,Arlett; Jessica Lynn & Yagil; Avi,27,0,30,3
1708253406536,PHYS 1CL,003,441666,Arlett; Jessica Lynn & Yagil; Avi,25,0,30,5
1708253406536,PHYS 1CL,004,441667,Arlett; Jessica Lynn & Yagil; Avi,30,0,30,0
1708253406536,PHYS 1CL,005,441668,Arlett; Jessica Lynn & Yagil; Avi,28,0,30,2
1708253406536,PHYS 1CL,006,441669,Arlett; Jessica Lynn & Yagil; Avi,25,0,30,5
1708253406536,PHYS 1CL,007,441671,Arlett; Jessica Lynn & Yagil; Avi,27,0,30,3
1708253406536,PHYS 1CL,008,441673,Arlett; Jessica Lynn & Yagil; Avi,30,0,30,0
1708253406536,PHYS 1CL,009,441674,Arlett; Jessica Lynn & Yagil; Avi,26,0,30,4
1708253406536,PHYS 1CL,010,441676,Arlett; Jessica Lynn & Yagil; Avi,30,0,30,0
1708253406536,PHYS 1CL,011,441677,Arlett; Jessica Lynn & Yagil; Avi,30,0,30,0
1708253406536,PHYS 1CL,012,441683,Arlett; Jessica Lynn & Yagil; Avi,30,0,30,0
1708253406536,PHYS 1CL,013,441685,Arlett; Jessica Lynn & Yagil; Avi,28,0,30,2
1708253406536,PHYS 1CL,014,441687,Arlett; Jessica Lynn & Yagil; Avi,30,0,30,0
1708253406536,PHYS 1CL,015,441689,Arlett; Jessica Lynn & Yagil; Avi,17,0,30,13
1708253406536,PHYS 1CL,016,441692,Arlett; Jessica Lynn & Yagil; Avi,29,0,30,1
1708253406536,PHYS 1CL,017,441696,Arlett; Jessica Lynn & Yagil; Avi,24,0,30,6
1708253406536,PHYS 1CL,018,441698,Arlett; Jessica Lynn & Yagil; Avi,25,0,30,5
1708253406536,PHYS 1CL,019,441702,Arlett; Jessica Lynn & Yagil; Avi,25,0,30,5
1708253406536,PHYS 1CL,020,441705,Arlett; Jessica Lynn & Yagil; Avi,29,0,30,1
1708253406536,PHYS 1CL,021,441706,Arlett; Jessica Lynn & Yagil; Avi,30,0,30,0
1708253406536,PHYS 1CL,022,441707,Arlett; Jessica Lynn & Yagil; Avi,30,0,30,0
1708253406536,PHYS 1CL,023,441708,Arlett; Jessica Lynn & Yagil; Avi,27,0,30,3
1708253406536,PHYS 1CL,024,441710,Arlett; Jessica Lynn & Yagil; Avi,29,0,30,1
1708253406536,PHYS 1CL,025,441711,Arlett; Jessica Lynn & Yagil; Avi,28,0,30,2
1708253406536,PHYS 1CL,026,441712,Arlett; Jessica Lynn & Yagil; Avi,29,0,30,1
1708253406536,PHYS 1CL,027,441713,Arlett; Jessica Lynn & Yagil; Avi,26,0,30,4
1708253406536,PHYS 1CL,028,441714,Arlett; Jessica Lynn & Yagil; Avi,29,0,30,1
1708253406536,PHYS 1CL,029,441715,Arlett; Jessica Lynn & Yagil; Avi,25,0,30,5
1708253406536,PHYS 1CL,030,441717,Arlett; Jessica Lynn & Yagil; Avi,29,0,30,1
1708253406536,PHYS 1CL,031,441718,Arlett; Jessica Lynn & Yagil; Avi,27,0,30,3
1708253406536,PHYS 1CL,032,441721,Arlett; Jessica Lynn & Yagil; Avi,30,0,30,0
1708253406536,PHYS 1CL,033,441724,Arlett; Jessica Lynn & Yagil; Avi,28,0,30,2
1708253406536,PHYS 1CL,034,441726,Arlett; Jessica Lynn & Yagil; Avi,29,0,30,1
1708253406536,PHYS 1CL,035,441728,Arlett; Jessica Lynn & Yagil; Avi,29,0,30,1
1708253406536,PHYS 1CL,036,441729,Arlett; Jessica Lynn & Yagil; Avi,30,0,30,0
1708253406536,PHYS 1CL,037,441730,Arlett; Jessica Lynn & Yagil; Avi,27,0,30,3
1708253406536,PHYS 1CL,038,441732,Arlett; Jessica Lynn & Yagil; Avi,29,0,30,1
1708253406536,PHYS 1CL,039,441733,Arlett; Jessica Lynn & Yagil; Avi,27,0,30,3
1708253406536,PHYS 1CL,040,441734,Arlett; Jessica Lynn & Yagil; Avi,30,0,30,0
1708253406536,PHYS 1CL,041,441735,Arlett; Jessica Lynn & Yagil; Avi,29,0,30,1
1708253406536,PHYS 1CL,042,441766,Arlett; Jessica Lynn & Yagil; Avi,30,0,30,0
1708253406536,PHYS 1CL,043,441768,Arlett; Jessica Lynn & Yagil; Avi,29,0,30,1
1708253406536,PHYS 1CL,044,441770,Arlett; Jessica Lynn & Yagil; Avi,30,0,30,0
1708253408096,PHYS 2A,A01,460308,Bal; Gurleen K,28,0,30,2
1708253408096,PHYS 2A,A02,460320,Bal; Gurleen K,30,0,30,0
1708253408096,PHYS 2A,A03,460321,Bal; Gurleen K,29,0,30,1
1708253408096,PHYS 2A,A04,460325,Bal; Gurleen K,28,0,30,2
1708253408096,PHYS 2A,A05,460326,Bal; Gurleen K,29,0,30,1
1708253408096,PHYS 2A,A06,460327,Bal; Gurleen K,30,0,30,0
1708253408096,PHYS 2A,A07,460495,Bal; Gurleen K,28,0,30,2
1708253408096,PHYS 2A,A08,460535,Bal; Gurleen K,27,0,30,3
1708253408096,PHYS 2A,A09,460536,Bal; Gurleen K,30,0,30,0
1708253408096,PHYS 2A,A10,460537,Bal; Gurleen K,30,0,30,0
1708253408096,PHYS 2A,A11,460538,Bal; Gurleen K,30,0,30,0
1708253408096,PHYS 2A,A12,460539,Bal; Gurleen K,30,0,30,0
1708253408679,PHYS 2B,A01,460620,Barreiro Guerrero; Julio,30,0,30,0
1708253408679,PHYS 2B,A02,460625,Barreiro Guerrero; Julio,30,0,30,0
1708253408679,PHYS 2B,A03,460626,Barreiro Guerrero; Julio,29,0,30,1
1708253408679,PHYS 2B,A04,460716,Barreiro Guerrero; Julio,26,0,30,4
1708253408679,PHYS 2B,A05,460756,Barreiro Guerrero; Julio,29,0,30,1
1708253408679,PHYS 2B,A06,460837,Barreiro Guerrero; Julio,30,0,30,0
1708253408679,PHYS 2B,A07,460865,Barreiro Guerrero; Julio,30,0,30,0
1708253408679,PHYS 2B,A08,460866,Barreiro Guerrero; Julio,30,0,30,0
1708253408679,PHYS 2B,A09,460867,Barreiro Guerrero; Julio,29,0,30,1
1708253408679,PHYS 2B,A10,460868,Barreiro Guerrero; Julio,30,0,30,0
1708253408679,PHYS 2B,A11,460869,Barreiro Guerrero; Julio,30,0,30,0
1708253408679,PHYS 2B,A12,460874,Barreiro Guerrero; Julio,30,0,30,0
1708253408679,PHYS 2B,B01,469381,Barreiro Guerrero; Julio,30,0,30,0
1708253408679,PHYS 2B,B02,469382,Barreiro Guerrero; Julio,29,0,30,1
1708253408679,PHYS 2B,B03,469402,Barreiro Guerrero; Julio,27,0,30,3
1708253408679,PHYS 2B,B04,469403,Barreiro Guerrero; Julio,28,0,30,2
1708253408679,PHYS 2B,B05,469442,Barreiro Guerrero; Julio,30,0,30,0
1708253408679,PHYS 2B,B06,469449,Barreiro Guerrero; Julio,30,0,30,0
1708253408679,PHYS 2B,B07,469450,Barreiro Guerrero; Julio,29,0,30,1
1708253408679,PHYS 2B,B08,469451,Barreiro Guerrero; Julio,30,0,30,0
1708253408679,PHYS 2B,B09,469457,Barreiro Guerrero; Julio,29,0,30,1
1708253408679,PHYS 2B,B10,469460,Barreiro Guerrero; Julio,30,0,30,0
1708253408679,PHYS 2B,B11,469468,Barreiro Guerrero; Julio,30,0,30,0
1708253408679,PHYS 2B,B12,469475,Barreiro Guerrero; Julio,30,0,30,0
1708253409222,PHYS 2BL,A01,441779,Meyertholen; Andrew D.,21,0,24,3
1708253409222,PHYS 2BL,A02,441780,Meyertholen; Andrew D.,17,0,24,7
1708253409222,PHYS 2BL,A03,441781,Meyertholen; Andrew D.,20,0,24,4
1708253409222,PHYS 2BL,A04,441782,Meyertholen; Andrew D.,21,0,24,3
1708253409222,PHYS 2BL,A05,441784,Meyertholen; Andrew D.,23,0,24,1
1708253409222,PHYS 2BL,A06,441786,Meyertholen; Andrew D.,23,0,24,1
1708253409222,PHYS 2BL,A07,441788,Meyertholen; Andrew D.,23,0,24,1
1708253409222,PHYS 2BL,A08,441790,Meyertholen; Andrew D.,24,0,24,0
1708253409222,PHYS 2BL,A09,441792,Meyertholen; Andrew D.,24,0,24,0
1708253409222,PHYS 2BL,A10,441794,Meyertholen; Andrew D.,23,0,24,1
1708253409222,PHYS 2BL,A11,441796,Meyertholen; Andrew D.,22,0,24,2
1708253409222,PHYS 2BL,A12,441798,Meyertholen; Andrew D.,24,0,24,0
1708253409222,PHYS 2BL,A13,441800,Meyertholen; Andrew D.,24,0,24,0
1708253409222,PHYS 2BL,A14,441802,Meyertholen; Andrew D.,24,0,24,0
1708253409222,PHYS 2BL,A15,441804,Meyertholen; Andrew D.,23,0,24,1
1708253409750,PHYS 2C,A01,460540,Tan; Tzer Han,30,0,30,0
1708253409750,PHYS 2C,A02,460541,Tan; Tzer Han,28,0,30,2
1708253409750,PHYS 2C,A03,460542,Tan; Tzer Han,28,0,30,2
1708253409750,PHYS 2C,A04,460543,Tan; Tzer Han,28,0,30,2
1708253409750,PHYS 2C,A05,460544,Tan; Tzer Han,28,0,30,2
1708253409750,PHYS 2C,A06,460545,Tan; Tzer Han,29,0,30,1
1708253409750,PHYS 2C,A07,460553,Tan; Tzer Han,30,0,30,0
1708253409750,PHYS 2C,A08,460561,Tan; Tzer Han,30,0,30,0
1708253409750,PHYS 2C,A09,460562,Tan; Tzer Han,28,0,30,2
1708253409750,PHYS 2C,A10,460563,Tan; Tzer Han,29,0,30,1
1708253409750,PHYS 2C,A11,460567,Tan; Tzer Han,30,0,30,0
1708253409750,PHYS 2C,A12,460568,Tan; Tzer Han,28,0,30,2
1708253410276,PHYS 2CL,A01,441809,Ni; Kaixuan,25,0,28,3
1708253410276,PHYS 2CL,A02,441811,Ni; Kaixuan,27,0,28,1
1708253410276,PHYS 2CL,A03,441814,Ni; Kaixuan,23,0,28,5
1708253410276,PHYS 2CL,A04,441817,Ni; Kaixuan,28,0,28,0
1708253410276,PHYS 2CL,A05,441819,Ni; Kaixuan,26,0,28,2
1708253410276,PHYS 2CL,A06,441820,Ni; Kaixuan,27,0,28,1
1708253410801,PHYS 2D,A01,460569,Sharma; Vivek A.,24,0,25,1
1708253410801,PHYS 2D,A02,460574,Sharma; Vivek A.,24,0,25,1
1708253410801,PHYS 2D,A03,460575,Sharma; Vivek A.,25,0,25,0
1708253411334,PHYS 4B,A01,441829,Grinstein; Benjamin,34,0,38,4
1708253411334,PHYS 4B,A02,441831,Grinstein; Benjamin,30,0,32,2
1708253411334,PHYS 4B,A03,441832,Grinstein; Benjamin,30,0,30,0
1708253411334,PHYS 4B,A04,441833,Grinstein; Benjamin,30,0,30,0
1708253411865,PHYS 4E,A01,441907,Frano Pereira; Alex M,33,0,34,1
1708253411865,PHYS 4E,A02,441958,Frano Pereira; Alex M,34,0,34,0
1708253412408,PHYS 10,A01,441971,Burgasser; Adam Jonathan,118,0,120,2
1708253412938,PHYS 13,A01,441974,Wright; Shelley Adams,61,0,65,4
1708253413464,PHYS 87,A00,486898,Grinstein; Benjamin,19,0,20,1
1708253413991,PHYS 100C,A01,441978,Averitt; Richard Douglas,58,0,60,2
1708253414518,PHYS 105B,A01,441985,Green; Daniel Richard,37,0,40,3
1708253415046,PHYS 120,A01,441995,Arnold; Kam S,40,0,44,4
1708253415046,PHYS 120,A02,442011,Arnold; Kam S,41,0,44,3
1708253415576,PHYS 130A,A01,442032,Parker; Daniel E,74,0,75,1
1708253416102,PHYS 130B,A01,442056,Branson; James G,47,0,50,3
1708253416629,PHYS 139,A00,442057,Jun; Suckjoon,30,0,30,0
1708253416629,PHYS 139,B00,442059,Duarte; Javier Mauricio & Li; Aobo,42,0,50,8
1708253417160,PHYS 140A,A01,442065,Shotwell; Brian,49,0,50,1
1708253417687,PHYS 152B,A01,442067,Hirsch; Jorge Eduardo,16,0,20,4
1708253418215,PHYS 154,A01,442069,Jenkins; Elizabeth,29,0,30,1
1708253418742,PHYS 162,A01,442096,Keating; Brian,64,0,65,1
1708253419271,PHYS 170,A01,486870,Oh; Seungeun,39,0,40,1
1708253419799,PHYS 177,A00,442103,Dudko; Olga,20,0,20,0
1708253420329,PHYS 203B,A01,442132,Fogler; Michael M.,20,0,20,0
1708253420854,PHYS 210A,A01,442143,Hwa; Terence T.,20,0,20,0
1708253421624,PHYS 212C,A01,442200,Chivukula; Raja S,18,0,20,2
1708253422150,PHYS 215C,A00,442201,Intriligator; Kenneth Arthur,19,0,20,1
1708253422675,PHYS 225C,A01,442203,Flauger; Raphael M,19,0,20,1
1708253423220,PHYS 227,A00,442204,Tytler; David Robert,29,0,30,1
1708253423745,PHYS 230,A01,442206,McGreevy; John A.,20,0,20,0
1708253424274,PHYS 239,A00,442207,Goldenfeld; Nigel,20,0,20,0
1708253424274,PHYS 239,B00,442208,Duarte; Javier Mauricio & Li; Aobo,5,0,5,0
1708253424811,PHYS 244,A01,442280,Norman; Michael L,12,0,20,8
1708253425337,PHYS 250,A00,442300,Fogler; Michael M.,50,0,50,0
1708253425863,PHYS 251,A00,442307,Grinstein; Benjamin,20,0,20,0
1708253426389,PHYS 252,A00,442348,Diamond; Patrick H,10,0,10,0
1708253426968,PHYS 253,A00,442349,Theissen; Christopher Alexander,30,0,30,0
1708253427492,PHYS 254,A00,442352,Hwa; Terence T.,30,0,30,0
1708253428021,PHYS 255,A00,442423,Hwa; Terence T.,30,0,30,0
1708253428547,PHYS 258,A00,442426,Theissen; Christopher Alexander,30,0,30,0
1708253429074,PHYS 260,A00,442427,Frano Pereira; Alex M,50,0,50,0
1708253429600,PHYS 277,A00,442428,Dudko; Olga,20,0,20,0
1708253430127,POLI 5D,A01,419010,Dai; Yinlin,5,0,7,2
1708253430127,POLI 5D,A02,419020,Dai; Yinlin,7,0,7,0
1708253430127,POLI 5D,A03,419022,Dai; Yinlin,4,0,6,2
1708253430127,POLI 5D,A04,419040,Dai; Yinlin,5,0,5,0
1708253430127,POLI 5D,B01,419065,Dai; Yinlin,7,0,7,0
1708253430127,POLI 5D,B02,419068,Dai; Yinlin,7,0,7,0
1708253430127,POLI 5D,B03,419069,Dai; Yinlin,6,0,6,0
1708253430127,POLI 5D,B04,419070,Dai; Yinlin,5,0,5,0
1708253430127,POLI 5D,C01,487211,Staff,3,0,5,2
1708253430653,POLI 11D,A01,419072,Desposato; Scott,32,0,34,2
1708253430653,POLI 11D,A02,419073,Desposato; Scott,33,0,34,1
1708253430653,POLI 11D,A03,419082,Desposato; Scott,32,0,34,2
1708253430653,POLI 11D,A04,419123,Desposato; Scott,34,0,34,0
1708253430653,POLI 11D,A05,419124,Desposato; Scott,34,0,34,0
1708253430653,POLI 11D,A06,419125,Desposato; Scott,34,0,34,0
1708253431185,POLI 12D,A01,419127,Gartzke; Erik,29,0,34,5
1708253431185,POLI 12D,A02,419128,Gartzke; Erik,34,0,34,0
1708253431185,POLI 12D,A03,419129,Gartzke; Erik,34,0,34,0
1708253431185,POLI 12D,A04,419130,Gartzke; Erik,34,0,34,0
1708253431185,POLI 12D,A05,419131,Gartzke; Erik,32,0,34,2
1708253431185,POLI 12D,A06,419168,Gartzke; Erik,34,0,34,0
1708253431713,POLI 13DR,A01,477733,Draper; Matthew William,28,0,34,6
1708253431713,POLI 13DR,A02,477734,Draper; Matthew William,32,0,34,2
1708253431713,POLI 13DR,A03,477736,Draper; Matthew William,33,0,34,1
1708253431713,POLI 13DR,A04,477737,Draper; Matthew William,32,0,34,2
1708253431713,POLI 13DR,A05,477739,Draper; Matthew William,31,0,34,3
1708253431713,POLI 13DR,A06,477740,Draper; Matthew William,34,0,34,0
1708253432245,POLI 30D,A01,419179,Desposato; Scott,19,0,28,9
1708253432245,POLI 30D,A02,419180,Desposato; Scott,25,0,28,3
1708253432245,POLI 30D,A03,419181,Desposato; Scott,27,0,28,1
1708253432245,POLI 30D,A04,419182,Desposato; Scott,28,0,28,0
1708253432245,POLI 30D,A05,419187,Desposato; Scott,24,0,28,4
1708253432245,POLI 30D,A06,419189,Desposato; Scott,28,0,28,0
1708253432770,POLI 100E,A00,419191,Pitcher; Kennedy Anell,105,0,115,10
1708253433294,POLI 104P,A00,419192,Orfield; Michael Bennett,183,0,196,13
1708253433819,POLI 104U,A00,419193,Nichter; Maysa,88,0,115,27
1708253434344,POLI 108,A00,419194,Adida; Claire,293,0,295,2
1708253434869,POLI 110C,A00,419195,Soon; Valerie,47,0,50,3
1708253435395,POLI 120D,A00,419207,Hansen; Jan Eric,48,0,50,2
1708253435922,POLI 124A,A00,419209,Fortunato; David,48,0,50,2
1708253436448,POLI 131CR,A00,419211,Hoston; Germaine,41,0,50,9
1708253436448,POLI 131CR,B00,481592,Hoston; Germaine,10,0,10,0
1708253436974,POLI 136A,A00,419212,Roeder; Philip G,111,0,115,4
1708253437504,POLI 140D,A00,419213,Wong; Tak Kei,183,0,192,9
1708253438033,POLI 142D,A00,419214,Gartzke; Erik,227,0,230,3
1708253438560,POLI 145C,A00,419222,Fisk; David Lee,101,0,115,14
1708253439085,POLI 150A,A00,419225,Wong; Tak Kei,216,0,230,14
1708253439615,POLI 170A,A00,419226,Skillman; Rachel Diane,115,0,115,0
1708253440141,POLI 179,A00,419238,Staff,95,0,104,9
1708253440667,POLI 194,A00,455332,Hill; Seth J,0,0,0,0
1708253441196,POLI 194SD,A00,419248,Nichter; Maysa,999,0,999,0
1708253441721,POLI 197SD,001,419258,Nichter; Maysa,999,0,999,0
1708253442251,POLI 203B,A00,419265,Slantchev; Branislav,21,0,25,4
1708253442776,POLI 214R,A00,419275,Hoston; Germaine,23,0,25,2
1708253443303,POLI 219,A00,419289,Soon; Valerie,24,0,25,1
1708253443833,POLI 220A,A00,419299,Ferree; Karen E,21,0,25,4
1708253444358,POLI 233,A00,419333,Adida; Claire,23,0,25,2
1708253444886,POLI 243,A00,479118,Joseph; Michael F,23,0,25,2
1708253445412,POLI 251,A00,419334,Ban; Pamela M,23,0,25,2
1708253445938,POLI 257,A00,419335,Hill; Seth J,25,0,25,0
1708253446467,POLI 273,A00,419336,Mignozzetti; Umberto,16,0,25,9
1708253446994,POLI 280,A00,419337,Hafner-Burton; Emilie,18,0,25,7
1708253447518,POLI 281,A00,419338,Ban; Pamela M,21,0,25,4
1708253448045,POLI 282,A00,419339,Ferree; Karen E,19,0,25,6
1708253448571,POLI 283,A00,419340,Naoi; Megumi,23,0,25,2
1708253449099,POLI 285,A00,419341,Ingham; Sean,25,0,25,0
1708253449624,POLI 286,A00,419342,Mignozzetti; Umberto,23,0,25,2
1708253450155,POLI 288,A00,479174,Fowler; James,13,0,15,2
1708253450682,PSY 296,001,465760,Besterman; Aaron David,49,0,50,1
1708253450682,PSY 296,002,465765,Eyler; Lisa T.,49,0,50,1
1708253450682,PSY 296,003,465767,Patel; Ekta Himanshu,49,0,50,1
1708253451208,PSYC 3R,A00,419378,Pilegard; Celeste Cristine,314,0,325,11
1708253451736,PSYC 7,A00,419384,Powell; Lindsey Jane,288,0,295,7
1708253452268,PSYC 60,A01,460208,Lowe; Angela Beth,31,0,35,4
1708253452268,PSYC 60,A02,460209,Lowe; Angela Beth,28,0,35,7
1708253452268,PSYC 60,A03,460210,Lowe; Angela Beth,35,0,35,0
1708253452268,PSYC 60,A04,460211,Lowe; Angela Beth,33,0,35,2
1708253452268,PSYC 60,A05,460212,Lowe; Angela Beth,34,0,35,1
1708253452268,PSYC 60,A06,460213,Lowe; Angela Beth,35,0,35,0
1708253452268,PSYC 60,A07,460214,Lowe; Angela Beth,33,0,35,2
1708253452268,PSYC 60,B01,460215,Rose; Fred E.,35,0,35,0
1708253452268,PSYC 60,B02,460216,Rose; Fred E.,35,0,35,0
1708253452268,PSYC 60,B03,460218,Rose; Fred E.,35,0,35,0
1708253452268,PSYC 60,B04,460219,Rose; Fred E.,35,0,35,0
1708253452268,PSYC 60,B05,460220,Rose; Fred E.,32,0,35,3
1708253452268,PSYC 60,B06,460221,Rose; Fred E.,35,0,35,0
1708253452268,PSYC 60,B07,460222,Rose; Fred E.,35,0,35,0
1708253452797,PSYC 70,A01,460223,Pilegard; Celeste Cristine,29,0,35,6
1708253452797,PSYC 70,A02,460224,Pilegard; Celeste Cristine,32,0,35,3
1708253452797,PSYC 70,A03,460225,Pilegard; Celeste Cristine,34,0,35,1
1708253452797,PSYC 70,A04,460266,Pilegard; Celeste Cristine,33,0,35,2
1708253452797,PSYC 70,A05,460267,Pilegard; Celeste Cristine,35,0,35,0
1708253452797,PSYC 70,A06,460277,Pilegard; Celeste Cristine,34,0,35,1
1708253453324,PSYC 71,A01,419620,Staff,19,0,21,2
1708253453324,PSYC 71,A02,419662,Staff,20,0,21,1
1708253453324,PSYC 71,B01,419682,Geller; Emma Harlan,24,0,25,1
1708253453324,PSYC 71,B02,419732,Geller; Emma Harlan,26,0,26,0
1708253453852,PSYC 88,A00,419733,Dobkins; Karen R.,47,0,65,18
1708253454379,PSYC 100,A00,419734,Chapman; Eddie Nathaniel,388,0,410,22
1708253454908,PSYC 101,A00,419735,Walker; Caren Michelle,272,0,295,23
1708253455436,PSYC 102,A00,419779,Moranton; Nirelia Melbina-,292,0,295,3
1708253455964,PSYC 104,A00,419880,Fine; Rachel,267,0,295,28
1708253456494,PSYC 105,A00,419946,Lowe; Angela Beth,276,0,295,19
1708253457020,PSYC 111B,A01,419948,Geller; Emma Harlan,35,0,35,0
1708253457550,PSYC 116C,A01,420046,Lang; Ariel,25,0,25,0
1708253458076,PSYC 117,A01,420092,Bajic; Daniel Andrew,25,0,25,0
1708253458605,PSYC 118,A01,420095,Miller; Cory T.,37,0,45,8
1708253459135,PSYC 124,A00,420096,Chapman; Eddie Nathaniel,381,0,410,29
1708253459664,PSYC 127,A00,420097,Dickenson; Janna Alene,14,0,20,6
1708253460191,PSYC 132,A00,420121,Staff,114,0,120,6
1708253460718,PSYC 133R,A01,420172,Golden; Susan S. & Gorman; Michael R.,10,0,16,6
1708253460718,PSYC 133R,A02,420173,Golden; Susan S. & Gorman; Michael R.,16,0,16,0
1708253460718,PSYC 133R,A03,420175,Golden; Susan S. & Gorman; Michael R.,16,0,16,0
1708253460718,PSYC 133R,A04,420249,Golden; Susan S. & Gorman; Michael R.,13,0,16,3
1708253461244,PSYC 134,A00,420311,Kaye; Walter H.,296,0,300,4
1708253461773,PSYC 137,A00,420312,Lin; Chujun,292,0,295,3
1708253462298,PSYC 144,A00,420313,Wixted; John T,287,0,295,8
1708253462827,PSYC 147,A00,420315,Wong; Lauren Hitomi,120,0,146,26
1708253463355,PSYC 164,A00,420328,Kaplan; Paul,259,0,295,36
1708253463881,PSYC 172,A00,420336,Dickenson; Janna Alene,294,0,300,6
1708253464410,PSYC 178,A00,420337,Glaser; Dale,131,0,146,15
1708253464937,PSYC 179,A00,420338,Lacefield; Katharine I,256,0,328,72
1708253465462,PSYC 181,A00,420339,Anagnostaras; Stephan,333,0,350,17
1708253465988,PSYC 184,A00,420367,Wilson; Brent M,275,0,295,20
1708253466516,PSYC 188,A00,420368,Lacefield; Katharine I,234,0,300,66
1708253467041,PSYC 190,A00,420378,Barner; David A.,374,0,395,21
1708253467568,PSYC 193,B00,420626,Brashier; Nadia Marie,215,0,216,1
1708253467568,PSYC 193,C00,420643,Gremel; Christina M,33,0,35,2
1708253468102,PSYC 193L,A01,420817,Brown; Sandra A,65,0,65,0
1708253468102,PSYC 193L,B01,420830,Staff,26,0,30,4
1708253468102,PSYC 193L,C01,420832,Staff,49,0,49,0
1708253468102,PSYC 193L,D01,420834,Staff,27,0,30,3
1708253468102,PSYC 193L,E01,493996,Aron; Adam,24,0,24,0
1708253468631,PSYC 194C,A01,420905,Heyman; Gail D.,1,0,1,0
1708253469157,PSYC 205,A00,420906,Harris; Christine Renee,17,0,20,3
1708253469683,PSYC 218,A00,420907,Brady; Timothy Francis,11,0,20,9
1708253470209,PSYC 224,A00,420908,Gremel; Christina M,30,0,30,0
1708253470736,PSYC 242,A00,421469,Walker; Caren Michelle,27,0,30,3
1708253471262,PSYC 247,A00,421473,Walker; Caren Michelle,14,0,20,6
1708253471791,PSYC 270C,A00,421554,Dobkins; Karen R.,13,0,20,7
1708253472319,PSYC 272,A00,421561,Gentner; Tim,20,0,20,0
1708253472847,PSYC 274,A00,421564,McCullough; Michael E,29,0,30,1
1708253473374,PSYC 275,A00,421620,Staff,23,0,30,7
1708253473902,PSYC 276,A00,421622,McCullough; Michael E,14,0,20,6
1708253474428,PSYC 280,A00,421623,Serences; John Thomas,76,0,85,9
1708253474970,PSYC 296,001,421667,Anagnostaras; Stephan,9999,0,9999,0
1708253474970,PSYC 296,002,421773,Aron; Adam,9999,0,9999,0
1708253474970,PSYC 296,003,421794,Mukku; Dhananjaya,9999,0,9999,0
1708253474970,PSYC 296,004,421795,Barner; David A.,9998,0,9999,1
1708253474970,PSYC 296,005,421796,Schachner; Adena,9999,0,9999,0
1708253474970,PSYC 296,006,421797,Brown; Sandra A,9999,0,9999,0
1708253474970,PSYC 296,007,421798,Chapman; Eddie Nathaniel,9999,0,9999,0
1708253474970,PSYC 296,008,421799,Dickenson; Janna Alene,9999,0,9999,0
1708253474970,PSYC 296,009,421800,Dobkins; Karen R.,9998,0,9999,1
1708253474970,PSYC 296,010,421801,Fan; Judith Ellen,9999,0,9999,0
1708253474970,PSYC 296,011,421803,Ferreira; Victor,9999,0,9999,0
1708253474970,PSYC 296,012,421814,Geller; Emma Harlan,9998,0,9999,1
1708253474970,PSYC 296,013,422102,Gentner; Tim,9999,0,9999,0
1708253474970,PSYC 296,014,422103,Gorman; Michael R.,9999,0,9999,0
1708253474970,PSYC 296,015,422104,Gremel; Christina M,9999,0,9999,0
1708253474970,PSYC 296,016,422106,Harris; Christine Renee,9999,0,9999,0
1708253474970,PSYC 296,017,422107,Heyman; Gail D.,9999,0,9999,0
1708253474970,PSYC 296,018,422108,McCullough; Michael E,9999,0,9999,0
1708253474970,PSYC 296,019,422109,Mc Kenzie; Craig R.M.,9999,0,9999,0
1708253474970,PSYC 296,020,422122,Miller; Cory T.,9999,0,9999,0
1708253474970,PSYC 296,021,422123,Pashler; Harold E,9999,0,9999,0
1708253474970,PSYC 296,022,422124,Pilegard; Celeste Cristine,9999,0,9999,0
1708253474970,PSYC 296,023,422125,Powell; Lindsey Jane,9999,0,9999,0
1708253474970,PSYC 296,025,422127,Rickard; Timothy C.,9998,0,9999,1
1708253474970,PSYC 296,026,422128,Serences; John Thomas,9998,0,9999,1
1708253474970,PSYC 296,027,422130,Walker; Caren Michelle,9998,0,9999,1
1708253474970,PSYC 296,028,422132,Winkielman; Piotr,9999,0,9999,0
1708253474970,PSYC 296,029,422134,Wixted; John T,9996,0,9999,3
1708253474970,PSYC 296,030,422146,Brady; Timothy Francis,9998,0,9999,1
1708253474970,PSYC 296,031,422154,Carver; Leslie J.,9999,0,9999,0
1708253474970,PSYC 296,032,422161,Lin; Chujun,9999,0,9999,0
1708253474970,PSYC 296,033,422169,Brashier; Nadia Marie,9998,0,9999,1
1708253474970,PSYC 296,034,422177,Oesch; Nicholas W,9999,0,9999,0
1708253475496,RAD 296,001,465795,Staff,50,0,50,0
1708253475496,RAD 296,002,465796,Staff,50,0,50,0
1708253475496,RAD 296,003,465797,Staff,50,0,50,0
1708253476027,RELI 150,A00,419353,Rahimi; Babak,37,0,40,3
1708253476558,REV 87,A00,422721,Lyon; Antony J.,19,0,20,1
1708253477083,RMAS 296,001,465827,Murphy; James D,49,0,50,1
1708253477083,RMAS 296,002,465828,Staff,50,0,50,0
1708253477083,RMAS 296,003,465831,Staff,50,0,50,0
1708253477610,RMED 296,001,466791,Staff,50,0,50,0
1708253477610,RMED 296,002,466792,Staff,50,0,50,0
1708253477610,RMED 296,003,466793,Staff,50,0,50,0
1708253478142,SE 3,A01,446938,Van Den Einde; Yael Dahlia,50,0,52,2
1708253478142,SE 3,A02,446942,Van Den Einde; Yael Dahlia,49,0,52,3
1708253478142,SE 3,A03,446948,Van Den Einde; Yael Dahlia,52,0,53,1
1708253478142,SE 3,A04,446965,Van Den Einde; Yael Dahlia,53,0,53,0
1708253478668,SE 9,A01,447015,Kuester; Falko,30,0,34,4
1708253478668,SE 9,A02,447017,Kuester; Falko,33,0,33,0
1708253478668,SE 9,A03,447022,Kuester; Falko,31,0,33,2
1708253479196,SE 101B,A01,447040,Kosmatka; John B,55,0,56,1
1708253479723,SE 105,A01,447042,Qiao; Yu,118,0,120,2
1708253480304,SE 110A,A01,467467,Asaro; Robert J,56,0,56,0
1708253480830,SE 110B,A00,447045,Zhu; Qiang,122,0,125,3
1708253481356,SE 130B,A01,447049,Chadha; Mayank,92,0,100,8
1708253481886,SE 131A,A01,447059,Krysl; Petr,102,0,110,8
1708253482414,SE 132,A01,447078,Chen; Jiun-Shyan,48,0,50,2
1708253482939,SE 140B,A01,447086,Restrepo; Jose,29,0,34,5
1708253482939,SE 140B,A02,447123,Restrepo; Jose,21,0,33,12
1708253482939,SE 140B,A03,447124,Restrepo; Jose,30,0,33,3
1708253483465,SE 143B,A01,447133,Tehrani; Mehran,11,0,15,4
1708253483465,SE 143B,A02,447134,Tehrani; Mehran,12,0,15,3
1708253483997,SE 150A,A01,447136,Uang; Chia-Ming,94,0,100,6
1708253484524,SE 150B,A01,447214,Morrison; Machel Leigh,49,0,50,1
1708253485053,SE 151B,A00,447215,Shing; P. Benson,71,0,75,4
1708253485580,SE 160B,A01,467468,Kim; Hyunsun Alicia,91,0,100,9
1708253486106,SE 165,A00,447238,Farrar; Charles R.,9,0,10,1
1708253486632,SE 184,A00,447253,Hutchinson; Tara,20,0,20,0
1708253487162,SE 202,A00,447392,Kosmatka; John B,25,0,30,5
1708253487691,SE 204,A00,447482,Todd; Michael,12,0,20,8
1708253488221,SE 206,A00,447483,Conte; Joel P,30,0,30,0
1708253488746,SE 213,A00,447499,Palermo; Alessandro,17,0,30,13
1708253489276,SE 215,A00,447500,Zhu; Qiang,34,0,45,11
1708253489801,SE 222,A00,447507,Elgamal; Ahmed,30,0,30,0
1708253490325,SE 227,A00,447576,Hutchinson; Tara,20,0,25,5
1708253490854,SE 244,A00,447577,Elgamal; Ahmed,29,0,30,1
1708253491383,SE 247,A00,447580,Hutchinson; Tara,0,0,5,5
1708253491908,SE 251B,A00,447612,Qiao; Yu,15,0,25,10
1708253492437,SE 253B,A00,447613,Kim; Hyonny,28,0,30,2
1708253492965,SE 260B,A00,447614,Kim; Hyunsun Alicia,10,0,10,0
1708253493490,SE 265,A00,447615,Farrar; Charles R.,20,0,25,5
1708253494016,SE 266,A00,447616,Loh; Chin Hsiung,23,0,25,2
1708253495068,SE 280,A00,447650,Krysl; Petr,22,0,25,3
1708253495600,SE 281,A01,447658,Kuester; Falko,12,0,30,18
1708253496129,SE 290,A00,447659,Qiao; Yu,78,0,100,22
1708253496657,SE 296,001,447666,Asaro; Robert J,9999,0,9999,0
1708253496657,SE 296,002,447669,Chen; Jiun-Shyan,9999,0,9999,0
1708253496657,SE 296,003,447689,Conte; Joel P,9999,0,9999,0
1708253496657,SE 296,004,447690,Elgamal; Ahmed,9999,0,9999,0
1708253496657,SE 296,005,447728,Hutchinson; Tara,9999,0,9999,0
1708253496657,SE 296,006,447733,Jandaghi Semnani; Shabnam,9999,0,9999,0
1708253496657,SE 296,007,447734,Kim; Hyonny,9999,0,9999,0
1708253496657,SE 296,008,447737,Kim; Hyunsun Alicia,9999,0,9999,0
1708253496657,SE 296,009,447738,Kosmatka; John B,9999,0,9999,0
1708253496657,SE 296,010,447739,Krysl; Petr,9999,0,9999,0
1708253496657,SE 296,011,447740,Kuester; Falko,9999,0,9999,0
1708253496657,SE 296,012,447741,Lanza Di Scalea; Francesco,9999,0,9999,0
1708253496657,SE 296,013,447742,Loh; Kenneth J. H.,9999,0,9999,0
1708253496657,SE 296,014,447745,McCartney; John Scott,9999,0,9999,0
1708253496657,SE 296,015,447747,Morrison; Machel Leigh,9999,0,9999,0
1708253496657,SE 296,016,447749,Mosqueda; Gilberto,9999,0,9999,0
1708253496657,SE 296,017,447874,Qiao; Yu,9999,0,9999,0
1708253496657,SE 296,018,447875,Restrepo; Jose,9999,0,9999,0
1708253496657,SE 296,019,447886,Shing; P. Benson,9999,0,9999,0
1708253496657,SE 296,020,447887,Todd; Michael,9999,0,9999,0
1708253496657,SE 296,021,447888,Tomac; Ingrid,9999,0,9999,0
1708253496657,SE 296,022,447889,Tsampras; Georgios,9999,0,9999,0
1708253496657,SE 296,023,447890,Uang; Chia-Ming,9999,0,9999,0
1708253496657,SE 296,024,447931,Van Den Einde; Yael Dahlia,9999,0,9999,0
1708253496657,SE 296,025,447932,Zhu; Qiang,9999,0,9999,0
1708253496657,SE 296,026,448007,Tehrani; Mehran,9999,0,9999,0
1708253496657,SE 296,027,448008,Palermo; Alessandro,9999,0,9999,0
1708253496657,SE 296,028,492941,Farrar; Charles R.,9998,0,9999,1
1708253497183,SIO 10,A00,446025,Borsa; Adrian Antal,573,0,590,17
1708253497708,SIO 16,A00,446031,Gee; Jeffrey S,119,0,120,1
1708253498236,SIO 50,A01,446057,Cook; Geoffrey W,19,0,22,3
1708253498236,SIO 50,A02,446058,Cook; Geoffrey W,21,0,22,1
1708253498762,SIO 75,A00,446060,Norris; Richard D.,32,0,35,3
1708253499288,SIO 87,A00,479215,Feddersen; Falk & Morzfeld; Matthias,20,0,20,0
1708253499288,SIO 87,B00,489613,Cook; Geoffrey W,19,0,20,1
1708253499288,SIO 87,C00,489620,Cook; Geoffrey W,20,0,20,0
1708253499813,SIO 90,A00,446061,Staff,61,0,70,9
1708253500344,SIO 113,A01,446064,May; David Alexander,27,0,30,3
1708253501397,SIO 128,A00,446115,Bartlett; Douglas H,110,0,120,10
1708253501928,SIO 135,A01,446153,Fricker; Helen A.,16,0,17,1
1708253501928,SIO 135,A02,446156,Fricker; Helen A.,14,0,18,4
1708253502455,SIO 136,A01,446159,Kacev; David & Wegner; Nicholas Craig & Bartlett; Douglas H,31,0,33,2
1708253502455,SIO 136,A02,446160,Kacev; David & Wegner; Nicholas Craig & Bartlett; Douglas H,33,0,33,0
1708253502983,SIO 139,A00,446164,Kacev; David,66,0,70,4
1708253503514,SIO 141,A01,446173,Pomeroy; Robert S.,11,0,12,1
1708253504040,SIO 143,A01,446175,Andersson; Andreas Jerry,20,0,30,10
1708253504567,SIO 145,A01,446181,Choy; Carolyn Anela,6,0,18,12
1708253505095,SIO 152,A01,446184,Van Allen; Emily Joyce,8,0,10,2
1708253505095,SIO 152,A02,479204,Van Allen; Emily Joyce,10,0,10,0
1708253505621,SIO 153,A01,446188,Capaldi; Tomas,24,0,26,2
1708253506148,SIO 160,A00,446189,Stegman; David,21,0,25,4
1708253506677,SIO 164,A00,446193,Staff,27,0,35,8
1708253507203,SIO 173,A00,446194,Lutsko; Nicholas J.,28,0,30,2
1708253507732,SIO 174,A00,446197,Aluwihare; Lihini & Russell; Lynn M.,26,0,30,4
1708253508258,SIO 181,A01,446200,Tresguerres; Martin,18,0,25,7
1708253508258,SIO 181,A02,446201,Tresguerres; Martin,23,0,25,2
1708253508258,SIO 181,A03,446209,Tresguerres; Martin,24,0,25,1
1708253508258,SIO 181,A04,446211,Tresguerres; Martin,24,0,25,1
1708253508258,SIO 181,A05,446223,Tresguerres; Martin,24,0,25,1
1708253508258,SIO 181,A06,446236,Tresguerres; Martin,24,0,25,1
1708253508783,SIO 192,A00,479211,Gerwick; William Henry,20,0,20,0
1708253509312,SIO 194,A00,455340,Hill; Seth J,0,0,0,0
1708253509839,SIOB 262,A00,446243,Gerwick; William Henry,23,0,25,2
1708253510365,SIOB 269,A00,446244,Staff,19,0,20,1
1708253510892,SIOB 270,A01,446261,Allen; Andrew Ellis & Petrik; Colleen Mary,18,0,20,2
1708253511421,SIOB 278,A00,446273,Arcila; Dahiana K,13,0,15,2
1708253511421,SIOB 278,B00,481742,Aburto Oropeza; Marco Octavio,18,0,20,2
1708253511951,SIOB 279,A00,446286,Franks; Peter,31,0,35,4
1708253512478,SIOB 291,A00,446292,Hechinger; Ryan F.,20,0,20,0
1708253513004,SIOB 296,A00,446293,Mongiardino Koch; Nicolas,16,0,20,4
1708253513532,SIOB 297,A00,446294,Allen; Eric,66,0,70,4
1708253514060,SIOC 202B,A00,446312,Stramski; Dariusz & Gabriel; Anne Alice-Agnes,17,0,20,3
1708253514588,SIOC 203C,A01,446314,Young; William Roy,5,0,5,0
1708253515118,SIOC 207C,A00,492798,Vasconcelos; Manuela,5,0,5,0
1708253515644,SIOC 208,A00,446315,Merrifield; Mark A,16,0,20,4
1708253516170,SIOC 209,A00,478924,Werner; Bradley T.,11,0,15,4
1708253516170,SIOC 209,B00,479224,Watson-Parris; Duncan,15,0,25,10
1708253516170,SIOC 209,C00,480739,Ricke; Katharine L,24,0,24,0
1708253516699,SIOC 212B,A01,446324,Cessi; Paola,40,0,40,0
1708253517227,SIOC 217C,A00,446325,Lutsko; Nicholas J.,25,0,25,0
1708253517753,SIOC 220,A00,446326,Rudnick; Daniel Lars,13,0,15,2
1708253518278,SIOC 224,A00,446327,Eisenman; Ian,20,0,25,5
1708253518805,SIOC 228,A00,446328,Shi; Yuanyuan,1,0,10,9
1708253519332,SIOC 235,A00,446342,Xie; Shang-Ping,14,0,15,1
1708253519859,SIOC 251,A00,446343,Evan; Amato Tomas,19,0,20,1
1708253520385,SIOG 200B,A00,446344,Gabriel; Anne Alice-Agnes,9,0,10,1
1708253520913,SIOG 221,A00,446354,Parnell-Turner; Ross Ernes,29,0,30,1
1708253521440,SIOG 227B,A00,446355,Laske; Gabi & Shearer; Peter M,19,0,20,1
1708253521966,SIOG 228,A00,446356,Van Allen; Emily Joyce,7,0,20,13
1708253522495,SIOG 230,A00,446359,Constable; Catherine G,25,0,25,0
1708253523021,SIOG 232,A00,446360,Constable; Catherine G & Constable; Steven C,37,0,40,3
1708253523551,SIOG 234,A00,446361,Sandwell; David T,15,0,15,0
1708253524078,SIOG 236,A01,477658,Fricker; Helen A.,5,0,5,0
1708253524078,SIOG 236,A02,477685,Fricker; Helen A.,3,0,5,2
1708253524605,SIOG 239,A00,446362,Gabriel; Anne Alice-Agnes,19,0,20,1
1708253524605,SIOG 239,B00,481507,May; David Alexander,6,0,6,0
1708253524605,SIOG 239,C00,486863,Fialko; Yuri A.,15,0,15,0
1708253525134,SIOG 268,A00,446364,Barbeau; Katherine,12,0,15,3
1708253525664,SOCE 194,A00,455341,Hill; Seth J,0,0,0,0
1708253526190,SOCG 204,A00,446551,Ng; Kwai,0,0,8,8
1708253526716,SOCG 206,A00,446552,Alvarez; Camila Huerta,4,0,8,4
1708253527246,SOCG 214,A00,446553,Raudenbush; Danielle,3,0,8,5
1708253527774,SOCG 255B,A00,446602,Serlin; David,2,0,5,3
1708253528304,SOCG 255C,A00,446813,Gates; Kelly,3,0,5,2
1708253528828,SOCG 290,A00,446910,Thorpe; Charles Robert,0,0,10,10
1708253528828,SOCG 290,B00,446911,Goldman; Harvey Stern,1,0,10,9
1708253528828,SOCG 290,C00,446914,Lampland; Martha,5,0,10,5
1708253529354,SOCI 2,A01,446373,Rogers; Julia Ellen,28,0,30,2
1708253529354,SOCI 2,A02,446374,Rogers; Julia Ellen,29,0,30,1
1708253529354,SOCI 2,A03,446382,Rogers; Julia Ellen,29,0,30,1
1708253529354,SOCI 2,A04,446384,Rogers; Julia Ellen,30,0,30,0
1708253529354,SOCI 2,A05,446389,Rogers; Julia Ellen,30,0,30,0
1708253529354,SOCI 2,A06,446393,Rogers; Julia Ellen,29,0,30,1
1708253529879,SOCI 20,A01,446396,Calderon-Zaks; Michael Aar,33,0,34,1
1708253529879,SOCI 20,A02,446409,Calderon-Zaks; Michael Aar,34,0,34,0
1708253530406,SOCI 40,A01,446417,Raudenbush; Danielle,30,0,32,2
1708253530406,SOCI 40,A02,446419,Raudenbush; Danielle,31,0,32,1
1708253530406,SOCI 40,A03,446434,Raudenbush; Danielle,31,0,32,1
1708253530406,SOCI 40,A04,446436,Raudenbush; Danielle,28,0,32,4
1708253530406,SOCI 40,A05,446441,Raudenbush; Danielle,29,0,32,3
1708253530406,SOCI 40,A06,446445,Raudenbush; Danielle,32,0,32,0
1708253530935,SOCI 60,A01,446461,Sutton; April Marie,30,0,32,2
1708253530935,SOCI 60,A02,446468,Sutton; April Marie,30,0,32,2
1708253530935,SOCI 60,A03,446469,Sutton; April Marie,26,0,32,6
1708253530935,SOCI 60,A04,446471,Sutton; April Marie,31,0,32,1
1708253531461,SOCI 100,A01,446480,Payne; Christine Anna,28,0,30,2
1708253531461,SOCI 100,A02,446491,Payne; Christine Anna,29,0,30,1
1708253531461,SOCI 100,A03,446492,Payne; Christine Anna,28,0,30,2
1708253531461,SOCI 100,A04,446493,Payne; Christine Anna,27,0,30,3
1708253531986,SOCI 103M,A00,481672,Kilpatrick; Kevin,27,0,28,1
1708253532511,SOCI 104,A00,446494,Turner; Christena L.,28,0,30,2
1708253533038,SOCI 104Q,A00,446495,Rogers; Julia Ellen,27,0,30,3
1708253533640,SOCI 106,A00,446496,Payne; Christine Anna,25,0,30,5
1708253534168,SOCI 107,A00,446497,Staff,30,0,30,0
1708253534696,SOCI 109,A00,446498,Rona-Tas; Akos,20,0,25,5
1708253535223,SOCI 111,A00,446499,Ribas Norris; Janet Vanesa,54,0,56,2
1708253535749,SOCI 114,A00,446500,Lampland; Martha,73,0,75,2
1708253536277,SOCI 117,A01,446502,Jones; Gabrielle Anastasia,14,0,17,3
1708253536277,SOCI 117,A02,446516,Jones; Gabrielle Anastasia,17,0,17,0
1708253536277,SOCI 117,A03,458787,Jones; Gabrielle Anastasia,17,0,17,0
1708253536277,SOCI 117,A04,458835,Jones; Gabrielle Anastasia,19,0,19,0
1708253536802,SOCI 120T,A00,446518,Staff,56,0,56,0
1708253537328,SOCI 123,A00,446519,Staff,79,0,80,1
1708253537854,SOCI 125,A00,487186,Calderon-Zaks; Michael Aar,55,0,56,1
1708253538384,SOCI 126,A01,446532,Jones; Makeba,15,0,15,0
1708253538384,SOCI 126,A02,446533,Jones; Makeba,15,0,15,0
1708253538384,SOCI 126,A03,458839,Jones; Makeba,15,0,15,0
1708253538384,SOCI 126,A04,458840,Jones; Makeba,15,0,15,0
1708253538910,SOCI 133,A00,446534,Calderon-Zaks; Michael Aar,53,0,56,3
1708253539440,SOCI 135,A00,486886,Ruiz; Jonathan Joseph,55,0,56,1
1708253539965,SOCI 136,A00,486887,Ruiz; Jonathan Joseph,56,0,56,0
1708253540494,SOCI 139,A00,446535,Ribas Norris; Janet Vanesa,78,0,80,2
1708253541021,SOCI 140J,A00,446537,Estefan; Michel,75,0,100,25
1708253541547,SOCI 142,A00,477639,Crofts; Christine,43,0,50,7
1708253542075,SOCI 146,A00,446538,Summers; Valerie R.,113,0,120,7
1708253542601,SOCI 151,A00,446540,Goldman; Harvey Stern,56,0,56,0
1708253543128,SOCI 156,A00,446541,Ostovany; Khashayar,55,0,56,1
1708253543656,SOCI 157,A00,446542,Jules-Rosette; Bennetta W.,28,0,28,0
1708253544181,SOCI 159,A00,494493,Estefan; Michel,93,0,96,3
1708253544707,SOCI 161,A00,477638,Staff,45,0,45,0
1708253545236,SOCI 162,A00,477642,Staff,54,0,55,1
1708253545762,SOCI 165,A00,446543,Rona-Tas; Akos,49,0,56,7
1708253546290,SOCI 171,A00,446544,Thorpe; Charles Robert,56,0,56,0
1708253546817,SOCI 173,A00,482888,Crofts; Christine,92,0,100,8
1708253547347,SOCI 180,A00,446545,Ostovany; Khashayar,55,0,56,1
1708253547872,SOCI 183,A00,446546,Sutton; April Marie,43,0,45,2
1708253548401,SOCI 185,A00,494495,Staff,30,0,30,0
1708253548926,SOCI 188D,A00,446549,Kokinis; Troy Andreas,24,0,25,1
1708253549454,SOCI 198RA,001,446550,Ng; Kwai,30,0,30,0
1708253549985,SOMC 224C,A00,466928,Bhakta; Savita Ganapathi,160,0,160,0
1708253550510,SOMC 229,A00,466925,Hoang; Mai Phuong,160,0,160,0
1708253551036,SOMC 240,A00,466937,Coyne; Christopher John,150,0,150,0
1708253551564,SOMC 242,A00,466931,Kline; Ahnika Sarah,160,0,160,0
1708253552092,SOMC 244,A00,466939,Mandel; Jess,150,0,150,0
1708253552617,SOMC 245C,A01,466935,Noel; Geoffroy Pierre Jean,160,0,160,0
1708253553143,SOMC 246C,A00,487163,Eyler; Lisa T.,160,0,160,0
1708253553669,SOMC 247C,A50,466950,Calcutt; Nigel A,160,0,160,0
1708253554194,SOMC 248C,A00,466936,Joshi; Weena Erin,160,0,160,0
1708253554720,SOMC 255C,A00,466951,Allison; Matthew,160,0,160,0
1708253555248,SPPH 161R,A01,476600,Chambers; Christina D,99,0,100,1
1708253555773,SPPH 263B,A01,460901,Hook; Vivian Yuan-Ho,25,0,25,0
1708253556301,SPPS 200A,A00,460907,Luli; Alex J,99,0,99,0
1708253556828,SPPS 200B,A00,460928,Luli; Alex J,99,0,99,0
1708253557357,SPPS 200C,A00,460934,Luli; Alex J,95,0,99,4
1708253557882,SPPS 203,A00,460955,Painter; Nathan A.,83,0,99,16
1708253558410,SPPS 205,A01,460978,Bandeira; Nuno Filipe Cabrita,64,0,80,16
1708253558936,SPPS 209,A00,460979,Bounthavong; Mark,94,0,99,5
1708253559462,SPPS 210,001,460980,Gustafsson; Asa Birgitta,99,0,99,0
1708253559990,SPPS 211A,A00,460987,Ferguson; Fleur,85,0,99,14
1708253560518,SPPS 211B,A00,460991,Ferguson; Fleur,96,0,99,3
1708253561044,SPPS 211C,A00,460992,Ferguson; Fleur,95,0,99,4
1708253561573,SPPS 211D,A00,460993,Tsunoda; Shirley M.,99,0,99,0
1708253562098,SPPS 212C,A01,460995,Saunders; Ila Maewal,95,0,99,4
1708253562630,SPPS 213C,A00,460996,Awdishu; Linda,95,0,99,4
1708253563159,SPPS 218B,A00,460997,Mandyam; Chitra,95,0,99,4
1708253563685,SPPS 225,A01,460999,Reed; Chantal,83,0,99,16
1708253564214,SPPS 236,A00,461000,Reid; Erin G.,96,0,99,3
1708253564739,SPPS 237,A00,461002,Mimoto; Mizuho Stacy,96,0,99,3
1708253565267,SPPS 238,A00,461041,Beyhan; Sinem,96,0,99,3
1708253565791,SPPS 241,A01,461122,Tsunoda; Shirley M.,83,0,99,16
1708253566320,SPPS 249,A00,461123,Brandl; Katharina,96,0,99,3
1708253566846,SPPS 250,A00,461126,Tsunoda; Shirley M.,45,0,50,5
1708253567371,SPPS 251,A00,461127,Chen; Timothy,99,0,99,0
1708253567898,SPPS 252,A00,461128,Abdul-Mutakabbir; Jacinda,74,0,80,6
1708253568424,SPPS 254,A00,481670,Shapiro; Desiree Nicolette,77,0,80,3
1708253568953,SPPS 261,A00,461129,Chambers; Christina D,93,0,99,6
1708253569478,SPPS 278,A00,459983,Fricovsky; Eduardo Santiago,98,0,99,1
1708253570006,SPPS 280,A00,461259,Fricovsky; Eduardo Santiago,19,0,20,1
1708253570531,SPPS 283,A00,461283,Tsunoda; Shirley M.,96,0,99,3
1708253571065,SURG 261,A00,466973,Staff,50,0,50,0
1708253571593,SURG 296,001,467004,Agha Hosseini; Ava,49,0,50,1
1708253571593,SURG 296,002,467005,Hinchcliff; Katharine Moss,49,0,50,1
1708253571593,SURG 296,003,467006,Eliceiri; Brian,49,0,50,1
1708253572134,SYN 1,001,448577,Bishop; Graham,19,0,20,1
1708253572134,SYN 1,002,448578,Iatarola; Briana Marie,19,0,20,1
1708253572134,SYN 1,003,448579,Browne; Emily,20,0,20,0
1708253572134,SYN 1,004,448580,Vega; Adrian,20,0,20,0
1708253572134,SYN 1,005,448581,Browne; Emily,20,0,20,0
1708253572134,SYN 1,006,448582,Rock; Martin,20,0,20,0
1708253572134,SYN 1,007,448583,Rock; Martin,20,0,20,0
1708253572134,SYN 1,008,448584,Iatarola; Briana Marie,19,0,20,1
1708253572134,SYN 1,009,448585,Bishop; Graham,20,0,20,0
1708253572134,SYN 1,010,448586,Bishop; Graham,20,0,20,0
1708253572134,SYN 1,011,448587,Gladstein; Jill M,15,0,15,0
1708253572134,SYN 1,012,448588,Meyer; Leslie Rose,20,0,20,0
1708253572134,SYN 1,013,448589,Rosenberg; Ryan Glenn,20,0,20,0
1708253572134,SYN 1,014,448627,Rosenberg; Ryan Glenn,19,0,20,1
1708253572134,SYN 1,015,448630,Atkinson; Arthur Laird,20,0,20,0
1708253572134,SYN 1,016,448651,Hom; Kirstyn Courtney,20,0,20,0
1708253572134,SYN 1,017,448652,Difruscio; Mark,20,0,20,0
1708253572134,SYN 1,018,448669,Hom; Kirstyn Courtney,20,0,20,0
1708253572134,SYN 1,019,448674,Hom; Kirstyn Courtney,18,0,20,2
1708253572134,SYN 1,020,448675,Atkinson; Arthur Laird,20,0,20,0
1708253572134,SYN 1,021,448678,Gladstein; Jill M,15,0,15,0
1708253572134,SYN 1,022,448682,Iatarola; Briana Marie,20,0,20,0
1708253572134,SYN 1,023,448691,Birberick; Brittany Celest,20,0,20,0
1708253572134,SYN 1,024,448751,Birberick; Brittany Celest,20,0,20,0
1708253572134,SYN 1,027,448766,Deavenport; James Cary,19,0,20,1
1708253572134,SYN 1,028,448767,Meyer; Leslie Rose,20,0,20,0
1708253572134,SYN 1,029,448775,Tawater; Hanna Jean,20,0,20,0
1708253572134,SYN 1,030,448777,Tawater; Hanna Jean,20,0,20,0
1708253572134,SYN 1,031,448792,Deavenport; James Cary,20,0,20,0
1708253572134,SYN 1,032,480169,Tawater; Hanna Jean,18,0,20,2
1708253572663,SYN 1R,001,448793,Difruscio; Mark,20,0,20,0
1708253572663,SYN 1R,004,449146,Difruscio; Mark,20,0,20,0
1708253573193,SYN 100,A01,449148,Staff,11,0,15,4
1708253573193,SYN 100,A02,449149,Staff,15,0,15,0
1708253573193,SYN 100,B01,449164,Gladstein; Jill M,0,0,0,0
1708253573193,SYN 100,B02,449166,Gladstein; Jill M,0,0,0,1
1708253573193,SYN 100,C01,449244,Staff,7,0,15,8
1708253573193,SYN 100,C02,449274,Staff,13,0,15,2
1708253573193,SYN 100,D01,449278,Staff,20,0,20,0
1708253573193,SYN 100,D02,449279,Staff,20,0,20,0
1708253573193,SYN 100,E01,449281,Rock; Martin,9,0,15,6
1708253573193,SYN 100,E02,449282,Rock; Martin,14,0,15,1
1708253573193,SYN 100,F01,449304,Browne; Emily,12,0,15,3
1708253573193,SYN 100,F02,449306,Browne; Emily,14,0,15,1
1708253573193,SYN 100,I01,449390,Gormally; Brenna,0,0,0,0
1708253573193,SYN 100,I02,449391,Gormally; Brenna,0,0,0,0
1708253573193,SYN 100,J01,449401,Atkinson; Arthur Laird,11,0,15,4
1708253573193,SYN 100,J02,449402,Atkinson; Arthur Laird,14,0,15,1
1708253573193,SYN 100,K01,449404,Deavenport; James Cary,11,0,15,4
1708253573193,SYN 100,K02,449405,Deavenport; James Cary,14,0,15,1
1708253573193,SYN 100,L01,449408,Rosenberg; Ryan Glenn,10,0,15,5
1708253573193,SYN 100,L02,449420,Rosenberg; Ryan Glenn,15,0,15,0
1708253573717,SYN 150,001,450016,Vega; Adrian,19,0,19,0
1708253573717,SYN 150,003,450031,Birberick; Brittany Celest,20,0,20,0
1708253574248,SYN 150R,001,494950,Vega; Adrian,20,0,20,0
1708253574774,SYN 198,001,494388,Staff,9999,0,9999,0
1708253575305,TDAC 1,A00,450042,Walsh; Kim C.,14,0,20,6
1708253575305,TDAC 1,B00,450043,Walsh; Kim C.,11,0,20,9
1708253575305,TDAC 1,C00,450044,Walsh; Kim C.,15,0,20,5
1708253575305,TDAC 1,D00,486830,Basso; Beatrice,20,0,20,0
1708253575305,TDAC 1,E00,492912,Walsh; Kim C.,15,0,20,5
1708253575305,TDAC 1,F00,492936,Walsh; Kim C.,18,0,20,2
1708253575832,TDAC 101,A00,450895,Celik; Aysan Karagasli,18,0,20,2
1708253576358,TDAC 102,A00,450904,Walsh; Kim C.,20,0,20,0
1708253576358,TDAC 102,B00,450916,Harting; Carla Kelso,20,0,20,0
1708253576892,TDAC 108,A00,450917,Buescher; Stephen W.,18,0,20,2
1708253577418,TDAC 109,A00,450924,Blair; Kyle Adam,20,0,20,0
1708253577943,TDAC 122,A00,451025,Perry; Lamar,30,0,30,0
1708253577943,TDAC 122,B00,480845,Perry; Lamar,30,0,30,0
1708253578484,TDAC 123,A00,451026,Buescher; Stephen W.,30,0,30,0
1708253578484,TDAC 123,B00,451028,Celik; Aysan Karagasli,30,0,30,0
1708253578484,TDAC 123,C00,480851,Perry; Lamar,30,0,30,0
1708253579010,TDDE 101,A00,451030,Guirguis; Mark C,18,0,20,2
1708253579536,TDDE 112,A00,451032,Staff,20,0,20,0
1708253580064,TDDE 130,A00,451033,Guirguis; Mark C,19,0,20,1
1708253580590,TDDE 132,A00,451034,Guirguis; Mark C,20,0,20,0
1708253581117,TDDE 169A,A00,481304,Petrovich; Victoria A.,19,0,20,1
1708253581642,TDDM 1,A00,450045,Weinberg; Sadie,27,0,30,3
1708253582168,TDDM 101,A00,451067,Staff,29,0,30,1
1708253582697,TDDR 101,A00,451068,Powell; Lora,29,0,34,5
1708253583223,TDDR 102,A00,451069,Powell; Lora,19,0,20,1
1708253583749,TDDR 111,A00,451070,Castro; Robert Jess,15,0,16,1
1708253583749,TDDR 111,B00,451071,Castro; Robert Jess,15,0,16,1
1708253584278,TDDR 190,A00,451073,Perry; Lamar,1,0,1,0
1708253584806,TDGE 1,A01,450047,Salovey; Todd,20,0,20,0
1708253584806,TDGE 1,A02,450048,Salovey; Todd,20,0,20,0
1708253584806,TDGE 1,A03,450085,Salovey; Todd,18,0,20,2
1708253584806,TDGE 1,A04,450093,Salovey; Todd,20,0,20,0
1708253584806,TDGE 1,A05,450096,Salovey; Todd,19,0,20,1
1708253584806,TDGE 1,A06,450132,Salovey; Todd,16,0,20,4
1708253585334,TDGE 25,A00,450236,Harting; Carla Kelso,12,0,20,8
1708253585334,TDGE 25,B00,450240,Harting; Carla Kelso,16,0,20,4
1708253585334,TDGE 25,C00,450243,Harting; Carla Kelso,14,0,20,6
1708253585334,TDGE 25,D00,450388,Harting; Carla Kelso,16,0,20,4
1708253585864,TDGE 100,A01,451098,Salovey; Todd,24,0,25,1
1708253585864,TDGE 100,A02,451099,Salovey; Todd,24,0,25,1
1708253586390,TDGE 124,A00,451122,Fulton; Julia,168,0,200,32
1708253586973,TDGE 125,A00,480853,Havis; Allan,197,0,200,3
1708253586973,TDGE 125,B00,480886,Staff,216,0,220,4
1708253587499,TDGE 133,A00,481097,Brill; Robert L.,20,0,20,0
1708253588026,TDGE 196B,A00,493144,Barricelli; Marc Alexander,1,0,1,0
1708253588026,TDGE 196B,B00,493148,Buescher; Stephen W.,2,0,2,0
1708253588026,TDGE 196B,C00,493151,Burelle; Julie Sara Veronique,1,0,1,0
1708253588026,TDGE 196B,D00,493189,Castro; Robert Jess,2,0,2,0
1708253588026,TDGE 196B,E00,493190,Guirguis; Mark C,1,0,1,0
1708253588026,TDGE 196B,F00,493240,Iizuka; Naomi Hisako,1,0,1,0
1708253588026,TDGE 196B,G00,493241,Perry; Lamar,1,0,1,0
1708253588026,TDGE 196B,H00,493249,Powell; Lora,1,0,1,0
1708253588026,TDGE 196B,I00,493296,Stein; Deborah Isobel,6,0,6,0
1708253588557,TDGR 213C,A00,451385,Buescher; Stephen W.,10,0,10,0
1708253589081,TDGR 220A,A00,451386,Barricelli; Marc Alexander,10,0,10,0
1708253589606,TDGR 239,A00,451387,Blair; Kyle Adam,10,0,10,0
1708253590137,TDGR 240,A00,481306,Portes; Elizabeth Marie,5,0,5,0
1708253590662,TDGR 245,A00,451388,Perry; Lamar,7,0,7,0
1708253591187,TDGR 250,A00,451395,Iizuka; Naomi Hisako,8,0,10,2
1708253591716,TDGR 251,A00,451397,Iizuka; Naomi Hisako,9,0,10,1
1708253591716,TDGR 251,B00,451398,Stein; Deborah Isobel,9,0,10,1
1708253592241,TDGR 257B,A00,451399,Finch; Michael S,8,0,10,2
1708253592775,TDGR 278,A00,481307,Petrovich; Victoria A.,4,0,5,1
1708253593305,TDGR 279,A00,451400,Bokovikova; Alina V,9,0,10,1
1708253593305,TDGR 279,B00,451401,Brill; Robert L.,10,0,10,0
1708253593305,TDGR 279,C00,451402,Petrovich; Victoria A.,10,0,10,0
1708253593305,TDGR 279,D00,451403,McElver; Robert Harrison,10,0,10,0
1708253593305,TDGR 279,E00,451404,Kuhl; Christopher August,10,0,10,0
1708253593832,TDGR 286,A00,451405,Knox; Leila Elizabeth,9,0,10,1
1708253594357,TDGR 288,A00,451406,Powell; Lora,6,0,7,1
1708253594886,TDGR 292,A00,451407,Power; Jade Yukana,10,0,10,0
1708253594886,TDGR 292,B00,451408,Mehrishi; Rishika,10,0,10,0
1708253595417,TDGR 293,001,451417,Power; Jade Yukana,7,0,7,0
1708253595417,TDGR 293,002,451418,Burelle; Julie Sara Veronique,7,0,7,0
1708253595417,TDGR 293,003,451419,Yapp; Hentyle T,7,0,7,0
1708253595417,TDGR 293,005,451421,Anderson; Mysia Anyse,7,0,7,0
1708253595942,TDGR 294,001,451429,Burelle; Julie Sara Veronique,7,0,7,0
1708253595942,TDGR 294,002,451431,Power; Jade Yukana,7,0,7,0
1708253595942,TDGR 294,003,451432,Yapp; Hentyle T,7,0,7,0
1708253596467,TDGR 295,A00,451433,Barricelli; Marc Alexander,10,0,10,0
1708253596992,TDGR 296,A00,451489,Powell; Lora,6,0,7,1
1708253596992,TDGR 296,B00,451497,Porter; Lisa,6,0,7,1
1708253597521,TDHD 175,A00,451123,Jun; Grace Shin Hae,40,0,40,0
1708253598053,TDHD 176,A00,451124,Caligagan; Maria T.,40,0,40,0
1708253598582,TDHT 10,A00,450409,Power; Jade Yukana,20,0,20,0
1708253598582,TDHT 10,B00,450450,Power; Jade Yukana,19,0,20,1
1708253599108,TDHT 23,A01,450546,Salimi; Rana,24,0,24,0
1708253599108,TDHT 23,A02,450549,Salimi; Rana,22,0,24,2
1708253599108,TDHT 23,A03,450553,Salimi; Rana,24,0,24,0
1708253599633,TDHT 101,A00,451125,Anderson; Mysia Anyse,25,0,25,0
1708253599633,TDHT 101,B00,451126,Mehrishi; Rishika,23,0,25,2
1708253600162,TDHT 104,A00,451225,Basso; Beatrice,22,0,25,3
1708253600688,TDHT 109,A01,451227,Anderson; Mysia Anyse,25,0,25,0
1708253601216,TDHT 122,A00,451228,Power; Jade Yukana,21,0,25,4
1708253601741,TDMV 1,A00,450558,Caligagan; Maria T.,15,0,30,15
1708253602268,TDMV 2,A00,450627,Anabo; Cherry,24,0,30,6
1708253602797,TDMV 3,A00,450630,Arcidiacono; Kristin,37,0,40,3
1708253603323,TDMV 11,A00,481244,Fyall; DauntÉ Edward,30,0,30,0
1708253603852,TDMV 20,A00,450789,Smith; Alison D,38,0,40,2
1708253604377,TDMV 110,A00,451229,Caligagan; Maria T.,28,0,30,2
1708253604904,TDMV 111,A00,451234,Smith; Alison D,28,0,30,2
1708253605431,TDMV 120,A00,451260,Weinberg; Sadie,30,0,30,0
1708253605431,TDMV 120,B00,451261,Sammartano; Tonnie,30,0,30,0
1708253605960,TDMV 122,A00,451262,Staff,28,0,30,2
1708253606486,TDMV 123,A00,451263,Duran; Marcos Antonio,28,0,30,2
1708253607011,TDMV 130,A00,451272,Mack; Kara Shanai',30,0,30,0
1708253607538,TDMV 138,A00,451275,Jun; Grace Shin Hae,4,0,30,26
1708253608065,TDMV 140,A00,451276,Lima; Paulo Henrique,40,0,40,0
1708253608065,TDMV 140,B00,451308,Power; Jade Yukana,39,0,40,1
1708253608065,TDMV 140,C00,451371,Caligagan; Tony,40,0,40,0
1708253608065,TDMV 140,D00,451373,Corrales; Joseph Bernales,28,0,30,2
1708253608594,TDMV 141,A00,451374,Caligagan; Tony,26,0,30,4
1708253609120,TDMV 142,A00,451375,Blanco; Juan Carlos,26,0,40,14
1708253609648,TDMV 143,A00,451376,Fyall; DauntÉ Edward,39,0,40,1
1708253610174,TDMV 144,A00,451377,Anabo; Cherry,39,0,40,1
1708253610702,TDMV 149,A00,451378,Jun; Grace Shin Hae,36,0,40,4
1708253611232,TDPF 162,A00,451379,Alvarez; Ana Maria,40,0,40,0
1708253611757,TDPR 6,A01,450799,Guirguis; Mark C,50,0,50,0
1708253611757,TDPR 6,A02,450801,Guirguis; Mark C,50,0,50,0
1708253612285,TDPR 102,A00,451380,Guirguis; Mark C,20,0,20,0
1708253612840,TDPR 104,A00,451381,Powell; Lora,15,0,15,0
1708253613366,TDPW 1,A00,450808,Stein; Deborah Isobel,14,0,15,1
1708253613366,TDPW 1,B00,450864,Stein; Deborah Isobel,13,0,15,2
1708253613366,TDPW 1,C00,450865,Stein; Deborah Isobel,15,0,15,0
1708253613366,TDPW 1,D00,450868,Stein; Deborah Isobel,13,0,15,2
1708253613366,TDPW 1,E00,450874,Stein; Deborah Isobel,14,0,15,1
1708253613891,TDPW 102,A00,451382,Staff,18,0,20,2
1708253614421,TDPW 104,A00,481182,Staff,17,0,20,3
1708253614948,TDTR 10,A00,450881,Wilson; Terry A.,28,0,30,2
1708253615476,TDTR 15,A00,450882,Smith; Alison D,30,0,30,0
1708253616005,TMC 15,A00,479039,Hemans; Patricia Ann Benitez,25,0,25,0
1708253616531,TMC 87,A00,479049,Solomon; Amanda Lee Albaniel,20,0,20,0
1708253617057,UROL 296,001,467060,Anger; Jennifer Tash,49,0,50,1
1708253617057,UROL 296,002,467061,Staff,50,0,50,0
1708253617584,USP 3,A01,458852,Martin; Isaac,34,0,35,1
1708253617584,USP 3,A02,458853,Martin; Isaac,35,0,35,0
1708253617584,USP 3,A03,458861,Martin; Isaac,34,0,35,1
1708253617584,USP 3,A04,458862,Martin; Isaac,32,0,35,3
1708253618113,USP 4,A00,451772,Schwaller; Nora Louise,19,0,25,6
1708253618639,USP 5,A01,458863,Shenkman; Michael Thomas,33,0,35,2
1708253618639,USP 5,A02,458864,Shenkman; Michael Thomas,31,0,35,4
1708253619167,USP 15,A01,458931,Staff,33,0,35,2
1708253619167,USP 15,A02,459024,Staff,31,0,35,4
1708253619699,USP 25,A00,451786,Sun; Feiyang,57,0,60,3
1708253620229,USP 100,A00,451787,Moses; Kelema Lee,55,0,60,5
1708253620756,USP 108,A00,477594,Martin; Isaac,25,0,25,0
1708253621281,USP 119,A00,477595,Schwaller; Nora Louise,23,0,25,2
1708253621811,USP 124,A00,451790,Hinds; Juli Beth,62,0,70,8
1708253622337,USP 128B,A01,451910,Lewis; Leslie R,12,0,13,1
1708253622867,USP 142B,A01,451954,Lewis; Leslie R,24,0,25,1
1708253623392,USP 142C,A00,451977,Lerner; Amy M,0,0,0,0
1708253623918,USP 145,A00,451999,Yaghmaee; Saman,140,0,146,6
1708253624446,USP 150,A00,452165,Staff,44,0,50,6
1708253624971,USP 151,A00,452166,Staff,49,0,50,1
1708253625497,USP 152A,A01,459025,Weaver; Todd D,25,0,25,0
1708253625497,USP 152A,A02,459074,Weaver; Todd D,24,0,25,1
1708253626025,USP 152B,A00,452224,Moeder; Nathan L,21,0,25,4
1708253626554,USP 153,A00,452339,Shenkman; Michael Thomas,50,0,50,0
1708253627081,USP 158A,A00,452410,Sun; Feiyang,25,0,25,0
1708253627610,USP 159B,A00,452411,Gherini; Paul Pier-Carlo,6,0,8,2
1708253628136,USP 160,A00,452412,Wartell; Julie Dara,25,0,25,0
1708253628665,USP 164,A00,452413,Moses; Kelema Lee,22,0,25,3
1708253629194,USP 165C,A00,452442,Frank; Lawrence Douglas,20,0,20,0
1708253629722,USP 169,A00,452598,Bajaj; Ravi Siddharth,32,0,35,3
1708253630249,USP 170,A00,477593,Entezam; Maryam,60,0,60,0
1708253630780,USP 172,A00,452676,Peerson; Susan,19,0,25,6
1708253631305,USP 175,A00,452848,Velasco; Diego,18,0,20,2
1708253631834,USP 177A,A00,453084,Velasco; Diego,21,0,25,4
1708253632360,USP 177B,A00,453127,Peerson; Susan,22,0,25,3
1708253632886,USP 183,A00,453128,Sutton; April Marie,19,0,20,1
1708253633412,USP 188B,A00,453187,Pezzoli; Keith,30,0,30,0
1708253633937,USP 190,A00,453234,Pezzoli; Keith,0,0,0,1
1708253634462,USP 191B,A00,453240,Polat; Soydan Alihan,18,0,20,2
1708253634991,USP 193,A00,453251,Bussell; Mirle Rabinowitz,24,0,25,1
1708253635516,USP 194,A00,455342,Hill; Seth J,0,0,0,0
1708253636048,USP 265C,A00,453264,Frank; Lawrence Douglas,10,0,10,0
1708253636581,VIS 3,A01,453427,Staff,25,0,25,0
1708253636581,VIS 3,A02,453428,Staff,15,0,25,10
1708253636581,VIS 3,A03,453429,Staff,25,0,25,0
1708253636581,VIS 3,A04,453430,Staff,21,0,25,4
1708253636581,VIS 3,A05,453431,Staff,25,0,25,0
1708253636581,VIS 3,A06,453432,Staff,23,0,25,2
1708253636581,VIS 3,A07,453433,Staff,17,0,25,8
1708253636581,VIS 3,A08,453434,Staff,23,0,25,2
1708253636581,VIS 3,A09,453435,Staff,21,0,25,4
1708253636581,VIS 3,A10,453436,Staff,23,0,25,2
1708253637108,VIS 9,A00,453437,Camargo; William,116,0,146,30
1708253637637,VIS 10,A00,453438,Kiratli; Solen,189,0,200,11
1708253638168,VIS 21B,A01,453440,Shen; Kuiyi,31,0,32,1
1708253638168,VIS 21B,A02,453441,Shen; Kuiyi,31,0,32,1
1708253638168,VIS 21B,A03,453442,Shen; Kuiyi,31,0,32,1
1708253638168,VIS 21B,A04,453443,Shen; Kuiyi,32,0,32,0
1708253638168,VIS 21B,A05,453444,Shen; Kuiyi,32,0,32,0
1708253638168,VIS 21B,A06,453452,Shen; Kuiyi,32,0,32,0
1708253638168,VIS 21B,A07,453468,Shen; Kuiyi,30,0,32,2
1708253638168,VIS 21B,A08,453587,Shen; Kuiyi,32,0,32,0
1708253638695,VIS 22,A01,453589,Rose; Jordan M,32,0,32,0
1708253638695,VIS 22,A02,453590,Rose; Jordan M,32,0,32,0
1708253638695,VIS 22,A03,453615,Rose; Jordan M,31,0,32,1
1708253638695,VIS 22,A04,453616,Rose; Jordan M,32,0,32,0
1708253638695,VIS 22,A05,453617,Rose; Jordan M,30,0,32,2
1708253638695,VIS 22,A06,453618,Rose; Jordan M,30,0,32,2
1708253638695,VIS 22,A07,453620,Rose; Jordan M,32,0,32,0
1708253638695,VIS 22,A08,453621,Rose; Jordan M,32,0,32,0
1708253638695,VIS 22,A09,453635,Rose; Jordan M,32,0,32,0
1708253638695,VIS 22,A10,453636,Rose; Jordan M,32,0,32,0
1708253639222,VIS 31,A00,453637,Dominguez; Ricardo,133,0,146,13
1708253639752,VIS 41,A01,453644,D'Elena-Tweed; Jessica Erin,23,0,25,2
1708253639752,VIS 41,A02,453645,D'Elena-Tweed; Jessica Erin,22,0,25,3
1708253639752,VIS 41,A03,453646,D'Elena-Tweed; Jessica Erin,25,0,25,0
1708253639752,VIS 41,A04,453647,D'Elena-Tweed; Jessica Erin,18,0,25,7
1708253639752,VIS 41,A05,453648,D'Elena-Tweed; Jessica Erin,25,0,25,0
1708253639752,VIS 41,A06,453650,D'Elena-Tweed; Jessica Erin,24,0,25,1
1708253640337,VIS 70N,A01,453652,Garnett; Mariah J,21,0,22,1
1708253640337,VIS 70N,A02,453653,Garnett; Mariah J,21,0,22,1
1708253640337,VIS 70N,A03,453654,Garnett; Mariah J,22,0,22,0
1708253640337,VIS 70N,A04,453657,Garnett; Mariah J,22,0,22,0
1708253640337,VIS 70N,A05,453662,Garnett; Mariah J,20,0,22,2
1708253640337,VIS 70N,A06,453663,Garnett; Mariah J,22,0,22,0
1708253640864,VIS 83,A00,453664,Kester; Grant,137,0,146,9
1708253641390,VIS 101A,A00,453666,Cruz; Edwin Teddy,10,0,15,5
1708253641916,VIS 102,A00,453668,Cruz; Edwin Teddy,81,0,85,4
1708253642442,VIS 105A,A00,453669,Adler; Amy,29,0,30,1
1708253642970,VIS 105B,A00,453738,Herc-Balaszek; Malgorzata,25,0,30,5
1708253642970,VIS 105B,B00,453739,Staff,27,0,30,3
1708253643495,VIS 106A,A00,453740,Staff,22,0,25,3
1708253644022,VIS 106B,A00,453741,De Luca; Mara Julia,20,0,25,5
1708253644552,VIS 106C,A00,453746,Vangenderen; Monique Luise,11,0,15,4
1708253645078,VIS 107A,A00,453747,Gregoire; Mathieu,19,0,25,6
1708253645607,VIS 107B,A00,453748,Dean; Danielle Adobi,23,0,25,2
1708253646132,VIS 110A,A00,453749,Adler; Amy,13,0,15,2
1708253646659,VIS 110E,A00,453798,Gregoire; Mathieu,14,0,15,1
1708253647185,VIS 110F,A00,453799,Staff,15,0,15,0
1708253647711,VIS 110N,A00,453803,Dean; Danielle Adobi,15,0,15,0
1708253648241,VIS 123B,A00,453804,Gaines; Malik Julian,75,0,75,0
1708253648768,VIS 125BN,A00,453813,Welchman; John C.,75,0,75,0
1708253649299,VIS 126P,A00,453814,Wardwell; Mariana Razo,74,0,75,1
1708253649825,VIS 128E,A00,453815,Staff,75,0,75,0
1708253650352,VIS 129E,A00,453855,Shen; Kuiyi,12,0,15,3
1708253650881,VIS 131,A00,453859,Trigilio; Michael,12,0,15,3
1708253650881,VIS 131,B00,479342,Mangolte; Babette,15,0,15,0
1708253651408,VIS 133A,A00,454231,Barbosa; Erika Katrina,13,0,15,2
1708253651934,VIS 134,A00,454232,Yoldas; Pinar,59,0,75,16
1708253652464,VIS 141B,A00,454233,Stalbaum; Brett,12,0,15,3
1708253652995,VIS 145B,A00,454234,Alexander; Amy J,14,0,15,1
1708253652995,VIS 145B,B00,454235,Kiratli; Solen,8,0,15,7
1708253653523,VIS 147A,A01,454237,Stalbaum; Brett,20,0,22,2
1708253653523,VIS 147A,A02,454238,Stalbaum; Brett,18,0,22,4
1708253654050,VIS 157,A01,454240,Cartwright; Lisa,32,0,34,2
1708253654050,VIS 157,A02,454241,Cartwright; Lisa,32,0,34,2
1708253654577,VIS 159,A01,454243,Akten; Mehmet,34,0,34,0
1708253654577,VIS 159,A02,454244,Akten; Mehmet,32,0,34,2
1708253654577,VIS 159,A03,454300,Akten; Mehmet,30,0,34,4
1708253654577,VIS 159,A04,454301,Akten; Mehmet,33,0,34,1
1708253654577,VIS 159,A05,454302,Akten; Mehmet,30,0,34,4
1708253654577,VIS 159,A06,454307,Akten; Mehmet,33,0,34,1
1708253654577,VIS 159,A07,454308,Akten; Mehmet,34,0,34,0
1708253654577,VIS 159,A08,454309,Akten; Mehmet,33,0,34,1
1708253655104,VIS 160B,A00,454310,Alexander; Amy J,13,0,15,2
1708253655104,VIS 160B,B00,454311,Akten; Mehmet,14,0,15,1
1708253655104,VIS 160B,C00,454312,Stone; Patricia,12,0,15,3
1708253655630,VIS 164,A00,454313,Cross; Brian R,19,0,22,3
1708253655630,VIS 164,B00,454314,Camargo; William,22,0,22,0
1708253656160,VIS 165,A00,454315,Erdmann; Dean,22,0,22,0
1708253656686,VIS 167,A00,454316,Staff,18,0,22,4
1708253657214,VIS 169A,A00,454317,Mostajo; Lorena,21,0,22,1
1708253657743,VIS 171,A00,454318,Nakayama; Yue,21,0,22,1
1708253658269,VIS 174,A00,454319,Staff,19,0,22,3
1708253658795,VIS 177,A00,454320,Cho; Erica,21,0,22,1
1708253659322,VIS 178,A00,454321,Staff,0,0,0,0
1708253659849,VIS 179,A00,454322,Erdmann; Dean,22,0,22,0
1708253660378,VIS 180A,A00,454323,Nakayama; Yue,21,0,22,1
1708253660905,VIS 180B,A00,454341,Cross; Brian R,20,0,22,2
1708253661432,VIS 183A,A00,454342,Cho; Erica,17,0,22,5
1708253661958,VIS 185,A00,454343,Miller; Nicole L,18,0,22,4
1708253662484,VIS 190,A00,454360,Crandall; Jordan,15,0,15,0
1708253662484,VIS 190,B00,454361,D'Elena-Tweed; Jessica Erin,10,0,15,5
1708253663015,VIS 202,A00,454369,Miller; Nicole L,12,0,15,3
1708253663544,VIS 203,A00,454370,Garnett; Mariah J,8,0,15,7
1708253664069,VIS 206,A00,454376,Kester; Grant,10,0,15,5
1708253664594,VIS 208,A00,454377,Moss; Ceci,15,0,15,0
1708253665120,VIS 211,A00,454413,Segade; Alexandro Abraham,0,0,0,2
1708253665646,VIS 243,A00,454429,Rose; Jordan M,5,0,15,10
1708253666174,VIS 255,A00,454430,Welchman; John C.,8,0,15,7
1708253666702,VIS 262,A00,454431,Yoldas; Pinar,11,0,15,4
1708253667235,WCWP 10A,001,454442,Uriarte; Emma,17,0,20,3
1708253667235,WCWP 10A,002,454443,Uriarte; Emma,14,0,20,6
1708253667235,WCWP 10A,003,454479,Uriarte; Emma,19,0,20,1
1708253667235,WCWP 10A,004,454480,Staff,0,0,0,0
1708253667235,WCWP 10A,005,454484,Staff,0,0,0,0
1708253667235,WCWP 10A,006,454485,Staff,0,0,0,0
1708253667235,WCWP 10A,007,454487,Staff,0,0,0,0
1708253667235,WCWP 10A,008,454488,Susi; Natalie,14,0,20,6
1708253667235,WCWP 10A,009,454489,Staff,0,0,0,0
1708253667235,WCWP 10A,010,454490,Staff,0,0,0,0
1708253667765,WCWP 10B,001,454492,Ornelas; Tricia,20,0,20,0
1708253667765,WCWP 10B,002,454501,Ornelas; Tricia,20,0,20,0
1708253667765,WCWP 10B,003,454565,Gagnon; Jeffrey C,2,0,20,18
1708253667765,WCWP 10B,004,454604,Ornelas; Tricia,16,0,20,4
1708253667765,WCWP 10B,005,454668,Staff,16,0,16,0
1708253667765,WCWP 10B,006,454724,Staff,16,0,16,0
1708253667765,WCWP 10B,007,454725,Staff,14,0,16,2
1708253667765,WCWP 10B,008,454768,Staff,0,0,0,0
1708253667765,WCWP 10B,009,454769,Staff,0,0,0,0
1708253667765,WCWP 10B,010,454770,Staff,0,0,0,0
1708253667765,WCWP 10B,011,454771,Dhir; Simrita,16,0,20,4
1708253667765,WCWP 10B,012,454772,Dhir; Simrita,16,0,20,4
1708253667765,WCWP 10B,013,454773,Merryman; Walter,17,0,20,3
1708253667765,WCWP 10B,014,454774,Dhir; Simrita,18,0,20,2
1708253667765,WCWP 10B,015,454775,Merryman; Walter,17,0,20,3
1708253667765,WCWP 10B,016,454776,Merryman; Walter,18,0,20,2
1708253667765,WCWP 10B,017,454777,Welji; Haleema Nazir,14,0,16,2
1708253667765,WCWP 10B,018,478868,Staff,16,0,16,0
1708253667765,WCWP 10B,019,478869,Staff,0,0,0,0
1708253667765,WCWP 10B,020,478876,Staff,0,0,0,0
1708253667765,WCWP 10B,021,478877,Staff,0,0,0,0
1708253667765,WCWP 10B,022,478887,Staff,0,0,0,0
1708253667765,WCWP 10B,023,478889,Staff,16,0,16,0
1708253667765,WCWP 10B,024,478892,Staff,0,0,0,0
1708253667765,WCWP 10B,025,478907,Staff,0,0,0,0
1708253668291,WCWP 100,A00,454800,McCleary; Keith Long,20,0,20,0
1708253668291,WCWP 100,B00,454804,McCleary; Keith Long,20,0,20,0
1708253668291,WCWP 100,C00,454822,Twohig; Niall Ivan,19,0,20,1
1708253668291,WCWP 100,D00,454855,Young; Mark T,20,0,20,0
1708253668291,WCWP 100,E00,454860,Twohig; Niall Ivan,19,0,20,1
1708253668291,WCWP 100,F00,454932,Young; Mark T,20,0,20,0
1708253668291,WCWP 100,G00,454933,Young; Mark T,20,0,20,0
1708253668817,WES 207,A00,454941,Kastner; Ryan Charles,20,0,20,0
1708253669345,WES 265,A00,454942,Staff,19,0,20,1
1708253671091,AAS 10,A01,392963,Butler; Elizabeth Annette,34,0,34,0
1708253671091,AAS 10,A02,392965,Butler; Elizabeth Annette,33,0,34,1
1708253671617,AAS 170,A00,392977,Butler; Elizabeth Annette,31,0,32,1
1708253672141,AAS 198,001,479182,Childs; Dennis R.,20,0,20,0
1708253672667,AESE 261,A00,387945,Staff,33,0,33,0
1708253673198,AESE 278D,A00,387953,Staff,33,0,33,0
1708253673725,AESE 278E,A00,387954,Staff,33,0,33,0
1708253674250,AESE 279A,A00,387956,Staff,33,0,33,0
1708253674776,AIP 197P,001,494494,Goldfarb; Brian,9999,0,9999,0
1708253675303,ANAR 100,A00,387884,Shtienberg; Gilad,15,0,16,1
1708253675834,ANAR 104,A01,387886,Tamberino; Anthony Thomas,21,0,25,4
1708253676361,ANAR 111,A00,387888,Staff,36,0,36,0
1708253676887,ANAR 115,A00,387889,Shtienberg; Gilad,36,0,36,0
1708253677415,ANAR 120,A00,387890,Staff,36,0,36,0
1708253677941,ANAR 155,A00,387891,Braswell; Geoffrey E.,15,0,25,10
1708253678471,ANAR 164,A00,387892,Staff,32,0,35,3
1708253678997,ANBI 100,A00,489626,Fox; Patrick Keolu Ozer,39,0,40,1
1708253679525,ANBI 111,A00,387893,Hrvoj Mihic; Branka,37,0,40,3
1708253680584,ANBI 144,A00,387896,Wilder; Linnea Lorene,72,0,75,3
1708253681110,ANBI 149,A00,489628,Non; Amy L,0,0,0,0
1708253681638,ANBI 173,A00,387897,Wilder; Linnea Lorene,74,0,75,1
1708253682168,ANBI 174,A00,489627,Strum; Shirley C.,13,0,15,2
1708253682697,ANES 296,001,463968,Gabriel; Rodney A,49,0,50,1
1708253682697,ANES 296,002,463969,Staff,50,0,50,0
1708253682697,ANES 296,003,463970,Staff,50,0,50,0
1708253683226,ANSC 100,A00,387898,Bialecki; Jon Anthony,40,0,40,0
1708253683752,ANSC 101,A00,387900,Sloane; Julia Kathryn,34,0,40,6
1708253684282,ANSC 117,A00,387901,Martin Sandino; Amanda Maria Yoland,13,0,15,2
1708253684807,ANSC 134,A00,387902,Staff,38,0,40,2
1708253685332,ANSC 137,A00,387903,Stewart; Alexander B,80,0,80,0
1708253685862,ANSC 138,A00,387904,Parish; Steven Martin,14,0,15,1
1708253686389,ANSC 142,A00,387905,Stone; Annika Britt,34,0,40,6
1708253686919,ANSC 147,A00,387906,Stewart; Alexander B,40,0,40,0
1708253687446,ANSC 148,A00,387907,Olivas Hernandez; Olga Lid,92,0,92,0
1708253687980,ANSC 186,A00,387910,Hankins; Joseph D.,28,0,30,2
1708253688505,ANTH 2,A01,387863,Marchetto; Maria Carolina,37,0,40,3
1708253688505,ANTH 2,A02,387864,Marchetto; Maria Carolina,40,0,40,0
1708253688505,ANTH 2,A03,387865,Marchetto; Maria Carolina,36,0,40,4
1708253688505,ANTH 2,A04,387866,Marchetto; Maria Carolina,39,0,40,1
1708253689037,ANTH 3,A01,387868,Stroth; Luke Reyneri,28,0,30,2
1708253689037,ANTH 3,A02,387869,Stroth; Luke Reyneri,29,0,30,1
1708253689037,ANTH 3,A03,387870,Stroth; Luke Reyneri,30,0,30,0
1708253689037,ANTH 3,A04,387871,Stroth; Luke Reyneri,29,0,30,1
1708253689566,ANTH 10,A00,387872,Stewart; Alexander B,80,0,80,0
1708253690092,ANTH 21,A01,387874,Stone; Annika Britt,40,0,40,0
1708253690092,ANTH 21,A02,387875,Stone; Annika Britt,40,0,40,0
1708253690092,ANTH 21,A03,387876,Stone; Annika Britt,40,0,40,0
1708253690092,ANTH 21,A04,387877,Stone; Annika Britt,39,0,40,1
1708253690623,ANTH 23,A01,387879,Staff,40,0,40,0
1708253690623,ANTH 23,A02,387880,Staff,40,0,40,0
1708253690623,ANTH 23,A03,387881,Staff,40,0,40,0
1708253690623,ANTH 23,A04,387882,Staff,40,0,40,0
1708253691149,ANTH 24,A00,387883,Pedersen; David,40,0,40,0
1708253691677,ANTH 103,A00,387911,Staff,343,0,350,7
1708253692207,ANTH 105,A00,387912,Staff,73,0,75,2
1708253692732,ANTH 112,A00,387913,Staff,23,0,25,2
1708253693261,ANTH 120,A00,479486,Parish; Steven Martin,28,0,30,2
1708253693791,ANTH 128B,A01,387923,Lewis; Leslie R,12,0,12,0
1708253694393,ANTH 192,A00,387925,Varma; Saiba,20,0,20,0
1708253694919,ANTH 196C,A00,387927,Varma; Saiba,15,0,15,0
1708253695450,ANTH 212,A00,387931,Marchetto; Maria Carolina,25,0,25,0
1708253695450,ANTH 212,B00,479487,Semendeferi; Ekaterini,25,0,25,0
1708253695976,ANTH 220,A00,387932,Csordas; Thomas J.,9,0,12,3
1708253696501,ANTH 230,001,493297,Goldstein; Paul S,18,0,20,2
1708253697029,ANTH 260,A00,479223,Jenkins; Janis A.,25,0,25,0
1708253697558,ANTH 272,A00,387936,Serlin; David,5,0,5,0
1708253698084,ANTH 273,A00,387938,Gates; Kelly,5,0,5,0
1708253698610,ANTH 288,A00,387940,Braswell; Geoffrey E.,25,0,25,0
1708253699140,ANTH 295,001,493298,Algaze; Guillermo,3,0,3,0
1708253699140,ANTH 295,002,493299,Brenner; Suzanne A,3,0,3,0
1708253699140,ANTH 295,003,493300,Csordas; Thomas J.,3,0,3,0
1708253699140,ANTH 295,004,493422,Fox; Patrick Keolu Ozer,3,0,3,0
1708253699140,ANTH 295,005,493472,Gagneux; Pascal,3,0,3,0
1708253699140,ANTH 295,006,493515,Goldstein; Paul S,3,0,3,0
1708253699140,ANTH 295,007,493592,Hankins; Joseph D.,3,0,3,0
1708253699140,ANTH 295,008,493631,Jassal; Aftab,3,0,3,0
1708253699140,ANTH 295,009,493639,Jenkins; Janis A.,3,0,3,0
1708253699140,ANTH 295,010,493657,Kaiser; Bronwyn Nicole,3,0,3,0
1708253699140,ANTH 295,011,493692,Kang; Byung Chu,3,0,3,0
1708253699140,ANTH 295,012,493758,Marchetto; Maria Carolina,3,0,3,0
1708253699140,ANTH 295,013,493761,Non; Amy L,3,0,3,0
1708253699140,ANTH 295,014,493762,Pedersen; David,3,0,3,0
1708253699140,ANTH 295,015,493825,Rivera-Collazo; Isabel C,3,0,3,0
1708253699140,ANTH 295,016,493826,Varma; Saiba,3,0,3,0
1708253699140,ANTH 295,017,493828,Yeh; Rihan Wen Xin,3,0,3,0
1708253699667,ANTH 296,001,493830,Braswell; Geoffrey E.,3,0,3,0
1708253699667,ANTH 296,002,493836,Marchetto; Maria Carolina,3,0,3,0
1708253699667,ANTH 296,003,493838,Rivera-Collazo; Isabel C,3,0,3,0
1708253699667,ANTH 296,004,493840,Varma; Saiba,3,0,3,0
1708253699667,ANTH 296,005,493842,Algaze; Guillermo,3,0,3,0
1708253699667,ANTH 296,006,493845,Brenner; Suzanne A,3,0,3,0
1708253699667,ANTH 296,007,493846,Csordas; Thomas J.,3,0,3,0
1708253699667,ANTH 296,008,493907,Fox; Patrick Keolu Ozer,3,0,3,0
1708253699667,ANTH 296,009,493949,Gagneux; Pascal,3,0,3,0
1708253699667,ANTH 296,010,493960,Goldstein; Paul S,3,0,3,0
1708253699667,ANTH 296,011,493961,Hankins; Joseph D.,3,0,3,0
1708253699667,ANTH 296,012,493962,Jassal; Aftab,3,0,3,0
1708253699667,ANTH 296,013,493963,Jenkins; Janis A.,3,0,3,0
1708253699667,ANTH 296,014,493964,Kaiser; Bronwyn Nicole,3,0,3,0
1708253699667,ANTH 296,015,493965,Kang; Byung Chu,3,0,3,0
1708253699667,ANTH 296,016,493966,Levy; Thomas E,3,0,3,0
1708253699667,ANTH 296,017,493967,Non; Amy L,3,0,3,0
1708253699667,ANTH 296,018,493968,Pedersen; David,3,0,3,0
1708253699667,ANTH 296,019,493969,Postero; Nancy Grey,3,0,3,0
1708253699667,ANTH 296,020,493970,Semendeferi; Ekaterini,3,0,3,0
1708253699667,ANTH 296,021,493971,Yeh; Rihan Wen Xin,3,0,3,0
1708253700200,AUD 236,A00,480192,Harris; Jeffrey Paul,12,0,12,0
1708253700727,AUD 260,A00,480227,Spriggs; Meghan K,12,0,12,0
1708253701258,AUD 272,A00,480367,Zettner; Erika,12,0,12,0
1708253701786,AUD 275,A00,480369,Zettner; Erika,12,0,12,0
1708253702313,AUD 284,A00,480370,Zettner; Erika,12,0,12,0
1708253702313,AUD 284,B00,480372,Spriggs; Meghan K,12,0,12,0
1708253702841,AUD 291,A00,480374,Zettner; Erika,12,0,12,0
1708253703366,AUD 296,A00,480375,Zettner; Erika,12,0,12,0
1708253703366,AUD 296,B00,480376,Harris; Jeffrey Paul,12,0,12,0
1708253703366,AUD 296,C00,480377,Ryan; Allen F.,12,0,12,0
1708253703901,AWP 3,002,387672,Given; William Allan,9,0,9,0
1708253703901,AWP 3,003,387678,Staff,5,0,5,0
1708253703901,AWP 3,004,387681,Staff,0,0,0,0
1708253703901,AWP 3,007,387784,West; Geoffrey Scott,4,0,5,1
1708253703901,AWP 3,009,387786,Kolodezh; Samuel,5,0,5,0
1708253703901,AWP 3,010,387787,Gilbert; Peter W,5,0,5,0
1708253704428,AWP 4A,001,387791,Staff,12,0,12,0
1708253704428,AWP 4A,002,387792,Staff,0,0,0,0
1708253704962,AWP 4B,001,387793,Bolin; Jillian,0,0,0,0
1708253704962,AWP 4B,002,387794,Bolin; Jillian,0,0,0,0
1708253704962,AWP 4B,003,387795,Bauer; Holly Jean,0,0,0,0
1708253704962,AWP 4B,004,387796,Vaughn; Kelsey Sara,0,0,0,0
1708253704962,AWP 4B,005,387797,Vaughn; Kelsey Sara,0,0,0,0
1708253704962,AWP 4B,007,387799,Ajo; Frances Margaret,0,0,0,0
1708253704962,AWP 4B,008,387800,Ajo; Frances Margaret,0,0,0,0
1708253704962,AWP 4B,009,387801,Hall; Graham T,0,0,0,0
1708253704962,AWP 4B,010,387802,Hall; Graham T,0,0,0,0
1708253704962,AWP 4B,011,387803,Heiser; Jerrod A,0,0,0,0
1708253704962,AWP 4B,012,387804,Heiser; Jerrod A,0,0,0,0
1708253704962,AWP 4B,013,387805,Jones; William Jadie,0,0,0,0
1708253704962,AWP 4B,014,387806,Jones; William Jadie,0,0,0,0
1708253704962,AWP 4B,015,387807,Christie; Veronica Ann,0,0,0,0
1708253704962,AWP 4B,016,387808,Christie; Veronica Ann,0,0,0,0
1708253704962,AWP 4B,019,387820,Falcon; Jennifer A,0,0,0,0
1708253704962,AWP 4B,020,387821,Falcon; Jennifer A,0,0,0,0
1708253704962,AWP 4B,021,387822,Eastin; Schuyler E.,0,0,0,0
1708253704962,AWP 4B,023,387824,Coulter; Jane Elisabeth,0,0,0,0
1708253704962,AWP 4B,025,387826,O'Neil; Courtney L,0,0,0,0
1708253704962,AWP 4B,026,387827,O'Neil; Courtney L,0,0,0,0
1708253704962,AWP 4B,027,387828,Tsurska Svetina; Olena,0,0,0,0
1708253704962,AWP 4B,028,387829,Tsurska Svetina; Olena,0,0,0,0
1708253704962,AWP 4B,029,387830,Spicer; Jacqueline,0,0,0,0
1708253704962,AWP 4B,030,387831,Spicer; Jacqueline,0,0,0,0
1708253704962,AWP 4B,031,387832,Steinberg; Stacy A,0,0,0,0
1708253704962,AWP 4B,032,387833,Steinberg; Stacy A,0,0,0,0
1708253704962,AWP 4B,033,387834,Chandler; Bailee Daniele,0,0,0,0
1708253704962,AWP 4B,034,387835,Chandler; Bailee Daniele,0,0,0,0
1708253704962,AWP 4B,035,387836,Tiernan; Christa Michelle,0,0,0,0
1708253704962,AWP 4B,036,387837,Tiernan; Christa Michelle,0,0,0,0
1708253704962,AWP 4B,037,387840,Gardella; Alexander Drew,0,0,0,0
1708253704962,AWP 4B,038,387841,Gardella; Alexander Drew,0,0,0,0
1708253704962,AWP 4B,039,387857,Zimmerman; Guy,0,0,0,0
1708253704962,AWP 4B,040,387858,Zimmerman; Guy,0,0,0,0
1708253704962,AWP 4B,041,387859,Zroka; Amy Liane,0,0,0,0
1708253704962,AWP 4B,042,387860,Zroka; Amy Liane,0,0,0,0
1708253705492,BENG 87,A00,489656,Sah; Robert Lie-Yuan,20,0,20,0
1708253705492,BENG 87,B00,489657,Sah; Robert Lie-Yuan,20,0,20,0
1708253705492,BENG 87,C00,494754,Omens; Jeffrey Howard,20,0,20,0
1708253706018,BENG 100,A01,387959,Alexandrov; Ludmil B,26,0,28,2
1708253706018,BENG 100,A02,387960,Alexandrov; Ludmil B,26,0,28,2
1708253706018,BENG 100,A03,387984,Alexandrov; Ludmil B,26,0,28,2
1708253706018,BENG 100,A04,387985,Alexandrov; Ludmil B,25,0,28,3
1708253706018,BENG 100,A05,387986,Alexandrov; Ludmil B,27,0,28,1
1708253706547,BENG 102,A00,387987,Chapelin; Fanny,55,0,56,1
1708253707075,BENG 103B,A00,387993,Fraley; Stephanie I.,116,0,120,4
1708253707601,BENG 112B,A01,388053,Shi; Lingyan,26,0,30,4
1708253707601,BENG 112B,A02,388054,Shi; Lingyan,29,0,30,1
1708253708131,BENG 125,A00,388055,Hasty; Jeff M,120,0,160,40
1708253708660,BENG 133,A01,388866,Mali; Prashant Gulab Ram,36,0,40,4
1708253709185,BENG 140B,A01,388884,Cabrales; Pedro,28,0,30,2
1708253709185,BENG 140B,A02,388885,Cabrales; Pedro,30,0,30,0
1708253709185,BENG 140B,A03,388886,Cabrales; Pedro,26,0,30,4
1708253709714,BENG 160,A50,388889,Aguado; Brian Alberto,23,0,25,2
1708253709714,BENG 160,A51,388919,Aguado; Brian Alberto,25,0,25,0
1708253709714,BENG 160,A52,388920,Aguado; Brian Alberto,25,0,25,0
1708253710239,BENG 168,A01,388961,Khojah; Reem I,30,0,30,0
1708253710765,BENG 172,A50,389087,Omens; Jeffrey Howard & Cabrales; Pedro,15,0,20,5
1708253710765,BENG 172,A51,389088,Omens; Jeffrey Howard & Cabrales; Pedro,14,0,20,6
1708253711294,BENG 182,A01,389128,Bafna; Vineet,28,0,30,2
1708253711820,BENG 186A,A00,389130,Kwon; Ester Jihae,105,0,120,15
1708253712347,BENG 187A,A00,389289,Taylor Amos; Alyssa C,157,0,170,13
1708253712876,BENG 187D,A00,389290,Taylor Amos; Alyssa C,33,0,60,27
1708253712876,BENG 187D,B00,389300,Taylor Amos; Alyssa C,51,0,60,9
1708253712876,BENG 187D,C00,389302,Taylor Amos; Alyssa C,35,0,60,25
1708253713403,BENG 189,A00,389303,Contijoch; Francisco,26,0,30,4
1708253713931,BENG 193,A00,389328,Engler; Adam J.,0,0,0,0
1708253714458,BENG 196,A00,436038,Engler; Adam J.,9999,0,9999,0
1708253714988,BENG 197,A00,436081,Engler; Adam J.,9999,0,9999,0
1708253715515,BENG 203,A00,389385,Bafna; Vineet & Zhong; Sheng,20,0,20,0
1708253716046,BENG 207,A00,389386,Kwon; Ester Jihae,10,0,40,30
1708253716046,BENG 207,B00,389400,Taylor Amos; Alyssa C,8,0,30,22
1708253716046,BENG 207,C00,389432,Khojah; Reem I,20,0,40,20
1708253716571,BENG 209,A00,389456,Scholtes Acevedo; Claire,30,0,30,0
1708253717101,BENG 213,A00,389496,Palsson; Bernhard O.,16,0,20,4
1708253718154,BENG 224,A00,389515,Staff,0,0,0,0
1708253718684,BENG 226,A01,479043,Schmid-Schoenbein; Geert W,7,0,30,23
1708253719211,BENG 227,A00,389591,Fraley; Stephanie I.,55,0,120,65
1708253719736,BENG 230C,A00,389810,Mc Culloch; Andrew Douglas,43,0,90,47
1708253720266,BENG 232,A01,390161,Sah; Robert Lie-Yuan,6,0,50,44
1708253720792,BENG 233,A00,390290,Shah; Sameer B,33,0,50,17
1708253721318,BENG 234,A00,390291,Silva; Gabriel,20,0,56,36
1708253721847,BENG 235,A00,390318,Bintu; Bogdan,16,0,40,24
1708253722373,BENG 276,A00,390357,Mc Culloch; Andrew Douglas & Amaro; Rommie E,0,0,0,0
1708253722900,BENG 280C,A01,390443,McVeigh; Elliot R.,45,0,56,11
1708253723429,BENG 281,A00,390444,Kravets; Vira V.,50,0,110,60
1708253723955,BENG 283,A00,390445,Komives; Elizabeth A,4,0,4,0
1708253724485,BENG 292,A01,390623,Ross; Camille,20,0,20,0
1708253725011,BENG 294C,A00,390709,Engler; Adam J.,17,0,20,3
1708253725537,BENG 295,A00,436300,Watson; John Thomas,9999,0,9999,0
1708253726062,BGGN 205,A00,423656,Daugherty; Matthew Dorton,47,0,60,13
1708253726590,BGGN 207,A01,423703,Ross; Camille,0,0,0,0
1708253727114,BGGN 215,A00,423704,Petrie; Katherine Lynn,22,0,30,8
1708253727641,BGGN 216,A01,423855,Mueller; Liam O'Connor,37,0,50,13
1708253728168,BGGN 218,A00,423861,David; Michael,19,0,30,11
1708253728693,BGGN 223,A00,423862,Bier; Ethan,17,0,35,18
1708253729222,BGGN 230,A00,423863,Taylor; Susan S.,8,0,15,7
1708253729749,BGGN 232,A00,423864,Briggs; Steven & Troemel; Emily Ruth,25,0,30,5
1708253730276,BGGN 239,A01,424014,Kronenberg; Mitchell E.,30,0,30,0
1708253730801,BGGN 240,A01,424016,Juavinett; Ashley Lauren,0,0,6,6
1708253731329,BGGN 248,A00,424017,Halpain; Shelley,26,0,30,4
1708253731858,BGGN 249C,A00,424052,Staff,33,0,33,0
1708253732385,BGGN 250,A01,424091,Zou; Yimin,7,0,8,1
1708253732913,BGGN 252,A01,424093,Sejnowski; Terrence J,5,0,6,1
1708253733441,BGGN 255,A00,424094,Root; Cory Matthew,29,0,30,1
1708253733967,BGGN 262,A01,424096,Villa Rodriguez; Elizabeth,30,0,30,0
1708253734493,BGGN 267,A01,424099,Benna; Marcus K & Aljadeff; Johnatan,5,0,6,1
1708253735022,BGGN 270,A00,477483,Juavinett; Ashley Lauren,67,0,75,8
1708253735570,BGGN 271,001,481745,Ackerman; Susan,9998,0,9999,1
1708253735570,BGGN 271,002,481746,Akbari; Omar Sultan,9999,0,9999,0
1708253735570,BGGN 271,003,481747,Allen; Nicola J,9999,0,9999,0
1708253735570,BGGN 271,004,481748,Banegas; Matthew Patrick,9999,0,9999,0
1708253735570,BGGN 271,005,481749,Breen; Ellen C.,9998,0,9999,1
1708253735570,BGGN 271,006,481750,Briggs; Steven,9998,0,9999,1
1708253735570,BGGN 271,007,481751,Bui; Jack D,9999,0,9999,0
1708253735570,BGGN 271,008,481762,Busch; Wolfgang,9999,0,9999,0
1708253735570,BGGN 271,009,481763,Castle; Michael James,9999,0,9999,0
1708253735570,BGGN 271,010,481764,Chang; John Tzu-yu,9999,0,9999,0
1708253735570,BGGN 271,011,481765,Chen; Ju,9998,0,9999,1
1708253735570,BGGN 271,012,481766,Chen; Xu,9999,0,9999,0
1708253735570,BGGN 271,013,481767,Cheng; Christine Shiang-Ling,9999,0,9999,0
1708253735570,BGGN 271,014,481768,Cherqui; Stephanie,9999,0,9999,0
1708253735570,BGGN 271,015,481769,Cho; Yoshitake,9999,0,9999,0
1708253735570,BGGN 271,016,481770,Church; Kellie Breen,9998,0,9999,1
1708253735570,BGGN 271,017,481771,Cleland; Elsa Eleanor,9999,0,9999,0
1708253735570,BGGN 271,018,481779,Cohen; Shiran,9998,0,9999,1
1708253735570,BGGN 271,019,481814,Cook-Andersen; Heidi Leigh,9999,0,9999,0
1708253735570,BGGN 271,020,481815,Cooke; James Edward,9999,0,9999,0
1708253735570,BGGN 271,021,481816,Coufal; Nicole Gabriele,9998,0,9999,1
1708253735570,BGGN 271,022,481818,Crotty Alexander; Laura E,9999,0,9999,0
1708253735570,BGGN 271,023,481819,Daugherty; Matthew Dorton,9998,0,9999,1
1708253735570,BGGN 271,024,481820,De Guglielmo; Giordano,9998,0,9999,1
1708253735570,BGGN 271,025,481821,Doherty; Taylor Alan,9998,0,9999,1
1708253735570,BGGN 271,026,481822,Dulawa; Stephanie Carole,9999,0,9999,0
1708253735570,BGGN 271,027,481823,Esko; Jeffrey D.,9998,0,9999,1
1708253735570,BGGN 271,028,481824,Feldstein; Ariel E,9998,0,9999,1
1708253735570,BGGN 271,029,481825,Friedman; Rick Adam,9999,0,9999,0
1708253735570,BGGN 271,030,481826,Furnari; Frank,9999,0,9999,0
1708253735570,BGGN 271,031,481829,Ghosh; Pradipta,9998,0,9999,1
1708253735570,BGGN 271,032,481830,Gleeson; Joseph Gerard,9999,0,9999,0
1708253735570,BGGN 271,033,481831,Golden; Susan S.,9998,0,9999,1
1708253735570,BGGN 271,034,481832,Goren; Alon M,9998,0,9999,1
1708253735570,BGGN 271,035,481834,Gustafsson; Asa Birgitta,9999,0,9999,0
1708253735570,BGGN 271,036,481836,Hamdoun; Amr,9999,0,9999,0
1708253735570,BGGN 271,037,481837,Hao; Nan,9999,0,9999,0
1708253735570,BGGN 271,038,481840,Holway; David A.,9998,0,9999,1
1708253735570,BGGN 271,039,481841,Huffaker; Alisa,9998,0,9999,1
1708253735570,BGGN 271,040,481843,Sebat; Lilia Mikhailovna,9998,0,9999,1
1708253735570,BGGN 271,041,481889,Ideker; Trey,9999,0,9999,0
1708253735570,BGGN 271,042,481890,Jiang; Qingfei,9998,0,9999,1
1708253735570,BGGN 271,043,482311,Jin; Yishi,9999,0,9999,0
1708253735570,BGGN 271,044,482334,Joiner; William J.,9999,0,9999,0
1708253735570,BGGN 271,045,482353,Kaech; Susan Michelle,9998,0,9999,1
1708253735570,BGGN 271,046,482378,Karin; Michael,9999,0,9999,0
1708253735570,BGGN 271,047,482379,Kleinfeld; David,9999,0,9999,0
1708253735570,BGGN 271,048,482413,Koffler; Yacov,9999,0,9999,0
1708253735570,BGGN 271,049,482414,Komiyama; Takaki,9999,0,9999,0
1708253735570,BGGN 271,050,482415,Kryazhimskiy; Sergey A,9999,0,9999,0
1708253735570,BGGN 271,051,482416,Lawson; Mark Andrew,9999,0,9999,0
1708253735570,BGGN 271,052,482417,Lee; Yun Sok,9999,0,9999,0
1708253735570,BGGN 271,053,482451,Leutgeb; Stefan,9998,0,9999,1
1708253735570,BGGN 271,054,482452,Lo; Stanley M.,9999,0,9999,0
1708253735570,BGGN 271,055,482453,Lu; Pengzhe,9998,0,9999,1
1708253735570,BGGN 271,056,482454,Lykke-Andersen; Jens,9998,0,9999,1
1708253735570,BGGN 271,057,482456,McDonnell; Lisa Marie,9999,0,9999,0
1708253735570,BGGN 271,058,482461,McHugh; Colleen A,9998,0,9999,1
1708253735570,BGGN 271,059,482478,Meharena; Hiruy Sibhatu,9999,0,9999,0
1708253735570,BGGN 271,060,482497,Morris; Gerald P,9999,0,9999,0
1708253735570,BGGN 271,061,482499,Mukamel; Eran A,9998,0,9999,1
1708253735570,BGGN 271,062,482535,Muotri; Alysson,9999,0,9999,0
1708253735570,BGGN 271,063,482551,Muroyama; Andrew David,9999,0,9999,0
1708253735570,BGGN 271,064,482552,Neal; Sonya E,9999,0,9999,0
1708253735570,BGGN 271,065,482618,Nieh; James Charles,9999,0,9999,0
1708253735570,BGGN 271,066,482619,O'Donoghue; Anthony John,9999,0,9999,0
1708253735570,BGGN 271,067,482626,Pantham; Priyadarshini,9999,0,9999,0
1708253735570,BGGN 271,068,482633,Parast; Mana,9999,0,9999,0
1708253735570,BGGN 271,069,482634,Perry; Michael William,9999,0,9999,0
1708253735570,BGGN 271,070,482639,Pride; David Tevis,9999,0,9999,0
1708253735570,BGGN 271,071,482645,Pruneda-Paz; Jose L.,9999,0,9999,0
1708253735570,BGGN 271,072,482648,Rana; Tariq,9999,0,9999,0
1708253735570,BGGN 271,073,482650,Risbrough; Victoria Blythe,9999,0,9999,0
1708253735570,BGGN 271,074,482655,Rissman; Robert Andrew,9999,0,9999,0
1708253735570,BGGN 271,075,482656,Rosenfeld; Michael G,9999,0,9999,0
1708253735570,BGGN 271,076,482657,Saier; Milton H.,9999,0,9999,0
1708253735570,BGGN 271,077,482663,Sander; Maike,9999,0,9999,0
1708253735570,BGGN 271,078,482664,Schenk; Simon,9999,0,9999,0
1708253735570,BGGN 271,079,482665,Schoeneberg; Johannes,9998,0,9999,1
1708253735570,BGGN 271,080,482666,Schroeder; Julian I,9998,0,9999,1
1708253735570,BGGN 271,081,482667,Shaner; Nathan C.,9999,0,9999,0
1708253735570,BGGN 271,082,482668,Sheikh; Farah,9999,0,9999,0
1708253735570,BGGN 271,083,482669,Shurin; Jonathan,9999,0,9999,0
1708253735570,BGGN 271,084,482675,Sigurdson; Christina,9999,0,9999,0
1708253735570,BGGN 271,085,482676,Smith; David M.,9999,0,9999,0
1708253735570,BGGN 271,086,482677,Steinmetz; Nicole F,9999,0,9999,0
1708253735570,BGGN 271,087,482692,Su; Chih-Ying,9999,0,9999,0
1708253735570,BGGN 271,088,482694,Suel; Gurol Mehmet,9999,0,9999,0
1708253735570,BGGN 271,089,482695,Telese; Francesca,9999,0,9999,0
1708253735570,BGGN 271,090,482745,Thackray; Varykina G.,9999,0,9999,0
1708253735570,BGGN 271,091,482746,Towers; Christina Garlingt,9999,0,9999,0
1708253735570,BGGN 271,092,482747,Troemel; Emily Ruth,9997,0,9999,2
1708253735570,BGGN 271,093,482748,Tye; Kay M,9999,0,9999,0
1708253735570,BGGN 271,094,482749,Valdez-Jasso; Daniela,9998,0,9999,1
1708253735570,BGGN 271,095,482750,Wahlin; Karl Jonas,9997,0,9999,2
1708253735570,BGGN 271,096,482751,Welsbie; Derek,9999,0,9999,0
1708253735570,BGGN 271,097,482752,Wilkinson; Miles Frome,9999,0,9999,0
1708253735570,BGGN 271,098,482754,Yaksh; Tony L.,9999,0,9999,0
1708253735570,BGGN 271,099,482760,Yang; Jing,9999,0,9999,0
1708253735570,BGGN 271,100,482761,Yeo; Eugene Wei-Ming,9998,0,9999,1
1708253735570,BGGN 271,101,482763,Ying; Wei,9999,0,9999,0
1708253735570,BGGN 271,102,482764,Zarrinpar; Amir,9999,0,9999,0
1708253735570,BGGN 271,103,482765,Zengler; Karsten B,9999,0,9999,0
1708253735570,BGGN 271,104,482766,Zhang; Dong-Er,9999,0,9999,0
1708253735570,BGGN 271,105,482768,Zhao; Yunde,9999,0,9999,0
1708253735570,BGGN 271,106,482776,Zheng; Binhai,9999,0,9999,0
1708253735570,BGGN 271,107,482777,Zheng; Ye,9998,0,9999,1
1708253735570,BGGN 271,108,482806,Zuniga; Elina I,9999,0,9999,0
1708253736098,BGGN 273,A01,424101,Mueller; Liam O'Connor,43,0,50,7
1708253736625,BGGN 280,A00,424102,Ernst; Andreas,3,0,5,2
1708253736625,BGGN 280,C00,481361,Amaro; Rommie E,2,0,5,3
1708253737150,BGGN 281,A00,424103,Desai; Arshad & Oegema; Karen,0,0,5,5
1708253737681,BGGN 283,A00,424104,Rivera; Fabian Chavez,0,0,5,5
1708253737681,BGGN 283,B00,424105,Russell; Alistair B,4,0,5,1
1708253737681,BGGN 283,D00,424107,Wildonger; Jill Cathleen,1,0,5,4
1708253738209,BGGN 284,A00,424108,Glasgow; Stacey Marie,2,0,5,3
1708253738737,BGGN 285,A00,424109,Chisholm; Andrew D.,1,0,5,4
1708253738737,BGGN 285,B00,424110,Farley; Emma Kristen,2,0,5,3
1708253739266,BGGN 295,A00,424120,Tour; Ella,9,0,30,21
1708253739790,BGJC 204,A00,424138,Lu; Li-Fan & Chang; John Tzu-yu,9998,0,9999,1
1708253740317,BGJC 215,A00,424139,Cooke; James Edward & Lo; Stanley M.,10,0,10,0
1708253740869,BGRD 200,001,485528,Ackerman; Susan,9998,0,9999,1
1708253740869,BGRD 200,002,485529,Akbari; Omar Sultan,9999,0,9999,0
1708253740869,BGRD 200,003,485530,Allen; Eric,9999,0,9999,0
1708253740869,BGRD 200,004,485531,Allen; Nicola J,9999,0,9999,0
1708253740869,BGRD 200,005,485533,Amaro; Rommie E,9999,0,9999,0
1708253740869,BGRD 200,006,485535,Augustine; Vineet,9999,0,9999,0
1708253740869,BGRD 200,007,485536,Ayres; Janelle Samantha,9999,0,9999,0
1708253740869,BGRD 200,008,485538,Banegas; Matthew Patrick,9999,0,9999,0
1708253740869,BGRD 200,009,485539,Banghart; Matthew Ryan,9999,0,9999,0
1708253740869,BGRD 200,010,485542,Benna; Marcus K,9999,0,9999,0
1708253740869,BGRD 200,011,485543,Bennett; Eric J,9999,0,9999,0
1708253740869,BGRD 200,012,485545,Bloodgood; Brenda Laurie,9999,0,9999,0
1708253740869,BGRD 200,013,485546,Breen; Ellen C.,9998,0,9999,1
1708253740869,BGRD 200,014,485548,Briggs; Steven,9998,0,9999,1
1708253740869,BGRD 200,015,485549,Bui; Jack D,9999,0,9999,0
1708253740869,BGRD 200,016,485552,Busch; Wolfgang,9999,0,9999,0
1708253740869,BGRD 200,017,485621,Callaway; Edward M,9999,0,9999,0
1708253740869,BGRD 200,018,485622,Castle; Michael James,9999,0,9999,0
1708253740869,BGRD 200,019,485623,Chaim; Isaac,9999,0,9999,0
1708253740869,BGRD 200,020,485624,Chang; John Tzu-yu,9999,0,9999,0
1708253740869,BGRD 200,021,485625,Chen; Ju,9999,0,9999,0
1708253740869,BGRD 200,022,485626,Chen; Xu,9999,0,9999,0
1708253740869,BGRD 200,023,485627,Cheng; Christine Shiang-Ling,9999,0,9999,0
1708253740869,BGRD 200,024,485632,Cherqui; Stephanie,9999,0,9999,0
1708253740869,BGRD 200,025,485633,Cho; Yoshitake,9999,0,9999,0
1708253740869,BGRD 200,026,485634,Church; Kellie Breen,9999,0,9999,0
1708253740869,BGRD 200,027,485635,Cleland; Elsa Eleanor,9999,0,9999,0
1708253740869,BGRD 200,028,485636,Cohen; Shiran,9998,0,9999,1
1708253740869,BGRD 200,029,485639,Cook-Andersen; Heidi Leigh,9999,0,9999,0
1708253740869,BGRD 200,030,485686,Cooke; James Edward,9999,0,9999,0
1708253740869,BGRD 200,031,485688,Cooper; Kimberly Lynn,9999,0,9999,0
1708253740869,BGRD 200,032,485689,Coufal; Nicole Gabriele,9998,0,9999,1
1708253740869,BGRD 200,033,485690,Crotty Alexander; Laura E,9999,0,9999,0
1708253740869,BGRD 200,034,485691,Staff,9999,0,9999,0
1708253740869,BGRD 200,035,485692,De Guglielmo; Giordano,9999,0,9999,0
1708253740869,BGRD 200,036,485693,De Silva; Shermin,9999,0,9999,0
1708253740869,BGRD 200,037,485694,Desai; Arshad,9999,0,9999,0
1708253740869,BGRD 200,038,485695,Dickinson; Alexandra Jazz,9999,0,9999,0
1708253740869,BGRD 200,039,485717,Doherty; Taylor Alan,9998,0,9999,1
1708253740869,BGRD 200,040,485720,Dulawa; Stephanie Carole,9999,0,9999,0
1708253740869,BGRD 200,041,485721,Ecker; Joseph R,9999,0,9999,0
1708253740869,BGRD 200,042,485760,Engle; Dannielle D,9999,0,9999,0
1708253740869,BGRD 200,043,485761,Ernst; Andreas,9998,0,9999,1
1708253740869,BGRD 200,044,485766,Esko; Jeffrey D.,9998,0,9999,1
1708253740869,BGRD 200,045,485905,Evans; Ronald M,9999,0,9999,0
1708253740869,BGRD 200,046,485907,Staff,9999,0,9999,0
1708253740869,BGRD 200,047,485918,Feldstein; Ariel E,9998,0,9999,1
1708253740869,BGRD 200,048,485938,Friedman; Rick Adam,9999,0,9999,0
1708253740869,BGRD 200,049,485986,Furnari; Frank,9999,0,9999,0
1708253740869,BGRD 200,050,486018,Gage; Fred H,9999,0,9999,0
1708253740869,BGRD 200,051,486139,George; Monique Leana,9999,0,9999,0
1708253740869,BGRD 200,052,486140,Ghosh; Pradipta,9998,0,9999,1
1708253740869,BGRD 200,053,486141,Glass; Christopher,9998,0,9999,1
1708253740869,BGRD 200,054,486142,Gleeson; Joseph Gerard,9999,0,9999,0
1708253740869,BGRD 200,055,486143,Golden; Susan S.,9999,0,9999,0
1708253740869,BGRD 200,056,486144,Goldrath; Ananda,9999,0,9999,0
1708253740869,BGRD 200,057,486145,Goren; Alon M,9998,0,9999,1
1708253740869,BGRD 200,058,486146,Gustafsson; Asa Birgitta,9999,0,9999,0
1708253740869,BGRD 200,059,486164,Gutkind; Jorge Silvio,9999,0,9999,0
1708253740869,BGRD 200,060,486203,Hamdoun; Amr,9999,0,9999,0
1708253740869,BGRD 200,061,486204,Hampton; Randolph Y.,9999,0,9999,0
1708253740869,BGRD 200,062,486205,Hao; Nan,9999,0,9999,0
1708253740869,BGRD 200,063,486206,Staff,9999,0,9999,0
1708253740869,BGRD 200,064,486207,Hasty; Jeff M,9999,0,9999,0
1708253740869,BGRD 200,065,486208,Hollern; Daniel Patrick,9999,0,9999,0
1708253740869,BGRD 200,066,486209,Holway; David A.,9997,0,9999,2
1708253740869,BGRD 200,067,486214,Huffaker; Alisa,9998,0,9999,1
1708253740869,BGRD 200,068,486215,Hui; Enfu,9999,0,9999,0
1708253740869,BGRD 200,069,486216,Hwa; Terence T.,9999,0,9999,0
1708253740869,BGRD 200,070,486217,Sebat; Lilia Mikhailovna,9998,0,9999,1
1708253740869,BGRD 200,071,486218,Ideker; Trey,9999,0,9999,0
1708253740869,BGRD 200,072,486219,Jackrel; Sara,9998,0,9999,1
1708253740869,BGRD 200,073,486224,Jiang; Qingfei,9998,0,9999,1
1708253740869,BGRD 200,074,486225,Jin; Yishi,9999,0,9999,0
1708253740869,BGRD 200,075,486226,Joiner; William J.,9999,0,9999,0
1708253740869,BGRD 200,076,486227,Jun; Suckjoon,9999,0,9999,0
1708253740869,BGRD 200,077,486228,Kadonaga; James T,9998,0,9999,1
1708253740869,BGRD 200,078,486229,Kaech; Susan Michelle,9997,0,9999,2
1708253740869,BGRD 200,079,486237,Karin; Michael,9999,0,9999,0
1708253740869,BGRD 200,080,486238,Kleinfeld; David,9999,0,9999,0
1708253740869,BGRD 200,081,486239,Knight; Robin,9999,0,9999,0
1708253740869,BGRD 200,082,486335,Koffler; Yacov,9999,0,9999,0
1708253740869,BGRD 200,083,486336,Komiyama; Takaki,9999,0,9999,0
1708253740869,BGRD 200,084,486337,Kosuri; Pallav,9999,0,9999,0
1708253740869,BGRD 200,085,486353,Kryazhimskiy; Sergey A,9999,0,9999,0
1708253740869,BGRD 200,086,486354,Kurle; Carolyn M.,9999,0,9999,0
1708253740869,BGRD 200,087,486355,Law; Julie A,9999,0,9999,0
1708253740869,BGRD 200,088,486356,Lawson; Mark Andrew,9999,0,9999,0
1708253740869,BGRD 200,089,486357,Lee; Kuo Fen,9999,0,9999,0
1708253740869,BGRD 200,090,486376,Lee; Yun Sok,9999,0,9999,0
1708253740869,BGRD 200,091,486413,Leutgeb; Jill K.,9999,0,9999,0
1708253740869,BGRD 200,092,486414,Leutgeb; Stefan,9998,0,9999,1
1708253740869,BGRD 200,093,486415,Lim; Byungkook,9999,0,9999,0
1708253740869,BGRD 200,094,486419,Lo; Stanley M.,9999,0,9999,0
1708253740869,BGRD 200,095,486420,Looger; Loren Lee,9999,0,9999,0
1708253740869,BGRD 200,096,486422,Lovett-Barron; Matthew Rod,9999,0,9999,0
1708253740869,BGRD 200,097,486423,Lu; Li-Fan,9998,0,9999,1
1708253740869,BGRD 200,098,486424,Lu; Pengzhe,9998,0,9999,1
1708253740869,BGRD 200,099,486425,Lykke-Andersen; Jens,9998,0,9999,1
1708253740869,BGRD 200,100,486426,Lyumkis; Dmitry Evgenievich,9999,0,9999,0
1708253740869,BGRD 200,101,486427,Madigan; Cressida Ariana,9999,0,9999,0
1708253740869,BGRD 200,102,486428,Staff,9999,0,9999,0
1708253740869,BGRD 200,103,486429,Mayfield; Stephen P.,9998,0,9999,1
1708253740869,BGRD 200,104,486430,McDonnell; Lisa Marie,9999,0,9999,0
1708253740869,BGRD 200,105,486620,McHugh; Colleen A,9998,0,9999,1
1708253740869,BGRD 200,106,486621,Meharena; Hiruy Sibhatu,9999,0,9999,0
1708253740869,BGRD 200,107,486622,Staff,9999,0,9999,0
1708253740869,BGRD 200,108,486681,Morris; Gerald P,9999,0,9999,0
1708253740869,BGRD 200,109,486682,Mukamel; Eran A,9998,0,9999,1
1708253740869,BGRD 200,110,486683,Muotri; Alysson,9999,0,9999,0
1708253740869,BGRD 200,111,486684,Muroyama; Andrew David,9999,0,9999,0
1708253740869,BGRD 200,112,486687,Murre; Cornelis,9999,0,9999,0
1708253740869,BGRD 200,113,486691,Neal; Sonya E,9999,0,9999,0
1708253740869,BGRD 200,114,486692,Nieh; James Charles,9998,0,9999,1
1708253740869,BGRD 200,115,486693,Nimmerjahn; Axel,9999,0,9999,0
1708253740869,BGRD 200,116,486694,Nizet; Victor F.,9999,0,9999,0
1708253740869,BGRD 200,117,486695,O'Donoghue; Anthony John,9999,0,9999,0
1708253740869,BGRD 200,118,486706,Oegema; Karen,9999,0,9999,0
1708253740869,BGRD 200,119,486708,O'Shea; Clodagh,9999,0,9999,0
1708253740869,BGRD 200,120,486709,Pantham; Priyadarshini,9999,0,9999,0
1708253740869,BGRD 200,121,486715,Parast; Mana,9999,0,9999,0
1708253740869,BGRD 200,122,486716,Pasquinelli; Amy,9998,0,9999,1
1708253740869,BGRD 200,123,486718,Pekkurnaz Banghart; Gulcin,9999,0,9999,0
1708253740869,BGRD 200,124,486720,Perry; Michael William,9999,0,9999,0
1708253740869,BGRD 200,125,486721,Pfaff; Samuel,9999,0,9999,0
1708253740869,BGRD 200,126,486723,Pogliano; Joseph,9999,0,9999,0
1708253740869,BGRD 200,127,486724,Pogliano; Kit J.,9999,0,9999,0
1708253740869,BGRD 200,128,486727,Pride; David Tevis,9999,0,9999,0
1708253740869,BGRD 200,129,486728,Pruneda-Paz; Jose L.,9999,0,9999,0
1708253740869,BGRD 200,130,486733,Staff,9999,0,9999,0
1708253740869,BGRD 200,131,486734,Rana; Tariq,9999,0,9999,0
1708253740869,BGRD 200,132,486736,Reck-Peterson; Samara L,9999,0,9999,0
1708253740869,BGRD 200,133,486738,Rennison; Diana,9999,0,9999,0
1708253740869,BGRD 200,134,486741,Rifkin; Scott,9999,0,9999,0
1708253740869,BGRD 200,135,486743,Risbrough; Victoria Blythe,9999,0,9999,0
1708253740869,BGRD 200,136,486749,Rissman; Robert Andrew,9999,0,9999,0
1708253740869,BGRD 200,137,486750,Rivera; Fabian Chavez,9999,0,9999,0
1708253740869,BGRD 200,138,486753,Root; Cory Matthew,9999,0,9999,0
1708253740869,BGRD 200,139,486760,Rosenfeld; Michael G,9998,0,9999,1
1708253740869,BGRD 200,140,486763,Russell; Alistair B,9999,0,9999,0
1708253740869,BGRD 200,141,486766,Saier; Milton H.,9999,0,9999,0
1708253740869,BGRD 200,142,486768,Sander; Maike,9999,0,9999,0
1708253740869,BGRD 200,143,486770,Saphire; Erica Ollmann,9999,0,9999,0
1708253740869,BGRD 200,144,486771,Schenk; Simon,9999,0,9999,0
1708253740869,BGRD 200,145,486774,Schoeneberg; Johannes,9999,0,9999,0
1708253740869,BGRD 200,146,486777,Schroeder; Julian I,9998,0,9999,1
1708253740869,BGRD 200,147,486783,Shah; Sameer B,9999,0,9999,0
1708253740869,BGRD 200,148,486784,Shaner; Nathan C.,9999,0,9999,0
1708253740869,BGRD 200,149,486785,Shaw; Reuben,9999,0,9999,0
1708253740869,BGRD 200,150,486786,Sheikh; Farah,9999,0,9999,0
1708253740869,BGRD 200,151,486787,Staff,9999,0,9999,0
1708253740869,BGRD 200,152,486788,Signer; Robert,9999,0,9999,0
1708253740869,BGRD 200,153,486789,Sigurdson; Christina,9999,0,9999,0
1708253740869,BGRD 200,154,486790,Smith; David M.,9999,0,9999,0
1708253740869,BGRD 200,155,486791,Soncin; Francesca,9999,0,9999,0
1708253740869,BGRD 200,156,486792,Steinmetz; Nicole F,9999,0,9999,0
1708253740869,BGRD 200,157,486793,Su; Chih-Ying,9999,0,9999,0
1708253740869,BGRD 200,158,486794,Suel; Gurol Mehmet,9999,0,9999,0
1708253740869,BGRD 200,159,486795,Sun; Xin,9999,0,9999,0
1708253740869,BGRD 200,160,486796,Telese; Francesca,9999,0,9999,0
1708253740869,BGRD 200,161,486797,Thackray; Varykina G.,9999,0,9999,0
1708253740869,BGRD 200,162,486798,Towers; Christina Garlingt,9999,0,9999,0
1708253740869,BGRD 200,163,486799,Traver; David,9999,0,9999,0
1708253740869,BGRD 200,164,486800,Troemel; Emily Ruth,9998,0,9999,1
1708253740869,BGRD 200,165,486801,Tye; Kay M,9999,0,9999,0
1708253740869,BGRD 200,166,486802,Valdez-Jasso; Daniela,9998,0,9999,1
1708253740869,BGRD 200,167,486803,Vijayanand; Pandurangan,9999,0,9999,0
1708253740869,BGRD 200,168,486804,Villa Rodriguez; Elizabeth,9999,0,9999,0
1708253740869,BGRD 200,169,486805,Wahlin; Karl Jonas,9997,0,9999,2
1708253740869,BGRD 200,170,486806,Wang; Jean Yin Jen,9999,0,9999,0
1708253740869,BGRD 200,171,486807,Welsbie; Derek,9999,0,9999,0
1708253740869,BGRD 200,172,486808,Wildonger; Jill Cathleen,9998,0,9999,1
1708253740869,BGRD 200,173,486809,Wilkinson; Miles Frome,9999,0,9999,0
1708253740869,BGRD 200,174,486810,Winzeler; Elizabeth A,9999,0,9999,0
1708253740869,BGRD 200,175,486811,Yaksh; Tony L.,9999,0,9999,0
1708253740869,BGRD 200,176,486812,Yang; Jing,9999,0,9999,0
1708253740869,BGRD 200,177,486813,Staff,9999,0,9999,0
1708253740869,BGRD 200,178,486814,Yeo; Eugene Wei-Ming,9998,0,9999,1
1708253740869,BGRD 200,179,486815,Ying; Wei,9999,0,9999,0
1708253740869,BGRD 200,180,486816,Zarrinpar; Amir,9999,0,9999,0
1708253740869,BGRD 200,181,486817,Zengler; Karsten B,9999,0,9999,0
1708253740869,BGRD 200,182,486818,Zhang; Dong-Er,9999,0,9999,0
1708253740869,BGRD 200,183,486819,Zhao; Yunde,9999,0,9999,0
1708253740869,BGRD 200,184,486820,Zheng; Binhai,9999,0,9999,0
1708253740869,BGRD 200,185,486821,Zheng; Ye,9998,0,9999,1
1708253740869,BGRD 200,186,486822,Zuniga; Elina I,9999,0,9999,0
1708253741399,BGSE 200,A00,424140,Tour; Ella & Petrie; Katherine Lynn,9995,0,9999,4
1708253741927,BGSE 205,A00,424177,Bennett; Eric J,49,0,50,1
1708253741927,BGSE 205,B00,424179,Bennett; Eric J,48,0,50,2
1708253741927,BGSE 205,C00,424182,Bennett; Eric J,47,0,50,3
1708253741927,BGSE 205,D00,424184,Bennett; Eric J,46,0,50,4
1708253741927,BGSE 205,E00,424185,Bennett; Eric J,50,0,50,0
1708253742456,BIBC 100,A01,425401,Corbett; Kevin Daniel,150,0,158,8
1708253742456,BIBC 100,B01,477769,Amaro; Rommie E,156,0,158,2
1708253742984,BIBC 102,A01,425425,Bozinovic; Goran,255,0,256,1
1708253742984,BIBC 102,B01,425440,Hampton; Randolph Y.,250,0,256,6
1708253742984,BIBC 102,C01,486849,Flagg; Matthew Paul,61,0,120,59
1708253743516,BIBC 103,A01,425476,Grossman; Emily N,17,0,24,7
1708253743516,BIBC 103,A02,425509,Grossman; Emily N,21,0,24,3
1708253743516,BIBC 103,A03,425530,Grossman; Emily N,18,0,24,6
1708253743516,BIBC 103,A04,425536,Grossman; Emily N,22,0,24,2
1708253743516,BIBC 103,B01,425538,Boumechache; Miyyada,20,0,24,4
1708253743516,BIBC 103,B02,425539,Boumechache; Miyyada,24,0,24,0
1708253743516,BIBC 103,B03,425548,Boumechache; Miyyada,24,0,24,0
1708253743516,BIBC 103,B04,425549,Boumechache; Miyyada,24,0,24,0
1708253744042,BIBC 120,A01,425592,Coleman; Aaron B.,242,0,256,14
1708253744568,BIBC 194,A00,425609,Ernst; Andreas,21,0,27,6
1708253744568,BIBC 194,B00,477632,Saier; Milton H.,26,0,27,1
1708253744568,BIBC 194,C00,481360,Amaro; Rommie E,23,0,27,4
1708253744568,BIBC 194,D00,486852,Flagg; Matthew Paul,21,0,32,11
1708253745106,BICD 100,A01,470377,Troemel; Emily Ruth,127,0,128,1
1708253745106,BICD 100,A02,470378,Troemel; Emily Ruth,126,0,128,2
1708253745106,BICD 100,B01,470409,Reinagel; Pam,59,0,64,5
1708253745106,BICD 100,B02,470413,Reinagel; Pam,62,0,64,2
1708253745106,BICD 100,B03,470464,Reinagel; Pam,64,0,64,0
1708253745106,BICD 100,B04,470468,Reinagel; Pam,63,0,64,1
1708253745106,BICD 100,C01,470469,Beyhan; Sinem,51,0,64,13
1708253745106,BICD 100,C02,470605,Beyhan; Sinem,58,0,64,6
1708253745106,BICD 100,C03,470606,Beyhan; Sinem,60,0,64,4
1708253745106,BICD 100,C04,470607,Beyhan; Sinem,63,0,64,1
1708253745106,BICD 100,D01,477465,Nguyen; Vu Quang,158,0,160,2
1708253745634,BICD 100R,A01,425674,Smith; Laurie,29,0,34,5
1708253745634,BICD 100R,A02,425675,Smith; Laurie,30,0,34,4
1708253745634,BICD 100R,A03,425676,Smith; Laurie,30,0,34,4
1708253746165,BICD 104,A01,425696,Greenspan; Ralph J.,60,0,64,4
1708253746691,BICD 110,A01,470608,Muroyama; Andrew David,264,0,275,11
1708253746691,BICD 110,B01,425721,Ernst; Andreas,245,0,275,30
1708253747218,BICD 112,A01,458177,Cooper; Kimberly Lynn & Traver; David,10,0,32,22
1708253747218,BICD 112,A02,458180,Cooper; Kimberly Lynn & Traver; David,28,0,32,4
1708253748816,BICD 123,A01,425725,Zhao; Yunde,24,0,32,8
1708253749346,BICD 140,A01,425728,Lu; Li-Fan,227,0,240,13
1708253749872,BICD 158,A01,425730,Bier; Ethan,136,0,145,9
1708253750397,BICD 194,A00,425731,Desai; Arshad & Oegema; Karen,18,0,27,9
1708253750397,BICD 194,B00,481735,Wilhelm; James E.,29,0,32,3
1708253750928,BIEB 121,A00,425732,Butler; Shannon Rhey,21,0,32,11
1708253750928,BIEB 121,B00,425733,Butler; Shannon Rhey,24,0,32,8
1708253751455,BIEB 130,A01,425735,Kurle; Carolyn M.,243,0,295,52
1708253751982,BIEB 146,A01,425737,Petrie; Katherine Lynn,365,0,395,30
1708253752508,BIEB 148,A01,470637,Rose; Noah Hartmann,59,0,63,4
1708253752508,BIEB 148,A02,470638,Rose; Noah Hartmann,61,0,63,2
1708253753034,BIEB 154,A01,458184,Stockwell; Sarah R,29,0,30,1
1708253753034,BIEB 154,A02,458186,Stockwell; Sarah R,29,0,30,1
1708253753560,BIEB 176,A01,425741,De Silva; Shermin,56,0,64,8
1708253754105,BIEB 182,A01,458194,Roy; Kaustuv,25,0,32,7
1708253754105,BIEB 182,A02,458215,Roy; Kaustuv,31,0,32,1
1708253754640,BILD 1,A01,424267,Patrick; Gentry,249,0,250,1
1708253754640,BILD 1,B01,424272,Burg; Michael,231,0,250,19
1708253754640,BILD 1,C01,424293,Pickett; Brooke Elizabeth,245,0,250,5
1708253754640,BILD 1,D01,458292,Gonzalez Gamboa; Ivonne,48,0,50,2
1708253754640,BILD 1,D02,458295,Gonzalez Gamboa; Ivonne,50,0,50,0
1708253754640,BILD 1,D03,458296,Gonzalez Gamboa; Ivonne,50,0,50,0
1708253754640,BILD 1,D04,458297,Gonzalez Gamboa; Ivonne,49,0,50,1
1708253754640,BILD 1,D05,458303,Gonzalez Gamboa; Ivonne,50,0,50,0
1708253755186,BILD 2,A01,458304,Reyes Gonzalez; Catalina,53,0,56,3
1708253755186,BILD 2,A02,458307,Reyes Gonzalez; Catalina,55,0,56,1
1708253755186,BILD 2,A03,458313,Reyes Gonzalez; Catalina,55,0,56,1
1708253755186,BILD 2,A04,458320,Reyes Gonzalez; Catalina,56,0,56,0
1708253755186,BILD 2,B01,458324,Reyes Gonzalez; Catalina,47,0,56,9
1708253755186,BILD 2,B02,458327,Reyes Gonzalez; Catalina,54,0,56,2
1708253755186,BILD 2,B03,458339,Reyes Gonzalez; Catalina,56,0,56,0
1708253755186,BILD 2,B04,458340,Reyes Gonzalez; Catalina,56,0,56,0
1708253755186,BILD 2,C01,458387,Park; Ji Young,44,0,49,5
1708253755186,BILD 2,C02,458544,Park; Ji Young,46,0,49,3
1708253755186,BILD 2,C03,458557,Park; Ji Young,47,0,49,2
1708253755186,BILD 2,C04,458563,Park; Ji Young,46,0,49,3
1708253755729,BILD 3,A01,424312,Hammond; LaTisha Marie,331,0,350,19
1708253755729,BILD 3,B01,470107,Stockwell; Sarah R,66,0,70,4
1708253755729,BILD 3,B02,470110,Stockwell; Sarah R,70,0,70,0
1708253755729,BILD 3,B03,470116,Stockwell; Sarah R,70,0,70,0
1708253755729,BILD 3,B04,470123,Stockwell; Sarah R,67,0,70,3
1708253755729,BILD 3,B05,470150,Stockwell; Sarah R,70,0,70,0
1708253755729,BILD 3,C01,470159,Cooper; Kimberly Lynn,67,0,70,3
1708253755729,BILD 3,C02,470160,Cooper; Kimberly Lynn,69,0,70,1
1708253755729,BILD 3,C03,470164,Cooper; Kimberly Lynn,70,0,70,0
1708253755729,BILD 3,C04,470165,Cooper; Kimberly Lynn,69,0,70,1
1708253755729,BILD 3,C05,470374,Cooper; Kimberly Lynn,68,0,70,2
1708253756275,BILD 4,A01,424318,Staff,22,0,24,2
1708253756275,BILD 4,A02,424324,Staff,24,0,24,0
1708253756275,BILD 4,A03,424325,Staff,24,0,24,0
1708253756275,BILD 4,A04,424326,Staff,22,0,24,2
1708253756275,BILD 4,A05,424327,Staff,24,0,24,0
1708253756275,BILD 4,A06,424330,Staff,24,0,24,0
1708253756275,BILD 4,A07,424331,Staff,24,0,24,0
1708253756275,BILD 4,A08,424342,Staff,24,0,24,0
1708253756275,BILD 4,B01,424462,Pickett; Brooke Elizabeth,23,0,24,1
1708253756275,BILD 4,B02,424466,Pickett; Brooke Elizabeth,24,0,24,0
1708253756275,BILD 4,B03,424469,Pickett; Brooke Elizabeth,23,0,24,1
1708253756275,BILD 4,B04,424470,Pickett; Brooke Elizabeth,22,0,24,2
1708253756275,BILD 4,B05,424700,Pickett; Brooke Elizabeth,23,0,24,1
1708253756275,BILD 4,B06,424723,Pickett; Brooke Elizabeth,24,0,24,0
1708253756275,BILD 4,B07,424730,Pickett; Brooke Elizabeth,24,0,24,0
1708253756275,BILD 4,B08,424929,Pickett; Brooke Elizabeth,22,0,24,2
1708253756275,BILD 4,C01,424947,Gonzalez Gamboa; Ivonne,22,0,24,2
1708253756275,BILD 4,C02,424951,Gonzalez Gamboa; Ivonne,23,0,24,1
1708253756275,BILD 4,C03,424991,Gonzalez Gamboa; Ivonne,23,0,24,1
1708253756275,BILD 4,C04,424993,Gonzalez Gamboa; Ivonne,24,0,24,0
1708253756275,BILD 4,C05,424994,Gonzalez Gamboa; Ivonne,24,0,24,0
1708253756275,BILD 4,C06,425209,Gonzalez Gamboa; Ivonne,24,0,24,0
1708253756275,BILD 4,C07,425233,Gonzalez Gamboa; Ivonne,24,0,24,0
1708253756275,BILD 4,C08,425247,Gonzalez Gamboa; Ivonne,24,0,24,0
1708253756802,BILD 60,A01,425326,Hammond; LaTisha Marie,62,0,64,2
1708253757330,BILD 83,A00,425347,Pogliano; Joseph,25,0,30,5
1708253757857,BILD 87,A00,425368,Saier; Milton H.,20,0,20,0
1708253758387,BIMM 100,A01,425744,Cooper; Andrew Michael,303,0,320,17
1708253758387,BIMM 100,B01,425746,Cooper; Andrew Michael,315,0,320,5
1708253758923,BIMM 101,A01,425748,McDonnell; Lisa Marie,8,0,24,16
1708253758923,BIMM 101,A02,425749,McDonnell; Lisa Marie,23,0,24,1
1708253758923,BIMM 101,B01,425751,Day; Christopher D,22,0,24,2
1708253758923,BIMM 101,B02,425752,Day; Christopher D,24,0,24,0
1708253758923,BIMM 101,B03,425753,Day; Christopher D,22,0,24,2
1708253758923,BIMM 101,B04,425754,Day; Christopher D,24,0,24,0
1708253758923,BIMM 101,C01,425756,Rusert; Jessica Marie,16,0,24,8
1708253758923,BIMM 101,C02,425757,Rusert; Jessica Marie,23,0,24,1
1708253758923,BIMM 101,C03,425758,Rusert; Jessica Marie,23,0,24,1
1708253758923,BIMM 101,C04,425759,Rusert; Jessica Marie,23,0,24,1
1708253759467,BIMM 110,A01,425764,Niwa; Maho,55,0,56,1
1708253759467,BIMM 110,A02,425765,Niwa; Maho,56,0,56,0
1708253759467,BIMM 110,A03,425766,Niwa; Maho,56,0,56,0
1708253759467,BIMM 110,A04,425767,Niwa; Maho,55,0,56,1
1708253759999,BIMM 116R,A01,425771,Golden; Susan S. & Gorman; Michael R.,55,0,72,17
1708253759999,BIMM 116R,A02,425772,Golden; Susan S. & Gorman; Michael R.,53,0,72,19
1708253759999,BIMM 116R,A03,425773,Golden; Susan S. & Gorman; Michael R.,66,0,72,6
1708253759999,BIMM 116R,A04,425774,Golden; Susan S. & Gorman; Michael R.,70,0,72,2
1708253760526,BIMM 118,A01,425779,David; Michael,83,0,96,13
1708253761056,BIMM 120,A01,425792,Pirino; Giorgia,203,0,216,13
1708253761056,BIMM 120,B01,470639,Saier; Milton H.,201,0,216,15
1708253761583,BIMM 121,A01,425830,Gustafson-Brown; Cindy,18,0,24,6
1708253761583,BIMM 121,A02,425831,Gustafson-Brown; Cindy,21,0,24,3
1708253761583,BIMM 121,A03,425832,Gustafson-Brown; Cindy,24,0,24,0
1708253761583,BIMM 121,A04,425833,Gustafson-Brown; Cindy,23,0,24,1
1708253761583,BIMM 121,B01,425835,Pirino; Giorgia,17,0,24,7
1708253761583,BIMM 121,B02,425836,Pirino; Giorgia,24,0,24,0
1708253761583,BIMM 121,C01,425838,Park; Ji Young,6,0,24,18
1708253761583,BIMM 121,C02,425839,Park; Ji Young,20,0,24,4
1708253762108,BIMM 134,A01,425841,Burg; Michael,393,0,416,23
1708253762638,BIMM 143,A01,425843,Grant; Barry J,17,0,40,23
1708253762638,BIMM 143,B01,425845,Bozinovic; Goran,33,0,40,7
1708253763169,BIMM 182,A01,455012,Bafna; Vineet,28,0,50,22
1708253763713,BIMM 194,A00,425847,Rivera; Fabian Chavez,24,0,27,3
1708253763713,BIMM 194,B00,425868,Russell; Alistair B,16,0,27,11
1708253763713,BIMM 194,D00,425870,Wildonger; Jill Cathleen,14,0,27,13
1708253764244,BIOM 202,A00,390710,Corbett; Kevin Daniel,93,0,100,7
1708253764770,BIOM 219,A00,390713,Ross; Camille,0,0,0,7
1708253765298,BIOM 231,A00,455099,Furnari; Frank,0,0,0,0
1708253765298,BIOM 231,B00,455100,Lopez Ramirez; Miguel Alej,0,0,0,0
1708253765824,BIOM 242,A00,390714,Hamilton; Bruce Alan,20,0,20,0
1708253766355,BIOM 246,A00,492784,Gordts; Philip & Varki; Ajit P & Lewis; Amanda Lark & Godula; Kamil & Gagneux; Pascal & Esko; Jeffrey D. & Bode; Lars,0,0,0,0
1708253766880,BIOM 252,A00,390715,Ayyagari; Radha,27,0,28,1
1708253767410,BIOM 254,A00,390718,Corbett; Kevin Daniel,14,0,20,6
1708253767939,BIOM 272,A00,390722,Hangauer; Matthew John,16,0,20,4
1708253768472,BIOM 274,A00,390725,Sun; Bryan Kee-Hong,7,0,15,8
1708253768997,BIOM 283,A00,390728,Komives; Elizabeth A,2,0,2,0
1708253769527,BIOM 285,A00,390730,Gaulton; Kyle J,10,0,20,10
1708253770053,BIOM 295,A00,455083,Brown; Joan Heller,0,0,0,0
1708253770602,BIPN 100,A01,425872,Augustine; Vineet,240,0,245,5
1708253770602,BIPN 100,B01,425874,George; Monique Leana,240,0,245,5
1708253770602,BIPN 100,C01,458640,Maita; Isabella Vincenza,44,0,49,5
1708253770602,BIPN 100,C02,458646,Maita; Isabella Vincenza,48,0,49,1
1708253770602,BIPN 100,C03,458714,Maita; Isabella Vincenza,48,0,49,1
1708253770602,BIPN 100,C04,458716,Maita; Isabella Vincenza,48,0,49,1
1708253770602,BIPN 100,C05,458717,Maita; Isabella Vincenza,46,0,49,3
1708253771129,BIPN 105,A01,425877,Armour; Jon Christopher,12,0,21,9
1708253771129,BIPN 105,A02,425878,Armour; Jon Christopher,21,0,21,0
1708253771129,BIPN 105,A03,425879,Armour; Jon Christopher,10,0,21,11
1708253771129,BIPN 105,A04,425880,Armour; Jon Christopher,20,0,21,1
1708253771655,BIPN 120,A01,425882,Cooke; James Edward,370,0,395,25
1708253772186,BIPN 140,A01,425884,Hibbs; Ryan E.,183,0,192,9
1708253772712,BIPN 144,A01,425886,Zou; Yimin,153,0,158,5
1708253773240,BIPN 145,A01,425888,Maita; Isabella Vincenza,41,0,42,1
1708253773240,BIPN 145,B01,425918,Marino; Marc J,37,0,42,5
1708253773240,BIPN 145,B02,425954,Marino; Marc J,40,0,42,2
1708253773767,BIPN 147,A01,426086,Sejnowski; Terrence J,53,0,64,11
1708253774294,BIPN 152,A01,426112,Halpain; Shelley,97,0,128,31
1708253774822,BIPN 162,A01,426120,Juavinett; Ashley Lauren,17,0,30,13
1708253775350,BIPN 164,A01,455010,Benna; Marcus K & Aljadeff; Johnatan,120,0,120,0
1708253775877,BIPN 194,A00,426122,Glasgow; Stacey Marie,20,0,27,7
1708253776406,BISP 170,A00,426158,French; Kathleen Ann,26,0,30,4
1708253776932,BISP 182,A00,426168,Pogliano; Joseph,9999,0,9999,0
1708253777458,BISP 194,A00,426240,Chisholm; Andrew D.,11,0,27,16
1708253777458,BISP 194,B00,426241,Farley; Emma Kristen,25,0,27,2
1708253777988,BNFO 281,A00,427175,Gaasterland; Theresa,85,0,100,15
1708253778514,BNFO 283,A00,427211,Carter; Hannah Kathryn & Chavez; Alejandro,39,0,50,11
1708253778514,BNFO 283,B00,480483,Amariuta-Bartell; Tiffany & Dorrestein; Pieter,21,0,30,9
1708253779043,BNFO 294,B01,427269,Ross; Camille,47,0,50,3
1708253779638,CAT 3,A01,396994,Glaser; Amelia,15,0,15,0
1708253779638,CAT 3,A02,396995,Glaser; Amelia,15,0,15,0
1708253779638,CAT 3,A03,396996,Glaser; Amelia,7,0,15,8
1708253779638,CAT 3,A04,396997,Glaser; Amelia,12,0,15,3
1708253779638,CAT 3,A05,397004,Glaser; Amelia,15,0,15,0
1708253779638,CAT 3,A06,397039,Glaser; Amelia,11,0,15,4
1708253779638,CAT 3,A07,397040,Glaser; Amelia,13,0,15,2
1708253779638,CAT 3,A08,397084,Glaser; Amelia,15,0,15,0
1708253779638,CAT 3,A09,397269,Glaser; Amelia,13,0,15,2
1708253779638,CAT 3,A10,397270,Glaser; Amelia,0,0,15,15
1708253779638,CAT 3,A11,397271,Glaser; Amelia,9,0,15,6
1708253779638,CAT 3,A12,397272,Glaser; Amelia,12,0,15,3
1708253779638,CAT 3,A13,397273,Glaser; Amelia,15,0,15,0
1708253779638,CAT 3,A14,397274,Glaser; Amelia,14,0,15,1
1708253779638,CAT 3,B01,397276,Porter; Lisa,15,0,15,0
1708253779638,CAT 3,B02,397277,Porter; Lisa,15,0,15,0
1708253779638,CAT 3,B03,397278,Porter; Lisa,14,0,15,1
1708253779638,CAT 3,B04,397279,Porter; Lisa,15,0,15,0
1708253779638,CAT 3,B06,397281,Porter; Lisa,15,0,15,0
1708253779638,CAT 3,B07,397291,Porter; Lisa,15,0,15,0
1708253779638,CAT 3,B09,397293,Porter; Lisa,15,0,15,0
1708253779638,CAT 3,B10,397294,Porter; Lisa,15,0,15,0
1708253779638,CAT 3,B11,397295,Porter; Lisa,12,0,15,3
1708253779638,CAT 3,B12,397296,Porter; Lisa,14,0,15,1
1708253779638,CAT 3,B13,397297,Porter; Lisa,11,0,15,4
1708253779638,CAT 3,B14,397298,Porter; Lisa,15,0,15,0
1708253779638,CAT 3,B15,397299,Porter; Lisa,15,0,15,0
1708253779638,CAT 3,B16,397300,Porter; Lisa,15,0,15,0
1708253779638,CAT 3,C01,397302,Marchisotto; Jennifer Anne,13,0,15,2
1708253779638,CAT 3,C02,397308,Marchisotto; Jennifer Anne,9,0,15,6
1708253779638,CAT 3,C03,397309,Marchisotto; Jennifer Anne,9,0,15,6
1708253779638,CAT 3,C04,397315,Marchisotto; Jennifer Anne,11,0,15,4
1708253779638,CAT 3,C05,397316,Marchisotto; Jennifer Anne,14,0,15,1
1708253779638,CAT 3,C06,397322,Marchisotto; Jennifer Anne,15,0,15,0
1708253779638,CAT 3,C07,397323,Marchisotto; Jennifer Anne,15,0,15,0
1708253779638,CAT 3,C08,397329,Marchisotto; Jennifer Anne,15,0,15,0
1708253779638,CAT 3,C09,397333,Marchisotto; Jennifer Anne,15,0,15,0
1708253779638,CAT 3,C10,397336,Marchisotto; Jennifer Anne,15,0,15,0
1708253779638,CAT 3,C11,397354,Marchisotto; Jennifer Anne,13,0,15,2
1708253779638,CAT 3,C12,397357,Marchisotto; Jennifer Anne,15,0,15,0
1708253779638,CAT 3,C13,397364,Marchisotto; Jennifer Anne,14,0,15,1
1708253779638,CAT 3,C14,397367,Marchisotto; Jennifer Anne,14,0,15,1
1708253779638,CAT 3,C15,397369,Marchisotto; Jennifer Anne,15,0,15,0
1708253779638,CAT 3,C16,397373,Marchisotto; Jennifer Anne,15,0,15,0
1708253779638,CAT 3,C17,397374,Marchisotto; Jennifer Anne,15,0,15,0
1708253779638,CAT 3,C18,397380,Marchisotto; Jennifer Anne,14,0,15,1
1708253779638,CAT 3,D02,397405,Rahimi; Babak,13,0,15,2
1708253779638,CAT 3,D03,397408,Rahimi; Babak,14,0,15,1
1708253779638,CAT 3,D04,397415,Rahimi; Babak,15,0,15,0
1708253779638,CAT 3,D05,397416,Rahimi; Babak,15,0,15,0
1708253779638,CAT 3,D06,397422,Rahimi; Babak,15,0,15,0
1708253779638,CAT 3,D07,397426,Rahimi; Babak,14,0,15,1
1708253779638,CAT 3,D09,397447,Rahimi; Babak,11,0,15,4
1708253779638,CAT 3,D10,397450,Rahimi; Babak,13,0,15,2
1708253779638,CAT 3,D11,397625,Rahimi; Babak,13,0,15,2
1708253779638,CAT 3,D12,397630,Rahimi; Babak,15,0,15,0
1708253779638,CAT 3,D13,397631,Rahimi; Babak,14,0,15,1
1708253779638,CAT 3,D14,397635,Rahimi; Babak,14,0,15,1
1708253780162,CAT 3CE,A01,397642,Bronstein; Phoebe Malan,25,0,25,0
1708253780690,CAT 87,A00,397645,Bronstein; Phoebe Malan,19,0,20,1
1708253781215,CAT 90,A00,480731,Bronstein; Phoebe Malan,20,0,20,0
1708253781758,CAT 124,A01,397662,Knight; Amy,5,0,5,0
1708253781758,CAT 124,A02,397722,Knight; Amy,5,0,5,0
1708253781758,CAT 124,A03,397726,Knight; Amy,5,0,5,0
1708253781758,CAT 124,A04,397829,Knight; Amy,4,0,5,1
1708253782553,CAT 125,001,397832,Popko; Elizabeth Ashley,20,0,20,0
1708253782553,CAT 125,002,397833,Delaville; Romain,20,0,20,0
1708253782553,CAT 125,003,397834,Marchisotto; Jennifer Anne,18,0,20,2
1708253782553,CAT 125,004,397835,Bigham; David Joseph,20,0,20,0
1708253782553,CAT 125,005,397836,Bigham; David Joseph,19,0,20,1
1708253782553,CAT 125,006,397837,Bigham; David Joseph,16,0,20,4
1708253782553,CAT 125,007,397838,Vanderschuit; Maya Alysia,20,0,20,0
1708253782553,CAT 125,008,397839,Vanderschuit; Maya Alysia,20,0,20,0
1708253782553,CAT 125,009,397840,Vanderschuit; Maya Alysia,20,0,20,0
1708253782553,CAT 125,010,397841,Morales; Celeste Georgianna,15,0,16,1
1708253782553,CAT 125,011,397842,Morales; Celeste Georgianna,16,0,16,0
1708253782553,CAT 125,012,397881,Morales; Celeste Georgianna,19,0,20,1
1708253782553,CAT 125,013,397954,Rose; Becca Rae,18,0,20,2
1708253782553,CAT 125,014,397956,Rose; Becca Rae,20,0,20,0
1708253782553,CAT 125,015,397998,Rose; Becca Rae,19,0,20,1
1708253782553,CAT 125,016,397999,Tosun; Adriana,20,0,20,0
1708253782553,CAT 125,017,398001,Tosun; Adriana,20,0,20,0
1708253782553,CAT 125,018,398009,Irwin; Matthew Joseph,19,0,20,1
1708253782553,CAT 125,019,398010,Irwin; Matthew Joseph,18,0,20,2
1708253782553,CAT 125,020,398014,Irwin; Matthew Joseph,20,0,20,0
1708253783082,CAT 125R,A00,398015,Smith; Lauryn Alissa,19,0,20,1
1708253783082,CAT 125R,B00,398016,Smith; Lauryn Alissa,17,0,20,3
1708253783082,CAT 125R,C00,398017,Smith; Lauryn Alissa,19,0,20,1
1708253783082,CAT 125R,D00,398019,Tosun; Adriana,19,0,20,1
1708253783082,CAT 125R,E00,398020,Hyland; Tina Mae,12,0,20,8
1708253783082,CAT 125R,F00,398027,Hyland; Tina Mae,18,0,20,2
1708253783082,CAT 125R,G00,398028,Hyland; Tina Mae,18,0,20,2
1708253783632,CCE 1,A01,396087,Kenley Grounds; Nicole,40,0,40,0
1708253783632,CCE 1,B01,396142,Quijada; David,39,0,40,1
1708253783632,CCE 1,C01,396159,Bigley; Michele Heather,39,0,40,1
1708253783632,CCE 1,D01,396164,Bigley; Michele Heather,40,0,40,0
1708253783632,CCE 1,E01,396166,Lee; Kassandra,40,0,40,0
1708253783632,CCE 1,F01,396168,Lee; Kassandra,40,0,40,0
1708253783632,CCE 1,G01,396170,Staff,40,0,40,0
1708253783632,CCE 1,H01,396172,Staff,40,0,40,0
1708253784158,CENG 101B,A00,392993,Chen; Shaochen,44,0,45,1
1708253784686,CENG 101C,A00,392997,Li; Yanran,148,0,150,2
1708253785213,CENG 113,A00,393000,Chen; Zheng,69,0,70,1
1708253785213,CENG 113,B00,393001,Li; Wan-Lu,69,0,70,1
1708253785739,CENG 124B,A00,393036,Powell; Alyssa & Russ; Benjamin Edward,113,0,120,7
1708253786270,CENG 157,A00,393220,Opatkiewicz; Justin Paul,50,0,57,7
1708253786795,CENG 160,A00,393231,Powell; Alyssa,70,0,80,10
1708253787320,CENG 170,A01,393238,Drews; Aaron,27,0,30,3
1708253787850,CENG 175,A00,393239,Steinmetz; Nicole F,34,0,35,1
1708253788377,CENG 176B,A01,393285,Opatkiewicz; Justin Paul,46,0,52,6
1708253788377,CENG 176B,B01,393629,Zhang; Liangfang,40,0,49,9
1708253788907,CENG 205,A00,393681,Jahed Motlagh; Zeinab,53,0,60,7
1708253789436,CENG 257,A00,393682,Opatkiewicz; Justin Paul,10,0,13,3
1708253789963,CGS 87,A00,489609,Wesling; Megan E.,20,0,20,0
1708253790492,CGS 100B,A00,396181,Whitley; Leila Marie,28,0,30,2
1708253791017,CGS 109,A00,396194,Whitley; Leila Marie,19,0,20,1
1708253791544,CGS 112,A00,396220,Martin Sandino; Amanda Maria Yoland,22,0,25,3
1708253792074,CGS 114,A00,396223,Steelman; Katherine Wallis,14,0,16,2
1708253792601,CGS 116,A00,396295,Staff,19,0,20,1
1708253793126,CGS 117,A00,396306,Martin Sandino; Amanda Maria Yoland,14,0,15,1
1708253793651,CGS 118,A00,396314,Hankins; Joseph D.,28,0,29,1
1708253794179,CGS 128,A00,396366,Whitley; Leila Marie,14,0,15,1
1708253794705,CGS 137,A00,396865,Martin Sandino; Amanda Maria Yoland,16,0,19,3
1708253795232,CGS 150,A00,396901,Taylor-Garcia; Daphne,18,0,18,0
1708253795762,CGS 196B,A00,396904,Lo; Stanley M.,7,0,7,0
1708253795762,CGS 196B,B00,396973,Brenner; Suzanne A,7,0,7,0
1708253795762,CGS 196B,C00,396985,Jones; Makeba,7,0,7,0
1708253796287,CGS 198,001,396987,Anderson; Patrick W.,0,0,0,0
1708253796287,CGS 198,002,396988,Anderson; Patrick W.,0,0,0,0
1708253796287,CGS 198,003,396989,Anderson; Patrick W.,0,0,0,0
1708253796287,CGS 198,004,396990,Anderson; Patrick W.,0,0,0,0
1708253796813,CGS 200,A00,396991,Perez; Roy,0,0,0,3
1708253797361,CHEM 6A,A01,459563,Deshmukh; Lalit,40,0,40,0
1708253797361,CHEM 6A,A02,459564,Deshmukh; Lalit,35,0,40,5
1708253797361,CHEM 6A,A03,459565,Deshmukh; Lalit,31,0,40,9
1708253797361,CHEM 6A,A04,459566,Deshmukh; Lalit,30,0,38,8
1708253797361,CHEM 6A,A05,459567,Deshmukh; Lalit,40,0,40,0
1708253797361,CHEM 6A,A06,459568,Deshmukh; Lalit,37,0,40,3
1708253797361,CHEM 6A,A07,459569,Deshmukh; Lalit,37,0,40,3
1708253797361,CHEM 6A,A08,459570,Deshmukh; Lalit,0,0,0,0
1708253797903,CHEM 6B,A01,467314,Ortony; Julia Helen,39,0,40,1
1708253797903,CHEM 6B,A02,467322,Ortony; Julia Helen,32,0,40,8
1708253797903,CHEM 6B,A03,467323,Ortony; Julia Helen,40,0,40,0
1708253797903,CHEM 6B,A04,467325,Ortony; Julia Helen,31,0,40,9
1708253797903,CHEM 6B,A05,467326,Ortony; Julia Helen,39,0,40,1
1708253797903,CHEM 6B,A06,467346,Ortony; Julia Helen,40,0,40,0
1708253797903,CHEM 6B,B01,467360,Hopkins; Patrycja Anna,35,0,40,5
1708253797903,CHEM 6B,B02,467363,Hopkins; Patrycja Anna,38,0,40,2
1708253797903,CHEM 6B,B03,467364,Hopkins; Patrycja Anna,35,0,40,5
1708253797903,CHEM 6B,B04,467380,Hopkins; Patrycja Anna,40,0,40,0
1708253797903,CHEM 6B,B05,467381,Hopkins; Patrycja Anna,40,0,40,0
1708253797903,CHEM 6B,B06,467382,Hopkins; Patrycja Anna,39,0,40,1
1708253798502,CHEM 6C,A01,468994,Ternansky; Robert J.,39,0,40,1
1708253798502,CHEM 6C,A02,469054,Ternansky; Robert J.,38,0,40,2
1708253798502,CHEM 6C,A03,469065,Ternansky; Robert J.,39,0,40,1
1708253798502,CHEM 6C,A04,469069,Ternansky; Robert J.,40,0,40,0
1708253798502,CHEM 6C,A05,469080,Ternansky; Robert J.,40,0,40,0
1708253798502,CHEM 6C,B01,469318,Ternansky; Robert J.,39,0,40,1
1708253798502,CHEM 6C,B02,469319,Ternansky; Robert J.,40,0,40,0
1708253798502,CHEM 6C,B03,469320,Ternansky; Robert J.,39,0,40,1
1708253798502,CHEM 6C,B04,469321,Ternansky; Robert J.,40,0,40,0
1708253798502,CHEM 6C,B05,469322,Ternansky; Robert J.,40,0,40,0
1708253798502,CHEM 6C,C01,469323,Schurmeier; Kimberly,38,0,40,2
1708253798502,CHEM 6C,C02,469324,Schurmeier; Kimberly,36,0,40,4
1708253798502,CHEM 6C,C03,469325,Schurmeier; Kimberly,38,0,40,2
1708253798502,CHEM 6C,C04,469326,Schurmeier; Kimberly,36,0,40,4
1708253798502,CHEM 6C,C05,469327,Schurmeier; Kimberly,40,0,40,0
1708253798502,CHEM 6C,D01,460183,Schurmeier; Kimberly,39,0,40,1
1708253798502,CHEM 6C,D02,460184,Schurmeier; Kimberly,32,0,40,8
1708253798502,CHEM 6C,D03,460185,Schurmeier; Kimberly,26,0,40,14
1708253798502,CHEM 6C,D04,460186,Schurmeier; Kimberly,38,0,40,2
1708253798502,CHEM 6C,D05,460187,Schurmeier; Kimberly,40,0,40,0
1708253798502,CHEM 6C,E01,460188,Stallings; Dontarie M,24,0,40,16
1708253798502,CHEM 6C,E02,460190,Stallings; Dontarie M,25,0,40,15
1708253798502,CHEM 6C,E03,460191,Stallings; Dontarie M,3,0,20,17
1708253798502,CHEM 6C,E04,460192,Stallings; Dontarie M,36,0,40,4
1708253798502,CHEM 6C,E05,460193,Stallings; Dontarie M,37,0,40,3
1708253799031,CHEM 6CH,A01,459630,Tezcan; Faik,40,0,40,0
1708253799592,CHEM 7L,A01,393998,Jazzar; Rodolphe,0,0,0,3
1708253799592,CHEM 7L,A02,393999,Jazzar; Rodolphe,10,0,24,14
1708253799592,CHEM 7L,A03,394000,Jazzar; Rodolphe,21,0,24,3
1708253799592,CHEM 7L,A04,394001,Jazzar; Rodolphe,22,0,24,2
1708253799592,CHEM 7L,A05,394002,Jazzar; Rodolphe,18,0,24,6
1708253799592,CHEM 7L,A06,394003,Jazzar; Rodolphe,22,0,24,2
1708253799592,CHEM 7L,A07,394004,Jazzar; Rodolphe,18,0,21,3
1708253799592,CHEM 7L,A08,394005,Jazzar; Rodolphe,0,0,0,0
1708253799592,CHEM 7L,A09,394006,Jazzar; Rodolphe,20,0,24,4
1708253799592,CHEM 7L,A10,394007,Jazzar; Rodolphe,24,0,24,0
1708253799592,CHEM 7L,B01,394009,Jazzar; Rodolphe,0,0,0,1
1708253799592,CHEM 7L,B02,394010,Jazzar; Rodolphe,1,0,6,5
1708253799592,CHEM 7L,B03,394011,Jazzar; Rodolphe,15,0,24,9
1708253799592,CHEM 7L,B04,394012,Jazzar; Rodolphe,18,0,21,3
1708253799592,CHEM 7L,B05,394013,Jazzar; Rodolphe,0,0,0,0
1708253799592,CHEM 7L,B06,394014,Jazzar; Rodolphe,15,0,24,9
1708253799592,CHEM 7L,B07,394015,Jazzar; Rodolphe,18,0,24,6
1708253799592,CHEM 7L,B08,394016,Jazzar; Rodolphe,23,0,24,1
1708253799592,CHEM 7L,B09,394017,Jazzar; Rodolphe,24,0,24,0
1708253799592,CHEM 7L,B10,394018,Jazzar; Rodolphe,24,0,24,0
1708253799592,CHEM 7L,C01,394020,Staff,0,0,0,0
1708253799592,CHEM 7L,C02,394021,Staff,21,0,24,3
1708253799592,CHEM 7L,C03,394022,Staff,23,0,24,1
1708253799592,CHEM 7L,C04,394023,Staff,24,0,24,0
1708253799592,CHEM 7L,C05,394024,Staff,0,0,0,0
1708253799592,CHEM 7L,C06,394025,Staff,20,0,24,4
1708253799592,CHEM 7L,C07,394026,Staff,22,0,24,2
1708253799592,CHEM 7L,C08,394027,Staff,23,0,24,1
1708253799592,CHEM 7L,C09,394028,Staff,24,0,24,0
1708253799592,CHEM 7L,C10,394029,Staff,23,0,24,1
1708253800119,CHEM 11,A01,459661,Staff,42,0,44,2
1708253800119,CHEM 11,A02,459664,Staff,44,0,44,0
1708253800119,CHEM 11,A03,459702,Staff,42,0,44,2
1708253800119,CHEM 11,A04,459707,Staff,44,0,44,0
1708253800119,CHEM 11,A05,459708,Staff,43,0,44,1
1708253800119,CHEM 11,A06,459711,Staff,41,0,44,3
1708253800651,CHEM 40A,A01,459576,Albizati; Kim F.,36,0,40,4
1708253800651,CHEM 40A,A02,459577,Albizati; Kim F.,33,0,40,7
1708253800651,CHEM 40A,A03,459578,Albizati; Kim F.,37,0,40,3
1708253800651,CHEM 40A,A04,459579,Albizati; Kim F.,38,0,40,2
1708253800651,CHEM 40A,A05,459580,Albizati; Kim F.,40,0,40,0
1708253800651,CHEM 40A,A06,459581,Albizati; Kim F.,37,0,40,3
1708253800651,CHEM 40A,A07,459582,Albizati; Kim F.,38,0,40,2
1708253800651,CHEM 40A,A08,459588,Albizati; Kim F.,39,0,40,1
1708253801195,CHEM 40B,A01,467442,Weizman; Haim,29,0,40,11
1708253801195,CHEM 40B,A02,467443,Weizman; Haim,33,0,40,7
1708253801195,CHEM 40B,A03,467444,Weizman; Haim,39,0,40,1
1708253801195,CHEM 40B,A04,467445,Weizman; Haim,38,0,40,2
1708253801195,CHEM 40B,A05,467446,Weizman; Haim,39,0,40,1
1708253801195,CHEM 40B,A06,467447,Weizman; Haim,37,0,40,3
1708253801195,CHEM 40B,A07,467448,Weizman; Haim,31,0,40,9
1708253801195,CHEM 40B,A08,467449,Weizman; Haim,40,0,40,0
1708253801195,CHEM 40B,B01,467383,Molinski; Tadeusz,40,0,40,0
1708253801195,CHEM 40B,B02,467384,Molinski; Tadeusz,40,0,40,0
1708253801195,CHEM 40B,B03,467385,Molinski; Tadeusz,40,0,40,0
1708253801195,CHEM 40B,B04,467399,Molinski; Tadeusz,40,0,40,0
1708253801195,CHEM 40B,B05,467400,Molinski; Tadeusz,40,0,40,0
1708253801195,CHEM 40B,B06,467401,Molinski; Tadeusz,40,0,40,0
1708253801195,CHEM 40B,B07,467402,Molinski; Tadeusz,40,0,40,0
1708253801195,CHEM 40B,B08,467404,Molinski; Tadeusz,39,0,40,1
1708253801743,CHEM 41B,A01,459571,Klosterman; Jeremy K,40,0,40,0
1708253801743,CHEM 41B,A02,459572,Klosterman; Jeremy K,36,0,37,1
1708253801743,CHEM 41B,A03,459573,Klosterman; Jeremy K,40,0,40,0
1708253802268,CHEM 41C,A01,459589,Tor; Yitzhak,40,0,40,0
1708253802268,CHEM 41C,A02,459624,Tor; Yitzhak,38,0,40,2
1708253802268,CHEM 41C,A03,459625,Tor; Yitzhak,40,0,40,0
1708253802268,CHEM 41C,A04,459626,Tor; Yitzhak,40,0,40,0
1708253802268,CHEM 41C,A05,459627,Tor; Yitzhak,29,0,29,0
1708253802268,CHEM 41C,A06,459628,Tor; Yitzhak,38,0,40,2
1708253802268,CHEM 41C,A07,459629,Tor; Yitzhak,40,0,40,0
1708253802866,CHEM 43A,A01,394068,Lam; Tin Yiu,12,0,24,12
1708253802866,CHEM 43A,A02,394088,Lam; Tin Yiu,23,0,24,1
1708253802866,CHEM 43A,A03,394092,Lam; Tin Yiu,23,0,24,1
1708253802866,CHEM 43A,A04,394093,Lam; Tin Yiu,21,0,24,3
1708253802866,CHEM 43A,A05,394094,Lam; Tin Yiu,23,0,24,1
1708253802866,CHEM 43A,A06,394096,Lam; Tin Yiu,15,0,24,9
1708253802866,CHEM 43A,A07,394115,Lam; Tin Yiu,20,0,24,4
1708253802866,CHEM 43A,A08,394116,Lam; Tin Yiu,22,0,24,2
1708253802866,CHEM 43A,A09,394117,Lam; Tin Yiu,22,0,24,2
1708253802866,CHEM 43A,A10,394118,Lam; Tin Yiu,20,0,24,4
1708253802866,CHEM 43A,A11,394119,Lam; Tin Yiu,8,0,13,5
1708253802866,CHEM 43A,A12,394120,Lam; Tin Yiu,24,0,24,0
1708253802866,CHEM 43A,A13,394132,Lam; Tin Yiu,24,0,24,0
1708253802866,CHEM 43A,B01,394134,Lam; Tin Yiu,24,0,24,0
1708253802866,CHEM 43A,B02,394135,Lam; Tin Yiu,16,0,24,8
1708253802866,CHEM 43A,B03,394136,Lam; Tin Yiu,13,0,24,11
1708253802866,CHEM 43A,B04,394137,Lam; Tin Yiu,17,0,24,7
1708253802866,CHEM 43A,B05,394138,Lam; Tin Yiu,20,0,24,4
1708253802866,CHEM 43A,B06,394139,Lam; Tin Yiu,19,0,24,5
1708253802866,CHEM 43A,B07,394140,Lam; Tin Yiu,20,0,24,4
1708253802866,CHEM 43A,B08,394141,Lam; Tin Yiu,24,0,24,0
1708253802866,CHEM 43A,B09,394142,Lam; Tin Yiu,20,0,24,4
1708253802866,CHEM 43A,B10,394143,Lam; Tin Yiu,24,0,24,0
1708253802866,CHEM 43A,B11,394145,Lam; Tin Yiu,22,0,24,2
1708253802866,CHEM 43A,B12,394146,Lam; Tin Yiu,23,0,24,1
1708253803394,CHEM 96,A00,394159,Bussey; Thomas J,24,0,25,1
1708253803921,CHEM 100A,A01,394161,Li; Shaowei,16,0,22,6
1708253803921,CHEM 100A,A02,394162,Li; Shaowei,20,0,24,4
1708253803921,CHEM 100A,A03,394163,Li; Shaowei,22,0,24,2
1708253803921,CHEM 100A,A04,394164,Li; Shaowei,24,0,24,0
1708253803921,CHEM 100A,A05,394165,Li; Shaowei,24,0,24,0
1708253803921,CHEM 100A,A06,394166,Li; Shaowei,20,0,22,2
1708253804447,CHEM 100B,A01,394175,Pomeroy; Robert S.,19,0,25,6
1708253804973,CHEM 105A,A01,394177,Young; Mark,31,0,39,8
1708253804973,CHEM 105A,B01,394179,Young; Mark,0,0,0,0
1708253805499,CHEM 108,A01,394181,Staff,14,0,20,6
1708253805499,CHEM 108,A02,394182,Staff,23,0,24,1
1708253805499,CHEM 108,B01,394184,Staff,4,0,20,16
1708253805499,CHEM 108,B02,394185,Staff,23,0,24,1
1708253806029,CHEM 109,A01,394187,Piercy; Marc Anthony,17,0,20,3
1708253806029,CHEM 109,A02,394188,Piercy; Marc Anthony,22,0,24,2
1708253806029,CHEM 109,B01,394193,Piercy; Marc Anthony,12,0,20,8
1708253806029,CHEM 109,B02,394194,Piercy; Marc Anthony,23,0,24,1
1708253806557,CHEM 111,A00,394195,Thiemens; Mark H,97,0,100,3
1708253807101,CHEM 114B,A01,459574,Piercy; Marc Anthony,39,0,45,6
1708253807101,CHEM 114B,A02,459575,Piercy; Marc Anthony,40,0,45,5
1708253807627,CHEM 114C,A01,467286,Komives; Elizabeth A,32,0,44,12
1708253807627,CHEM 114C,A02,467287,Komives; Elizabeth A,42,0,44,2
1708253807627,CHEM 114C,A03,467290,Komives; Elizabeth A,42,0,44,2
1708253807627,CHEM 114C,A04,467295,Komives; Elizabeth A,43,0,44,1
1708253808152,CHEM 114D,A00,394198,Ghosh; Gourisankar,29,0,30,1
1708253808677,CHEM 118,A01,459788,Donoghue; Daniel J.,37,0,40,3
1708253808677,CHEM 118,A02,459800,Donoghue; Daniel J.,37,0,40,3
1708253808677,CHEM 118,A03,459807,Donoghue; Daniel J.,36,0,40,4
1708253808677,CHEM 118,A04,459809,Donoghue; Daniel J.,38,0,40,2
1708253808677,CHEM 118,A05,459811,Donoghue; Daniel J.,37,0,40,3
1708253808677,CHEM 118,A06,459826,Donoghue; Daniel J.,39,0,40,1
1708253809203,CHEM 119,A01,467427,Joseph; Simpson,35,0,40,5
1708253809203,CHEM 119,A02,467441,Joseph; Simpson,0,0,0,0
1708253809733,CHEM 120B,A01,467450,Griffith; Kent,37,0,40,3
1708253809733,CHEM 120B,A02,467451,Griffith; Kent,34,0,40,6
1708253809733,CHEM 120B,A03,467452,Griffith; Kent,35,0,40,5
1708253810258,CHEM 123,A00,394211,Schimpf; Alina M,0,0,0,1
1708253810783,CHEM 125,A00,394217,Tezcan; Faik,18,0,20,2
1708253811313,CHEM 126A,A01,459715,Yong; Haiwang,39,0,40,1
1708253811313,CHEM 126A,A02,459725,Yong; Haiwang,36,0,40,4
1708253811854,CHEM 126B,A01,467405,Tauber; Michael,36,0,40,4
1708253811854,CHEM 126B,A02,467406,Tauber; Michael,39,0,40,1
1708253811854,CHEM 126B,A03,467426,Tauber; Michael,39,0,40,1
1708253812379,CHEM 132,A01,460181,Galperin; Michael,42,0,45,3
1708253812379,CHEM 132,A02,460182,Galperin; Michael,37,0,45,8
1708253812908,CHEM 135,A01,394222,Tauber; Michael,15,0,15,0
1708253813438,CHEM 143B,A01,394229,Klosterman; Jeremy K,16,0,24,8
1708253813438,CHEM 143B,A02,394230,Klosterman; Jeremy K,21,0,24,3
1708253813964,CHEM 156,A00,394231,Romero; Erik Anthony,30,0,30,0
1708253814494,CHEM 157,A00,394232,Tor; Yitzhak,74,0,80,6
1708253815020,CHEM 165,A01,460194,Herzik; Mark Anthony,21,0,25,4
1708253815546,CHEM 167,A01,467296,Deshmukh; Lalit,39,0,40,1
1708253815546,CHEM 167,A02,467297,Deshmukh; Lalit,33,0,40,7
1708253815546,CHEM 167,A03,467298,Deshmukh; Lalit,37,0,40,3
1708253815546,CHEM 167,A04,467312,Deshmukh; Lalit,37,0,40,3
1708253816075,CHEM 173,A00,394284,Young; Mark,48,0,50,2
1708253816617,CHEM 174,A01,455015,Pomeroy; Robert S.,45,0,50,5
1708253817163,CHEM 186,A00,477716,Paesani; Francesco & Gilson; Michael K.,6,0,12,6
1708253817687,CHEM 188,A00,394294,Bussey; Thomas J,19,0,20,1
1708253818216,CHEM 214,A00,394336,Ghosh; Gourisankar,12,0,20,8
1708253818743,CHEM 217,A00,394341,Joseph; Simpson,25,0,30,5
1708253819269,CHEM 221,A00,394425,Taylor; Susan S.,10,0,20,10
1708253819795,CHEM 225,A00,394429,Tezcan; Faik,4,0,10,6
1708253820319,CHEM 227,A00,394430,Schimpf; Alina M,26,0,30,4
1708253820848,CHEM 229,A00,394431,Stauber; Julia Megan,13,0,20,7
1708253821373,CHEM 235,A01,394433,Tauber; Michael,20,0,20,0
1708253821899,CHEM 236,A00,394434,Kummel; Andrew C,14,0,15,1
1708253822426,CHEM 241,A00,394435,Pokorski; Jonathan Kyle,14,0,15,1
1708253822958,CHEM 250,A00,394436,Weizman; Haim,0,0,0,16
1708253823484,CHEM 256,A00,394437,Romero; Erik Anthony,15,0,20,5
1708253824027,CHEM 257,A00,394438,Tor; Yitzhak,23,0,30,7
1708253824568,CHEM 265,A01,460195,Herzik; Mark Anthony,13,0,20,7
1708253825094,CHEM 273,A00,394440,Young; Mark,13,0,20,7
1708253825624,CHEM 276,A00,394441,Mc Culloch; Andrew Douglas & Amaro; Rommie E,0,0,0,0
1708253826151,CHEM 283,A00,394443,Komives; Elizabeth A,2,0,4,2
1708253826697,CHEM 286,A00,477693,Paesani; Francesco & Gilson; Michael K.,26,0,34,8
1708253827221,CHEM 291,A00,394446,Komives; Elizabeth A,20,0,20,0
1708253827746,CHEM 294,A00,394447,Romero; Erik Anthony,50,0,50,0
1708253828274,CHIN 10CD,A01,394453,Liu; Mingming,17,0,17,0
1708253828274,CHIN 10CD,A02,394457,Liu; Mingming,18,0,18,0
1708253828802,CHIN 10CM,A01,394465,Chen; Pei-Chia,11,0,12,1
1708253828802,CHIN 10CM,A02,394466,Chen; Pei-Chia,12,0,12,0
1708253828802,CHIN 10CM,B01,394468,Liu; Mingming,11,0,13,2
1708253828802,CHIN 10CM,B02,394469,Liu; Mingming,13,0,13,0
1708253829328,CHIN 10CN,A01,394581,Xu; Li,14,0,14,0
1708253829328,CHIN 10CN,A02,394582,Xu; Li,14,0,14,0
1708253829328,CHIN 10CN,B01,394585,Xu; Li,14,0,14,0
1708253829328,CHIN 10CN,B02,394586,Xu; Li,13,0,14,1
1708253829853,CHIN 20CD,A01,394591,Wang; Xiao,11,0,12,1
1708253829853,CHIN 20CD,A02,394592,Wang; Xiao,11,0,12,1
1708253830384,CHIN 20CN,A01,394597,Anderson; Qin-Hong,7,0,8,1
1708253830384,CHIN 20CN,A02,394599,Anderson; Qin-Hong,8,0,8,0
1708253830384,CHIN 20CN,B01,394601,Anderson; Qin-Hong,14,0,15,1
1708253830910,CHIN 100CM,A00,394602,Anderson; Qin-Hong,19,0,20,1
1708253831439,CHIN 100CN,A00,394603,Chen; Pei-Chia,24,0,24,0
1708253831966,CHIN 169B,A00,394623,Wang; Xiao,19,0,20,1
1708253832496,CLAS 87,A00,394669,Herbst; Matthew,19,0,20,1
1708253833022,CLAS 121R,A01,394671,Herbst; Matthew,11,0,12,1
1708253833022,CLAS 121R,B01,486854,Herbst; Matthew,8,0,8,0
1708253833551,CLIN 294C,A00,476856,Wierenga; Christina E & Banks; Sarah Jane,20,0,20,0
1708253834076,CLIN 296,001,476768,Brookman; Lauren Irene,94,0,100,6
1708253834076,CLIN 296,002,476855,Brookman; Lauren Irene,10,0,10,0
1708253834601,CLRE 238R,A00,394675,Mehta; Ravindra L.,9998,0,9999,1
1708253835129,CLRE 254,A00,394678,Vaida; Florin,9999,0,9999,0
1708253835654,CLRE 256,A00,394685,Morris; Sheldon,9999,0,9999,0
1708253836181,CLRE 258,A00,394692,Mehta; Ravindra L.,9999,0,9999,0
1708253836706,CLRE 260,A00,394693,Cuomo; Raphael Eduardo,9999,0,9999,0
1708253837231,CLRE 264,A00,394696,Mehta; Ravindra L.,9999,0,9999,0
1708253837759,CLRE 267,A00,394703,Vaida; Florin,9999,0,9999,0
1708253838283,CLRE 297,001,394705,Cuomo; Raphael Eduardo,9999,0,9999,0
1708253838809,CMM 246,A00,492783,Gordts; Philip & Varki; Ajit P & Lewis; Amanda Lark & Godula; Kamil & Gagneux; Pascal & Esko; Jeffrey D. & Bode; Lars,9,0,10,1
1708253839338,CMM 250,A00,492943,Willert; Karl Heinrich,31,0,40,9
1708253839866,COGR 200B,A00,395746,Jack; Caroline Sarah,2,0,5,3
1708253840392,COGR 225B,A00,395750,Serlin; David,1,0,5,4
1708253840921,COGR 225C,A00,395753,Gates; Kelly,1,0,5,4
1708253841450,COGR 275,A00,395943,Goldfarb; Brian,6,0,10,4
1708253841450,COGR 275,B00,396046,Fattal; Alexander Leor,4,0,10,6
1708253841450,COGR 275,C00,396047,Kidman; Shawna F,4,0,10,6
1708253841978,COGR 280,A00,396048,Ahn; Patricia Jeehyun,6,0,10,4
1708253842511,COGS 1,A01,407484,Boyle; Mary E. T.,52,0,60,8
1708253842511,COGS 1,A02,407498,Boyle; Mary E. T.,54,0,60,6
1708253842511,COGS 1,A03,407504,Boyle; Mary E. T.,59,0,60,1
1708253842511,COGS 1,A04,407512,Boyle; Mary E. T.,57,0,60,3
1708253842511,COGS 1,A05,407513,Boyle; Mary E. T.,60,0,60,0
1708253842511,COGS 1,A06,407514,Boyle; Mary E. T.,58,0,60,2
1708253842511,COGS 1,A07,407515,Boyle; Mary E. T.,57,0,57,0
1708253843039,COGS 9,A01,407520,Shannon; Kyle Michael,54,0,60,6
1708253843039,COGS 9,A02,407521,Shannon; Kyle Michael,60,0,60,0
1708253843039,COGS 9,A03,407522,Shannon; Kyle Michael,59,0,60,1
1708253843039,COGS 9,A04,407524,Shannon; Kyle Michael,57,0,60,3
1708253843039,COGS 9,A05,407525,Shannon; Kyle Michael,59,0,60,1
1708253843566,COGS 10,A01,407527,Morgan; Eric,45,0,50,5
1708253843566,COGS 10,A02,407530,Morgan; Eric,46,0,50,4
1708253843566,COGS 10,A03,407531,Morgan; Eric,46,0,50,4
1708253843566,COGS 10,A04,407532,Morgan; Eric,47,0,50,3
1708253843566,COGS 10,A05,407534,Morgan; Eric,47,0,50,3
1708253843566,COGS 10,A06,407539,Morgan; Eric,50,0,50,0
1708253843566,COGS 10,A07,407628,Morgan; Eric,50,0,50,0
1708253844092,COGS 11,A01,407699,Boroditsky; Lera,179,0,180,1
1708253844617,COGS 12,A00,407702,Boroditsky; Lera,75,0,75,0
1708253845159,COGS 14A,A01,407706,Barrera; Steven James,51,0,57,6
1708253845159,COGS 14A,A02,407707,Barrera; Steven James,54,0,57,3
1708253845159,COGS 14A,A03,407712,Barrera; Steven James,0,0,0,1
1708253845159,COGS 14A,A04,407715,Barrera; Steven James,57,0,57,0
1708253845159,COGS 14A,A05,407717,Barrera; Steven James,55,0,56,1
1708253845159,COGS 14A,A06,407718,Barrera; Steven James,52,0,55,3
1708253845159,COGS 14A,A07,407720,Barrera; Steven James,49,0,55,6
1708253845684,COGS 14B,A01,407723,Hoffman; Drew Ellen,52,0,57,5
1708253845684,COGS 14B,A02,407726,Hoffman; Drew Ellen,48,0,55,7
1708253845684,COGS 14B,A03,407727,Hoffman; Drew Ellen,52,0,55,3
1708253845684,COGS 14B,A04,407729,Hoffman; Drew Ellen,52,0,55,3
1708253845684,COGS 14B,A05,407730,Hoffman; Drew Ellen,50,0,55,5
1708253846227,COGS 17,A01,407733,Johnson; Christine M.,50,0,50,0
1708253846227,COGS 17,A02,407734,Johnson; Christine M.,48,0,50,2
1708253846227,COGS 17,A03,407735,Johnson; Christine M.,46,0,50,4
1708253846227,COGS 17,A04,407740,Johnson; Christine M.,47,0,50,3
1708253846227,COGS 17,A05,407745,Johnson; Christine M.,48,0,50,2
1708253846227,COGS 17,A06,407824,Johnson; Christine M.,48,0,50,2
1708253846227,COGS 17,A07,407878,Johnson; Christine M.,50,0,55,5
1708253846227,COGS 17,A08,408015,Johnson; Christine M.,52,0,55,3
1708253846776,COGS 18,A01,408118,Ellis; Shannon Elizabeth,27,0,35,8
1708253846776,COGS 18,A02,408119,Ellis; Shannon Elizabeth,31,0,35,4
1708253846776,COGS 18,A03,408120,Ellis; Shannon Elizabeth,23,0,35,12
1708253846776,COGS 18,A04,408136,Ellis; Shannon Elizabeth,33,0,35,2
1708253846776,COGS 18,A05,408141,Ellis; Shannon Elizabeth,35,0,35,0
1708253846776,COGS 18,A06,408143,Ellis; Shannon Elizabeth,34,0,35,1
1708253846776,COGS 18,A07,408144,Ellis; Shannon Elizabeth,35,0,35,0
1708253846776,COGS 18,A08,408145,Ellis; Shannon Elizabeth,34,0,35,1
1708253846776,COGS 18,A09,408146,Ellis; Shannon Elizabeth,35,0,35,0
1708253846776,COGS 18,B01,408148,Ellis; Shannon Elizabeth,30,0,32,2
1708253846776,COGS 18,B02,408149,Ellis; Shannon Elizabeth,26,0,32,6
1708253846776,COGS 18,B03,408151,Ellis; Shannon Elizabeth,27,0,33,6
1708253846776,COGS 18,B04,408154,Ellis; Shannon Elizabeth,32,0,33,1
1708253846776,COGS 18,B05,408163,Ellis; Shannon Elizabeth,29,0,33,4
1708253846776,COGS 18,B06,408176,Ellis; Shannon Elizabeth,33,0,33,0
1708253846776,COGS 18,B07,408177,Ellis; Shannon Elizabeth,31,0,33,2
1708253846776,COGS 18,B08,408178,Ellis; Shannon Elizabeth,32,0,33,1
1708253846776,COGS 18,B09,408195,Ellis; Shannon Elizabeth,31,0,33,2
1708253847304,COGS 87,A00,408196,Deak; Gedeon O.,20,0,20,0
1708253847304,COGS 87,B00,479478,Fleischer; Jason G,20,0,20,0
1708253847847,COGS 100,A01,408262,Allen; Michael Gordon,54,0,56,2
1708253847847,COGS 100,A02,408263,Allen; Michael Gordon,52,0,56,4
1708253847847,COGS 100,A03,408264,Allen; Michael Gordon,55,0,56,1
1708253847847,COGS 100,A04,408265,Allen; Michael Gordon,56,0,56,0
1708253847847,COGS 100,A05,408266,Allen; Michael Gordon,56,0,56,0
1708253847847,COGS 100,A06,408349,Allen; Michael Gordon,55,0,56,1
1708253848377,COGS 101A,A01,408352,Morgan; Eric,60,0,60,0
1708253848377,COGS 101A,A02,408353,Morgan; Eric,58,0,60,2
1708253848377,COGS 101A,A03,408354,Morgan; Eric,57,0,60,3
1708253848377,COGS 101A,A04,408355,Morgan; Eric,59,0,60,1
1708253848904,COGS 101B,A01,408373,Barrera; Steven James,47,0,50,3
1708253848904,COGS 101B,A02,408380,Barrera; Steven James,46,0,50,4
1708253848904,COGS 101B,A03,408384,Barrera; Steven James,38,0,50,12
1708253848904,COGS 101B,A04,408385,Barrera; Steven James,37,0,50,13
1708253849431,COGS 101C,A01,408387,Trott; Sean Thomas,48,0,50,2
1708253849431,COGS 101C,A02,408388,Trott; Sean Thomas,43,0,50,7
1708253849431,COGS 101C,A03,408389,Trott; Sean Thomas,45,0,50,5
1708253849960,COGS 107A,A01,408396,Boyle; Mary E. T.,54,0,56,2
1708253849960,COGS 107A,A02,408397,Boyle; Mary E. T.,54,0,56,2
1708253849960,COGS 107A,A03,408399,Boyle; Mary E. T.,51,0,56,5
1708253849960,COGS 107A,A04,408409,Boyle; Mary E. T.,50,0,56,6
1708253849960,COGS 107A,A05,408410,Boyle; Mary E. T.,51,0,56,5
1708253849960,COGS 107A,A06,408411,Boyle; Mary E. T.,55,0,56,1
1708253850501,COGS 107B,A01,408413,Mooshagian; Eric Frederick,46,0,50,4
1708253850501,COGS 107B,A02,408414,Mooshagian; Eric Frederick,43,0,50,7
1708253850501,COGS 107B,A03,408428,Mooshagian; Eric Frederick,43,0,50,7
1708253850501,COGS 107B,A04,408434,Mooshagian; Eric Frederick,46,0,50,4
1708253850501,COGS 107B,A05,408435,Mooshagian; Eric Frederick,50,0,50,0
1708253850501,COGS 107B,A06,408446,Mooshagian; Eric Frederick,49,0,50,1
1708253851043,COGS 107C,A01,408500,Chiba; Andrea,51,0,60,9
1708253851043,COGS 107C,A02,408519,Chiba; Andrea,55,0,60,5
1708253851043,COGS 107C,A03,408524,Chiba; Andrea,56,0,60,4
1708253851586,COGS 108,A01,408532,Fleischer; Jason G,45,0,60,15
1708253851586,COGS 108,A02,408543,Fleischer; Jason G,58,0,60,2
1708253851586,COGS 108,A03,408544,Fleischer; Jason G,59,0,60,1
1708253851586,COGS 108,A04,408552,Fleischer; Jason G,32,0,60,28
1708253851586,COGS 108,A05,408554,Fleischer; Jason G,47,0,60,13
1708253851586,COGS 108,A06,408574,Fleischer; Jason G,43,0,60,17
1708253851586,COGS 108,A07,408576,Fleischer; Jason G,56,0,60,4
1708253852115,COGS 112,A01,408682,Hoffman; Drew Ellen,32,0,50,18
1708253852115,COGS 112,A02,408683,Hoffman; Drew Ellen,38,0,50,12
1708253852115,COGS 112,A03,408684,Hoffman; Drew Ellen,48,0,60,12
1708253852643,COGS 122,A01,408695,Dow; Steven P,21,0,50,29
1708253853168,COGS 125,A00,408697,Klemmer; Scott R,35,0,50,15
1708253853698,COGS 126,A01,408787,Hollan; James D.,44,0,50,6
1708253854228,COGS 138,A01,408866,Khosla; Meenakshi,71,0,75,4
1708253854754,COGS 142,A01,408868,Rossano; Federico,49,0,50,1
1708253855280,COGS 144,A01,408950,Rossano; Federico,48,0,50,2
1708253855822,COGS 155,A01,408993,Staff,49,0,50,1
1708253856407,COGS 157,A00,408994,Creel; Sarah,0,0,0,0
1708253856933,COGS 160,A00,409031,Deak; Gedeon O.,20,0,20,0
1708253857458,COGS 175,A01,409035,Rill; Bryan,67,0,75,8
1708253857987,COGS 178,A00,409274,Jernigan; Terry Lynne,68,0,70,2
1708253859529,COGS 179,A00,409278,Staff,40,0,40,0
1708253860056,COGS 184,A01,409317,Johnson; Christine M.,42,0,50,8
1708253860586,COGS 185,A01,409476,Tu; Zhuowen,33,0,50,17
1708253860586,COGS 185,A02,409525,Tu; Zhuowen,45,0,50,5
1708253861113,COGS 188,A01,409527,Fleischer; Jason G,44,0,75,31
1708253861661,COGS 190C,001,409528,Chiba; Andrea,9999,0,9999,0
1708253861661,COGS 190C,002,409530,Fleischer; Jason G,9999,0,9999,0
1708253861661,COGS 190C,003,409531,Boyle; Mary E. T.,9999,0,9999,0
1708253861661,COGS 190C,004,409532,Nitz; Douglas A.,9999,0,9999,0
1708253861661,COGS 190C,005,409535,Rangel; Lara M,9999,0,9999,0
1708253861661,COGS 190C,006,409536,Rossano; Federico,9999,0,9999,0
1708253861661,COGS 190C,007,409537,Deak; Gedeon O.,9999,0,9999,0
1708253861661,COGS 190C,008,409538,Trott; Sean Thomas,9999,0,9999,0
1708253861661,COGS 190C,009,409540,Creel; Sarah,9999,0,9999,0
1708253861661,COGS 190C,010,409541,Voytek; Bradley Thomas,9999,0,9999,0
1708253861661,COGS 190C,011,409542,Greene; Deanna Jacquelyn,9999,0,9999,0
1708253861661,COGS 190C,012,409543,Ellis; Shannon Elizabeth,9999,0,9999,0
1708253861661,COGS 190C,013,409546,Kirsh; David Joel,9999,0,9999,0
1708253862185,COGS 190D,A00,409547,Voytek; Bradley Thomas,20,0,20,0
1708253862710,COGS 194,A00,409548,Hill; Seth J,9999,0,9999,0
1708253863239,COGS 200,A01,406697,Creel; Sarah,0,0,0,0
1708253863766,COGS 205,A00,406698,Chiba; Andrea,20,0,20,0
1708253864293,COGS 209,A00,406699,Mukamel; Eran A,41,0,68,27
1708253864836,COGS 210C,001,406700,Kirsh; David Joel,9999,0,9999,0
1708253864836,COGS 210C,002,406701,Greene; Deanna Jacquelyn,9998,0,9999,1
1708253864836,COGS 210C,003,406702,Xia; Haijun,9999,0,9999,0
1708253864836,COGS 210C,004,406703,Nitz; Douglas A.,9998,0,9999,1
1708253864836,COGS 210C,005,406710,Hollan; James D.,9999,0,9999,0
1708253864836,COGS 210C,006,406713,De Sa; Virginia,9999,0,9999,0
1708253864836,COGS 210C,007,406714,Rossano; Federico,9999,0,9999,0
1708253864836,COGS 210C,008,406740,Kiyonaga; Anastasia,9999,0,9999,0
1708253864836,COGS 210C,009,406745,Guo; Philip J,9998,0,9999,1
1708253864836,COGS 210C,010,406746,Dow; Steven P,9999,0,9999,0
1708253864836,COGS 210C,011,406747,Bergen; Benjamin,9999,0,9999,0
1708253864836,COGS 210C,012,406758,Coulson; Seana M,9999,0,9999,0
1708253865360,COGS 211C,A00,406763,Coulson; Seana M,17,0,20,3
1708253865890,COGS 229,A00,406788,Hollan; James D. & Xia; Haijun,4,0,10,6
1708253866416,COGS 238,A00,406789,Bergen; Benjamin,17,0,20,3
1708253866942,COGS 278,A00,406794,Jernigan; Terry Lynne,18,0,20,2
1708253867486,COMM 10,A01,394711,Schmidt; Thomas Rainer,20,0,24,4
1708253867486,COMM 10,A02,394714,Schmidt; Thomas Rainer,24,0,24,0
1708253867486,COMM 10,A03,394716,Schmidt; Thomas Rainer,24,0,24,0
1708253867486,COMM 10,A04,394717,Schmidt; Thomas Rainer,22,0,24,2
1708253867486,COMM 10,A05,394731,Schmidt; Thomas Rainer,24,0,24,0
1708253867486,COMM 10,A06,394733,Schmidt; Thomas Rainer,24,0,24,0
1708253867486,COMM 10,A07,394740,Schmidt; Thomas Rainer,24,0,24,0
1708253867486,COMM 10,A08,394741,Schmidt; Thomas Rainer,24,0,24,0
1708253867486,COMM 10,A09,394751,Schmidt; Thomas Rainer,23,0,24,1
1708253867486,COMM 10,A10,394779,Schmidt; Thomas Rainer,24,0,24,0
1708253867486,COMM 10,A11,394809,Schmidt; Thomas Rainer,24,0,24,0
1708253867486,COMM 10,A12,394811,Schmidt; Thomas Rainer,24,0,24,0
1708253867486,COMM 10,A13,394818,Schmidt; Thomas Rainer,24,0,24,0
1708253867486,COMM 10,A14,394825,Schmidt; Thomas Rainer,23,0,24,1
1708253867486,COMM 10,A15,394828,Schmidt; Thomas Rainer,24,0,24,0
1708253867486,COMM 10,A16,394829,Schmidt; Thomas Rainer,0,0,0,0
1708253867486,COMM 10,A17,486828,Schmidt; Thomas Rainer,20,0,21,1
1708253868016,COMM 20,A01,394834,McKenna; Denise,69,0,70,1
1708253868541,COMM 80,A01,394849,Campbell; Robert Harold,120,0,120,0
1708253869087,COMM 100C,A01,394957,Kidman; Shawna F,24,0,25,1
1708253869087,COMM 100C,A02,394972,Kidman; Shawna F,25,0,25,0
1708253869087,COMM 100C,A03,394977,Kidman; Shawna F,22,0,25,3
1708253869087,COMM 100C,A04,394981,Kidman; Shawna F,25,0,25,0
1708253869087,COMM 100C,A05,394985,Kidman; Shawna F,24,0,25,1
1708253869087,COMM 100C,A06,394989,Kidman; Shawna F,23,0,25,2
1708253869087,COMM 100C,A07,394993,Kidman; Shawna F,24,0,25,1
1708253869087,COMM 100C,A08,394997,Kidman; Shawna F,23,0,25,2
1708253869087,COMM 100C,A09,394999,Kidman; Shawna F,25,0,25,0
1708253869087,COMM 100C,A10,395018,Kidman; Shawna F,25,0,25,0
1708253869087,COMM 100C,A11,395041,Kidman; Shawna F,24,0,25,1
1708253869087,COMM 100C,A12,395080,Kidman; Shawna F,24,0,25,1
1708253869613,COMM 101,A01,395135,Halm; Gavin Patrick,15,0,15,0
1708253869613,COMM 101,A02,395252,Halm; Gavin Patrick,15,0,15,0
1708253869613,COMM 101,A03,395253,Halm; Gavin Patrick,15,0,15,0
1708253869613,COMM 101,A04,395263,Halm; Gavin Patrick,15,0,15,0
1708253870139,COMM 101D,A00,395264,Martinico; Daniel J,13,0,16,3
1708253870665,COMM 101K,A00,395266,Ahn; Patricia Jeehyun,16,0,18,2
1708253871195,COMM 101N,A00,395267,Martinico; Daniel J,16,0,16,0
1708253871720,COMM 102C,A01,395270,Campion; Camille E,5,0,6,1
1708253871720,COMM 102C,A02,395271,Campion; Camille E,6,0,6,0
1708253871720,COMM 102C,A03,395272,Campion; Camille E,5,0,6,1
1708253872245,COMM 102M,A01,395285,Davis; Zeinabu I.,9,0,10,1
1708253872245,COMM 102M,A02,395288,Davis; Zeinabu I.,8,0,10,2
1708253872769,COMM 103D,A00,395343,Gates; Kelly,34,0,35,1
1708253873295,COMM 107,A00,395461,Serlin; David,33,0,35,2
1708253873821,COMM 109D,A00,395462,Halm; Gavin Patrick,72,0,75,3
1708253874347,COMM 110G,A00,395481,Whitworth-Smith; Andrew C,32,0,35,3
1708253874873,COMM 110M,A00,395482,Harb; Anthony Joseph,34,0,35,1
1708253875401,COMM 111A,A00,487217,Pavon Aramburu; Maria Laur,34,0,35,1
1708253875928,COMM 113T,A00,395516,Fields; Gary,35,0,35,0
1708253876455,COMM 114A,A00,395517,Zilberg; Elana,32,0,35,3
1708253876984,COMM 114B,A00,395523,Zilberg; Elana,19,0,20,1
1708253877510,COMM 114E,A00,487218,Pavon Aramburu; Maria Laur,34,0,35,1
1708253878036,COMM 114W,A00,395524,Walkover; Lillian B,17,0,18,1
1708253878580,COMM 126,A00,479341,Staff,26,0,30,4
1708253879106,COMM 132,A00,481491,Rojo Solis; Juan Jose,0,0,0,0
1708253879648,COMM 134,A00,395578,Abuelhiga; Soraya Jill,28,0,30,2
1708253880175,COMM 143,A00,395579,Rojo Solis; Juan Jose,28,0,30,2
1708253880718,COMM 146,A00,395584,Jack; Caroline Sarah,29,0,30,1
1708253881243,COMM 168,A00,395592,Harb; Anthony Joseph,29,0,30,1
1708253881773,COMM 170,A00,395608,Pavon Aramburu; Maria Laur,30,0,30,0
1708253882298,COMM 173,A00,395609,Alac; Morana,29,0,30,1
1708253882826,COMM 174,A00,395679,Alac; Morana,30,0,30,0
1708253883352,COMM 190,A00,395682,Abuelhiga; Soraya Jill,19,0,23,4
1708253883352,COMM 190,B00,395696,Staff,21,0,23,2
1708253883352,COMM 190,C00,395697,Fattal; Alexander Leor,22,0,23,1
1708253883893,CSE 8A,A50,459200,Miranda; Gregory Joseph,34,0,35,1
1708253883893,CSE 8A,A51,459205,Miranda; Gregory Joseph,34,0,35,1
1708253883893,CSE 8A,A52,459206,Miranda; Gregory Joseph,34,0,35,1
1708253883893,CSE 8A,A53,459212,Miranda; Gregory Joseph,34,0,35,1
1708253883893,CSE 8A,A54,459213,Miranda; Gregory Joseph,34,0,35,1
1708253883893,CSE 8A,A55,459232,Miranda; Gregory Joseph,34,0,35,1
1708253884423,CSE 11,A01,470735,Ochoa; Benjamin Lawrence,180,0,195,15
1708253884948,CSE 12,A01,470744,Cao; Yingjun,189,0,200,11
1708253884948,CSE 12,B01,470752,Miranda; Gregory Joseph,71,0,100,29
1708253884948,CSE 12,B02,470760,Miranda; Gregory Joseph,93,0,100,7
1708253885481,CSE 15L,A01,410174,Solares; Edwin A,6,0,10,4
1708253885481,CSE 15L,B01,410215,Solares; Edwin A,7,0,10,3
1708253885481,CSE 15L,C01,410305,Solares; Edwin A,3,0,10,7
1708253885481,CSE 15L,D01,410400,Solares; Edwin A,1,0,10,9
1708253886006,CSE 20,A01,470765,Minnes Kemp; Mor Mia,145,0,150,5
1708253886531,CSE 21,A01,470776,Jones; Miles E,68,0,73,5
1708253886531,CSE 21,A02,482889,Jones; Miles E,68,0,72,4
1708253887075,CSE 29,A01,494014,Soosai Raj; Adalbert Geral,48,0,50,2
1708253887075,CSE 29,A02,494016,Soosai Raj; Adalbert Geral,40,0,50,10
1708253887075,CSE 29,B01,494018,Shalev; Aaron D,16,0,20,4
1708253887621,CSE 30,A01,470784,Cao; Yingjun,141,0,150,9
1708253887621,CSE 30,B01,467469,Muller; P Keith,98,0,120,22
1708253888148,CSE 87,A00,410528,Moshiri; Niema,20,0,20,0
1708253888675,CSE 90,A00,486885,Minnes Kemp; Mor Mia,0,0,0,0
1708253889201,CSE 91,A00,486872,Minnes Kemp; Mor Mia,0,0,0,0
1708253889201,CSE 91,B00,486873,Minnes Kemp; Mor Mia,0,0,0,0
1708253889727,CSE 95,A00,410529,Minnes Kemp; Mor Mia,50,0,50,0
1708253890254,CSE 100,A01,470792,Sahoo; Debashis,54,0,70,16
1708253890780,CSE 100R,A01,410556,Moshiri; Niema,1,0,40,39
1708253891309,CSE 101,A01,470797,Jones; Miles E,14,0,44,30
1708253891309,CSE 101,A02,482892,Jones; Miles E,31,0,43,12
1708253891838,CSE 105,A01,470800,Micciancio; Daniele,85,0,98,13
1708253892363,CSE 107,A01,467479,Bellare; Mihir,141,0,146,5
1708253892891,CSE 109,A01,459538,Shang; Jingbo,0,0,25,25
1708253893423,CSE 110,A50,459395,Powell; Thomas Allan,49,0,50,1
1708253893423,CSE 110,A51,459512,Powell; Thomas Allan,37,0,50,13
1708253893423,CSE 110,A52,459513,Powell; Thomas Allan,46,0,50,4
1708253893423,CSE 110,A53,459514,Powell; Thomas Allan,48,0,50,2
1708253893423,CSE 110,A54,459515,Powell; Thomas Allan,47,0,50,3
1708253893423,CSE 110,A55,459516,Powell; Thomas Allan,45,0,50,5
1708253893423,CSE 110,A56,459517,Powell; Thomas Allan,47,0,48,1
1708253893950,CSE 112,A50,459518,Powell; Thomas Allan,132,0,146,14
1708253894479,CSE 120,A01,470808,Zhou; Yuan-Yuan,167,0,200,33
1708253895004,CSE 125,A00,410564,Voelker; Geoffrey M.,30,0,30,0
1708253895530,CSE 127,A01,467484,Fernandes; Earlence T,175,0,196,21
1708253896060,CSE 130,A01,467485,Polikarpova; Nadezhda,176,0,192,16
1708253896587,CSE 131,A01,459522,Ding; Yufei,36,0,50,14
1708253897115,CSE 132B,A01,470816,Deutsch; Alin Bernard,60,0,70,10
1708253897648,CSE 140,A01,410606,Orailoglu; Alex,99,0,100,1
1708253897648,CSE 140,B01,410622,Eldon; John,130,0,146,16
1708253898174,CSE 140L,A01,410655,Orailoglu; Alex,99,0,100,1
1708253898174,CSE 140L,B01,410658,Eldon; John,122,0,146,24
1708253898703,CSE 141,A01,467486,Zhao; Jishen,173,0,196,23
1708253899230,CSE 141L,A01,410685,Eldon; John,162,0,196,34
1708253899755,CSE 145,A01,410713,Kastner; Ryan Charles,25,0,25,0
1708253900285,CSE 150B,A01,470824,Gao; Sicun,310,0,362,52
1708253900814,CSE 156,A01,467487,Nakashole; Ndapandula,138,0,192,54
1708253901340,CSE 165,A01,410757,Weibel; Nadir & Schulze; Jurgen P.,40,0,50,10
1708253901867,CSE 168,A01,410759,Ramamoorthi; Ravi,24,0,25,1
1708253901867,CSE 168,A02,410761,Ramamoorthi; Ravi,24,0,25,1
1708253902396,CSE 175,A01,410764,Kumar; Rakesh,48,0,50,2
1708253902922,CSE 182,A01,455011,Bafna; Vineet,47,0,50,3
1708253903455,CSE 185,A01,410895,Gymrek; Melissa Ann,41,0,57,16
1708253903455,CSE 185,A02,479240,Gymrek; Melissa Ann,53,0,58,5
1708253904004,CSE 190,A00,410982,Grier; Daniel T,48,0,50,2
1708253904004,CSE 190,B00,410983,Riek; Laurel D,50,0,50,0
1708253904004,CSE 190,C00,410984,Staff,36,0,50,14
1708253904004,CSE 190,D00,481666,Saha; Barna & Impagliazzo; Russell,27,0,28,1
1708253904531,CSE 203A,A00,410985,Saha; Barna & Impagliazzo; Russell,0,0,0,0
1708253905060,CSE 209A,A00,410986,Grier; Daniel T,0,0,0,0
1708253905605,CSE 209B,A00,410987,Bellare; Mihir,0,0,0,0
1708253906133,CSE 217,A01,459553,Weibel; Nadir,0,0,0,0
1708253906660,CSE 218,A00,410989,Griswold; William G.,0,0,0,0
1708253907188,CSE 219,A00,410990,Hollan; James D. & Xia; Haijun,0,0,0,0
1708253907730,CSE 224,A01,470832,Snoeren; Alex C.,0,0,0,0
1708253908255,CSE 229A,A00,410993,Shalev; Aaron D,0,0,0,0
1708253908781,CSE 229C,A00,410994,Fernandes; Earlence T,0,0,0,0
1708253909323,CSE 231,A01,467488,Jhala; Ranjit,0,0,0,0
1708253909867,CSE 233,A00,410996,Vianu; Victor Dan,0,0,0,0
1708253910393,CSE 237D,A00,410998,Kastner; Ryan Charles,0,0,0,0
1708253911213,CSE 239A,A00,410999,Vianu; Victor Dan,0,0,0,0
1708253911739,CSE 239B,A00,411000,Coblenz; Michael J,0,0,0,0
1708253912265,CSE 240A,A00,411001,Chin; Bryan W.,0,0,0,0
1708253912792,CSE 252D,A00,411004,Chandraker; Manmohan Krishna,0,0,0,0
1708253913317,CSE 256,A00,411005,Nakashole; Ndapandula,0,0,0,0
1708253913843,CSE 260,A01,467491,Chin; Bryan W.,0,0,0,0
1708253914372,CSE 276B,A00,411007,Riek; Laurel D,0,0,0,0
1708253914897,CSE 276F,A01,459554,Su; Hao,0,0,0,0
1708253915430,CSE 283,A00,411009,Bafna; Vineet & Zhong; Sheng,0,0,0,0
1708253916973,CSE 290,A00,411010,Gao; Sicun,0,0,0,0
1708253916973,CSE 290,B00,411011,Chern; Albert Ren-Haur,0,0,0,0
1708253916973,CSE 290,C00,411012,Swanson; Steven James,0,0,0,0
1708253916973,CSE 290,E00,411013,Su; Hao,0,0,0,0
1708253916973,CSE 290,F00,411014,Riek; Laurel D,0,0,0,0
1708253916973,CSE 290,G00,411015,Gymrek; Melissa Ann,0,0,0,0
1708253916973,CSE 290,H00,479239,Dasgupta; Sanjoy & Gymrek; Melissa Ann,0,0,0,0
1708253916973,CSE 290,I00,481669,Bafna; Vineet,0,0,0,0
1708253916973,CSE 290,J00,494949,Paturi; Ramamohan,0,0,0,0
1708253917541,CSE 291,A00,411016,Li; Tzumao,0,0,0,0
1708253917541,CSE 291,B00,411017,Heninger; Nadia A,0,0,0,0
1708253917541,CSE 291,C00,411114,Chern; Albert Ren-Haur,0,0,0,0
1708253917541,CSE 291,D00,411115,Zhang; Yiying,0,0,0,0
1708253917541,CSE 291,E00,411116,Cheng; Chung Kuan,0,0,0,0
1708253917541,CSE 291,G00,411118,Lerner; Sorin,0,0,0,0
1708253917541,CSE 291,I00,481509,Shang; Jingbo,0,0,0,0
1708253917541,CSE 291,J00,494844,Savage; Stefan & Stefan; Deian,50,0,50,0
1708253918131,CSE 293,001,487239,Bafna; Vineet,9999,0,9999,0
1708253918131,CSE 293,002,487240,Bellare; Mihir,9999,0,9999,0
1708253918131,CSE 293,003,487241,Berg-Kirkpatrick; Taylor D,9999,0,9999,0
1708253918131,CSE 293,004,487242,Chandraker; Manmohan Krishna,9999,0,9999,0
1708253918131,CSE 293,005,487243,Cheng; Chung Kuan,9999,0,9999,0
1708253918131,CSE 293,006,487244,Christensen; Henrik I,9999,0,9999,0
1708253918131,CSE 293,007,487245,Coblenz; Michael J,9999,0,9999,0
1708253918131,CSE 293,008,487363,Cottrell; Garrison W,9999,0,9999,0
1708253918131,CSE 293,009,487366,Deutsch; Alin Bernard,9999,0,9999,0
1708253918131,CSE 293,010,487433,Esmaeilzadeh; Hadi,9999,0,9999,0
1708253918131,CSE 293,011,487434,Freund; Yoav,9999,0,9999,0
1708253918131,CSE 293,012,487455,Griswold; William G.,9999,0,9999,0
1708253918131,CSE 293,013,487469,Gymrek; Melissa Ann,9999,0,9999,0
1708253918131,CSE 293,014,487470,Heninger; Nadia A,9999,0,9999,0
1708253918131,CSE 293,015,487471,Impagliazzo; Russell,9999,0,9999,0
1708253918131,CSE 293,016,487472,Jhala; Ranjit,9999,0,9999,0
1708253918131,CSE 293,017,487473,Kahng; Andrew Byun,9999,0,9999,0
1708253918131,CSE 293,018,487474,Kane; Daniel Mertz,9999,0,9999,0
1708253918131,CSE 293,019,487475,Kriegman; David J,9999,0,9999,0
1708253918131,CSE 293,020,487476,Kumar; Arun Kumar,9999,0,9999,0
1708253918131,CSE 293,021,487477,Lerner; Sorin,9999,0,9999,0
1708253918131,CSE 293,022,487478,Lovett; Shachar,9999,0,9999,0
1708253918131,CSE 293,023,487520,McAuley; Julian John,9999,0,9999,0
1708253918131,CSE 293,024,487522,Micciancio; Daniele,9999,0,9999,0
1708253918131,CSE 293,025,487577,Orailoglu; Alex,9999,0,9999,0
1708253918131,CSE 293,026,487586,Pannuto; Patrick William,9999,0,9999,0
1708253918131,CSE 293,027,487598,Paturi; Ramamohan,9999,0,9999,0
1708253918131,CSE 293,028,487604,Polikarpova; Nadezhda,9999,0,9999,0
1708253918131,CSE 293,029,487609,Politz; Joseph Gibbs,9999,0,9999,0
1708253918131,CSE 293,030,487642,Porter; George M,9999,0,9999,0
1708253918131,CSE 293,031,487665,Porter; Leonard Emerson,9999,0,9999,0
1708253918131,CSE 293,032,487689,Ramamoorthi; Ravi,9999,0,9999,0
1708253918131,CSE 293,033,487698,Riek; Laurel D,9999,0,9999,0
1708253918131,CSE 293,034,487712,Sahoo; Debashis,9999,0,9999,0
1708253918131,CSE 293,035,487721,Saul; Lawrence,9999,0,9999,0
1708253918131,CSE 293,036,487735,Savage; Stefan,9999,0,9999,0
1708253918131,CSE 293,037,487744,Schulze; Jurgen P.,9999,0,9999,0
1708253918131,CSE 293,038,487758,Snoeren; Alex C.,9999,0,9999,0
1708253918131,CSE 293,039,487767,Shang; Jingbo,9999,0,9999,0
1708253918131,CSE 293,040,487790,Stefan; Deian,9999,0,9999,0
1708253918131,CSE 293,041,487817,Su; Hao,9999,0,9999,0
1708253918131,CSE 293,042,487827,Swanson; Steven James,9999,0,9999,0
1708253918131,CSE 293,043,487830,Tullsen; Dean Michael,9999,0,9999,0
1708253918131,CSE 293,044,487837,Vaccaro; Kristen Marie,9999,0,9999,0
1708253918131,CSE 293,045,487838,Voelker; Geoffrey M.,9999,0,9999,0
1708253918131,CSE 293,046,487842,Zhao; Jishen,9999,0,9999,0
1708253918131,CSE 293,047,487847,Zhou; Yuan-Yuan,9999,0,9999,0
1708253918131,CSE 293,048,487852,Gao; Sicun,9999,0,9999,0
1708253918131,CSE 293,049,487853,Weibel; Nadir,9999,0,9999,0
1708253918131,CSE 293,050,487854,Gupta; Rajesh K.,9999,0,9999,0
1708253918131,CSE 293,051,487855,Soosai Raj; Adalbert Geral,9999,0,9999,0
1708253918131,CSE 293,052,494373,Zhang; Hao,9999,0,9999,0
1708253918657,CSE 294,A00,411124,Voelker; Geoffrey M.,15,0,15,0
1708253919199,CSS 100,A01,396053,Trott; Sean Thomas,43,0,50,7
1708253919728,CSS 120,A01,479237,Mignozzetti; Umberto,47,0,50,3
1708253919728,CSS 120,A02,479238,Mignozzetti; Umberto,50,0,50,0
1708253920255,CSS 209,A00,396054,Styler; William Francis,21,0,35,14
1708253920783,CSS 296,001,396055,Mignozzetti; Umberto,0,0,0,1
1708253920783,CSS 296,002,396056,Styler; William Francis,0,0,0,1
1708253920783,CSS 296,003,396057,Broz; James Lawrence,0,0,0,2
1708253920783,CSS 296,004,396058,Elliott; Graham,0,0,0,5
1708253920783,CSS 296,005,396059,Sun; Feiyang,0,0,0,0
1708253920783,CSS 296,006,396060,Dewaard; Andrew Michael,0,0,0,0
1708253921311,DDPM 210,A00,400652,Ma; Joseph David,36,0,36,0
1708253921837,DDPM 211,A00,400653,Ma; Joseph David,36,0,36,0
1708253922366,DDPM 214,A00,400720,Ma; Joseph David,36,0,36,0
1708253922893,DERM 296,001,464131,Staff,50,0,50,0
1708253922893,DERM 296,002,464178,Staff,50,0,50,0
1708253922893,DERM 296,003,464181,Staff,50,0,50,0
1708253923460,DOC 3,A01,399409,Strom; Megan C.,0,0,0,0
1708253923460,DOC 3,A02,399414,Strom; Megan C.,0,0,0,0
1708253923460,DOC 3,A03,399432,Strom; Megan C.,0,0,0,0
1708253923460,DOC 3,A04,399461,Strom; Megan C.,0,0,0,0
1708253923460,DOC 3,A05,399470,Strom; Megan C.,0,0,0,0
1708253923460,DOC 3,A06,399476,Strom; Megan C.,0,0,0,0
1708253923460,DOC 3,A07,399547,Strom; Megan C.,0,0,0,0
1708253923460,DOC 3,A08,399548,Strom; Megan C.,0,0,0,0
1708253923460,DOC 3,A09,399675,Strom; Megan C.,0,0,0,0
1708253923460,DOC 3,A10,399687,Strom; Megan C.,0,0,0,0
1708253923460,DOC 3,A11,399704,Strom; Megan C.,0,0,0,0
1708253923460,DOC 3,A12,399707,Strom; Megan C.,0,0,0,0
1708253923460,DOC 3,A13,399714,Strom; Megan C.,0,0,0,0
1708253923460,DOC 3,A14,399721,Strom; Megan C.,0,0,0,0
1708253923460,DOC 3,A15,399765,Strom; Megan C.,0,0,0,0
1708253923460,DOC 3,A16,399766,Strom; Megan C.,0,0,0,0
1708253923460,DOC 3,B01,399786,Strom; Megan C.,0,0,0,0
1708253923460,DOC 3,B02,399787,Strom; Megan C.,0,0,0,0
1708253923460,DOC 3,B03,399788,Strom; Megan C.,0,0,0,0
1708253923460,DOC 3,B04,399845,Strom; Megan C.,0,0,0,0
1708253923460,DOC 3,B05,399846,Strom; Megan C.,0,0,0,0
1708253923460,DOC 3,B06,399895,Strom; Megan C.,0,0,0,0
1708253923460,DOC 3,B07,399916,Strom; Megan C.,0,0,0,0
1708253923460,DOC 3,B08,400073,Strom; Megan C.,0,0,0,0
1708253923460,DOC 3,B09,400074,Strom; Megan C.,0,0,0,0
1708253923460,DOC 3,B10,400076,Strom; Megan C.,0,0,0,0
1708253923460,DOC 3,B11,400077,Strom; Megan C.,0,0,0,0
1708253923460,DOC 3,B12,400078,Strom; Megan C.,0,0,0,0
1708253923460,DOC 3,B13,400079,Strom; Megan C.,0,0,0,0
1708253923460,DOC 3,B14,400080,Strom; Megan C.,0,0,0,0
1708253923460,DOC 3,B15,400081,Strom; Megan C.,0,0,0,0
1708253923460,DOC 3,B16,400082,Strom; Megan C.,0,0,0,0
1708253923460,DOC 3,C01,400084,Chapman; Dillon,0,0,0,0
1708253923460,DOC 3,C02,400085,Chapman; Dillon,0,0,0,0
1708253923460,DOC 3,C03,400086,Chapman; Dillon,0,0,0,0
1708253923460,DOC 3,C04,400087,Chapman; Dillon,0,0,0,0
1708253923460,DOC 3,C05,400113,Chapman; Dillon,0,0,0,0
1708253923460,DOC 3,C06,400114,Chapman; Dillon,0,0,0,0
1708253923460,DOC 3,C07,400117,Chapman; Dillon,0,0,0,0
1708253923460,DOC 3,C08,400118,Chapman; Dillon,0,0,0,0
1708253923460,DOC 3,C09,400119,Chapman; Dillon,0,0,0,0
1708253923460,DOC 3,C10,400121,Chapman; Dillon,0,0,0,0
1708253923460,DOC 3,C11,400122,Chapman; Dillon,0,0,0,0
1708253923460,DOC 3,C12,400126,Chapman; Dillon,0,0,0,0
1708253923460,DOC 3,C13,400157,Chapman; Dillon,0,0,0,0
1708253923460,DOC 3,C14,400240,Chapman; Dillon,0,0,0,0
1708253923460,DOC 3,C15,400241,Chapman; Dillon,0,0,0,0
1708253923460,DOC 3,C16,400242,Chapman; Dillon,0,0,0,0
1708253923460,DOC 3,D01,400253,Chapman; Dillon,0,0,0,0
1708253923460,DOC 3,D02,400294,Chapman; Dillon,0,0,0,0
1708253923460,DOC 3,D03,400295,Chapman; Dillon,0,0,0,0
1708253923460,DOC 3,D04,400430,Chapman; Dillon,0,0,0,0
1708253923460,DOC 3,D05,400438,Chapman; Dillon,0,0,0,0
1708253923460,DOC 3,D06,400439,Chapman; Dillon,0,0,0,0
1708253923460,DOC 3,D07,400441,Chapman; Dillon,0,0,0,0
1708253923460,DOC 3,D08,400442,Chapman; Dillon,0,0,0,0
1708253923460,DOC 3,D09,400443,Chapman; Dillon,0,0,0,0
1708253923460,DOC 3,D10,400445,Chapman; Dillon,0,0,0,0
1708253923460,DOC 3,D11,400446,Chapman; Dillon,0,0,0,0
1708253923460,DOC 3,D12,400447,Chapman; Dillon,0,0,0,0
1708253923460,DOC 3,D13,400448,Chapman; Dillon,0,0,0,0
1708253923460,DOC 3,D14,400646,Chapman; Dillon,0,0,0,0
1708253923460,DOC 3,D15,400647,Chapman; Dillon,0,0,0,0
1708253923460,DOC 3,D16,400648,Chapman; Dillon,0,0,0,0
1708253923992,DOC 100D,A00,400649,Pass; Natalye Joann,22,0,25,3
1708253923992,DOC 100D,B00,400650,Pass; Natalye Joann,25,0,25,0
1708253924519,DSC 10,A01,398041,Tiefenbruck; Janine LoBue,142,0,147,5
1708253924519,DSC 10,B01,398180,Tiefenbruck; Janine LoBue,144,0,147,3
1708253924519,DSC 10,C01,398400,Tiefenbruck; Janine LoBue,143,0,147,4
1708253925046,DSC 20,A01,398415,Langlois; Marina,200,0,200,0
1708253925577,DSC 30,A01,398436,Langlois; Marina,156,0,158,2
1708253925577,DSC 30,B01,398439,Langlois; Marina,144,0,150,6
1708253926105,DSC 40A,A01,398441,Rampure; Suraj,123,0,125,2
1708253926105,DSC 40A,B01,398443,Rampure; Suraj,125,0,125,0
1708253926630,DSC 40B,A01,398445,Staff,150,0,150,0
1708253927160,DSC 80,A01,398470,Lau; Samuel Ethan,70,0,70,0
1708253927160,DSC 80,B01,398541,Lau; Samuel Ethan,68,0,70,2
1708253927686,DSC 95,A01,398650,Rampure; Suraj,50,0,50,0
1708253928213,DSC 100,A01,398683,Salimi; Babak,147,0,150,3
1708253928740,DSC 102,A01,398708,Jin; Haojian,145,0,150,5
1708253929266,DSC 106,A01,398711,Wilber; Jared Dane,146,0,149,3
1708253929797,DSC 140A,A01,398724,Eldridge; Justin Matthew,98,0,100,2
1708253929797,DSC 140A,B01,479346,Ustun; Tevfik Berk,50,0,50,0
1708253930330,DSC 140B,A01,398726,Weng; Tsui-Wei (lily),144,0,150,6
1708253930857,DSC 190,A01,398738,Silberman; Jack,20,0,20,0
1708253930857,DSC 190,B01,479475,Ustun; Tevfik Berk,29,0,30,1
1708253930857,DSC 190,C01,481341,Rahman; Tauhidur,50,0,50,0
1708253931384,DSC 197,001,494360,Eldridge; Justin Matthew,9999,0,9999,0
1708253931912,DSC 214,A00,477322,Staff,21,0,60,39
1708253932441,DSC 231,A01,398863,Gupta; Rajesh K.,60,0,60,0
1708253932968,DSC 232R,A01,487133,Solares; Edwin A,39,0,60,21
1708253933495,DSC 240,A00,398957,Belkin; Mikhail,74,0,90,16
1708253934563,DSC 243,A00,398958,Ma; Yian,59,0,60,1
1708253935087,DSC 245,A00,398959,Huang; Biwei,41,0,60,19
1708253935613,DSC 253,A00,398960,Shang; Jingbo,0,0,30,30
1708253936138,DSC 258R,A01,398962,Shang; Jingbo,43,0,60,17
1708253936669,DSC 267R,A01,398964,Staff,56,0,60,4
1708253937205,DSC 291,A00,398965,Belkin; Mikhail,90,0,90,0
1708253937205,DSC 291,B00,398966,Weng; Tsui-Wei (lily),90,0,90,0
1708253937205,DSC 291,C00,398997,Staff,60,0,60,0
1708253937205,DSC 291,D00,398998,Zhang; Hao,40,0,40,0
1708253937205,DSC 291,E00,477386,Staff,50,0,50,0
1708253937730,DSC 293,A00,477388,Ustun; Tevfik Berk,9989,0,9999,10
1708253938256,DSC 295,A00,480826,Danks; David J,30,0,40,10
1708253938781,DSE 220,A00,398034,Dasgupta; Sanjoy,20,0,20,0
1708253939309,DSE 230,A00,398035,Nguyen; Mai Huong,20,0,20,0
1708253939836,DSE 260B,A00,398037,Altintas De Callaf; Ilkay,20,0,20,0
1708253940364,DSGN 1,A01,408210,Klemmer; Scott R,46,0,50,4
1708253940364,DSGN 1,A02,408245,Klemmer; Scott R,47,0,50,3
1708253940890,DSGN 119,A00,407467,Hollan; James D. & Xia; Haijun,76,0,90,14
1708253941419,DSGN 160,A00,494371,Aronoff-Spencer; Eliah Sea,15,0,20,5
1708253941946,DSGN 219,A00,474323,Hollan; James D. & Xia; Haijun,15,0,15,0
1708253942474,ECE 5,A01,428645,Morris; Karcher William,21,0,24,3
1708253942474,ECE 5,A02,428646,Morris; Karcher William,24,0,24,0
1708253942474,ECE 5,A03,428647,Morris; Karcher William,24,0,24,0
1708253942474,ECE 5,A04,428648,Morris; Karcher William,24,0,24,0
1708253943006,ECE 15,A01,428650,Sahay; Rajeev,119,0,120,1
1708253943533,ECE 16,A01,428652,Wang; Edward Jay,22,0,30,8
1708253944059,ECE 17,A01,428654,Sahay; Rajeev,48,0,60,12
1708253944587,ECE 25,A50,428657,Dey; Sujit,30,0,30,0
1708253944587,ECE 25,A51,428658,Dey; Sujit,30,0,30,0
1708253945114,ECE 30,A50,428674,Mir Arabbaygi; Siavash,27,0,30,3
1708253945114,ECE 30,A51,428675,Mir Arabbaygi; Siavash,28,0,30,2
1708253945114,ECE 30,A52,428676,Mir Arabbaygi; Siavash,28,0,30,2
1708253945114,ECE 30,A53,428679,Mir Arabbaygi; Siavash,29,0,30,1
1708253945114,ECE 30,A54,428680,Mir Arabbaygi; Siavash,30,0,30,0
1708253945645,ECE 35,A50,428684,Taur; Yuan,29,0,30,1
1708253945645,ECE 35,A51,428685,Taur; Yuan,30,0,30,0
1708253945645,ECE 35,A52,428686,Taur; Yuan,30,0,30,0
1708253945645,ECE 35,A53,428687,Taur; Yuan,29,0,30,1
1708253946169,ECE 45,A01,428689,Zeger; Kenneth A.,137,0,150,13
1708253946710,ECE 65,A50,428701,Baghdadchi; Saharnaz,28,0,30,2
1708253946710,ECE 65,A51,428742,Baghdadchi; Saharnaz,29,0,30,1
1708253946710,ECE 65,A52,428743,Baghdadchi; Saharnaz,30,0,30,0
1708253946710,ECE 65,A53,428754,Baghdadchi; Saharnaz,26,0,30,4
1708253946710,ECE 65,A54,428796,Baghdadchi; Saharnaz,30,0,30,0
1708253946710,ECE 65,A55,428797,Baghdadchi; Saharnaz,29,0,30,1
1708253946710,ECE 65,A56,428803,Baghdadchi; Saharnaz,30,0,30,0
1708253947239,ECE 100,A01,428978,Baghdadchi; Saharnaz,29,0,30,1
1708253947239,ECE 100,A02,428988,Baghdadchi; Saharnaz,30,0,30,0
1708253947239,ECE 100,A03,428989,Baghdadchi; Saharnaz,29,0,30,1
1708253947239,ECE 100,A04,429008,Baghdadchi; Saharnaz,29,0,30,1
1708253947763,ECE 101,A01,429017,Bharadia; Dinesh,57,0,60,3
1708253947763,ECE 101,A02,429019,Bharadia; Dinesh,60,0,60,0
1708253948291,ECE 103,A01,429027,Kuzum; Duygu,74,0,75,1
1708253948820,ECE 107,A01,429055,Fullerton; Eric E,73,0,75,2
1708253949345,ECE 108,A01,429068,Kang; Mingu,53,0,60,7
1708253949875,ECE 109,A01,429085,Orlitsky; Alon,98,0,100,2
1708253949875,ECE 109,A02,429098,Orlitsky; Alon,96,0,100,4
1708253950405,ECE 111,A01,429132,Turakhia; Yatish Girish,173,0,180,7
1708253950931,ECE 115,A01,429314,Yip; Michael,22,0,26,4
1708253951457,ECE 123,A01,429327,Sievenpiper; Daniel F.,56,0,60,4
1708253951990,ECE 125B,A50,429397,Esmaili; Gholamreza,23,0,24,1
1708253951990,ECE 125B,A51,429627,Esmaili; Gholamreza,23,0,24,1
1708253952516,ECE 134,A00,429630,Ng; Tse Nga,50,0,50,0
1708253953043,ECE 136L,A01,429634,Dayeh; Shadi Ahmad,3,0,5,2
1708253953043,ECE 136L,A02,429636,Dayeh; Shadi Ahmad,3,0,5,2
1708253953043,ECE 136L,A03,429637,Dayeh; Shadi Ahmad,5,0,5,0
1708253953043,ECE 136L,A04,429641,Dayeh; Shadi Ahmad,5,0,5,0
1708253953568,ECE 139,A00,429642,Nomura; Kenji,17,0,20,3
1708253954097,ECE 140B,A01,455349,Khoshabeh; Ramsin & Gessner; Richard K.,19,0,24,5
1708253954097,ECE 140B,A02,455351,Khoshabeh; Ramsin & Gessner; Richard K.,23,0,24,1
1708253954097,ECE 140B,A03,455354,Khoshabeh; Ramsin & Gessner; Richard K.,21,0,22,1
1708253954627,ECE 141B,A01,455355,Gessner; Richard K.,48,0,50,2
1708253955156,ECE 148,A01,492803,Silberman; Jack,0,0,0,0
1708253955685,ECE 153,A01,429655,Naghizadeh Ardabili; Parin,94,0,100,6
1708253956210,ECE 157A,A01,429657,Bharadia; Dinesh,22,0,25,3
1708253956737,ECE 158B,A01,429659,Zhang; Xinyu,14,0,20,6
1708253957263,ECE 161C,A00,429660,Cosman; Pamela C.,58,0,60,2
1708253958032,ECE 163,A00,429664,Hsueh; Tzu-Chien,95,0,100,5
1708253958564,ECE 165,A51,429672,Mercier; Patrick Philip,20,0,30,10
1708253958564,ECE 165,A52,429673,Mercier; Patrick Philip,22,0,30,8
1708253958564,ECE 165,A53,429674,Mercier; Patrick Philip,30,0,30,0
1708253958564,ECE 165,A54,429675,Mercier; Patrick Philip,30,0,30,0
1708253959090,ECE 171A,A01,429813,Zheng; Yang,96,0,100,4
1708253959623,ECE 175B,A01,429886,Xie; Pengtao,72,0,75,3
1708253960150,ECE 183,A01,430023,Mookherjea; Shayan,26,0,30,4
1708253960680,ECE 185,A01,430025,Papen; George C.,19,0,20,1
1708253961208,ECE 191,A00,430039,Zhang; Xinyu,30,0,30,0
1708253961733,ECE 196,A00,430040,Morris; Karcher William,18,0,24,6
1708253961733,ECE 196,B00,430045,Morris; Karcher William,23,0,24,1
1708253962498,ECE 198,001,430052,Nguyen; Truong Quang,9999,0,9999,0
1708253963078,ECE 200,001,438659,Atanasov; Nikolay A.,9999,0,9999,0
1708253963078,ECE 200,002,438660,Bharadia; Dinesh,9999,0,9999,0
1708253963078,ECE 200,003,438668,Cheng; Chung Kuan,9999,0,9999,0
1708253963078,ECE 200,004,438845,Cosman; Pamela C.,9999,0,9999,0
1708253963078,ECE 200,005,438846,Dayeh; Shadi Ahmad,9999,0,9999,0
1708253963078,ECE 200,006,438847,Fainman; Yeshaiahu,9999,0,9999,0
1708253963078,ECE 200,007,438848,Ford; Joseph Earl,9999,0,9999,0
1708253963078,ECE 200,008,438849,Franceschetti; Massimo,9999,0,9999,0
1708253963078,ECE 200,009,438850,Fullerton; Eric E,9999,0,9999,0
1708253963078,ECE 200,010,438851,Galton; Ian A,9999,0,9999,0
1708253963078,ECE 200,011,438852,Gilja; Vikash,9999,0,9999,0
1708253963078,ECE 200,012,438853,Hall; Drew A.,9999,0,9999,0
1708253963078,ECE 200,013,438854,Hsueh; Tzu-Chien,9999,0,9999,0
1708253963078,ECE 200,014,438855,Javidi; Tara,9999,0,9999,0
1708253963078,ECE 200,015,438865,Kahng; Andrew Byun,9999,0,9999,0
1708253963078,ECE 200,016,438866,Kim; Young-Han,9999,0,9999,0
1708253963078,ECE 200,017,438876,Koushanfar; Farinaz,9999,0,9999,0
1708253963078,ECE 200,018,438877,Kuzum; Duygu,9999,0,9999,0
1708253963078,ECE 200,019,438934,Le; Hanh-Phuc,9999,0,9999,0
1708253963078,ECE 200,020,438954,Lin; Bill,9999,0,9999,0
1708253963078,ECE 200,021,438955,Liu; Zhaowei,9999,0,9999,0
1708253963078,ECE 200,022,438957,Lo; Yu-Hwa,9999,0,9999,0
1708253963078,ECE 200,023,439086,Lomakin; Vitaliy,9999,0,9999,0
1708253963078,ECE 200,024,439087,Mercier; Patrick Philip,9999,0,9999,0
1708253963078,ECE 200,025,439088,Meyer; Florian,9999,0,9999,0
1708253963078,ECE 200,026,439090,Milstein; Laurence B.,9999,0,9999,0
1708253963078,ECE 200,027,439208,Mir Arabbaygi; Siavash,9999,0,9999,0
1708253963078,ECE 200,028,439209,Mookherjea; Shayan,9999,0,9999,0
1708253963078,ECE 200,029,439210,Morris; Karcher William,9999,0,9999,0
1708253963078,ECE 200,030,439211,Ng; Tse Nga,9999,0,9999,0
1708253963078,ECE 200,031,439219,Nguyen; Truong Quang,9999,0,9999,0
1708253963078,ECE 200,032,439220,Nomura; Kenji,9999,0,9999,0
1708253963078,ECE 200,033,439221,Orlitsky; Alon,9999,0,9999,0
1708253963078,ECE 200,034,439222,Pal; Piya,9999,0,9999,0
1708253963078,ECE 200,035,439223,Papen; George C.,9999,0,9999,0
1708253963078,ECE 200,036,439224,Radic; Stojan,9999,0,9999,0
1708253963078,ECE 200,037,439225,Rao; Bhaskar D.,9999,0,9999,0
1708253963078,ECE 200,038,439227,Rao; Ramesh R,9999,0,9999,0
1708253963078,ECE 200,039,439231,Rebeiz; Gabriel,9999,0,9999,0
1708253963078,ECE 200,040,439232,Sanford; John R,9999,0,9999,0
1708253963078,ECE 200,041,439302,Siegel; Paul H.,9999,0,9999,0
1708253963078,ECE 200,042,439303,Sievenpiper; Daniel F.,9999,0,9999,0
1708253963078,ECE 200,043,439305,Sworder; David D.,9999,0,9999,0
1708253963078,ECE 200,044,439306,Taur; Yuan,9999,0,9999,0
1708253963078,ECE 200,045,439419,Touri; Behrouz,9999,0,9999,0
1708253963078,ECE 200,046,439425,Trivedi; Mohan M.,9999,0,9999,0
1708253963078,ECE 200,047,439538,Vasconcelos; Nuno,9999,0,9999,0
1708253963078,ECE 200,048,439546,Wang; Xiaolong,9999,0,9999,0
1708253963078,ECE 200,049,439549,Xie; Pengtao,9999,0,9999,0
1708253963078,ECE 200,050,439551,Yip; Michael,9999,0,9999,0
1708253963078,ECE 200,051,439553,Zeger; Kenneth A.,9999,0,9999,0
1708253963078,ECE 200,052,439554,Zhang; Xinyu,9999,0,9999,0
1708253963078,ECE 200,053,439555,Zheng; Yang,9999,0,9999,0
1708253963078,ECE 200,054,439557,Turakhia; Yatish Girish,9999,0,9999,0
1708253963078,ECE 200,055,439558,Kang; Mingu,9999,0,9999,0
1708253963078,ECE 200,056,439560,Shi; Yuanyuan,9999,0,9999,0
1708253963078,ECE 200,057,439564,Wang; Edward Jay,9999,0,9999,0
1708253963078,ECE 200,058,439565,Antipa; Nicholas A,9999,0,9999,0
1708253963078,ECE 200,059,439566,Zheng; Yang,9999,0,9999,0
1708253963078,ECE 200,060,492991,Yu; Paul K L,9999,0,9999,0
1708253963078,ECE 200,061,492992,Ndao; Abdoulaye,9999,0,9999,0
1708253963078,ECE 200,062,493019,Naghizadeh Ardabili; Parin,9999,0,9999,0
1708253963078,ECE 200,063,493033,Sahay; Rajeev,9999,0,9999,0
1708253963603,ECE 208,A00,430053,Mir Arabbaygi; Siavash,0,0,0,0
1708253964132,ECE 212CN,A00,430054,Liu; Zhaowei,0,0,0,0
1708253964657,ECE 222C,A00,430055,Lomakin; Vitaliy,0,0,0,0
1708253965184,ECE 227,A00,430057,Franceschetti; Massimo,0,0,0,0
1708253965709,ECE 228,A00,430078,Shi; Yuanyuan,0,0,0,0
1708253966310,ECE 230C,A00,430079,Yu; Paul K L,0,0,0,0
1708253966836,ECE 235,A00,430081,Taur; Yuan,0,0,0,0
1708253967366,ECE 236B,A00,430082,Lo; Yu-Hwa,0,0,0,0
1708253967892,ECE 240C,A00,430083,Mookherjea; Shayan,0,0,0,0
1708253968422,ECE 250,A00,430115,Touri; Behrouz,0,0,0,0
1708253968953,ECE 251B,A00,430166,Vasconcelos; Manuela,0,0,0,0
1708253969476,ECE 258B,A00,430167,Milstein; Laurence B.,0,0,0,0
1708253970002,ECE 260C,A00,430168,Eldon; John,0,0,0,0
1708253970528,ECE 264B,A00,430169,Galton; Ian A,0,0,0,0
1708253971057,ECE 265B,A00,430170,Gudem; Prasad S.S.,0,0,0,0
1708253971583,ECE 266,A01,430273,Hall; Drew A.,0,0,0,0
1708253972112,ECE 271C,A00,430283,Vasconcelos; Nuno,0,0,0,0
1708253972638,ECE 272A,A01,430340,Poveda Fonseca; Jorge,0,0,0,0
1708253973166,ECE 273,A00,430352,Wang; Jun-Kun,0,0,0,0
1708253973694,ECE 276B,A00,430353,Atanasov; Nikolay A.,0,0,0,0
1708253974225,ECE 284,A00,430385,Wang; Edward,0,0,0,0
1708253974754,ECE 285,A00,430386,Wang; Xiaolong,0,0,0,0
1708253974754,ECE 285,B00,430387,Antipa; Nicholas A,0,0,0,0
1708253975281,ECON 1,A01,409576,Crane; Meredith Helen,87,0,100,13
1708253975281,ECON 1,A02,409577,Crane; Meredith Helen,96,0,100,4
1708253975281,ECON 1,A03,409578,Crane; Meredith Helen,97,0,100,3
1708253975806,ECON 2,A01,409580,Candido; Maria Teresa,70,0,75,5
1708253976336,ECON 3,A01,409582,Crane; Meredith Helen,109,0,120,11
1708253976336,ECON 3,A02,409583,Crane; Meredith Helen,114,0,115,1
1708253976336,ECON 3,A03,409584,Crane; Meredith Helen,110,0,115,5
1708253976862,ECON 4,A01,409586,Levkoff; Steven B.,88,0,92,4
1708253976862,ECON 4,A02,409587,Levkoff; Steven B.,89,0,90,1
1708253977391,ECON 5,A01,409589,Dai; Yinlin,53,0,58,5
1708253977391,ECON 5,A02,409590,Dai; Yinlin,56,0,58,2
1708253977391,ECON 5,A03,409591,Dai; Yinlin,54,0,54,0
1708253977391,ECON 5,A04,409593,Dai; Yinlin,55,0,55,0
1708253977391,ECON 5,B01,409595,Dai; Yinlin,57,0,58,1
1708253977391,ECON 5,B02,409596,Dai; Yinlin,49,0,49,0
1708253977391,ECON 5,B03,409597,Dai; Yinlin,59,0,59,0
1708253977391,ECON 5,B04,409598,Dai; Yinlin,55,0,55,0
1708253977391,ECON 5,C01,487209,Staff,40,0,45,5
1708253977921,ECON 100A,A01,409600,Famulari; Melissa,94,0,100,6
1708253977921,ECON 100A,A02,409601,Famulari; Melissa,98,0,100,2
1708253977921,ECON 100A,A03,409604,Famulari; Melissa,98,0,100,2
1708253977921,ECON 100A,B01,409610,Famulari; Melissa,76,0,80,4
1708253978445,ECON 100AH,A00,409612,Famulari; Melissa,19,0,20,1
1708253978978,ECON 100B,A01,409614,Grigoryan; Aram,109,0,120,11
1708253978978,ECON 100B,A02,409616,Grigoryan; Aram,117,0,120,3
1708253978978,ECON 100B,B01,409626,Grigoryan; Aram,47,0,50,3
1708253978978,ECON 100B,B02,409627,Grigoryan; Aram,49,0,50,1
1708253979504,ECON 100C,A01,409629,Levkoff; Steven B.,143,0,146,3
1708253979504,ECON 100C,B01,409632,Levkoff; Steven B.,143,0,146,3
1708253980033,ECON 106,A00,409633,Bowen; T. Renee,90,0,90,0
1708253980562,ECON 109T,A00,409634,Trevino; Isabel,18,0,20,2
1708253981087,ECON 110A,A01,409637,Staff,68,0,75,7
1708253981614,ECON 110B,A01,409663,Herreno Lopera; Juan,119,0,125,6
1708253981614,ECON 110B,A02,409682,Herreno Lopera; Juan,125,0,125,0
1708253981614,ECON 110B,B01,409734,Herreno Lopera; Juan,99,0,100,1
1708253982146,ECON 120A,A01,409739,Candido; Maria Teresa,84,0,90,6
1708253982146,ECON 120A,A02,409740,Candido; Maria Teresa,87,0,90,3
1708253982146,ECON 120A,B01,409742,Candido; Maria Teresa,85,0,90,5
1708253982146,ECON 120A,B02,409743,Candido; Maria Teresa,90,0,90,0
1708253982677,ECON 120B,A01,409748,Ma; Xinwei,128,0,130,2
1708253982677,ECON 120B,A02,409754,Ma; Xinwei,128,0,130,2
1708253982677,ECON 120B,B01,409756,Ma; Xinwei,25,0,40,15
1708253983204,ECON 120C,A01,409758,Sun; Yixiao,141,0,146,5
1708253983204,ECON 120C,B01,409762,Sun; Yixiao,144,0,146,2
1708253983734,ECON 129,A00,409763,Eckert; Fabian Paul,44,0,50,6
1708253984261,ECON 134,A00,409764,Gelber; Alexander Michael,45,0,50,5
1708253984261,ECON 134,B00,409765,Gelber; Alexander Michael,49,0,50,1
1708253984787,ECON 137,A00,409766,Niehaus; Paul,19,0,20,1
1708253985317,ECON 142,A00,409767,Trevino; Isabel,39,0,40,1
1708253985317,ECON 142,B00,409768,Trevino; Isabel,38,0,40,2
1708253985846,ECON 164,A00,409771,Muralidharan; Karthik,118,0,120,2
1708253986372,ECON 172A,A01,409773,Newhouse; Herbert S,67,0,75,8
1708253986902,ECON 172B,A01,409775,Newhouse; Herbert S,74,0,75,1
1708253986902,ECON 172B,B01,409777,Newhouse; Herbert S,71,0,75,4
1708253987953,ECON 191A,A00,409780,Cullen; Julie,20,0,20,0
1708253988492,ECON 200C,A00,409782,Du; Songzi,34,0,35,1
1708253989023,ECON 210C,A00,409784,Herreno Lopera; Juan & Wieland; Johannes Friedrich,35,0,35,0
1708253989549,ECON 220C,A00,409785,Sun; Yixiao,35,0,35,0
1708253990080,ECON 220F,A00,409786,Carson; Richard T,27,0,30,3
1708253990605,ECON 221,A00,409787,Zhu; Ying,25,0,25,0
1708253991131,ECON 241,A00,409788,Muralidharan; Karthik,18,0,20,2
1708253991661,ECON 243,A00,409789,Niehaus; Paul,18,0,20,2
1708253992186,ECON 248,A00,409790,Eckert; Fabian Paul,18,0,20,2
1708253992712,ECON 250C,A00,409791,Arnold; David Hall & Betts; Julian,25,0,25,0
1708253993240,ECON 268,A00,409792,Jacobsen; Mark,24,0,25,1
1708253993771,ECON 281,A00,409793,Meckel; Katherine Hunter,19,0,20,1
1708253993771,ECON 281,B00,409794,Herreno Lopera; Juan & Wieland; Johannes Friedrich,19,0,20,1
1708253993771,ECON 281,C00,477854,Herreno Lopera; Juan & Wieland; Johannes Friedrich,18,0,20,2
1708253994299,ECON 285,A00,409795,Eckert; Fabian Paul,20,0,20,0
1708253994823,ECON 286,A00,409796,Ma; Xinwei,15,0,15,0
1708253994823,ECON 286,B00,409797,Hamilton; James D.,15,0,15,0
1708253994823,ECON 286,C00,409798,Grigoryan; Aram,15,0,15,0
1708253994823,ECON 286,D00,409799,Niehaus; Paul,15,0,15,0
1708253995348,ECON 296,A00,409800,Eckert; Fabian Paul,20,0,20,0
1708253995874,EDS 31,A00,409801,Bussey; Thomas J,9,0,10,1
1708253996402,EDS 38,A01,409803,Chung; Luz Marina,25,0,25,0
1708253996930,EDS 39,A01,409805,Heinzman; Erica M.,24,0,25,1
1708253997457,EDS 102,A01,409807,Ambo; Theresa Jean,37,0,45,8
1708253997983,EDS 110R,A01,409809,Staff,42,0,50,8
1708253997983,EDS 110R,B01,481358,Staff,20,0,20,0
1708253998510,EDS 111,A00,479044,Wishard Guerra; Alison G.,56,0,60,4
1708253999040,EDS 117,A01,409818,Jones; Gabrielle Anastasia,21,0,23,2
1708253999040,EDS 117,A02,409819,Jones; Gabrielle Anastasia,23,0,23,0
1708253999040,EDS 117,A03,409820,Jones; Gabrielle Anastasia,22,0,23,1
1708253999040,EDS 117,A04,409821,Jones; Gabrielle Anastasia,21,0,21,0
1708253999567,EDS 118,A00,409828,Warstadt; Melissa Fawn,46,0,50,4
1708254000091,EDS 123,A00,409831,Bussey; Thomas J,10,0,10,0
1708254000621,EDS 124AR,A00,419352,Simon; Elizabeth A,81,0,100,19
1708254000621,EDS 124AR,B00,419377,Simon; Elizabeth A,97,0,100,3
1708254000621,EDS 124AR,C00,481485,Simon; Elizabeth A,25,0,25,0
1708254000621,EDS 124AR,D00,481490,Simon; Elizabeth A,25,0,25,0
1708254001152,EDS 124BR,A00,409838,Eguchi; Emi,52,0,75,23
1708254001152,EDS 124BR,B00,481363,Eguchi; Emi,25,0,25,0
1708254001677,EDS 125,A00,409839,Aragon; Maria Jose,48,0,50,2
1708254002205,EDS 126,A01,409843,Jones; Makeba,19,0,25,6
1708254002205,EDS 126,A02,409844,Jones; Makeba,25,0,25,0
1708254002205,EDS 126,A03,409846,Jones; Makeba,25,0,25,0
1708254002205,EDS 126,A04,409847,Jones; Makeba,25,0,25,0
1708254002734,EDS 128B,A01,409851,Pappas; Elizabeth,49,0,50,1
1708254003260,EDS 129C,A01,409906,Millstone; Rachel Diana,44,0,50,6
1708254003794,EDS 130,A01,409954,Mendez; Kathrina Mendoza,14,0,15,1
1708254003794,EDS 130,A02,409955,Mendez; Kathrina Mendoza,24,0,25,1
1708254003794,EDS 130,A03,409956,Mendez; Kathrina Mendoza,20,0,20,0
1708254004320,EDS 133,A01,409961,Bintliff; Amy S.V.,15,0,20,5
1708254004320,EDS 133,A02,409962,Bintliff; Amy S.V.,20,0,20,0
1708254004320,EDS 133,A03,489636,Bintliff; Amy S.V.,15,0,15,0
1708254004849,EDS 136,A01,409964,Chung; Luz Marina,30,0,30,0
1708254004849,EDS 136,A02,409977,Chung; Luz Marina,30,0,30,0
1708254005376,EDS 139,A00,479197,Millstone; Rachel Diana,42,0,50,8
1708254005376,EDS 139,B00,479198,Pappas; Elizabeth,49,0,50,1
1708254005376,EDS 139,C00,479199,Mendez; Kathrina Mendoza,58,0,60,2
1708254005376,EDS 139,D00,479200,Bintliff; Amy S.V.,56,0,60,4
1708254005376,EDS 139,E00,479201,Chung; Luz Marina,59,0,60,1
1708254005376,EDS 139,F00,479202,Bintliff; Amy S.V.,15,0,15,0
1708254005376,EDS 139,G00,479203,Mamas; Christoforos,27,0,30,3
1708254005376,EDS 139,H00,493997,Choi; Bailey Miyeon,28,0,30,2
1708254005905,EDS 141,A00,409979,Mamas; Christoforos,38,0,40,2
1708254006449,EDS 145,A01,409989,Choi; Bailey Miyeon,13,0,15,2
1708254006449,EDS 145,A02,409990,Choi; Bailey Miyeon,15,0,15,0
1708254006974,EDS 180,A00,409991,Chapman; Thandeka K,30,0,30,0
1708254006974,EDS 180,B00,409992,Ambo; Theresa Jean,24,0,25,1
1708254006974,EDS 180,C00,409993,Jones; Gabrielle Anastasia,20,0,20,0
1708254006974,EDS 180,D00,409994,Phuong; Andrew,24,0,24,0
1708254007509,EDS 198,001,487216,Eguchi; Emi,20,0,20,0
1708254008033,EDS 205B,A00,409995,Staff,40,0,45,5
1708254008033,EDS 205B,B00,409997,Staff,42,0,45,3
1708254008560,EDS 232,A00,409999,Hopkins; Megan Beth,9,0,12,3
1708254009088,EDS 255,A00,410001,Phuong; Andrew,14,0,15,1
1708254009612,EDS 257,A00,410003,Datnow; Amanda Lee,14,0,15,1
1708254010139,EDS 282,A00,479192,Daly; Alan J.,16,0,16,0
1708254010665,EDS 287B,A00,479193,Daly; Alan J.,16,0,16,0
1708254011192,EDS 288A,A00,410005,Staff,18,0,18,0
1708254011717,EDS 288C,A00,410007,Staff,18,0,18,0
1708254012242,EDS 289B,A01,410009,Daly; Alan J.,18,0,18,0
1708254012768,EDS 290,A00,410010,Black; Alison Michelle,30,0,30,0
1708254012768,EDS 290,B00,410012,Choi; Bailey Miyeon,29,0,30,1
1708254012768,EDS 290,C00,479205,Heinzman; Erica M.,0,0,0,0
1708254013297,EDS 291B,A01,479195,Daly; Alan J.,16,0,16,0
1708254013822,EDS 293B,A01,410016,Staff,18,0,18,0
1708254014348,EDS 294B,A00,479196,Burrell; Sade Renee,16,0,16,0
1708254014878,EDS 296,001,478927,Ambo; Theresa Jean,0,0,0,0
1708254014878,EDS 296,002,478935,Aragon; Maria Jose,0,0,0,1
1708254014878,EDS 296,003,478936,Chapman; Thandeka K,0,0,0,0
1708254014878,EDS 296,004,478942,Bintliff; Amy S.V.,0,0,0,0
1708254014878,EDS 296,005,478943,Clarke; Sherice Nicole,0,0,0,0
1708254014878,EDS 296,006,478967,Cohen; Shana R,0,0,0,1
1708254014878,EDS 296,007,478968,Datnow; Amanda Lee,0,0,0,0
1708254014878,EDS 296,008,478969,Daly; Alan J.,0,0,0,0
1708254014878,EDS 296,009,478970,Eguchi; Emi,0,0,0,0
1708254014878,EDS 296,010,478971,Fine; Sarah,0,0,0,0
1708254014878,EDS 296,011,478972,Jones; Gabrielle Anastasia,0,0,0,0
1708254014878,EDS 296,012,479020,Jones; Makeba,0,0,0,0
1708254014878,EDS 296,013,479021,Halter; Christopher P.,0,0,0,0
1708254014878,EDS 296,014,479027,Hofstetter; Carolyn,0,0,0,0
1708254014878,EDS 296,015,479028,Hopkins; Megan Beth,0,0,0,0
1708254014878,EDS 296,016,479034,Mamas; Christoforos,0,0,0,0
1708254014878,EDS 296,017,479035,Pollock; Mica,0,0,0,0
1708254014878,EDS 296,018,479036,Wishard Guerra; Alison G.,0,0,0,0
1708254014878,EDS 296,019,494549,Phuong; Andrew,0,0,0,0
1708254015411,EMED 296,001,464428,Singh; Sukhdeep,49,0,50,1
1708254015411,EMED 296,002,464438,Subramony; Rachna,49,0,50,1
1708254015411,EMED 296,003,464490,Staff,50,0,50,0
1708254015939,ENG 10,A00,399006,Evdokimenko; Ekaterina,30,0,30,0
1708254016466,ENG 100D,A00,399084,Ngo; Anh-Thu T.,33,0,50,17
1708254016993,ENG 100DR,A00,479230,Ngo; Anh-Thu T.,29,0,40,11
1708254017521,ENG 100L,A00,399163,Kleissl; Jan,6,0,6,0
1708254017521,ENG 100L,B00,399217,Bratton; Maryann,8,0,8,0
1708254017521,ENG 100L,C00,399218,Yu; Paul K L,8,0,8,0
1708254017521,ENG 100L,D00,399257,Bratton; Maryann,6,0,6,0
1708254017521,ENG 100L,E00,399258,de Oliveira; Mauricio,9,0,10,1
1708254017521,ENG 100L,F00,399314,Bratton; Maryann,7,0,7,0
1708254017521,ENG 100L,G00,399394,Boyle; Mary E. T.,14,0,15,1
1708254018052,ENVR 102,A00,400777,Daly; Heather Marie,19,0,20,1
1708254018052,ENVR 102,B00,400778,Montejo; Carolina,24,0,25,1
1708254018052,ENVR 102,C00,400791,Staff,23,0,25,2
1708254018580,ENVR 140,A01,400813,Siapno; Jacqueline A,12,0,15,3
1708254018580,ENVR 140,A02,400870,Siapno; Jacqueline A,15,0,15,0
1708254018580,ENVR 140,A03,400889,Siapno; Jacqueline A,15,0,15,0
1708254018580,ENVR 140,A04,400890,Siapno; Jacqueline A,15,0,15,0
1708254019107,ENVR 144,A01,400929,Herbst; Matthew,20,0,20,0
1708254019705,ERC 20,A00,400722,Evans; Ivan T,30,0,30,0
1708254020235,ESYS 103,A01,400931,Lerner; Amy M,32,0,34,2
1708254020235,ESYS 103,A02,400934,Lerner; Amy M,34,0,34,0
1708254020235,ESYS 103,A03,400938,Lerner; Amy M,28,0,34,6
1708254020235,ESYS 103,A04,400939,Lerner; Amy M,33,0,34,1
1708254020235,ESYS 103,A05,400940,Lerner; Amy M,34,0,34,0
1708254020235,ESYS 103,A06,400941,Lerner; Amy M,33,0,34,1
1708254020764,ESYS 187C,A01,400945,Hetherington; Elizabeth Dorsey,28,0,40,12
1708254020764,ESYS 187C,A02,400946,Hetherington; Elizabeth Dorsey,39,0,40,1
1708254021289,ETHN 3R,A01,400948,Streeby; Shelley,21,0,25,4
1708254021289,ETHN 3R,A02,401220,Streeby; Shelley,24,0,25,1
1708254021289,ETHN 3R,A03,401231,Streeby; Shelley,22,0,25,3
1708254021289,ETHN 3R,A04,401236,Streeby; Shelley,23,0,25,2
1708254021289,ETHN 3R,A05,401241,Streeby; Shelley,21,0,25,4
1708254021289,ETHN 3R,A06,401311,Streeby; Shelley,21,0,25,4
1708254021289,ETHN 3R,A07,401318,Streeby; Shelley,25,0,25,0
1708254021289,ETHN 3R,A08,401319,Streeby; Shelley,25,0,25,0
1708254021289,ETHN 3R,A09,401397,Streeby; Shelley,25,0,25,0
1708254021289,ETHN 3R,A10,401398,Streeby; Shelley,25,0,25,0
1708254021289,ETHN 3R,A11,401399,Streeby; Shelley,24,0,25,1
1708254021289,ETHN 3R,A12,401518,Streeby; Shelley,25,0,25,0
1708254021289,ETHN 3R,A13,401551,Streeby; Shelley,24,0,25,1
1708254021289,ETHN 3R,A14,401552,Streeby; Shelley,23,0,25,2
1708254021826,ETHN 30,A01,401554,Fuste; Jose Ignacio,24,0,25,1
1708254021826,ETHN 30,A02,401555,Fuste; Jose Ignacio,25,0,25,0
1708254021826,ETHN 30,A03,401556,Fuste; Jose Ignacio,25,0,25,0
1708254021826,ETHN 30,A04,401557,Fuste; Jose Ignacio,25,0,25,0
1708254022354,ETHN 100C,A00,401558,Museus; Samuel David,36,0,40,4
1708254022878,ETHN 101TV,A01,401560,Marez; Curtis F.,21,0,25,4
1708254022878,ETHN 101TV,A02,401564,Marez; Curtis F.,25,0,25,0
1708254023404,ETHN 108,A00,401584,Hankins; Sarah E.,25,0,29,4
1708254023933,ETHN 113A,A00,401657,Werner; Bradley T.,15,0,15,0
1708254024462,ETHN 114B,A00,401724,Frank; Ross H.,19,0,20,1
1708254024989,ETHN 120D,A01,401848,Alvarez; Luis A,8,0,10,2
1708254024989,ETHN 120D,A02,401853,Alvarez; Luis A,10,0,10,0
1708254025517,ETHN 125R,A00,401858,Sasaki; Christen T,39,0,50,11
1708254026042,ETHN 126,A00,401865,Tran; Ly Thi Hai,39,0,40,1
1708254026569,ETHN 127,A00,401866,Martin Sandino; Amanda Maria Yoland,24,0,25,1
1708254027097,ETHN 137,A00,401867,Martin Sandino; Amanda Maria Yoland,19,0,19,0
1708254027624,ETHN 139,A00,401992,Perreira; Christopher Michael,25,0,25,0
1708254028150,ETHN 143,A00,402059,Marez; Curtis F.,39,0,40,1
1708254028679,ETHN 144M,A00,402060,Jolivette; Andrew J,62,0,65,3
1708254029205,ETHN 150,A00,402158,Taylor-Garcia; Daphne,16,0,18,2
1708254029731,ETHN 153,A00,402160,Martinez-Matsuda; Veronica,24,0,25,1
1708254030255,ETHN 179,A00,402165,Richards; Stephanie F,23,0,25,2
1708254030783,ETHN 183,A00,402217,Steelman; Katherine Wallis,16,0,16,0
1708254031309,ETHN 186,A00,402313,Perez; Roy,15,0,15,0
1708254031838,ETHN 189,A00,479226,Museus; Samuel David,29,0,30,1
1708254032366,ETHN 196H,A00,402314,Espiritu; Yen,0,0,0,0
1708254032366,ETHN 196H,B00,402325,Perreira; Christopher Michael,0,0,0,0
1708254032366,ETHN 196H,C00,402344,Perez; Roy,0,0,0,0
1708254032366,ETHN 196H,D00,402345,Streeby; Shelley,0,0,0,0
1708254032366,ETHN 196H,E00,402346,Taylor-Garcia; Daphne,0,0,0,0
1708254032892,ETHN 200C,A00,402358,Fuste; Jose Ignacio,19,0,20,1
1708254033420,ETHN 230,A00,402359,Streeby; Shelley,16,0,20,4
1708254033948,ETHN 291,A00,402363,Perreira; Christopher Michael,16,0,20,4
1708254034474,EXPR 100,A00,477778,Staff,9999,0,9999,0
1708254034999,EXPR 105,A00,477779,Staff,9999,0,9999,0
1708254035528,EXPR 201,A00,477780,Staff,9999,0,9999,0
1708254036054,EXPR 205,A00,477781,Staff,9999,0,9999,0
1708254036584,FILM 87,A00,402794,Rahimi; Babak,19,0,20,1
1708254036584,FILM 87,B00,402796,Rahimi; Babak,20,0,20,0
1708254036584,FILM 87,C00,402821,Havis; Allan,19,0,20,1
1708254037115,FMPH 95,A00,481734,Larsen; Britta Ann,0,0,0,2
1708254037642,FMPH 101,A00,404648,Tan; Gene Brian,31,0,40,9
1708254038170,FMPH 102,A01,404692,Rana; Brinda Kanti,25,0,28,3
1708254038170,FMPH 102,A02,404714,Rana; Brinda Kanti,28,0,28,0
1708254038170,FMPH 102,B01,404739,Rana; Brinda Kanti,26,0,28,2
1708254038170,FMPH 102,B02,404746,Rana; Brinda Kanti,28,0,28,0
1708254038698,FMPH 110,A00,404747,Campbell; Chadwick Karl,52,0,55,3
1708254038698,FMPH 110,B00,404789,Zoumas-Morse; Christine E.,24,0,30,6
1708254039225,FMPH 120,A00,404792,Nguyen-Grozavu; France T.,48,0,60,12
1708254039757,FMPH 130,A00,404859,Gould; Carlos Francisco,49,0,55,6
1708254039757,FMPH 130,B00,479047,Ciborowski; Haley Minae,52,0,55,3
1708254040286,FMPH 155,A00,404864,Fielding-Miller; Rebecca,65,0,65,0
1708254040815,FMPH 161,A00,404865,Zoumas-Morse; Christine E.,27,0,35,8
1708254041368,FMPH 191,A00,404866,Eikey; Elizabeth Victoria,35,0,35,0
1708254041898,FMPH 194,A00,404938,Larsen; Britta Ann,0,0,0,0
1708254041898,FMPH 194,B00,404939,Marquez; Becky,0,0,0,0
1708254041898,FMPH 194,C00,404949,Nguyen-Grozavu; France T.,0,0,0,0
1708254041898,FMPH 194,D00,404950,Stone; Matthew David,0,0,0,0
1708254041898,FMPH 194,E00,404958,White; Anne Elizabeth Clar,0,0,0,0
1708254041898,FMPH 194,F00,404969,Zoumas-Morse; Christine E.,0,0,0,0
1708254042428,FMPH 223,A00,404977,Vaida; Florin,7,0,26,19
1708254042954,FMPH 225,A00,404978,Zou; Jingjing,0,0,0,0
1708254043480,FMPH 291,A00,404992,Salem; Rany Mansour,15,0,15,0
1708254043480,FMPH 291,C00,405005,Schwartzman; Armin,0,0,0,11
1708254043480,FMPH 291,D00,479113,Shadyab; Aladdin Hassan,0,0,0,0
1708254043480,FMPH 291,E00,479114,Shadyab; Aladdin Hassan,0,0,0,0
1708254043480,FMPH 291,F00,479115,Wynn; Adriane Michelle,0,0,0,3
1708254043480,FMPH 291,G00,479116,Xu; Ronghui,0,0,0,10
1708254043480,FMPH 291,H00,479119,Vaida; Florin,0,0,0,2
1708254044006,FPM 258C,A00,405129,Chen; Brian Hwa-Yang,11,0,15,4
1708254044531,FPM 259C,A00,405130,Nguyen; Annie Lu & Araneta; Maria Rosario Gorrez,4,0,5,1
1708254045060,FPM 278,A00,405131,Strong; David R,13,0,15,2
1708254045588,FPM 280C,A01,405133,Banegas; Matthew Patrick,10,0,10,0
1708254046115,FPM 296,001,464651,Johnson; Michelle Lee,49,0,50,1
1708254046115,FPM 296,002,464652,Staff,50,0,50,0
1708254046115,FPM 296,003,464653,Staff,50,0,50,0
1708254046642,FPM 297,001,479175,Vaida; Florin,9999,0,9999,0
1708254046642,FPM 297,002,494007,Strong; David R,9999,0,9999,0
1708254046642,FPM 297,003,494364,Bazzi; Angela Robertson,9999,0,9999,0
1708254047169,GLBH 20,A00,405134,Elwardani; Nile Regina,143,0,146,3
1708254047695,GLBH 100,A00,405135,Bhavsar; Radhika,68,0,70,2
1708254047695,GLBH 100,B00,477773,Villarino; Margarita,39,0,44,5
1708254047695,GLBH 100,C00,477855,Jenkins; Janis A.,20,0,20,0
1708254047695,GLBH 100,D00,481337,Mishra; Jyoti,40,0,40,0
1708254048222,GLBH 101,A00,405136,Sloane; Julia Kathryn,40,0,40,0
1708254048748,GLBH 107,A00,405137,Wilson; Brenda K,63,0,70,7
1708254049279,GLBH 111,A01,486865,Burgos; Jose L.,0,0,0,0
1708254049279,GLBH 111,B01,486867,Burgos; Jose L.,0,0,0,0
1708254049804,GLBH 114W,A00,405138,Walkover; Lillian B,17,0,17,0
1708254050336,GLBH 118,A00,405140,Wilson; Brenda K,31,0,32,1
1708254050862,GLBH 147,A00,405141,Stewart; Alexander B,40,0,40,0
1708254051388,GLBH 148,A00,405142,Olivas Hernandez; Olga Lid,93,0,100,7
1708254051917,GLBH 150B,A00,486855,Sanchez; Giselle,0,0,0,0
1708254052447,GLBH 181,A00,405154,Burgos; Jose L.,211,0,216,5
1708254052976,GLBH 215,A00,479241,Walkover; Lillian B,18,0,18,0
1708254053502,GLBH 260,A00,480722,Elwardani; Nile Regina,18,0,18,0
1708254054030,GSS 20,A00,405155,Siapno; Jacqueline A,25,0,30,5
1708254054555,GSS 25,A00,405156,Batarseh; Amanda Alicia,24,0,30,6
1708254055085,HDS 1,A01,405160,Reese; Clarissa Jane,25,0,25,0
1708254055085,HDS 1,A02,405168,Reese; Clarissa Jane,25,0,25,0
1708254055085,HDS 1,A03,405169,Reese; Clarissa Jane,22,0,25,3
1708254055085,HDS 1,A04,405170,Reese; Clarissa Jane,24,0,25,1
1708254055085,HDS 1,A05,405171,Reese; Clarissa Jane,23,0,25,2
1708254055085,HDS 1,A06,405172,Reese; Clarissa Jane,24,0,25,1
1708254055085,HDS 1,A07,405173,Reese; Clarissa Jane,24,0,25,1
1708254055613,HDS 60,A01,405175,Warstadt; Melissa Fawn,34,0,35,1
1708254055613,HDS 60,A02,405176,Warstadt; Melissa Fawn,33,0,35,2
1708254056140,HDS 95,A00,405177,Staff,38,0,40,2
1708254056667,HDS 120,A00,405178,Staff,0,0,0,0
1708254057193,HDS 122,A00,405179,Rodriguez; Victoria Calip,64,0,75,11
1708254057722,HDS 150,A00,405180,Staff,20,0,20,0
1708254057722,HDS 150,B00,405181,Staff,20,0,20,0
1708254057722,HDS 150,C00,405182,Staff,20,0,20,0
1708254058249,HDS 181,A01,405185,Bjorklund; Peter,30,0,30,0
1708254058774,HDS 191,A01,405187,Reese; Clarissa Jane,40,0,40,0
1708254058774,HDS 191,B01,405194,Staff,25,0,25,0
1708254059298,HIAF 113,A00,403736,Prestholdt; Jeremy,74,0,75,1
1708254059825,HIAF 114,A00,403738,Gyamfi; Bright,49,0,50,1
1708254060350,HIEA 132,A00,403740,Kletzer; Benjamin Nathan,25,0,30,5
1708254060879,HIEA 154,A00,403741,Henry; Todd A.,62,0,64,2
1708254061404,HIEU 139,A00,403742,Strasser; Ulrike,52,0,56,4
1708254061929,HIEU 171,A00,403743,Hansen; Jan Eric,62,0,64,2
1708254062459,HIEU 176,A00,403744,Hertz; Deborah,14,0,15,1
1708254062985,HIEU 183,A00,403800,Gallant; Thomas W.,15,0,15,0
1708254063511,HIEU 276,A00,403862,Hertz; Deborah,0,0,0,0
1708254064043,HIGL 127,A00,403802,Ivey; James Alexander,56,0,56,0
1708254064570,HIGR 201,A00,494372,Pineda De Avila; Nydia,9,0,10,1
1708254065096,HIGR 205,A00,403863,Strasser; Ulrike,11,0,15,4
1708254065623,HIGR 217C,A00,403864,Lu; Weijing,9,0,10,1
1708254066151,HIGR 239,A00,403865,Serlin; David,4,0,5,1
1708254066675,HIGR 240,A00,403875,Gates; Kelly,2,0,5,3
1708254067207,HILA 101,A00,403818,LeNeave; Kimiko Nicole,62,0,64,2
1708254067734,HILA 119,A00,403819,Kozameh; Sara J,47,0,50,3
1708254068259,HILA 144,A00,403821,Kozameh; Sara J,50,0,50,0
1708254068790,HILD 2C,A01,402843,Hendrickson; Gerald M.,31,0,32,1
1708254068790,HILD 2C,A02,403030,Hendrickson; Gerald M.,31,0,32,1
1708254068790,HILD 2C,A03,403042,Hendrickson; Gerald M.,32,0,32,0
1708254068790,HILD 2C,A04,403048,Hendrickson; Gerald M.,30,0,32,2
1708254068790,HILD 2C,A05,403049,Hendrickson; Gerald M.,32,0,32,0
1708254068790,HILD 2C,A06,403098,Hendrickson; Gerald M.,32,0,32,0
1708254069317,HILD 7C,A01,403501,Bermudez; Rosie Cano,27,0,32,5
1708254069317,HILD 7C,A02,403513,Bermudez; Rosie Cano,30,0,32,2
1708254069317,HILD 7C,A03,403570,Bermudez; Rosie Cano,32,0,32,0
1708254069317,HILD 7C,A04,403572,Bermudez; Rosie Cano,32,0,32,0
1708254069317,HILD 7C,A05,403587,Bermudez; Rosie Cano,32,0,32,0
1708254069317,HILD 7C,A06,403588,Bermudez; Rosie Cano,32,0,32,0
1708254069317,HILD 7C,A07,403589,Bermudez; Rosie Cano,29,0,32,3
1708254069317,HILD 7C,A08,403590,Bermudez; Rosie Cano,32,0,32,0
1708254069317,HILD 7C,A09,403601,Bermudez; Rosie Cano,30,0,32,2
1708254069317,HILD 7C,A10,403602,Bermudez; Rosie Cano,32,0,32,0
1708254069317,HILD 7C,A11,403603,Bermudez; Rosie Cano,32,0,32,0
1708254069317,HILD 7C,A12,403604,Bermudez; Rosie Cano,32,0,32,0
1708254069849,HILD 12,A01,403607,Henry; Todd A.,32,0,32,0
1708254069849,HILD 12,A02,403608,Henry; Todd A.,31,0,32,1
1708254069849,HILD 12,A03,403609,Henry; Todd A.,32,0,32,0
1708254069849,HILD 12,A04,403699,Henry; Todd A.,32,0,32,0
1708254069849,HILD 12,A05,403700,Henry; Todd A.,32,0,32,0
1708254069849,HILD 12,A06,403701,Henry; Todd A.,32,0,32,0
1708254070375,HILD 30,A01,403703,Soleiman; Matthew Teymour,29,0,32,3
1708254070375,HILD 30,A02,403704,Soleiman; Matthew Teymour,30,0,32,2
1708254070903,HINE 118,A00,403822,Kayali; Hasan,50,0,50,0
1708254071433,HISC 119,A00,403823,Golan; Tal,26,0,30,4
1708254071961,HISC 123,A00,403839,Pineda De Avila; Nydia,44,0,50,6
1708254072493,HITO 87,A00,403707,Patterson; Patrick H.,15,0,15,0
1708254072493,HITO 87,B00,403709,Patterson; Patrick H.,15,0,15,0
1708254072493,HITO 87,C00,403735,Schneewind; Sarah,15,0,15,0
1708254073074,HITO 100,B00,403841,Klann; Mary Cameron,24,0,25,1
1708254073603,HITO 170,A00,403842,Watts; Edward J.,8,0,10,2
1708254074130,HITO 193,A00,455333,Hill; Seth J,0,0,0,0
1708254074660,HIUS 114A,A00,403843,Lewandoski; Julia Mavis,52,0,56,4
1708254075185,HIUS 120D,A01,403854,Alvarez; Luis A,8,0,10,2
1708254075185,HIUS 120D,A02,403855,Alvarez; Luis A,10,0,10,0
1708254075710,HIUS 136,A00,403857,Martinez-Matsuda; Veronica,21,0,25,4
1708254076242,HIUS 144,A00,403858,Martinez-Matsuda; Veronica,55,0,56,1
1708254076242,HIUS 144,B00,403859,Vandevelde; Kenneth Joseph,54,0,56,2
1708254076242,HIUS 144,C00,403860,Klann; Mary Cameron,52,0,56,4
1708254076242,HIUS 144,D00,403861,Lewandoski; Julia Mavis,55,0,56,1
1708254076777,HUM 2,A01,422723,Watts; Edward J.,16,0,16,0
1708254076777,HUM 2,A02,422735,Watts; Edward J.,15,0,16,1
1708254076777,HUM 2,A03,422736,Watts; Edward J.,15,0,16,1
1708254076777,HUM 2,A04,422737,Watts; Edward J.,16,0,16,0
1708254076777,HUM 2,A05,422738,Watts; Edward J.,15,0,16,1
1708254076777,HUM 2,A06,422760,Watts; Edward J.,15,0,16,1
1708254076777,HUM 2,A07,422778,Watts; Edward J.,16,0,16,0
1708254076777,HUM 2,A08,422793,Watts; Edward J.,16,0,16,0
1708254076777,HUM 2,A09,422794,Watts; Edward J.,16,0,16,0
1708254076777,HUM 2,A10,422795,Watts; Edward J.,16,0,16,0
1708254076777,HUM 2,B01,422805,Markman; Kristina,13,0,16,3
1708254076777,HUM 2,B02,422806,Markman; Kristina,14,0,16,2
1708254076777,HUM 2,B03,422807,Markman; Kristina,14,0,16,2
1708254076777,HUM 2,B04,422808,Markman; Kristina,16,0,16,0
1708254076777,HUM 2,B05,422809,Markman; Kristina,16,0,16,0
1708254076777,HUM 2,B06,422842,Markman; Kristina,16,0,16,0
1708254076777,HUM 2,B07,422843,Markman; Kristina,15,0,16,1
1708254076777,HUM 2,B08,422848,Markman; Kristina,16,0,16,0
1708254076777,HUM 2,B09,422850,Markman; Kristina,15,0,16,1
1708254076777,HUM 2,B10,422851,Markman; Kristina,12,0,16,4
1708254076777,HUM 2,B11,422852,Markman; Kristina,15,0,16,1
1708254076777,HUM 2,B12,422853,Markman; Kristina,16,0,16,0
1708254076777,HUM 2,C01,422855,Rodriguez; Bretton Sigfred,15,0,16,1
1708254076777,HUM 2,C02,422856,Rodriguez; Bretton Sigfred,16,0,16,0
1708254076777,HUM 2,C03,422859,Rodriguez; Bretton Sigfred,15,0,16,1
1708254076777,HUM 2,C04,423106,Rodriguez; Bretton Sigfred,12,0,16,4
1708254076777,HUM 2,C05,423107,Rodriguez; Bretton Sigfred,15,0,16,1
1708254076777,HUM 2,C06,423108,Rodriguez; Bretton Sigfred,14,0,16,2
1708254076777,HUM 2,C07,423109,Rodriguez; Bretton Sigfred,15,0,16,1
1708254076777,HUM 2,C08,423110,Rodriguez; Bretton Sigfred,15,0,16,1
1708254076777,HUM 2,C09,423133,Rodriguez; Bretton Sigfred,14,0,16,2
1708254076777,HUM 2,C10,423134,Rodriguez; Bretton Sigfred,14,0,16,2
1708254076777,HUM 2,C11,423135,Rodriguez; Bretton Sigfred,16,0,16,0
1708254076777,HUM 2,C12,423136,Rodriguez; Bretton Sigfred,15,0,16,1
1708254076777,HUM 2,C13,423137,Rodriguez; Bretton Sigfred,16,0,16,0
1708254076777,HUM 2,C14,423138,Rodriguez; Bretton Sigfred,16,0,16,0
1708254076777,HUM 2,D01,423140,West; Geoffrey Scott,13,0,16,3
1708254076777,HUM 2,D02,423141,West; Geoffrey Scott,15,0,16,1
1708254076777,HUM 2,D03,423142,West; Geoffrey Scott,15,0,16,1
1708254076777,HUM 2,D04,423143,West; Geoffrey Scott,14,0,16,2
1708254076777,HUM 2,D05,423144,West; Geoffrey Scott,16,0,16,0
1708254076777,HUM 2,D06,423145,West; Geoffrey Scott,16,0,16,0
1708254076777,HUM 2,D07,423146,West; Geoffrey Scott,16,0,16,0
1708254076777,HUM 2,D08,423158,West; Geoffrey Scott,16,0,16,0
1708254076777,HUM 2,D09,423169,West; Geoffrey Scott,16,0,16,0
1708254076777,HUM 2,D10,423174,West; Geoffrey Scott,16,0,16,0
1708254076777,HUM 2,D11,423175,West; Geoffrey Scott,16,0,16,0
1708254076777,HUM 2,D12,423179,West; Geoffrey Scott,15,0,16,1
1708254076777,HUM 2,D13,423188,West; Geoffrey Scott,15,0,16,1
1708254076777,HUM 2,D14,423204,West; Geoffrey Scott,16,0,16,0
1708254077332,HUM 5,A01,423221,Lyon; Antony J.,26,0,30,4
1708254077332,HUM 5,A02,423232,Lyon; Antony J.,24,0,30,6
1708254077332,HUM 5,A03,423237,Lyon; Antony J.,18,0,30,12
1708254077332,HUM 5,A04,423240,Lyon; Antony J.,25,0,30,5
1708254077332,HUM 5,A05,423242,Lyon; Antony J.,28,0,30,2
1708254077332,HUM 5,A06,423244,Lyon; Antony J.,23,0,30,7
1708254077332,HUM 5,A07,423247,Lyon; Antony J.,27,0,30,3
1708254077332,HUM 5,A08,423254,Lyon; Antony J.,27,0,30,3
1708254077332,HUM 5,B01,423286,Patterson; Patrick H.,28,0,30,2
1708254077332,HUM 5,B02,423291,Patterson; Patrick H.,29,0,30,1
1708254077332,HUM 5,B03,423294,Patterson; Patrick H.,28,0,30,2
1708254077332,HUM 5,B04,423297,Patterson; Patrick H.,29,0,30,1
1708254077332,HUM 5,B05,423313,Patterson; Patrick H.,30,0,30,0
1708254077332,HUM 5,B06,423318,Patterson; Patrick H.,30,0,30,0
1708254077332,HUM 5,B07,423362,Patterson; Patrick H.,29,0,30,1
1708254077332,HUM 5,B08,423363,Patterson; Patrick H.,29,0,30,1
1708254077332,HUM 5,C01,423365,Caldwell; Michael Alan,22,0,30,8
1708254077332,HUM 5,C02,423474,Caldwell; Michael Alan,24,0,30,6
1708254077332,HUM 5,C03,423528,Caldwell; Michael Alan,30,0,30,0
1708254077332,HUM 5,C04,423529,Caldwell; Michael Alan,27,0,30,3
1708254077332,HUM 5,C05,423545,Caldwell; Michael Alan,30,0,30,0
1708254077332,HUM 5,C06,423546,Caldwell; Michael Alan,30,0,30,0
1708254077332,HUM 5,C07,423547,Caldwell; Michael Alan,29,0,30,1
1708254077332,HUM 5,C08,423548,Caldwell; Michael Alan,28,0,30,2
1708254077864,INTL 101,A01,404350,Day; Joel Keith,23,0,25,2
1708254077864,INTL 101,A02,404356,Day; Joel Keith,25,0,25,0
1708254077864,INTL 101,A03,404357,Day; Joel Keith,24,0,25,1
1708254077864,INTL 101,A04,404360,Day; Joel Keith,25,0,25,0
1708254078391,INTL 102,A01,404375,Fisk; David Lee,25,0,25,0
1708254078391,INTL 102,A02,404376,Fisk; David Lee,22,0,25,3
1708254078391,INTL 102,A03,404377,Fisk; David Lee,20,0,25,5
1708254078391,INTL 102,A04,404381,Fisk; David Lee,25,0,25,0
1708254078918,INTL 190,A00,404396,Samphantharak; Krislert,24,0,25,1
1708254078918,INTL 190,B00,404402,McIntosh; Justin Daniel,24,0,25,1
1708254078918,INTL 190,C00,404403,Vos; Stacie N.,24,0,25,1
1708254078918,INTL 190,D00,404404,Nadkarni; Vidya,24,0,25,1
1708254078918,INTL 190,E00,404407,Scott; Jeffrey F,25,0,25,0
1708254078918,INTL 190,F00,404409,Auerbach; Bradford C,25,0,25,0
1708254078918,INTL 190,G00,404442,Auerbach; Bradford C,25,0,25,0
1708254078918,INTL 190,H00,404465,Segui; Alan S,25,0,25,0
1708254078918,INTL 190,I00,404481,Segui; Alan S,25,0,25,0
1708254079471,JAPN 10C,A01,403881,Iwamoto; Naoki,15,0,15,0
1708254079471,JAPN 10C,B01,403884,McKee; Mayumi Mochizuki,15,0,15,0
1708254079471,JAPN 10C,C01,403887,Sato; Kyoko,10,0,10,0
1708254079471,JAPN 10C,C02,403888,Sato; Kyoko,10,0,10,0
1708254079471,JAPN 10C,D01,403890,Inada; Minori,8,0,10,2
1708254079471,JAPN 10C,D02,403891,Inada; Minori,10,0,10,0
1708254079471,JAPN 10C,E01,403893,Sato; Kyoko,10,0,10,0
1708254079471,JAPN 10C,E02,403894,Sato; Kyoko,10,0,10,0
1708254079471,JAPN 10C,F01,403896,McKee; Mayumi Mochizuki,10,0,10,0
1708254079471,JAPN 10C,F02,403897,McKee; Mayumi Mochizuki,10,0,10,0
1708254079471,JAPN 10C,G01,403899,Homma; Kunihiko,10,0,10,0
1708254079471,JAPN 10C,G02,403900,Homma; Kunihiko,10,0,10,0
1708254079471,JAPN 10C,H01,403902,Maruyama; Rie,10,0,10,0
1708254079471,JAPN 10C,H02,403903,Maruyama; Rie,9,0,10,1
1708254079471,JAPN 10C,I01,403905,Inada; Minori,10,0,10,0
1708254079471,JAPN 10C,I02,403906,Inada; Minori,9,0,10,1
1708254079471,JAPN 10C,J01,403915,Iwamoto; Naoki,10,0,10,0
1708254079471,JAPN 10C,J02,403916,Iwamoto; Naoki,9,0,10,1
1708254079471,JAPN 10C,K01,403918,Ross; Kayoko F,10,0,10,0
1708254079471,JAPN 10C,K02,403928,Ross; Kayoko F,10,0,10,0
1708254079471,JAPN 10C,L01,403935,Homma; Kunihiko,9,0,10,1
1708254079471,JAPN 10C,L02,403936,Homma; Kunihiko,10,0,10,0
1708254079471,JAPN 10C,M02,403939,Kamioka; Sachiko,13,0,15,2
1708254079471,JAPN 10C,N01,479041,Iwamoto; Naoki,15,0,15,0
1708254079997,JAPN 10CR,A01,403982,Inada; Minori,12,0,12,0
1708254079997,JAPN 10CR,A02,403983,Inada; Minori,12,0,12,0
1708254080523,JAPN 20C,A01,403988,Homma; Kunihiko,10,0,12,2
1708254080523,JAPN 20C,B02,404029,Kamioka; Sachiko,10,0,12,2
1708254080523,JAPN 20C,C01,404033,Takeda; Izumi,8,0,12,4
1708254080523,JAPN 20C,D02,404114,Kamioka; Sachiko,11,0,12,1
1708254080523,JAPN 20C,E01,404135,Simpson; Junko Tokuda,12,0,12,0
1708254081051,JAPN 130C,A01,404144,Maruyama; Rie,9,0,9,0
1708254081051,JAPN 130C,A02,404145,Maruyama; Rie,9,0,9,0
1708254081051,JAPN 130C,B01,404147,Simpson; Junko Tokuda,8,0,9,1
1708254081051,JAPN 130C,B02,404148,Simpson; Junko Tokuda,9,0,9,0
1708254081583,JAPN 135C,A00,404176,Ross; Kayoko F,16,0,16,0
1708254081583,JAPN 135C,B00,404253,Takeda; Izumi,14,0,16,2
1708254082109,JAPN 140C,A00,404255,Sato; Kyoko,18,0,20,2
1708254082635,JAPN 150C,A00,404258,McKee; Mayumi Mochizuki,14,0,14,0
1708254083162,JAPN 190,A00,404260,Miyao; Daisuke,17,0,20,3
1708254083693,JAPN 196B,001,487237,Turner; Christena L.,9999,0,9999,0
1708254084220,JWSP 3,A01,404485,Shuster; Alana,20,0,20,0
1708254084752,LATI 10,A01,405201,Kennemore; Amy Michelle,27,0,30,3
1708254084752,LATI 10,A02,405202,Kennemore; Amy Michelle,27,0,30,3
1708254084752,LATI 10,A03,405208,Kennemore; Amy Michelle,28,0,30,2
1708254085282,LATI 50,A01,405214,Kokinis; Troy Andreas,34,0,35,1
1708254085282,LATI 50,A02,405215,Kokinis; Troy Andreas,34,0,35,1
1708254085808,LATI 130,A01,482880,Alvarez; Camila Huerta,29,0,30,1
1708254086336,LATI 160,A01,477482,Kokinis; Troy Andreas,30,0,30,0
1708254086864,LATI 180,A00,405221,Kennemore; Amy Michelle,28,0,30,2
1708254086864,LATI 180,B00,405222,Mostajo; Lorena,30,0,30,0
1708254087397,LIAB 1C,A00,405278,Saab; Dima,13,0,14,1
1708254087397,LIAB 1C,B00,405279,Saab; Dima,11,0,14,3
1708254087923,LIAB 1CX,A00,405281,Akjeje; Abdelhak,19,0,20,1
1708254087923,LIAB 1CX,B00,405291,Akjeje; Abdelhak,20,0,20,0
1708254088450,LIAB 1F,A00,482814,El Cheddadi; Youniss,14,0,14,0
1708254088982,LIDS 19,001,492979,Goodall; Grant Todd,9999,0,9999,0
1708254088982,LIDS 19,002,492980,Goodall; Grant Todd,9999,0,9999,0
1708254088982,LIDS 19,003,492981,Goodall; Grant Todd,9999,0,9999,0
1708254088982,LIDS 19,004,492982,Goodall; Grant Todd,9999,0,9999,0
1708254088982,LIDS 19,005,492983,Goodall; Grant Todd,9999,0,9999,0
1708254088982,LIDS 19,006,492984,Goodall; Grant Todd,9999,0,9999,0
1708254088982,LIDS 19,007,492985,Goodall; Grant Todd,9999,0,9999,0
1708254088982,LIDS 19,008,492986,Goodall; Grant Todd,9999,0,9999,0
1708254088982,LIDS 19,009,492987,Goodall; Grant Todd,9999,0,9999,0
1708254088982,LIDS 19,010,492988,Goodall; Grant Todd,9999,0,9999,0
1708254088982,LIDS 19,011,492989,Goodall; Grant Todd,9999,0,9999,0
1708254088982,LIDS 19,012,492990,Goodall; Grant Todd,9999,0,9999,0
1708254089512,LIFR 1A,A00,405299,Van Moer; Vinciane G,13,0,14,1
1708254089512,LIFR 1A,B00,405300,Van Moer; Vinciane G,13,0,14,1
1708254089512,LIFR 1A,C00,405301,Van Moer; Vinciane G,13,0,14,1
1708254089512,LIFR 1A,D00,405307,Van Moer; Vinciane G,14,0,14,0
1708254090039,LIFR 1AX,A00,405308,Van Moer; Vinciane G,27,0,28,1
1708254090039,LIFR 1AX,B00,405309,Van Moer; Vinciane G,27,0,28,1
1708254090565,LIFR 1C,A00,405310,Van Moer; Vinciane G,14,0,14,0
1708254090565,LIFR 1C,B00,405311,Van Moer; Vinciane G,12,0,14,2
1708254090565,LIFR 1C,C00,405325,Van Moer; Vinciane G,13,0,14,1
1708254090565,LIFR 1C,D00,405326,Van Moer; Vinciane G,11,0,14,3
1708254091092,LIFR 1CX,A00,405332,Van Moer; Vinciane G,25,0,28,3
1708254091092,LIFR 1CX,B00,405333,Van Moer; Vinciane G,27,0,28,1
1708254091621,LIFR 1D,A00,405334,Van Moer; Vinciane G,13,0,14,1
1708254091621,LIFR 1D,B00,405335,Van Moer; Vinciane G,13,0,14,1
1708254091621,LIFR 1D,C00,405336,Van Moer; Vinciane G,13,0,14,1
1708254091621,LIFR 1D,D00,405337,Van Moer; Vinciane G,13,0,14,1
1708254092147,LIFR 1DX,A00,405338,Van Moer; Vinciane G,25,0,28,3
1708254092147,LIFR 1DX,B00,405394,Van Moer; Vinciane G,27,0,28,1
1708254092678,LIFR 11,001,405395,Goodall; Grant Todd,999,0,999,0
1708254093216,LIGM 1C,A00,405398,Fischer-Grunski; Eva K,12,0,14,2
1708254093216,LIGM 1C,B00,405400,Fischer-Grunski; Eva K,13,0,14,1
1708254093216,LIGM 1C,C00,405403,Fischer-Grunski; Eva K,13,0,14,1
1708254093216,LIGM 1C,D00,405404,Fischer-Grunski; Eva K,13,0,14,1
1708254093741,LIGM 1CX,A00,405407,Fischer-Grunski; Eva K,27,0,28,1
1708254093741,LIGM 1CX,B00,405408,Fischer-Grunski; Eva K,26,0,28,2
1708254094271,LIGM 11,001,405464,Goodall; Grant Todd,999,0,999,0
1708254094804,LIGN 8,A00,411133,McIntosh; Justin Daniel,232,0,240,8
1708254095334,LIGN 17,A00,411141,Kehler; Andrew Scott,287,0,300,13
1708254095861,LIGN 101,A01,411144,Staff,28,0,30,2
1708254095861,LIGN 101,A02,411147,Staff,29,0,30,1
1708254095861,LIGN 101,A03,411154,Staff,27,0,30,3
1708254095861,LIGN 101,A04,411163,Staff,29,0,30,1
1708254096388,LIGN 120,A01,411165,Ackerman; Farrell,28,0,30,2
1708254096388,LIGN 120,A02,411177,Ackerman; Farrell,23,0,27,4
1708254096919,LIGN 130,A01,411223,Staff,29,0,30,1
1708254096919,LIGN 130,A02,411231,Staff,30,0,30,0
1708254096919,LIGN 130,A03,411232,Staff,29,0,30,1
1708254097446,LIGN 141,A00,411276,Rose; Sharon,37,0,40,3
1708254097971,LIGN 144,A00,411277,Lott; Margaret S.,22,0,24,2
1708254098501,LIGN 148,A00,411278,Mayberry; Rachel,71,0,75,4
1708254099028,LIGN 165,A00,411279,Bergen; Leon,41,0,70,29
1708254099559,LIGN 168,A01,411281,Styler; William Francis,65,0,70,5
1708254100088,LIGN 175,A00,482816,Rodriguez Aispuro; Alejandro,35,0,40,5
1708254100618,LIGN 230,A00,411293,Caponigro; Ivano,19,0,20,1
1708254101149,LIGN 238,A00,411308,Bergen; Benjamin,20,0,20,0
1708254101675,LIGN 252,A00,411309,Bergen; Leon,28,0,30,2
1708254102201,LIGN 256,A00,411310,Nakashole; Ndapandula,0,0,5,5
1708254102728,LIGN 272,A00,482887,Kluender; Robert,10,0,10,0
1708254103256,LIHL 112P,A00,405228,Pagkalinawan; Leticia Cant,27,0,28,1
1708254103780,LIHL 114P,A00,405229,Nguyen; Hoan Thi,26,0,28,2
1708254104336,LIHL 117P,A00,405256,Sadegholvad; Elham,27,0,28,1
1708254104861,LIHL 118,A00,405257,Chen; Areana Yen,28,0,28,0
1708254105389,LIHL 124P,A00,405262,Nguyen; Hoan Thi,28,0,28,0
1708254105918,LIHL 132P,A00,405263,Pagkalinawan; Leticia Cant,28,0,28,0
1708254106448,LIHL 134P,A00,405269,Nguyen; Hoan Thi,28,0,28,0
1708254107056,LIHL 138,A00,405270,Chen; Areana Yen,27,0,28,1
1708254107587,LIIT 1C,A00,405465,Carnelos; Chiara,12,0,14,2
1708254107587,LIIT 1C,B00,405466,Carnelos; Chiara,14,0,14,0
1708254108112,LIIT 1CX,A00,405594,Carnelos; Chiara,28,0,28,0
1708254108641,LIPO 1C,A00,405595,Paladini; Denise,13,0,14,1
1708254108641,LIPO 1C,B00,405596,Paladini; Denise,14,0,14,0
1708254109169,LIPO 1CX,A00,405597,De Abreu; Cassia,28,0,28,0
1708254109694,LISL 1A,C00,405600,Lott; Margaret S.,13,0,14,1
1708254109694,LISL 1A,D00,405601,Lott; Margaret S.,10,0,14,4
1708254109694,LISL 1A,E00,405602,Lott; Margaret S.,13,0,14,1
1708254109694,LISL 1A,F00,405603,Lott; Margaret S.,13,0,14,1
1708254110226,LISL 1AR,A00,480605,Lott; Margaret S.,13,0,15,2
1708254110226,LISL 1AR,B00,480606,Lott; Margaret S.,14,0,15,1
1708254110757,LISL 1AX,A00,405754,Lott; Margaret S.,26,0,28,2
1708254110757,LISL 1AX,B00,405755,Lott; Margaret S.,23,0,28,5
1708254111287,LISL 1C,A00,405776,Lott; Margaret S.,13,0,14,1
1708254111287,LISL 1C,B00,405779,Lott; Margaret S.,14,0,14,0
1708254111287,LISL 1C,C00,405785,Lott; Margaret S.,14,0,14,0
1708254111287,LISL 1C,D00,405787,Lott; Margaret S.,9,0,14,5
1708254111287,LISL 1C,E00,405827,Lott; Margaret S.,12,0,14,2
1708254111287,LISL 1C,F00,405830,Lott; Margaret S.,13,0,14,1
1708254111814,LISL 1CX,A00,405844,Lott; Margaret S.,25,0,28,3
1708254111814,LISL 1CX,B00,405848,Lott; Margaret S.,25,0,28,3
1708254111814,LISL 1CX,C00,405849,Lott; Margaret S.,28,0,28,0
1708254112346,LISL 1D,A00,405850,Lott; Margaret S.,8,0,14,6
1708254112346,LISL 1D,B00,405851,Lott; Margaret S.,13,0,14,1
1708254112346,LISL 1D,C00,405852,Lott; Margaret S.,10,0,14,4
1708254112878,LISL 1DX,A00,405854,Lott; Margaret S.,17,0,22,5
1708254112878,LISL 1DX,B00,405855,Lott; Margaret S.,18,0,22,4
1708254113410,LISP 1A,001,405856,Munoz Sanchez; Alicia,11,0,14,3
1708254113410,LISP 1A,002,405857,Munoz Sanchez; Alicia,13,0,14,1
1708254113410,LISP 1A,003,405858,Munoz Sanchez; Alicia,14,0,14,0
1708254113410,LISP 1A,004,405861,Munoz Sanchez; Alicia,14,0,14,0
1708254113936,LISP 1AX,001,405862,Munoz Sanchez; Alicia,28,0,28,0
1708254113936,LISP 1AX,002,405863,Munoz Sanchez; Alicia,25,0,28,3
1708254114463,LISP 1C,001,405864,Munoz Sanchez; Alicia,13,0,14,1
1708254114463,LISP 1C,002,405865,Munoz Sanchez; Alicia,12,0,14,2
1708254114463,LISP 1C,003,405879,Munoz Sanchez; Alicia,12,0,14,2
1708254114463,LISP 1C,004,405880,Munoz Sanchez; Alicia,13,0,14,1
1708254114463,LISP 1C,005,405881,Munoz Sanchez; Alicia,12,0,14,2
1708254114463,LISP 1C,006,405882,Munoz Sanchez; Alicia,12,0,14,2
1708254114463,LISP 1C,007,405904,Munoz Sanchez; Alicia,14,0,14,0
1708254114463,LISP 1C,008,405905,Munoz Sanchez; Alicia,14,0,14,0
1708254114463,LISP 1C,009,405908,Munoz Sanchez; Alicia,14,0,14,0
1708254114463,LISP 1C,010,405917,Munoz Sanchez; Alicia,13,0,14,1
1708254114989,LISP 1CX,001,405922,Munoz Sanchez; Alicia,24,0,28,4
1708254114989,LISP 1CX,002,405990,Munoz Sanchez; Alicia,26,0,28,2
1708254114989,LISP 1CX,003,406007,Munoz Sanchez; Alicia,27,0,28,1
1708254114989,LISP 1CX,004,406008,Munoz Sanchez; Alicia,25,0,28,3
1708254114989,LISP 1CX,005,406015,Munoz Sanchez; Alicia,26,0,28,2
1708254115531,LISP 1D,001,406016,Munoz Sanchez; Alicia,12,0,14,2
1708254115531,LISP 1D,002,406017,Munoz Sanchez; Alicia,13,0,14,1
1708254115531,LISP 1D,003,406018,Munoz Sanchez; Alicia,14,0,14,0
1708254115531,LISP 1D,004,406019,Munoz Sanchez; Alicia,11,0,14,3
1708254115531,LISP 1D,005,406020,Munoz Sanchez; Alicia,13,0,14,1
1708254115531,LISP 1D,006,406021,Munoz Sanchez; Alicia,10,0,14,4
1708254115531,LISP 1D,007,406022,Munoz Sanchez; Alicia,12,0,14,2
1708254115531,LISP 1D,008,406023,Munoz Sanchez; Alicia,13,0,14,1
1708254115531,LISP 1D,009,406024,Munoz Sanchez; Alicia,11,0,14,3
1708254115531,LISP 1D,010,406025,Munoz Sanchez; Alicia,12,0,14,2
1708254115531,LISP 1D,011,406026,Munoz Sanchez; Alicia,13,0,14,1
1708254115531,LISP 1D,012,406027,Munoz Sanchez; Alicia,13,0,14,1
1708254115531,LISP 1D,013,406028,Munoz Sanchez; Alicia,12,0,14,2
1708254115531,LISP 1D,014,406029,Munoz Sanchez; Alicia,12,0,14,2
1708254115531,LISP 1D,015,406030,Munoz Sanchez; Alicia,10,0,14,4
1708254115531,LISP 1D,016,406031,Munoz Sanchez; Alicia,14,0,14,0
1708254115531,LISP 1D,017,406032,Munoz Sanchez; Alicia,14,0,14,0
1708254115531,LISP 1D,018,406033,Munoz Sanchez; Alicia,12,0,14,2
1708254115531,LISP 1D,019,406034,Munoz Sanchez; Alicia,13,0,14,1
1708254115531,LISP 1D,020,406035,Munoz Sanchez; Alicia,14,0,14,0
1708254115531,LISP 1D,021,406036,Munoz Sanchez; Alicia,13,0,14,1
1708254115531,LISP 1D,022,406037,Munoz Sanchez; Alicia,14,0,14,0
1708254115531,LISP 1D,023,406038,Munoz Sanchez; Alicia,14,0,14,0
1708254115531,LISP 1D,024,406039,Munoz Sanchez; Alicia,13,0,14,1
1708254116060,LISP 1DX,001,406040,Munoz Sanchez; Alicia,28,0,28,0
1708254116060,LISP 1DX,002,406041,Munoz Sanchez; Alicia,27,0,28,1
1708254116060,LISP 1DX,003,406127,Munoz Sanchez; Alicia,24,0,28,4
1708254116060,LISP 1DX,004,406128,Munoz Sanchez; Alicia,17,0,28,11
1708254116060,LISP 1DX,005,406418,Munoz Sanchez; Alicia,24,0,28,4
1708254116060,LISP 1DX,006,406536,Munoz Sanchez; Alicia,27,0,28,1
1708254116060,LISP 1DX,007,406561,Munoz Sanchez; Alicia,23,0,28,5
1708254116060,LISP 1DX,008,406576,Munoz Sanchez; Alicia,25,0,28,3
1708254116060,LISP 1DX,009,406679,Munoz Sanchez; Alicia,28,0,28,0
1708254116060,LISP 1DX,010,406691,Munoz Sanchez; Alicia,26,0,28,2
1708254116060,LISP 1DX,011,406692,Munoz Sanchez; Alicia,28,0,28,0
1708254116060,LISP 1DX,012,406693,Munoz Sanchez; Alicia,28,0,28,0
1708254116592,LISP 17,001,406694,Munoz Sanchez; Alicia,18,0,20,2
1708254117118,LISP 18,001,406695,Munoz Sanchez; Alicia,20,0,20,0
1708254117644,LTAM 105,A00,412520,Ruiz; Ariana,28,0,40,12
1708254118172,LTCH 101,A00,479214,Zhu; Ping,39,0,40,1
1708254118698,LTCS 87,A00,492906,Nguyen; Hoang Tan,20,0,20,0
1708254118698,LTCS 87,B00,492907,Nguyen; Hoang Tan,20,0,20,0
1708254119225,LTCS 150,A00,412543,Liao; Ping H,39,0,40,1
1708254119749,LTCS 225,A00,412819,Mendoza; Andrea,14,0,15,1
1708254120277,LTCS 250,A00,412821,Lee; Jin-Kyung,15,0,15,0
1708254120806,LTEA 110B,A00,412548,Liao; Ping H,60,0,60,0
1708254121335,LTEA 120A,A00,479216,Zhu; Ping,36,0,40,4
1708254121865,LTEA 120C,A00,412552,Fiss; Geraldine Anna,295,0,300,5
1708254122393,LTEA 132,A00,412561,Mendoza; Andrea,51,0,60,9
1708254122919,LTEA 141,A00,412565,Lee; Jin-Kyung,37,0,40,3
1708254123452,LTEN 23,A01,411317,Vijay; Ameeth Varma,24,0,25,1
1708254123452,LTEN 23,A02,411318,Vijay; Ameeth Varma,24,0,25,1
1708254123452,LTEN 23,A03,411371,Vijay; Ameeth Varma,25,0,25,0
1708254123452,LTEN 23,A04,411375,Vijay; Ameeth Varma,24,0,25,1
1708254123985,LTEN 28,A01,411632,Blanco; John D,25,0,25,0
1708254123985,LTEN 28,A02,411697,Blanco; John D,25,0,25,0
1708254123985,LTEN 28,A03,411698,Blanco; John D,25,0,25,0
1708254123985,LTEN 28,A04,411709,Blanco; John D,25,0,25,0
1708254123985,LTEN 28,A05,411719,Blanco; John D,25,0,25,0
1708254123985,LTEN 28,A06,411744,Blanco; John D,25,0,25,0
1708254123985,LTEN 28,A07,411780,Blanco; John D,25,0,25,0
1708254123985,LTEN 28,A08,411820,Blanco; John D,25,0,25,0
1708254124516,LTEN 110,A00,486891,Vitkus; Daniel J.,38,0,40,2
1708254125042,LTEN 144,A00,412570,Vijay; Ameeth Varma,39,0,40,1
1708254125569,LTEN 180,A00,412581,Perreira; Christopher Michael,18,0,25,7
1708254126096,LTEN 181,A00,412582,Mukherjee; Silpa,55,0,60,5
1708254126680,LTEN 245,A00,412824,Johnson; Sara E.,13,0,15,2
1708254127206,LTEN 259,A00,412825,Streeby; Shelley,13,0,15,2
1708254127735,LTEU 111,A00,412588,Kontje; Todd Curtis,38,0,40,2
1708254128261,LTEU 140,A00,480172,De Marchi Gherini; Adriana,36,0,37,1
1708254128794,LTEU 141,A00,412592,Cohen; Alain J. J.,40,0,40,0
1708254129340,LTFR 2A,A01,411996,Ploye; Catherine,25,0,25,0
1708254130103,LTFR 2C,A00,411997,Ploye; Catherine,24,0,25,1
1708254130634,LTFR 142,A00,412597,Zhiri; Oumelbanine,20,0,20,0
1708254131163,LTGK 3,A00,412001,Murray; Kourtney Kristine,30,0,30,0
1708254131693,LTGM 2C,A00,412002,Fischer-Grunski; Eva K,25,0,25,0
1708254132229,LTKO 1C,A01,412029,Cho; Hye Jin,24,0,25,1
1708254132229,LTKO 1C,B01,412164,Cho; Hye Jin,23,0,25,2
1708254132229,LTKO 1C,C01,412168,Cho; Hye Jin,25,0,25,0
1708254132229,LTKO 1C,D01,412353,Yim; Nancy,24,0,25,1
1708254132229,LTKO 1C,E01,412372,Yim; Nancy,25,0,25,0
1708254132755,LTKO 2C,A01,412374,Yim; Nancy,21,0,25,4
1708254133308,LTKO 130P,A00,412601,Lee; Jeyseon,25,0,25,0
1708254133834,LTKO 135,A00,412606,Lee; Jeyseon,25,0,25,0
1708254134362,LTLA 3,A00,412375,Murray; Kourtney Kristine,36,0,40,4
1708254134893,LTRU 1C,A01,412491,Wells; Patricia Rebecca,24,0,25,1
1708254135420,LTRU 104A,A01,412614,Wells; Patricia Rebecca,20,0,20,0
1708254135952,LTSP 2A,A01,412493,Lampell; Toni,24,0,25,1
1708254136497,LTSP 2B,A01,412497,Lampell; Toni,22,0,25,3
1708254136497,LTSP 2B,B01,479218,Lampell; Toni,24,0,25,1
1708254137025,LTSP 2C,A01,412499,Mastromartino; Alexandra L,23,0,25,2
1708254137555,LTSP 2D,A00,412500,Dominguez; Noelia,24,0,25,1
1708254138084,LTSP 2E,A00,412501,Mastromartino; Alexandra L,24,0,25,1
1708254138084,LTSP 2E,B00,412502,Mastromartino; Alexandra L,25,0,25,0
1708254138610,LTSP 87,A00,479212,Bessett; Ryan Matthew,20,0,20,0
1708254139139,LTSP 100B,A00,412619,Dominguez; Noelia,25,0,25,0
1708254139139,LTSP 100B,B00,412623,Dominguez; Noelia,24,0,25,1
1708254139665,LTSP 116,A00,412628,Blanco; John D,28,0,30,2
1708254140197,LTSP 135A,A00,412631,Parra; Max,27,0,30,3
1708254140725,LTSP 174,A00,479213,Staff,28,0,30,2
1708254141255,LTTH 115,A00,412632,Kontje; Todd Curtis,35,0,40,5
1708254141782,LTTH 210C,A00,412826,Batarseh; Amanda Alicia,14,0,15,1
1708254142339,LTTH 255,A00,412827,Ali; Mohammad Kazim,13,0,15,2
1708254142869,LTTH 260,A00,412828,Kim; Joo Ok,30,0,30,0
1708254143395,LTWL 19C,A00,412503,Kelting; Edward William,40,0,40,0
1708254143920,LTWL 101,A00,412633,Kelting; Edward William,39,0,40,1
1708254144445,LTWL 114,A00,412656,Fiss; Geraldine Anna,60,0,60,0
1708254144976,LTWL 123,A00,412674,Lampert-Weissig; Lisa,31,0,40,9
1708254145502,LTWL 172,A00,412729,De Marchi Gherini; Adriana,37,0,40,3
1708254146029,LTWL 183,A00,412731,Cohen; Alain J. J.,38,0,40,2
1708254146556,LTWL 184,A00,479219,Mukherjee; Silpa,38,0,40,2
1708254147083,LTWL 194A,A00,489635,Vijay; Ameeth Varma,27,0,31,4
1708254147864,LTWR 8A,A01,412505,Springer; Anna Joy,24,0,25,1
1708254147864,LTWR 8A,A02,412506,Springer; Anna Joy,24,0,25,1
1708254147864,LTWR 8A,A03,412507,Springer; Anna Joy,25,0,25,0
1708254147864,LTWR 8A,A04,412508,Springer; Anna Joy,23,0,25,2
1708254148390,LTWR 8C,A01,412511,Forbes; Camille,23,0,25,2
1708254148390,LTWR 8C,A02,412512,Forbes; Camille,25,0,25,0
1708254148390,LTWR 8C,A03,412514,Forbes; Camille,25,0,25,0
1708254148390,LTWR 8C,A04,412519,Forbes; Camille,24,0,25,1
1708254148919,LTWR 100,A00,412734,Forbes; Camille,7,0,15,8
1708254149447,LTWR 113,A00,412816,Carroll; Amy Sara,28,0,30,2
1708254149974,LTWR 114,A00,412817,Springer; Anna Joy,23,0,30,7
1708254150501,LTWR 126,A00,412818,Hoang; Lily Kim,25,0,30,5
1708254151026,LTWR 215,A00,412880,Carroll; Amy Sara,19,0,20,1
1708254151564,MAE 3,A01,435606,Qi; Huihui,16,0,20,4
1708254151564,MAE 3,A02,435607,Qi; Huihui,15,0,20,5
1708254151564,MAE 3,A03,435608,Qi; Huihui,19,0,20,1
1708254151564,MAE 3,B01,435618,Delson; Nathan Joseph & Mullin; Jennifer S,20,0,20,0
1708254151564,MAE 3,B02,435626,Delson; Nathan Joseph & Mullin; Jennifer S,20,0,20,0
1708254151564,MAE 3,B03,435666,Delson; Nathan Joseph & Mullin; Jennifer S,20,0,20,0
1708254151564,MAE 3,B04,435679,Delson; Nathan Joseph & Mullin; Jennifer S,20,0,20,0
1708254151564,MAE 3,B05,494545,Delson; Nathan Joseph & Mullin; Jennifer S,20,0,20,0
1708254152090,MAE 8,A01,435688,Pham; Hieu Tan,197,0,200,3
1708254152623,MAE 30B,A00,435689,Lubarda; Marko,128,0,130,2
1708254152623,MAE 30B,B00,435701,Ghazinejad; Maziar,117,0,130,13
1708254153150,MAE 101B,A00,435702,Saintillan; David,146,0,150,4
1708254153150,MAE 101B,B00,435703,Nomura; Keiko K.,138,0,146,8
1708254153676,MAE 101C,A00,435704,Sadeghizadeh; Zahra,53,0,65,12
1708254154210,MAE 101D,A00,435705,Chen; Renkun,14,0,20,6
1708254154742,MAE 105,A00,435706,Becker; Janet Maria,115,0,120,5
1708254155275,MAE 107,A00,435707,Lindsey; Stephanie,48,0,50,2
1708254155275,MAE 107,B00,435708,Davidson; Michael R,55,0,60,5
1708254155803,MAE 119,A00,435710,Hidalgo-Gonzalez; Patricia,100,0,120,20
1708254156329,MAE 120,A00,435722,Arefiev; Alexey,49,0,65,16
1708254156863,MAE 125,A00,435723,Kleissl; Jan,60,0,65,5
1708254157390,MAE 131A,A00,435724,Qi; Huihui,119,0,125,6
1708254157390,MAE 131A,B00,435725,Meyers; Marc,123,0,125,2
1708254157917,MAE 143B,A00,435726,Morimoto; Tania,114,0,120,6
1708254157917,MAE 143B,B00,435727,Herbert; Sylvia Lee,117,0,120,3
1708254157917,MAE 143B,C00,435728,Diagne; Mamadou Lamine,108,0,120,12
1708254158448,MAE 145,A00,435729,Martinez; Sonia,41,0,60,19
1708254158975,MAE 148,A01,492802,Silberman; Jack,14,0,24,10
1708254159500,MAE 150,A00,435730,Pham; Hieu Tan,51,0,60,9
1708254160027,MAE 152,A00,435731,Llewellyn Smith; Stefan G.,14,0,14,0
1708254160027,MAE 152,B00,435747,Llewellyn Smith; Stefan G.,12,0,14,2
1708254160027,MAE 152,C00,435748,Llewellyn Smith; Stefan G.,12,0,14,2
1708254160027,MAE 152,D00,435749,Llewellyn Smith; Stefan G.,8,0,14,6
1708254160027,MAE 152,E00,435750,Llewellyn Smith; Stefan G.,13,0,14,1
1708254160569,MAE 155B,A01,435752,Hwang; John T,36,0,50,14
1708254160569,MAE 155B,B01,435768,Anderson; Mark Ronald,27,0,50,23
1708254160569,MAE 155B,C01,494006,Saha; Abhishek,0,0,0,0
1708254161123,MAE 156B,A01,435770,Tustaniwskyj; Jerry I,33,0,40,7
1708254161123,MAE 156B,B01,435772,Ghazinejad; Maziar,35,0,40,5
1708254161123,MAE 156B,C01,435774,Delson; Nathan Joseph,38,0,40,2
1708254161123,MAE 156B,D01,435776,Saha; Abhishek,31,0,40,9
1708254161648,MAE 166,A00,435777,Fullerton; Eric E,44,0,50,6
1708254162181,MAE 170,A01,435779,Lubarda; Marko,30,0,32,2
1708254162181,MAE 170,A02,435780,Lubarda; Marko,27,0,32,5
1708254162181,MAE 170,A03,435781,Lubarda; Marko,32,0,32,0
1708254162181,MAE 170,A04,435782,Lubarda; Marko,31,0,32,1
1708254162181,MAE 170,A05,435783,Lubarda; Marko,29,0,32,3
1708254162181,MAE 170,A06,435784,Lubarda; Marko,30,0,32,2
1708254162181,MAE 170,B01,435786,Evdokimenko; Ekaterina,23,0,24,1
1708254162181,MAE 170,B02,435787,Evdokimenko; Ekaterina,20,0,24,4
1708254162181,MAE 170,B03,435788,Evdokimenko; Ekaterina,23,0,24,1
1708254162181,MAE 170,B04,435789,Evdokimenko; Ekaterina,23,0,24,1
1708254162181,MAE 170,B05,435790,Evdokimenko; Ekaterina,19,0,24,5
1708254162181,MAE 170,B06,435791,Evdokimenko; Ekaterina,23,0,24,1
1708254162707,MAE 180,A00,479477,Sadeghizadeh; Zahra,55,0,60,5
1708254163235,MAE 184,A00,435792,Anderson; Mark Ronald,6,0,50,44
1708254163768,MAE 190,A00,435793,Beg; Farhat N.,17,0,20,3
1708254163768,MAE 190,B00,479209,Gerardo; Hortense Flotilde,12,0,15,3
1708254164299,MAE 202,A00,435794,Bandaru; Prabhakar,32,0,70,38
1708254164826,MAE 205,A00,435804,Hwang; John T & Tynan; George Robert & Seshadri; Kalyanasundaram & Rangamani; Padmini & Bandaru; Prabhakar,9990,0,9999,9
1708254165359,MAE 207,A00,435805,Beg; Farhat N.,9,0,10,1
1708254165359,MAE 207,B00,435815,Campbell; Edward Michael,6,0,10,4
1708254165359,MAE 207,C00,477499,Gerardo; Hortense Flotilde,6,0,30,24
1708254165885,MAE 209,A00,435816,Scholtes Acevedo; Claire,25,0,30,5
1708254166415,MAE 210C,A00,435817,Becker; Janet Maria,22,0,30,8
1708254166942,MAE 211,A00,435818,Seshadri; Kalyanasundaram,20,0,30,10
1708254167469,MAE 214A,A00,435819,Sarkar; Sutanu,27,0,35,8
1708254167994,MAE 217C,A00,435820,Marinoni; Alessandro,10,0,10,0
1708254168526,MAE 221C,A00,435821,Seshadri; Kalyanasundaram,9,0,15,6
1708254169054,MAE 221D,A00,435822,Poulikakos; Lisa Voula,23,0,30,7
1708254169586,MAE 224A,A00,435823,Pawlak; Geno Ronald,5,0,10,5
1708254170111,MAE 227,A00,435824,Hidalgo-Gonzalez; Patricia,21,0,35,14
1708254170642,MAE 231A,A00,435825,Boechler; Nicholas Sebastia,14,0,30,16
1708254171167,MAE 240,A00,435826,Rosengren; Aaron,19,0,30,11
1708254171696,MAE 242,A00,435827,Martinez; Sonia,0,0,45,45
1708254172224,MAE 249,A00,435842,Tolley; Michael Thomas,0,0,35,35
1708254172749,MAE 253,A00,435891,Staff,24,0,25,1
1708254173285,MAE 256,A00,435949,Coimbra; Carlos F.,6,0,10,4
1708254173810,MAE 263,A00,435987,Rangamani; Padmini,10,0,10,0
1708254174341,MAE 266,A00,435988,Evdokimenko; Ekaterina,7,0,30,23
1708254174872,MAE 271C,A00,435990,Arzt; Eduard,10,0,10,0
1708254175400,MAE 281B,A00,435991,Cortes; Jorge,9,0,25,16
1708254175928,MAE 288A,A00,435998,McEneaney; William Michael,6,0,40,34
1708254176459,MAE 288B,A00,435999,Bitmead; Robert R.,41,0,45,4
1708254176985,MAE 290C,A00,436008,Schmidt; Oliver,26,0,30,4
1708254177511,MAE 294C,A01,436010,Young; William Roy,19,0,20,1
1708254178043,MATH 2,A01,431271,Staff,31,0,35,4
1708254178043,MATH 2,B01,431273,Staff,29,0,35,6
1708254178043,MATH 2,C01,431275,Staff,31,0,35,4
1708254178587,MATH 3C,A01,431277,Safii; Soheil,12,0,15,3
1708254178587,MATH 3C,A02,431278,Safii; Soheil,12,0,15,3
1708254178587,MATH 3C,A03,431279,Safii; Soheil,12,0,15,3
1708254178587,MATH 3C,A04,431280,Safii; Soheil,15,0,15,0
1708254178587,MATH 3C,A05,431281,Safii; Soheil,14,0,15,1
1708254178587,MATH 3C,A06,431282,Safii; Soheil,15,0,15,0
1708254179137,MATH 10A,A01,431284,Bowers; Adam R.,20,0,30,10
1708254179137,MATH 10A,A02,431285,Bowers; Adam R.,18,0,30,12
1708254179137,MATH 10A,A03,431369,Bowers; Adam R.,28,0,30,2
1708254179137,MATH 10A,A04,431395,Bowers; Adam R.,27,0,30,3
1708254179137,MATH 10A,A05,431450,Bowers; Adam R.,28,0,30,2
1708254179137,MATH 10A,A06,431508,Bowers; Adam R.,30,0,30,0
1708254179137,MATH 10A,B01,431572,Kowalenko; Ethan J,24,0,30,6
1708254179137,MATH 10A,B02,431573,Kowalenko; Ethan J,29,0,30,1
1708254179137,MATH 10A,B03,431574,Kowalenko; Ethan J,30,0,30,0
1708254179137,MATH 10A,B04,431576,Kowalenko; Ethan J,30,0,30,0
1708254179137,MATH 10A,B05,431577,Kowalenko; Ethan J,30,0,30,0
1708254179137,MATH 10A,B06,431583,Kowalenko; Ethan J,30,0,30,0
1708254179705,MATH 10B,A01,431595,Habib; Yousaf,29,0,36,7
1708254179705,MATH 10B,A02,431597,Habib; Yousaf,35,0,36,1
1708254179705,MATH 10B,A03,431669,Habib; Yousaf,37,0,37,0
1708254179705,MATH 10B,A04,431670,Habib; Yousaf,36,0,37,1
1708254179705,MATH 10B,A05,431671,Habib; Yousaf,70,0,70,0
1708254179705,MATH 10B,B01,431673,Habib; Yousaf,25,0,33,8
1708254179705,MATH 10B,B02,431712,Habib; Yousaf,33,0,33,0
1708254179705,MATH 10B,B03,431713,Habib; Yousaf,33,0,33,0
1708254179705,MATH 10B,B04,431714,Habib; Yousaf,33,0,33,0
1708254179705,MATH 10B,B05,431715,Habib; Yousaf,60,0,60,0
1708254179705,MATH 10B,C01,431717,Bach; Quang Tran,57,0,60,3
1708254179705,MATH 10B,C02,431718,Bach; Quang Tran,18,0,34,16
1708254179705,MATH 10B,C03,431719,Bach; Quang Tran,34,0,34,0
1708254179705,MATH 10B,C04,431720,Bach; Quang Tran,33,0,34,1
1708254179705,MATH 10B,C05,431721,Bach; Quang Tran,32,0,34,2
1708254179705,MATH 10B,D01,431723,Staff,28,0,34,6
1708254179705,MATH 10B,D02,431724,Staff,34,0,34,0
1708254179705,MATH 10B,D03,431725,Staff,34,0,34,0
1708254179705,MATH 10B,D04,431726,Staff,34,0,34,0
1708254179705,MATH 10B,D05,431727,Staff,57,0,60,3
1708254180265,MATH 10C,A01,431741,Staff,94,0,96,2
1708254180265,MATH 10C,A02,431742,Staff,39,0,40,1
1708254180265,MATH 10C,B01,431744,Staff,95,0,96,1
1708254180265,MATH 10C,B02,431746,Staff,27,0,40,13
1708254180265,MATH 10C,C01,431748,Pardo Guerra; Sebastian,30,0,40,10
1708254180265,MATH 10C,C02,431885,Pardo Guerra; Sebastian,40,0,40,0
1708254180265,MATH 10C,C03,431895,Pardo Guerra; Sebastian,32,0,33,1
1708254180265,MATH 10C,C04,431896,Pardo Guerra; Sebastian,32,0,32,0
1708254180864,MATH 11,A01,431933,Rava; Denise,82,0,100,18
1708254180864,MATH 11,A02,431960,Rava; Denise,66,0,70,4
1708254180864,MATH 11,A03,431971,Rava; Denise,39,0,40,1
1708254180864,MATH 11,B01,432053,Staff,99,0,100,1
1708254180864,MATH 11,B02,432064,Staff,37,0,45,8
1708254180864,MATH 11,B03,432073,Staff,44,0,45,1
1708254181399,MATH 18,A01,432082,Mackall; Eoin Travis,65,0,70,5
1708254181399,MATH 18,A02,432086,Mackall; Eoin Travis,68,0,70,2
1708254181399,MATH 18,B01,432089,Suk; Andrew Hoon,39,0,40,1
1708254181399,MATH 18,B02,432090,Suk; Andrew Hoon,35,0,40,5
1708254181399,MATH 18,B03,432091,Suk; Andrew Hoon,33,0,40,7
1708254181399,MATH 18,B04,432092,Suk; Andrew Hoon,30,0,40,10
1708254181399,MATH 18,B05,432093,Suk; Andrew Hoon,34,0,35,1
1708254181399,MATH 18,B06,432094,Suk; Andrew Hoon,33,0,35,2
1708254181399,MATH 18,B07,432095,Suk; Andrew Hoon,98,0,100,2
1708254181399,MATH 18,B08,432096,Suk; Andrew Hoon,100,0,100,0
1708254181399,MATH 18,B09,432097,Suk; Andrew Hoon,98,0,100,2
1708254181399,MATH 18,B10,432098,Suk; Andrew Hoon,69,0,70,1
1708254181925,MATH 20A,A01,432101,Briones; Jor-el Thomas Caparas,30,0,40,10
1708254181925,MATH 20A,A02,432102,Briones; Jor-el Thomas Caparas,98,0,100,2
1708254181925,MATH 20A,B01,432104,Briones; Jor-el Thomas Caparas,99,0,100,1
1708254181925,MATH 20A,B02,432105,Briones; Jor-el Thomas Caparas,40,0,40,0
1708254182454,MATH 20B,A01,432107,Quarfoot; David James,33,0,35,2
1708254182454,MATH 20B,A02,432108,Quarfoot; David James,18,0,35,17
1708254182454,MATH 20B,A03,432109,Quarfoot; David James,32,0,35,3
1708254182454,MATH 20B,A04,432110,Quarfoot; David James,34,0,35,1
1708254182454,MATH 20B,A05,432331,Quarfoot; David James,26,0,32,6
1708254182454,MATH 20B,A06,432411,Quarfoot; David James,31,0,32,1
1708254182454,MATH 20B,B01,432413,Mackall; Eoin Travis,62,0,65,3
1708254182454,MATH 20B,B02,432443,Mackall; Eoin Travis,65,0,65,0
1708254182454,MATH 20B,B03,432444,Mackall; Eoin Travis,60,0,60,0
1708254182454,MATH 20B,B04,432471,Mackall; Eoin Travis,60,0,60,0
1708254182982,MATH 20C,A01,432473,Ohm; Ko Woon,26,0,38,12
1708254182982,MATH 20C,A02,432474,Ohm; Ko Woon,36,0,38,2
1708254182982,MATH 20C,A03,432475,Ohm; Ko Woon,34,0,37,3
1708254182982,MATH 20C,A04,432546,Ohm; Ko Woon,36,0,37,1
1708254182982,MATH 20C,A05,432550,Ohm; Ko Woon,88,0,90,2
1708254182982,MATH 20C,B01,432568,Ohm; Ko Woon,43,0,45,2
1708254182982,MATH 20C,B02,432594,Ohm; Ko Woon,40,0,45,5
1708254182982,MATH 20C,B03,432609,Ohm; Ko Woon,85,0,90,5
1708254182982,MATH 20C,C01,432613,Cheng; Hsiao-Bing,67,0,70,3
1708254182982,MATH 20C,C02,432614,Cheng; Hsiao-Bing,68,0,70,2
1708254182982,MATH 20C,C03,432615,Cheng; Hsiao-Bing,70,0,70,0
1708254182982,MATH 20C,D01,432617,Cheng; Hsiao-Bing,69,0,70,1
1708254182982,MATH 20C,D02,432618,Cheng; Hsiao-Bing,68,0,70,2
1708254182982,MATH 20C,D03,432619,Cheng; Hsiao-Bing,70,0,70,0
1708254183512,MATH 20D,A01,432622,Hammock; Frances H,58,0,60,2
1708254183512,MATH 20D,A02,432623,Hammock; Frances H,58,0,60,2
1708254183512,MATH 20D,A03,432658,Hammock; Frances H,35,0,35,0
1708254183512,MATH 20D,A04,432660,Hammock; Frances H,35,0,35,0
1708254183512,MATH 20D,B01,432702,Hammock; Frances H,66,0,70,4
1708254183512,MATH 20D,B02,432703,Hammock; Frances H,70,0,70,0
1708254183512,MATH 20D,B03,432766,Hammock; Frances H,30,0,30,0
1708254183512,MATH 20D,B04,432782,Hammock; Frances H,20,0,30,10
1708254183512,MATH 20D,C01,432811,Sheng; Hongyi,60,0,60,0
1708254183512,MATH 20D,C02,432931,Sheng; Hongyi,60,0,60,0
1708254183512,MATH 20D,C03,432945,Sheng; Hongyi,28,0,30,2
1708254183512,MATH 20D,C04,432949,Sheng; Hongyi,30,0,30,0
1708254184041,MATH 20E,A01,433007,Eggers; John Dietrich,70,0,80,10
1708254184041,MATH 20E,A02,433070,Eggers; John Dietrich,77,0,80,3
1708254184041,MATH 20E,A03,433079,Eggers; John Dietrich,32,0,35,3
1708254184041,MATH 20E,B01,433092,Staff,86,0,90,4
1708254184041,MATH 20E,B02,433093,Staff,90,0,90,0
1708254184041,MATH 20E,C01,433237,Bach; Quang Tran,52,0,60,8
1708254184041,MATH 20E,C02,433238,Bach; Quang Tran,69,0,70,1
1708254184041,MATH 20E,C03,433239,Bach; Quang Tran,70,0,70,0
1708254184568,MATH 31CH,A01,433241,Rabin; Jeffrey Mark,35,0,35,0
1708254185094,MATH 95,A00,433242,Stevens; Laura Jeanne,30,0,30,0
1708254185621,MATH 100C,A01,433244,Pollack; Aaron,31,0,35,4
1708254185621,MATH 100C,A02,433245,Pollack; Aaron,35,0,35,0
1708254186151,MATH 102,A01,433298,Ophir; Amit,29,0,30,1
1708254186151,MATH 102,A02,433369,Ophir; Amit,30,0,30,0
1708254186151,MATH 102,A03,433373,Ophir; Amit,30,0,30,0
1708254186151,MATH 102,A04,433374,Ophir; Amit,29,0,30,1
1708254186151,MATH 102,B01,433572,Zhang; Ming,28,0,30,2
1708254186151,MATH 102,B02,433732,Zhang; Ming,30,0,30,0
1708254186151,MATH 102,B03,433733,Zhang; Ming,30,0,30,0
1708254186151,MATH 102,B04,433734,Zhang; Ming,29,0,30,1
1708254186679,MATH 103B,A01,433793,Lu; Yunze,23,0,30,7
1708254186679,MATH 103B,A02,433795,Lu; Yunze,30,0,30,0
1708254186679,MATH 103B,A03,433830,Lu; Yunze,28,0,30,2
1708254186679,MATH 103B,B01,433845,Lahiri; Aranya,24,0,30,6
1708254186679,MATH 103B,B02,433846,Lahiri; Aranya,28,0,30,2
1708254186679,MATH 103B,B03,433847,Lahiri; Aranya,27,0,30,3
1708254187207,MATH 109,A01,433849,Aycock; Jon Merrill,6,0,10,4
1708254187207,MATH 109,A02,433850,Aycock; Jon Merrill,9,0,10,1
1708254187207,MATH 109,B01,433852,Klevdal; Christian Sleek,10,0,10,0
1708254187207,MATH 109,B02,433859,Klevdal; Christian Sleek,10,0,10,0
1708254187207,MATH 109,C01,433861,Treuer; John N,5,0,10,5
1708254187207,MATH 109,C02,433862,Treuer; John N,10,0,10,0
1708254187207,MATH 109,D01,433864,Treuer; John N,8,0,10,2
1708254187207,MATH 109,D02,433865,Treuer; John N,8,0,10,2
1708254187207,MATH 109,E01,433868,Sheng; Hongyi,10,0,10,0
1708254187207,MATH 109,E02,433869,Sheng; Hongyi,19,0,20,1
1708254187739,MATH 110,A01,433871,Pillai; Mohandas K,24,0,35,11
1708254187739,MATH 110,A02,433872,Pillai; Mohandas K,33,0,35,2
1708254188264,MATH 112B,A01,480683,Komarova; Natalia,27,0,27,0
1708254188790,MATH 120B,A01,433885,Xiao; Ming,32,0,35,3
1708254188790,MATH 120B,A02,433886,Xiao; Ming,34,0,35,1
1708254189319,MATH 121B,A01,433888,Stevens; Laura Jeanne,29,0,30,1
1708254189844,MATH 140B,A01,433890,Seward; Brandon M.,31,0,35,4
1708254189844,MATH 140B,A02,433891,Seward; Brandon M.,35,0,35,0
1708254190375,MATH 140C,A01,433895,Spolaor; Luca,32,0,35,3
1708254190375,MATH 140C,A02,433896,Spolaor; Luca,35,0,35,0
1708254190904,MATH 142B,A01,433966,Eggers; John Dietrich,25,0,35,10
1708254190904,MATH 142B,A02,434063,Eggers; John Dietrich,32,0,35,3
1708254190904,MATH 142B,B01,434071,Sanchez; Anthony,32,0,35,3
1708254190904,MATH 142B,B02,434083,Sanchez; Anthony,34,0,35,1
1708254190904,MATH 142B,C01,434094,Kunnawalkam Elayavalli; Sr,31,0,35,4
1708254190904,MATH 142B,C02,434095,Kunnawalkam Elayavalli; Sr,34,0,35,1
1708254191435,MATH 144,A01,434097,Cloninger; Alexander,30,0,30,0
1708254191965,MATH 150B,A01,434104,Parise; Davide,33,0,35,2
1708254192492,MATH 152,A01,434107,Grier; Daniel T,20,0,40,20
1708254193023,MATH 154,A01,434109,Wesley; William J,31,0,35,4
1708254193023,MATH 154,A02,434119,Wesley; William J,35,0,35,0
1708254193023,MATH 154,A03,434120,Wesley; William J,35,0,35,0
1708254193023,MATH 154,A04,434121,Wesley; William J,34,0,35,1
1708254193023,MATH 154,B01,434126,Aliabadi Sr.; Mohsen,26,0,35,9
1708254193023,MATH 154,B02,434127,Aliabadi Sr.; Mohsen,34,0,35,1
1708254193023,MATH 154,B03,434138,Aliabadi Sr.; Mohsen,35,0,35,0
1708254193023,MATH 154,B04,434139,Aliabadi Sr.; Mohsen,35,0,35,0
1708254193549,MATH 163,A01,434144,Bowers; Adam R.,0,0,5,5
1708254194077,MATH 170A,A01,434148,Nag; Panchali,36,0,36,0
1708254194077,MATH 170A,A02,434149,Nag; Panchali,36,0,36,0
1708254194077,MATH 170A,A03,434150,Nag; Panchali,36,0,37,1
1708254194077,MATH 170A,A04,434151,Nag; Panchali,36,0,36,0
1708254194605,MATH 170B,A01,434155,Huang; Lei,31,0,35,4
1708254194605,MATH 170B,A02,434160,Huang; Lei,35,0,35,0
1708254194605,MATH 170B,A03,434161,Huang; Lei,35,0,35,0
1708254194605,MATH 170B,A04,434162,Huang; Lei,35,0,35,0
1708254195131,MATH 170C,A01,434176,Leok; Melvin,30,0,35,5
1708254195131,MATH 170C,A02,434300,Leok; Melvin,34,0,35,1
1708254195662,MATH 171B,A01,434576,Nie; Jiawang,24,0,35,11
1708254195662,MATH 171B,A02,434583,Nie; Jiawang,35,0,35,0
1708254195662,MATH 171B,A03,434584,Nie; Jiawang,35,0,35,0
1708254195662,MATH 171B,A04,434609,Nie; Jiawang,35,0,35,0
1708254196189,MATH 180A,A01,434638,Gartland; Christopher John,29,0,30,1
1708254196189,MATH 180A,A02,434821,Gartland; Christopher John,28,0,30,2
1708254196189,MATH 180A,A03,434833,Gartland; Christopher John,24,0,30,6
1708254196189,MATH 180A,A04,434839,Gartland; Christopher John,30,0,30,0
1708254196189,MATH 180A,A05,434843,Gartland; Christopher John,30,0,30,0
1708254196189,MATH 180A,A06,434895,Gartland; Christopher John,30,0,30,0
1708254196721,MATH 180B,A01,435085,Gartland; Christopher John,30,0,35,5
1708254196721,MATH 180B,A02,435086,Gartland; Christopher John,35,0,35,0
1708254196721,MATH 180B,A03,435087,Gartland; Christopher John,34,0,35,1
1708254196721,MATH 180B,A04,435088,Gartland; Christopher John,35,0,35,0
1708254197248,MATH 180C,A01,435090,Carfagnini; Marco,29,0,35,6
1708254197248,MATH 180C,A02,435091,Carfagnini; Marco,35,0,35,0
1708254197248,MATH 180C,A03,435092,Carfagnini; Marco,32,0,35,3
1708254197248,MATH 180C,A04,435113,Carfagnini; Marco,35,0,35,0
1708254197783,MATH 181A,A01,435279,Zhang; Danna,30,0,35,5
1708254197783,MATH 181A,A02,435300,Zhang; Danna,35,0,35,0
1708254197783,MATH 181A,A03,435301,Zhang; Danna,21,0,35,14
1708254197783,MATH 181A,A04,435302,Zhang; Danna,31,0,35,4
1708254198309,MATH 181B,A01,435315,Rava; Denise,33,0,35,2
1708254198309,MATH 181B,A02,435316,Rava; Denise,32,0,35,3
1708254198309,MATH 181B,A03,435317,Rava; Denise,33,0,35,2
1708254198309,MATH 181B,A04,435318,Rava; Denise,35,0,35,0
1708254198838,MATH 183,A01,435320,Quarfoot; David James,26,0,35,9
1708254198838,MATH 183,A02,435321,Quarfoot; David James,35,0,35,0
1708254198838,MATH 183,A03,435322,Quarfoot; David James,32,0,35,3
1708254198838,MATH 183,A04,435323,Quarfoot; David James,34,0,35,1
1708254198838,MATH 183,A05,435327,Quarfoot; David James,34,0,35,1
1708254198838,MATH 183,A06,435329,Quarfoot; David James,33,0,35,2
1708254199373,MATH 184,A01,435337,Verstraete; Jacques Allan,32,0,35,3
1708254199373,MATH 184,A02,435338,Verstraete; Jacques Allan,35,0,35,0
1708254199373,MATH 184,A03,435339,Verstraete; Jacques Allan,34,0,35,1
1708254199373,MATH 184,A04,435347,Verstraete; Jacques Allan,30,0,35,5
1708254199899,MATH 185,A01,435432,Arias-Castro; Ery,15,0,30,15
1708254199899,MATH 185,A02,435436,Arias-Castro; Ery,30,0,30,0
1708254199899,MATH 185,A03,435437,Arias-Castro; Ery,30,0,30,0
1708254199899,MATH 185,A04,435438,Arias-Castro; Ery,30,0,30,0
1708254200434,MATH 187A,A01,435443,Agrawal; Shishir,15,0,30,15
1708254200434,MATH 187A,A02,435444,Agrawal; Shishir,30,0,30,0
1708254200434,MATH 187A,A03,435503,Agrawal; Shishir,28,0,30,2
1708254200434,MATH 187A,A04,435507,Agrawal; Shishir,30,0,30,0
1708254200434,MATH 187A,A05,435554,Agrawal; Shishir,22,0,30,8
1708254200434,MATH 187A,A06,435558,Agrawal; Shishir,28,0,30,2
1708254200969,MATH 187B,A01,435570,Bucur; Alina Ioana,24,0,35,11
1708254200969,MATH 187B,A02,435571,Bucur; Alina Ioana,35,0,35,0
1708254201496,MATH 188,A01,435573,Kunnawalkam Elayavalli; Sr,35,0,35,0
1708254202024,MATH 189,A01,435577,Vishwanath; Siddharth,0,0,10,10
1708254202024,MATH 189,A02,435594,Vishwanath; Siddharth,0,0,10,10
1708254202024,MATH 189,A03,435595,Vishwanath; Siddharth,0,0,10,10
1708254202024,MATH 189,A04,435596,Vishwanath; Siddharth,0,0,10,10
1708254202024,MATH 189,A05,480706,Vishwanath; Siddharth,2,0,10,8
1708254202024,MATH 189,A06,481362,Vishwanath; Siddharth,6,0,10,4
1708254202555,MATH 200C,A00,430388,Bucur; Alina Ioana,15,0,15,0
1708254203087,MATH 202C,A00,430389,Rhoades; Brendon Patrick,15,0,15,0
1708254203615,MATH 203C,A00,430390,Izadi; Elham,15,0,15,0
1708254204141,MATH 204C,A00,430391,Sorensen; Claus M,15,0,15,0
1708254204666,MATH 208,A00,430392,Izadi; Elham,8,0,10,2
1708254205194,MATH 209,A00,430393,Pollack; Aaron,10,0,10,0
1708254205721,MATH 211A,A00,430394,Salehi Golsefidy; Alireza,10,0,10,0
1708254206246,MATH 211B,A00,430395,Seward; Brandon M.,10,0,10,0
1708254206777,MATH 212B,A01,480692,Komarova; Natalia,5,0,5,0
1708254207302,MATH 216C,A00,430429,Saab; Rayan,13,0,15,2
1708254207830,MATH 217,A00,430430,Li; Bo,13,0,15,2
1708254208356,MATH 218,A00,430431,Li; Bo,8,0,10,2
1708254208885,MATH 220C,A00,430432,Xiao; Ming,15,0,15,0
1708254209412,MATH 240C,A00,430433,Ebenfelt; Peter F,14,0,15,1
1708254209939,MATH 241B,A00,430434,Ioana; Adrian,14,0,15,1
1708254210468,MATH 243,A00,430435,Kunnawalkam Elayavalli; Sr,9,0,10,1
1708254210993,MATH 248,A00,430436,Bejenaru; Ioan,9,0,10,1
1708254211524,MATH 251C,A00,430437,Wenzl; Hans G,15,0,15,0
1708254212053,MATH 258,A00,430438,Spolaor; Luca,10,0,10,0
1708254212580,MATH 261C,A00,430439,Manners; Frederick,14,0,15,1
1708254213109,MATH 262A,A00,430440,Warnke; Lutz Peter,14,0,15,1
1708254213636,MATH 268,A00,430441,Buss; Samuel R,10,0,10,0
1708254214162,MATH 269,A00,430442,Rhoades; Brendon Patrick & Warnke; Lutz Peter,10,0,10,0
1708254214687,MATH 270C,A00,430445,Cheng; Li-Tien,15,0,15,0
1708254215216,MATH 273B,A00,430452,Zhu; Yuhua,15,0,15,0
1708254215742,MATH 276,A00,430458,Mc Culloch; Andrew Douglas & Amaro; Rommie E,0,0,0,0
1708254216272,MATH 277A,A00,430464,Dumitriu; Ioana,14,0,15,1
1708254216800,MATH 278A,A00,430470,Cheng; Li-Tien,9,0,10,1
1708254217326,MATH 278B,A00,430471,Cloninger; Alexander,10,0,10,0
1708254217855,MATH 278C,A00,430472,Nie; Jiawang,9,0,10,1
1708254218381,MATH 280C,A00,430485,Schweinsberg; Jason,13,0,15,2
1708254218907,MATH 281C,A00,430496,Arias-Castro; Ery,8,0,15,7
1708254219432,MATH 284,A00,430503,Xu; Ronghui,11,0,15,4
1708254219962,MATH 287C,A00,430520,Zhang; Danna,14,0,15,1
1708254220490,MATH 288,A00,430527,Carfagnini; Marco,9,0,10,1
1708254221017,MATH 289A,A00,430541,Novak; Jonathan I,14,0,15,1
1708254221543,MATH 290C,A00,430548,Roberts; Justin Deritter,13,0,15,2
1708254222068,MATH 292,A00,430660,Lu; Yunze,10,0,10,0
1708254222594,MATH 294,A00,430678,Fitzsimmons; Patrick J,11,0,15,4
1708254223123,MATH 295,A00,430692,Bejenaru; Ioan,15,0,15,0
1708254223649,MATH 297,001,430721,Gamst; Anthony Collins,0,0,0,0
1708254224177,MATS 200,A00,414457,Graeve; Olivia A,9995,0,9999,4
1708254224705,MATS 201C,A00,414465,Arzt; Eduard,38,0,50,12
1708254225229,MATS 236,A00,414466,Staff,17,0,20,3
1708254225756,MATS 252,A00,414467,Evdokimenko; Ekaterina,42,0,45,3
1708254226282,MATS 261B,A00,414468,Qiao; Yu,17,0,25,8
1708254226810,MATS 295,A00,414469,Graeve; Olivia A,9999,0,9999,0
1708254226810,MATS 295,B00,478858,Kummel; Andrew C,9999,0,9999,0
1708254227347,MCWP 40,001,414476,Montejo; Carolina,19,0,20,1
1708254227347,MCWP 40,004,414480,Wastal; Carrie King,13,0,15,2
1708254227347,MCWP 40,005,414481,Wastal; Carrie King,10,0,15,5
1708254227347,MCWP 40,006,414482,Wastal; Carrie King,12,0,15,3
1708254227347,MCWP 40,007,414483,Wastal; Carrie King,13,0,15,2
1708254227347,MCWP 40,008,414484,Wastal; Carrie King,15,0,15,0
1708254227347,MCWP 40,009,414487,Wastal; Carrie King,12,0,15,3
1708254227347,MCWP 40,014,414505,Staff,20,0,20,0
1708254227347,MCWP 40,015,494362,Wastal; Carrie King,14,0,15,1
1708254227881,MCWP 50,002,414534,Bartulis; Jason Michael,20,0,20,0
1708254227881,MCWP 50,003,414536,Bartulis; Jason Michael,20,0,20,0
1708254227881,MCWP 50,004,414538,Krone; Jarret,16,0,20,4
1708254227881,MCWP 50,005,414539,Krone; Jarret,19,0,20,1
1708254227881,MCWP 50,006,414540,Smith; Haydee Marie,16,0,20,4
1708254227881,MCWP 50,007,414544,Compas; Sean Matthew,14,0,20,6
1708254227881,MCWP 50,008,414549,Redela; Pamela Morgan,20,0,20,0
1708254227881,MCWP 50,011,414557,Carter; Andrea L,16,0,20,4
1708254227881,MCWP 50,012,414592,Silva; Kelly B,20,0,20,0
1708254227881,MCWP 50,013,414593,Silva; Kelly B,19,0,20,1
1708254227881,MCWP 50,014,414594,Carter; Andrea L,20,0,20,0
1708254227881,MCWP 50,016,414596,Morshed; Michael James,14,0,20,6
1708254227881,MCWP 50,017,414598,Morshed; Michael James,17,0,20,3
1708254227881,MCWP 50,019,414601,Redela; Pamela Morgan,17,0,20,3
1708254227881,MCWP 50,020,414606,Carter; Jennifer A,20,0,20,0
1708254227881,MCWP 50,021,414607,Carter; Jennifer A,19,0,20,1
1708254227881,MCWP 50,022,414649,Compas; Sean Matthew,11,0,20,9
1708254227881,MCWP 50,023,414650,Smith; Haydee Marie,20,0,20,0
1708254227881,MCWP 50,024,414651,Nies; Laurie Elizabeth,19,0,20,1
1708254227881,MCWP 50,025,414655,Nies; Laurie Elizabeth,18,0,20,2
1708254227881,MCWP 50,026,414656,Pham; Vincent Minhduc,19,0,20,1
1708254227881,MCWP 50,027,414657,Pham; Vincent Minhduc,20,0,20,0
1708254227881,MCWP 50,028,414668,Morshed; Michael James,16,0,20,4
1708254227881,MCWP 50,029,414669,Morshed; Michael James,19,0,20,1
1708254228411,MCWP 50R,A00,486838,Miller; Elizabeth Deen,19,0,20,1
1708254228411,MCWP 50R,B00,486843,Miller; Elizabeth Deen,16,0,20,4
1708254228411,MCWP 50R,C00,486844,Miller; Elizabeth Deen,19,0,20,1
1708254228949,MCWP 125,A00,414670,Wilson; Marion E.,20,0,20,0
1708254228949,MCWP 125,B00,414674,Guillen; Melinda,20,0,20,0
1708254228949,MCWP 125,C00,414678,Guillen; Melinda,20,0,20,0
1708254228949,MCWP 125,D00,414682,Guillen; Melinda,20,0,20,0
1708254229476,MED 231,A00,476440,Hurst; Samantha,7,0,7,0
1708254230016,MED 246,A00,492785,Gordts; Philip & Varki; Ajit P & Lewis; Amanda Lark & Godula; Kamil & Gagneux; Pascal & Esko; Jeffrey D. & Bode; Lars,10,0,10,0
1708254230545,MED 262,A00,492942,Koola; Jejo David,28,0,30,2
1708254231071,MED 267,A01,492789,Hogarth; Michael Andrew,25,0,30,5
1708254231603,MED 275,A00,464684,Liu; George Yenhsi,10,0,10,0
1708254232129,MED 276,A00,492786,Sitapati; Amy,23,0,25,2
1708254232656,MED 278,A00,492787,Carter; Hannah Kathryn & Mesirov; Jill P. & Curtius; Kathleen Mary,20,0,20,0
1708254233186,MED 296,001,464685,Chi; Neil C.,48,0,50,2
1708254233186,MED 296,002,464686,Hong; Kimberly N,49,0,50,1
1708254233186,MED 296,003,464687,Staff,50,0,50,0
1708254233715,MGT 3,A00,442429,Wagner; Timothy Ryan,95,0,98,3
1708254234295,MGT 4,A01,442443,Levkoff; Steven B.,0,0,5,5
1708254234295,MGT 4,A02,442444,Levkoff; Steven B.,4,0,5,1
1708254234827,MGT 5,A00,442446,Molloie Jr.; William H,184,0,196,12
1708254235355,MGT 12,A00,442447,Lindenberger; Wade Douglas,83,0,100,17
1708254235355,MGT 12,B00,442448,Lindenberger; Wade Douglas,71,0,100,29
1708254235355,MGT 12,C00,442449,Pecore; Joseph P.,88,0,100,12
1708254235881,MGT 16,A00,442452,Buchanan; Harold G,97,0,100,3
1708254235881,MGT 16,B00,442459,Buchanan; Harold G,92,0,100,8
1708254235881,MGT 16,C00,442461,Campbell; Robert Harold,113,0,120,7
1708254235881,MGT 16,D00,442475,Campbell; Robert Harold,118,0,120,2
1708254236414,MGT 18,A00,442477,McKay; Michael J,98,0,98,0
1708254236414,MGT 18,B00,442491,McKay; Michael J,96,0,98,2
1708254236414,MGT 18,C00,442493,McKay; Michael J,98,0,98,0
1708254236414,MGT 18,D00,442503,Chamberlain; Travis Dean,98,0,98,0
1708254236940,MGT 45,A00,442508,Pecore; Joseph P.,146,0,150,4
1708254236940,MGT 45,B00,442510,Pecore; Joseph P.,142,0,150,8
1708254237467,MGT 71,A00,442524,Lee; Hyun Seok,77,0,98,21
1708254237997,MGT 71R,A00,442526,Phiroz; Zal Navroze,77,0,98,21
1708254238525,MGT 100,A00,442541,Wilbur; Kenneth C,82,0,98,16
1708254238525,MGT 100,B00,442542,Wilbur; Kenneth C,89,0,98,9
1708254239061,MGT 103,A00,442543,Eberhard; Craig A,98,0,98,0
1708254239061,MGT 103,B00,442544,Eberhard; Craig A,95,0,98,3
1708254239061,MGT 103,C00,442545,Ehrich; Kristine R,90,0,98,8
1708254239061,MGT 103,D00,442547,Ehrich; Kristine R,96,0,98,2
1708254239061,MGT 103,E00,442548,Ehrich; Kristine R,97,0,98,1
1708254239061,MGT 103,F00,442549,Demill; Burritt,92,0,98,6
1708254239061,MGT 103,G00,442550,Bates; Kenneth Walter,97,0,98,1
1708254239588,MGT 105,A00,442558,Bates; Kenneth Walter,86,0,98,12
1708254240113,MGT 106,A00,442560,Eberhard; Craig A,95,0,98,3
1708254240645,MGT 109,A00,442574,Campbell; Colin Leslie,90,0,98,8
1708254241175,MGT 112,A00,442576,Somasundaram; Tyagarajan,96,0,98,2
1708254241175,MGT 112,B00,442590,Somasundaram; Tyagarajan,94,0,98,4
1708254241175,MGT 112,C00,442592,Zimmermann; Carsten,87,0,98,11
1708254241702,MGT 119,A00,442602,Staff,97,0,98,1
1708254241702,MGT 119,B00,442603,Anderson; Jon Marcus,96,0,98,2
1708254242228,MGT 121B,A00,442606,Klaas; Jeffrey David,94,0,98,4
1708254242757,MGT 128R,A00,442607,Krishnan; Viswanathan,84,0,98,14
1708254243284,MGT 131A,A00,442608,Houskeeper; Robert,148,0,150,2
1708254243814,MGT 131B,A00,442609,Houskeeper; Robert,100,0,100,0
1708254244341,MGT 132,A00,442610,Blakley; Bruce,97,0,98,1
1708254244867,MGT 137,A00,442611,Lindenberger; Wade Douglas,85,0,98,13
1708254245397,MGT 147,A00,442612,Anderson; John Charles,31,0,40,9
1708254245923,MGT 151R,A00,442613,Phiroz; Zal Navroze,92,0,98,6
1708254246448,MGT 153,A00,442650,Perols; Johan Lars,55,0,80,25
1708254246979,MGT 162,A00,442652,Demill; Burritt,81,0,98,17
1708254246979,MGT 162,B00,442654,Demill; Burritt,88,0,98,10
1708254246979,MGT 162,C00,442776,Staff,95,0,98,3
1708254246979,MGT 162,D00,442778,Staff,96,0,98,2
1708254247508,MGT 164,A00,442780,McKay; Mary A,97,0,98,1
1708254247508,MGT 164,B00,442849,McKay; Mary A,96,0,98,2
1708254247508,MGT 164,C00,442917,McKay; Mary A,97,0,98,1
1708254247508,MGT 164,D00,442949,Meyer; Alison Bloomfield,90,0,98,8
1708254248040,MGT 166,A00,443017,Moran; Cathleen L.,95,0,98,3
1708254248040,MGT 166,B00,443045,Moran; Cathleen L.,97,0,98,1
1708254248040,MGT 166,C00,443046,Moran; Cathleen L.,98,0,98,0
1708254248567,MGT 167,A00,443047,Klaas; Jeffrey David,93,0,98,5
1708254249092,MGT 171R,A00,443048,Phiroz; Zal Navroze,86,0,98,12
1708254249626,MGT 172,A00,443049,Hedges; Kathleen & Royal; Rebecca,116,0,120,4
1708254249626,MGT 172,B00,443050,Hedges; Kathleen,95,0,98,3
1708254249626,MGT 172,C00,443051,Zimmermann; Carsten,96,0,98,2
1708254250153,MGT 173,A00,443052,Hayes; Sherry Lorine,92,0,100,8
1708254250684,MGT 175,A00,443053,Gopal; Christopher S.,98,0,98,0
1708254251210,MGT 180,A00,443055,Bliss; Barbara Ann,139,0,150,11
1708254251210,MGT 180,B00,443069,Bliss; Barbara Ann,145,0,150,5
1708254251742,MGT 181,A00,443120,Buchanan; Harold G,147,0,150,3
1708254252267,MGT 183,A00,443121,Banerjee; Snehal,88,0,98,10
1708254252796,MGT 185,A00,443122,Dunn; Louis Jean,90,0,98,8
1708254253322,MGT 187,A00,443133,Dunn; Louis Jean,95,0,100,5
1708254253853,MGT 189,A00,443134,Avenancio-Leon; Carlos,98,0,98,0
1708254254378,MGT 227,A00,479242,Serra Garcia; Marta,19,0,20,1
1708254254905,MGT 259,A00,443135,Oveis; Christopher S,19,0,20,1
1708254255442,MGT 296,001,481416,Gneezy; Ayelet,3,0,3,0
1708254255442,MGT 296,002,481420,Amir; On,3,0,3,0
1708254255442,MGT 296,003,481466,Amir; On & Karmarkar; Uma R,3,0,3,0
1708254255442,MGT 296,004,481468,Liu; Jun,3,0,3,0
1708254255442,MGT 296,005,481469,Misra; Kanishka,3,0,3,0
1708254255442,MGT 296,006,481470,Erat; Sanjiv,3,0,3,0
1708254255442,MGT 296,007,481473,Timmermann; Allan,3,0,3,0
1708254255442,MGT 296,008,481474,Smith; Pamela Karen,3,0,3,0
1708254255442,MGT 296,009,481477,Zhang; Zhe,3,0,3,0
1708254255442,MGT 296,010,481478,Oveis; Christopher S,3,0,3,0
1708254255442,MGT 296,011,481479,Amir; On & Gneezy; Ayelet,3,0,3,0
1708254255442,MGT 296,012,481481,Wilbur; Kenneth C,3,0,3,0
1708254255982,MMW 13,A01,412918,Chang; Edmond Yi-Teh,15,0,16,1
1708254255982,MMW 13,A02,412928,Chang; Edmond Yi-Teh,16,0,16,0
1708254255982,MMW 13,A03,413017,Chang; Edmond Yi-Teh,16,0,16,0
1708254255982,MMW 13,A04,413018,Chang; Edmond Yi-Teh,16,0,16,0
1708254255982,MMW 13,A05,413019,Chang; Edmond Yi-Teh,15,0,16,1
1708254255982,MMW 13,A06,413020,Chang; Edmond Yi-Teh,16,0,16,0
1708254255982,MMW 13,A07,413021,Chang; Edmond Yi-Teh,15,0,16,1
1708254255982,MMW 13,A08,413023,Chang; Edmond Yi-Teh,16,0,16,0
1708254255982,MMW 13,A09,413024,Chang; Edmond Yi-Teh,16,0,16,0
1708254255982,MMW 13,A10,413025,Chang; Edmond Yi-Teh,16,0,16,0
1708254255982,MMW 13,A11,413026,Chang; Edmond Yi-Teh,16,0,16,0
1708254255982,MMW 13,A12,413027,Chang; Edmond Yi-Teh,16,0,16,0
1708254255982,MMW 13,A13,413028,Chang; Edmond Yi-Teh,0,0,0,0
1708254255982,MMW 13,A14,413029,Chang; Edmond Yi-Teh,0,0,0,0
1708254255982,MMW 13,A15,413030,Chang; Edmond Yi-Teh,14,0,16,2
1708254255982,MMW 13,A16,413031,Chang; Edmond Yi-Teh,15,0,16,1
1708254255982,MMW 13,A17,413032,Chang; Edmond Yi-Teh,16,0,16,0
1708254255982,MMW 13,A18,413034,Chang; Edmond Yi-Teh,14,0,16,2
1708254255982,MMW 13,A19,413035,Chang; Edmond Yi-Teh,16,0,16,0
1708254255982,MMW 13,A20,413036,Chang; Edmond Yi-Teh,16,0,16,0
1708254255982,MMW 13,A21,413037,Chang; Edmond Yi-Teh,0,0,0,0
1708254255982,MMW 13,A22,413038,Chang; Edmond Yi-Teh,0,0,0,0
1708254255982,MMW 13,B01,413290,Zhiri; Oumelbanine,15,0,16,1
1708254255982,MMW 13,B02,413291,Zhiri; Oumelbanine,15,0,16,1
1708254255982,MMW 13,B03,413308,Zhiri; Oumelbanine,14,0,16,2
1708254255982,MMW 13,B04,413322,Zhiri; Oumelbanine,14,0,16,2
1708254255982,MMW 13,B05,413343,Zhiri; Oumelbanine,12,0,16,4
1708254255982,MMW 13,B06,413344,Zhiri; Oumelbanine,14,0,16,2
1708254255982,MMW 13,B07,413524,Zhiri; Oumelbanine,16,0,16,0
1708254255982,MMW 13,B08,413584,Zhiri; Oumelbanine,16,0,16,0
1708254255982,MMW 13,B09,413588,Zhiri; Oumelbanine,15,0,16,1
1708254255982,MMW 13,B10,413590,Zhiri; Oumelbanine,16,0,16,0
1708254255982,MMW 13,B11,413779,Zhiri; Oumelbanine,12,0,16,4
1708254255982,MMW 13,B12,413780,Zhiri; Oumelbanine,9,0,16,7
1708254255982,MMW 13,B13,413781,Zhiri; Oumelbanine,0,0,0,0
1708254255982,MMW 13,B14,413782,Zhiri; Oumelbanine,0,0,0,0
1708254255982,MMW 13,B15,413808,Zhiri; Oumelbanine,16,0,16,0
1708254255982,MMW 13,B16,413815,Zhiri; Oumelbanine,15,0,16,1
1708254255982,MMW 13,B17,413816,Zhiri; Oumelbanine,15,0,16,1
1708254255982,MMW 13,B18,413817,Zhiri; Oumelbanine,12,0,16,4
1708254255982,MMW 13,B19,413822,Zhiri; Oumelbanine,16,0,16,0
1708254255982,MMW 13,B20,413823,Zhiri; Oumelbanine,14,0,16,2
1708254255982,MMW 13,B21,413825,Zhiri; Oumelbanine,0,0,0,0
1708254255982,MMW 13,B22,413826,Zhiri; Oumelbanine,0,0,0,0
1708254255982,MMW 13,B23,413827,Zhiri; Oumelbanine,16,0,16,0
1708254255982,MMW 13,B24,413834,Zhiri; Oumelbanine,15,0,16,1
1708254255982,MMW 13,C01,413859,Vitkus; Daniel J.,16,0,16,0
1708254255982,MMW 13,C02,413860,Vitkus; Daniel J.,16,0,16,0
1708254255982,MMW 13,C04,413868,Vitkus; Daniel J.,0,0,0,0
1708254255982,MMW 13,C05,413869,Vitkus; Daniel J.,16,0,16,0
1708254255982,MMW 13,C06,413871,Vitkus; Daniel J.,16,0,16,0
1708254255982,MMW 13,C07,413886,Vitkus; Daniel J.,16,0,16,0
1708254255982,MMW 13,C08,413908,Vitkus; Daniel J.,16,0,16,0
1708254255982,MMW 13,C09,413930,Vitkus; Daniel J.,16,0,16,0
1708254255982,MMW 13,C10,413952,Vitkus; Daniel J.,15,0,16,1
1708254255982,MMW 13,C11,413972,Vitkus; Daniel J.,16,0,16,0
1708254255982,MMW 13,C12,413991,Vitkus; Daniel J.,16,0,16,0
1708254255982,MMW 13,C13,414007,Vitkus; Daniel J.,0,0,0,0
1708254255982,MMW 13,C14,414017,Vitkus; Daniel J.,0,0,0,0
1708254255982,MMW 13,C15,414030,Vitkus; Daniel J.,16,0,16,0
1708254255982,MMW 13,C16,414032,Vitkus; Daniel J.,16,0,16,0
1708254255982,MMW 13,C17,414033,Vitkus; Daniel J.,15,0,16,1
1708254255982,MMW 13,C18,414034,Vitkus; Daniel J.,16,0,16,0
1708254255982,MMW 13,C19,414041,Vitkus; Daniel J.,16,0,16,0
1708254255982,MMW 13,C20,414056,Vitkus; Daniel J.,16,0,16,0
1708254255982,MMW 13,C21,414057,Vitkus; Daniel J.,15,0,16,1
1708254255982,MMW 13,C22,414059,Vitkus; Daniel J.,16,0,16,0
1708254256512,MMW 15,A01,414065,Chang; Edmond Yi-Teh,28,0,28,0
1708254256512,MMW 15,A02,414067,Chang; Edmond Yi-Teh,27,0,28,1
1708254256512,MMW 15,A03,414092,Chang; Edmond Yi-Teh,26,0,28,2
1708254256512,MMW 15,A04,414104,Chang; Edmond Yi-Teh,28,0,28,0
1708254256512,MMW 15,A05,414121,Chang; Edmond Yi-Teh,0,0,0,0
1708254256512,MMW 15,A06,414122,Chang; Edmond Yi-Teh,0,0,0,0
1708254256512,MMW 15,A07,414123,Chang; Edmond Yi-Teh,27,0,28,1
1708254256512,MMW 15,A08,414124,Chang; Edmond Yi-Teh,28,0,28,0
1708254256512,MMW 15,A09,414125,Chang; Edmond Yi-Teh,0,0,0,0
1708254256512,MMW 15,A10,414130,Chang; Edmond Yi-Teh,0,0,0,0
1708254256512,MMW 15,B01,414132,Radcliff; Pamela B.,27,0,28,1
1708254256512,MMW 15,B02,414134,Radcliff; Pamela B.,27,0,28,1
1708254256512,MMW 15,B03,414135,Radcliff; Pamela B.,26,0,28,2
1708254256512,MMW 15,B04,414136,Radcliff; Pamela B.,27,0,28,1
1708254256512,MMW 15,B05,414137,Radcliff; Pamela B.,28,0,28,0
1708254256512,MMW 15,B06,414138,Radcliff; Pamela B.,27,0,28,1
1708254256512,MMW 15,B07,414140,Radcliff; Pamela B.,26,0,28,2
1708254256512,MMW 15,B08,414141,Radcliff; Pamela B.,28,0,28,0
1708254256512,MMW 15,C01,414143,Prestholdt; Jeremy,0,0,0,0
1708254256512,MMW 15,C02,414144,Prestholdt; Jeremy,0,0,0,0
1708254256512,MMW 15,C03,414145,Prestholdt; Jeremy,24,0,28,4
1708254256512,MMW 15,C04,414147,Prestholdt; Jeremy,17,0,28,11
1708254256512,MMW 15,C05,414148,Prestholdt; Jeremy,28,0,28,0
1708254256512,MMW 15,C06,414149,Prestholdt; Jeremy,26,0,28,2
1708254256512,MMW 15,C07,414152,Prestholdt; Jeremy,25,0,28,3
1708254256512,MMW 15,C08,414153,Prestholdt; Jeremy,23,0,28,5
1708254257042,MSED 295,A00,477850,Rabin; Jeffrey Mark,5,0,5,0
1708254257042,MSED 295,B00,477852,Lo; Stanley M.,5,0,5,0
1708254257569,MSED 296C,A00,477853,Staff,14,0,15,1
1708254258097,MUS 1C,A01,416488,Ishov; Alexander Alexandrovich,24,0,25,1
1708254258097,MUS 1C,A02,416502,Ishov; Alexander Alexandrovich,25,0,25,0
1708254258097,MUS 1C,A03,416519,Ishov; Alexander Alexandrovich,25,0,25,0
1708254258097,MUS 1C,A04,416520,Ishov; Alexander Alexandrovich,25,0,25,0
1708254258097,MUS 1C,A05,416521,Ishov; Alexander Alexandrovich,25,0,25,0
1708254258624,MUS 2C,A01,416523,Richards; Stephanie F,30,0,30,0
1708254259155,MUS 2CK,A00,416524,Ohnishi; Takae,15,0,15,0
1708254259155,MUS 2CK,B00,416547,Ohnishi; Takae,15,0,15,0
1708254259681,MUS 2JK,A00,416548,Kenyatta; Kamau,15,0,15,0
1708254260214,MUS 4,A01,416562,Staff,25,0,25,0
1708254260214,MUS 4,A02,416634,Staff,24,0,25,1
1708254260214,MUS 4,A03,416644,Staff,25,0,25,0
1708254260214,MUS 4,A04,416659,Staff,24,0,25,1
1708254260214,MUS 4,A05,416667,Staff,25,0,25,0
1708254260214,MUS 4,A06,416757,Staff,25,0,25,0
1708254260214,MUS 4,A07,416830,Staff,25,0,25,0
1708254260214,MUS 4,A08,416953,Staff,23,0,25,2
1708254260214,MUS 4,A09,417005,Staff,25,0,25,0
1708254260214,MUS 4,A10,417007,Staff,24,0,25,1
1708254260741,MUS 7,A01,417048,Staff,23,0,24,1
1708254260741,MUS 7,A02,417102,Staff,23,0,24,1
1708254260741,MUS 7,A03,417103,Staff,23,0,24,1
1708254260741,MUS 7,A04,417114,Staff,22,0,24,2
1708254261268,MUS 8,A01,417119,Staff,14,0,20,6
1708254261268,MUS 8,A02,417163,Staff,16,0,20,4
1708254261268,MUS 8,A03,417164,Staff,16,0,20,4
1708254261268,MUS 8,A04,417165,Staff,17,0,20,3
1708254261268,MUS 8,A05,417194,Staff,18,0,20,2
1708254261268,MUS 8,A06,417198,Staff,20,0,20,0
1708254261800,MUS 11,A01,417201,Terrazas Perez; Wilfrido D,21,0,25,4
1708254261800,MUS 11,A02,417219,Terrazas Perez; Wilfrido D,23,0,25,2
1708254261800,MUS 11,A03,417220,Terrazas Perez; Wilfrido D,25,0,25,0
1708254261800,MUS 11,A04,417222,Terrazas Perez; Wilfrido D,25,0,25,0
1708254261800,MUS 11,A05,417223,Terrazas Perez; Wilfrido D,24,0,25,1
1708254261800,MUS 11,A06,417295,Terrazas Perez; Wilfrido D,23,0,25,2
1708254261800,MUS 11,A07,417297,Terrazas Perez; Wilfrido D,24,0,25,1
1708254261800,MUS 11,A08,417298,Terrazas Perez; Wilfrido D,25,0,25,0
1708254262326,MUS 12,A01,417300,Guy; Nancy,25,0,25,0
1708254262326,MUS 12,A02,417301,Guy; Nancy,25,0,25,0
1708254262326,MUS 12,A03,417302,Guy; Nancy,25,0,25,0
1708254262326,MUS 12,A04,417303,Guy; Nancy,25,0,25,0
1708254262852,MUS 13,A01,417305,Leslie Santana; Myrta,25,0,25,0
1708254262852,MUS 13,A02,417306,Leslie Santana; Myrta,25,0,25,0
1708254262852,MUS 13,A03,417307,Leslie Santana; Myrta,25,0,25,0
1708254262852,MUS 13,A04,417308,Leslie Santana; Myrta,25,0,25,0
1708254263379,MUS 15,A01,417327,Schaffer; Max Benjamin,18,0,20,2
1708254263379,MUS 15,A02,417331,Schaffer; Max Benjamin,19,0,20,1
1708254263379,MUS 15,A03,417358,Schaffer; Max Benjamin,19,0,20,1
1708254263379,MUS 15,A04,417359,Schaffer; Max Benjamin,17,0,20,3
1708254263379,MUS 15,A05,417360,Schaffer; Max Benjamin,20,0,20,0
1708254263379,MUS 15,A06,417370,Schaffer; Max Benjamin,20,0,20,0
1708254263379,MUS 15,A07,417371,Schaffer; Max Benjamin,17,0,20,3
1708254263379,MUS 15,A08,417372,Schaffer; Max Benjamin,18,0,20,2
1708254263379,MUS 15,A09,417378,Schaffer; Max Benjamin,19,0,20,1
1708254263379,MUS 15,A10,417379,Schaffer; Max Benjamin,19,0,20,1
1708254263911,MUS 17,A01,417381,Staff,22,0,25,3
1708254263911,MUS 17,A02,417406,Staff,24,0,25,1
1708254263911,MUS 17,A03,417420,Staff,24,0,25,1
1708254263911,MUS 17,A04,417594,Staff,24,0,25,1
1708254263911,MUS 17,A05,417595,Staff,25,0,25,0
1708254263911,MUS 17,A06,417605,Staff,21,0,25,4
1708254263911,MUS 17,A07,417606,Staff,25,0,25,0
1708254263911,MUS 17,A08,417627,Staff,25,0,25,0
1708254263911,MUS 17,A09,417628,Staff,21,0,25,4
1708254263911,MUS 17,A10,417629,Staff,24,0,25,1
1708254263911,MUS 17,A11,417630,Staff,25,0,25,0
1708254263911,MUS 17,A12,417631,Staff,24,0,25,1
1708254263911,MUS 17,A13,417632,Staff,25,0,25,0
1708254263911,MUS 17,A14,417633,Staff,25,0,25,0
1708254264440,MUS 32,001,418855,Dresser; Mark Stuart,10,0,10,0
1708254264440,MUS 32,002,418856,Kenyatta; Kamau,9,0,10,1
1708254264440,MUS 32,003,418864,Curtis; Charles Rector,10,0,10,0
1708254264440,MUS 32,004,418865,Carlstrom; Mitchell Kraig,9,0,10,1
1708254264440,MUS 32,005,418868,Terrazas Perez; Wilfrido D,10,0,10,0
1708254264440,MUS 32,006,418869,Ohnishi; Takae,10,0,10,0
1708254264440,MUS 32,007,418872,Burr; Anthony I,10,0,10,0
1708254264440,MUS 32,008,418873,Carlson; Erik Norman,10,0,10,0
1708254264440,MUS 32,009,418874,Blair; Kyle Adam,10,0,10,0
1708254264440,MUS 32,010,418875,Richards; Stephanie F,10,0,10,0
1708254264968,MUS 32V,A00,417634,Narucki; Susan M,10,0,10,0
1708254264968,MUS 32V,B00,417635,Staff,10,0,10,0
1708254265497,MUS 32VM,A00,417636,Staff,15,0,15,0
1708254266027,MUS 33C,A00,417637,Taylor; Alexander Lawther,20,0,20,0
1708254266553,MUS 43,A00,417647,Burr; Anthony I,83,0,90,7
1708254267079,MUS 95D,A00,417919,Staff,40,0,40,0
1708254267607,MUS 95E,A00,417933,Henson; Matthew Alexander,55,0,55,0
1708254268136,MUS 95G,A00,417935,Anderson; Kenneth,387,0,395,8
1708254268136,MUS 95G,B00,417937,Anderson; Kenneth,394,0,395,1
1708254268665,MUS 95JC,A00,417939,Kenyatta; Kamau,30,0,30,0
1708254269195,MUS 95L,A00,417940,Jones; Michael David,50,0,50,0
1708254269725,MUS 95W,A00,417946,Seshadri; Kartik,29,0,30,1
1708254269725,MUS 95W,B00,417948,Seshadri; Kartik,30,0,30,0
1708254270254,MUS 101C,A01,417951,Burr; Anthony I,33,0,35,2
1708254270781,MUS 103C,A00,417952,Davis; Anthony Curtis,14,0,15,1
1708254271312,MUS 103F,A00,417959,Obermueller; Karola,1,0,1,0
1708254271841,MUS 113,A00,418015,Narucki; Susan M,13,0,15,2
1708254272368,MUS 120C,A01,418032,Leslie Santana; Myrta,25,0,25,0
1708254272892,MUS 127,A00,418037,Richards; Stephanie F,92,0,100,8
1708254273421,MUS 130,A00,418047,Ohnishi; Takae,30,0,30,0
1708254273947,MUS 131,A00,418065,Roberts; Matana,30,0,30,0
1708254274474,MUS 132,001,418883,Dresser; Mark Stuart,10,0,10,0
1708254274474,MUS 132,002,418885,Kenyatta; Kamau,10,0,10,0
1708254274474,MUS 132,003,418886,Curtis; Charles Rector,10,0,10,0
1708254274474,MUS 132,004,418887,Carlstrom; Mitchell Kraig,10,0,10,0
1708254274474,MUS 132,005,418888,Jones; Michael David,10,0,10,0
1708254274474,MUS 132,006,418889,Terrazas Perez; Wilfrido D,10,0,10,0
1708254274474,MUS 132,007,418893,Ohnishi; Takae,10,0,10,0
1708254274474,MUS 132,008,418894,Burr; Anthony I,10,0,10,0
1708254274474,MUS 132,009,418896,Carlson; Erik Norman,10,0,10,0
1708254274474,MUS 132,010,418900,Blair; Kyle Adam,10,0,10,0
1708254274474,MUS 132,011,418932,Richards; Stephanie F,10,0,10,0
1708254274474,MUS 132,012,418933,Nourai; Keyarash,10,0,10,0
1708254275004,MUS 132R,A00,418067,Burr; Anthony I,5,0,5,0
1708254275004,MUS 132R,B00,418078,Jones; Michael David,5,0,5,0
1708254275529,MUS 132V,A00,418092,Narucki; Susan M,15,0,15,0
1708254275529,MUS 132V,B00,418096,Staff,15,0,15,0
1708254276059,MUS 134,A00,418098,Staff,40,0,40,0
1708254276586,MUS 137C,A00,418109,Kenyatta; Kamau,25,0,25,0
1708254277115,MUS 143,A00,418123,Burr; Anthony I,33,0,40,7
1708254277642,MUS 150,A00,418127,Davis; Anthony Curtis,28,0,30,2
1708254278171,MUS 151,A00,418129,Hankins; Sarah E.,20,0,30,10
1708254278697,MUS 160B,A00,418172,Staff,11,0,15,4
1708254278697,MUS 160B,B00,418175,Dubnov; Shlomo,14,0,15,1
1708254279222,MUS 172,A01,418178,Staff,36,0,40,4
1708254279748,MUS 174C,A00,418179,Erbe; Tom,24,0,27,3
1708254280275,MUS 175,A00,418247,Smyth; Tamara R.,28,0,30,2
1708254280804,MUS 177,A00,418265,Erbe; Tom,11,0,15,4
1708254281330,MUS 201A,A00,418267,Narucki; Susan M,15,0,15,0
1708254281330,MUS 201A,B00,418268,Dresser; Mark Stuart,13,0,15,2
1708254281862,MUS 203C,A00,418269,Lou; Michelle Siulai,15,0,15,0
1708254282390,MUS 203D,A00,418272,Davis; Anthony Curtis,4,0,5,1
1708254282390,MUS 203D,B00,418275,Obermueller; Karola,5,0,5,0
1708254282390,MUS 203D,C00,418277,Liang; Lei,5,0,5,0
1708254282390,MUS 203D,D00,418323,Lou; Michelle Siulai,5,0,5,0
1708254282918,MUS 204,A00,418324,Obermueller; Karola,24,0,25,1
1708254283444,MUS 205,A00,418325,Cimini; Amy Marie,22,0,25,3
1708254283970,MUS 206,A00,418326,Liang; Lei,13,0,15,2
1708254283970,MUS 206,B00,418327,Roberts; Matana,13,0,15,2
1708254284499,MUS 215C,A00,418328,Cimini; Amy Marie,14,0,15,1
1708254285025,MUS 232,001,418937,Dresser; Mark Stuart,9,0,10,1
1708254285025,MUS 232,002,418969,Kenyatta; Kamau,10,0,10,0
1708254285025,MUS 232,003,418971,Curtis; Charles Rector,10,0,10,0
1708254285025,MUS 232,004,418974,Terrazas Perez; Wilfrido D,10,0,10,0
1708254285025,MUS 232,005,418979,Ohnishi; Takae,10,0,10,0
1708254285025,MUS 232,006,418980,Burr; Anthony I,10,0,10,0
1708254285025,MUS 232,007,418981,Carlson; Erik Norman,10,0,10,0
1708254285025,MUS 232,008,418982,Richards; Stephanie F,10,0,10,0
1708254285025,MUS 232,009,418985,Narucki; Susan M,10,0,10,0
1708254285553,MUS 234,A00,418329,Staff,15,0,15,0
1708254286082,MUS 245,A00,418330,Carlson; Erik Norman,14,0,15,1
1708254286608,MUS 267,A00,418331,Erbe; Tom,15,0,15,0
1708254287136,MUS 270B,A00,418332,Staff,15,0,15,0
1708254287716,MUS 270D,A00,479231,Smyth; Tamara R.,15,0,15,0
1708254288247,NANO 103,A00,414714,Jahed Motlagh; Zeinab,40,0,40,0
1708254288775,NANO 108,A00,414740,Lubarda; Vlado,70,0,70,0
1708254289302,NANO 112,A01,414825,Vazquez Mena; Oscar,70,0,70,0
1708254289833,NANO 115L,A01,414830,Yang; Kesong,37,0,38,1
1708254289833,NANO 115L,B01,414832,Xu; Sheng,35,0,38,3
1708254290359,NANO 120B,A01,414835,Vecchio; Kenneth S,33,0,35,2
1708254290359,NANO 120B,B01,414841,Fenning; David,30,0,35,5
1708254290888,NANO 156,A00,414843,Fullerton; Eric E,24,0,30,6
1708254291414,NANO 158,A00,414844,Luo; Jian,29,0,30,1
1708254291946,NANO 175,A00,414850,Steinmetz; Nicole F,30,0,35,5
1708254292476,NANO 200,A00,414852,Jahed Motlagh; Zeinab,118,0,120,2
1708254293003,NANO 241,A00,414854,Pokorski; Jonathan Kyle,18,0,25,7
1708254293529,NANO 262,A00,414858,Wang; Joseph,50,0,50,0
1708254294059,NANO 271,A00,414862,Cubukcu; Ertugrul,22,0,25,3
1708254294585,NANO 272,A00,414877,Xu; Sheng,42,0,50,8
1708254295114,NANO 279,A00,414878,Liu; Ping,32,0,40,8
1708254295641,NANO 282,A00,414879,Steinmetz; Nicole F,30,0,30,0
1708254296170,NEU 200C,A00,455013,Staff,0,0,0,1
1708254296701,NEU 276,A01,479489,Staff,35,0,36,1
1708254297227,NEU 277,A00,479492,Risbrough; Victoria Blythe,0,0,0,0
1708254297757,NEU 296,001,464921,Evans; Sean Jeffrey,48,0,50,2
1708254297757,NEU 296,002,464922,Staff,50,0,50,0
1708254297757,NEU 296,003,464925,Staff,50,0,50,0
1708254298282,NEUG 221,A00,479490,Zheng; Binhai,15,0,15,0
1708254298813,NEUG 280,A00,479491,Chen; Xu,0,0,0,0
1708254299342,NEUG 296,A00,479493,Bloodgood; Brenda Laurie,9998,0,9999,1
1708254299869,OPTH 296,001,465054,Baxter; Sally Liu,49,0,50,1
1708254299869,OPTH 296,002,465068,Afshari; Natalie,49,0,50,1
1708254299869,OPTH 296,003,465074,Staff,50,0,50,0
1708254300393,ORTH 296,A00,465104,Staff,50,0,50,0
1708254300393,ORTH 296,001,465111,Staff,50,0,50,0
1708254300393,ORTH 296,002,465120,Staff,50,0,50,0
1708254300926,PATH 224,A01,494386,Ross; Camille,11,0,12,1
1708254301453,PATH 296,001,465373,Calcutt; Nigel A,49,0,50,1
1708254301453,PATH 296,002,465374,Staff,50,0,50,0
1708254301453,PATH 296,003,465375,Staff,50,0,50,0
1708254301979,PEDS 296,001,465527,Weiss; Katherine Jean,49,0,50,1
1708254301979,PEDS 296,002,465528,Staff,50,0,50,0
1708254301979,PEDS 296,003,465529,Staff,50,0,50,0
1708254302507,PH 196BH,A01,405158,Binkin; Nancy Jeanne,20,0,20,0
1708254303035,PHAR 219,A00,415016,Ross; Camille,1,0,1,0
1708254303563,PHAR 231,A00,415017,Furnari; Frank,20,0,20,0
1708254303563,PHAR 231,B00,415018,Lopez Ramirez; Miguel Alej,20,0,20,0
1708254304089,PHAR 276,A00,415020,Mc Culloch; Andrew Douglas & Amaro; Rommie E,1,0,1,0
1708254304621,PHAR 295,A00,415022,Brown; Joan Heller,15,0,15,0
1708254305148,PHIL 1,A00,415023,Harrell; Maralee Mae,58,0,60,2
1708254305679,PHIL 10,A01,415026,Grush; Rick Scott,40,0,44,4
1708254305679,PHIL 10,A02,415028,Grush; Rick Scott,42,0,44,2
1708254305679,PHIL 10,A03,415029,Grush; Rick Scott,0,0,0,0
1708254305679,PHIL 10,A04,415031,Grush; Rick Scott,0,0,0,0
1708254305679,PHIL 10,A05,415113,Grush; Rick Scott,43,0,44,1
1708254305679,PHIL 10,A06,415114,Grush; Rick Scott,43,0,44,1
1708254305679,PHIL 10,A07,415116,Grush; Rick Scott,44,0,44,0
1708254305679,PHIL 10,A08,415118,Grush; Rick Scott,43,0,44,1
1708254306213,PHIL 12,A01,415120,McKenzie; Kerry V.,28,0,30,2
1708254306213,PHIL 12,A02,415136,McKenzie; Kerry V.,30,0,30,0
1708254306213,PHIL 12,A03,415137,McKenzie; Kerry V.,27,0,30,3
1708254306213,PHIL 12,A04,415142,McKenzie; Kerry V.,30,0,30,0
1708254306743,PHIL 13,A01,415165,Brink; David O.,25,0,25,0
1708254306743,PHIL 13,A02,415179,Brink; David O.,22,0,25,3
1708254306743,PHIL 13,A03,415185,Brink; David O.,24,0,25,1
1708254306743,PHIL 13,A04,415201,Brink; David O.,25,0,25,0
1708254306743,PHIL 13,A05,415204,Brink; David O.,25,0,25,0
1708254306743,PHIL 13,A06,415220,Brink; David O.,25,0,25,0
1708254307284,PHIL 15,A01,415250,Fulkerson; Matthew Todd,26,0,30,4
1708254307284,PHIL 15,A02,415281,Fulkerson; Matthew Todd,29,0,30,1
1708254307818,PHIL 27,A01,415293,Brandt; Reuven A,20,0,25,5
1708254307818,PHIL 27,A02,415296,Brandt; Reuven A,0,0,0,0
1708254307818,PHIL 27,A03,415332,Brandt; Reuven A,22,0,25,3
1708254307818,PHIL 27,A04,415333,Brandt; Reuven A,22,0,25,3
1708254307818,PHIL 27,A05,415342,Brandt; Reuven A,20,0,25,5
1708254307818,PHIL 27,A06,415384,Brandt; Reuven A,24,0,25,1
1708254307818,PHIL 27,A07,415385,Brandt; Reuven A,25,0,25,0
1708254307818,PHIL 27,A08,415391,Brandt; Reuven A,0,0,0,0
1708254307818,PHIL 27,A09,415406,Brandt; Reuven A,0,0,0,0
1708254307818,PHIL 27,A10,415407,Brandt; Reuven A,0,0,0,0
1708254308350,PHIL 28,A01,415412,Lamey; Andy M.,24,0,25,1
1708254308350,PHIL 28,A02,415470,Lamey; Andy M.,20,0,25,5
1708254308350,PHIL 28,A03,415474,Lamey; Andy M.,0,0,0,0
1708254308350,PHIL 28,A04,415475,Lamey; Andy M.,22,0,25,3
1708254308350,PHIL 28,A05,415487,Lamey; Andy M.,24,0,25,1
1708254308350,PHIL 28,A06,415506,Lamey; Andy M.,21,0,25,4
1708254308350,PHIL 28,A07,415507,Lamey; Andy M.,25,0,25,0
1708254308350,PHIL 28,A08,415508,Lamey; Andy M.,24,0,25,1
1708254308350,PHIL 28,A09,415509,Lamey; Andy M.,24,0,25,1
1708254308350,PHIL 28,A10,415510,Lamey; Andy M.,0,0,0,0
1708254308876,PHIL 33,A01,415521,Hardimon; Michael O.,35,0,35,0
1708254308876,PHIL 33,A02,415522,Hardimon; Michael O.,35,0,35,0
1708254309410,PHIL 60,A00,415523,Marechal; Patricia,55,0,60,5
1708254309937,PHIL 102,A00,415524,Johnson; Monte,37,0,40,3
1708254310468,PHIL 106,A00,415544,Watkins; Eric,40,0,40,0
1708254311009,PHIL 112,A00,415545,Watkins; Eric,34,0,40,6
1708254311535,PHIL 115,A00,415548,Nelkin; Dana Kay,20,0,20,0
1708254312060,PHIL 120,A00,415549,Carr; Jennifer Rose,64,0,65,1
1708254312586,PHIL 134,A00,415552,Carr; Jennifer Rose,40,0,40,0
1708254313116,PHIL 150,A00,415553,Cohen; Jonathan David,38,0,40,2
1708254313645,PHIL 171,A00,415561,Brink; David O.,39,0,40,1
1708254314171,PHIL 172,A00,415563,Lamey; Andy M.,40,0,40,0
1708254314713,PHIL 174,A01,415576,Danks; David J,21,0,25,4
1708254314713,PHIL 174,A02,415582,Danks; David J,22,0,25,3
1708254314713,PHIL 174,A03,415583,Danks; David J,24,0,25,1
1708254314713,PHIL 174,A04,415584,Danks; David J,25,0,25,0
1708254315241,PHIL 175,A00,415585,Shields; Christopher John,40,0,40,0
1708254315766,PHIL 181,A00,415601,Tolley; Clinton,34,0,40,6
1708254316295,PHIL 209B,A00,415655,Serlin; David,4,0,5,1
1708254316821,PHIL 209C,A00,415658,Gates; Kelly,5,0,5,0
1708254317346,PHIL 210,A00,415659,Marechal; Patricia,20,0,20,0
1708254317872,PHIL 230,A00,415661,Grush; Rick Scott,20,0,20,0
1708254318398,PHIL 232,A00,415662,Sher; Gila,20,0,20,0
1708254318924,PHIL 260,A00,415675,Bazargan-Forward; Saba,20,0,20,0
1708254319450,PHIL 277,A00,479176,Tolley; Clinton,9,0,10,1
1708254319978,PHIL 285,A00,415685,Kovaka; Karenc,20,0,20,0
1708254320508,PHIL 287,A00,415697,Marechal; Patricia,5,0,5,0
1708254321041,PHIL 290,001,415701,Nelkin; Dana Kay,9999,0,9999,0
1708254321041,PHIL 290,002,415721,Bazargan-Forward; Saba,9999,0,9999,0
1708254321041,PHIL 290,003,415731,Brandt; Reuven A,9999,0,9999,0
1708254321041,PHIL 290,004,415743,Brink; David O.,9999,0,9999,0
1708254321041,PHIL 290,005,415747,Callender; Craig Adam,9999,0,9999,0
1708254321041,PHIL 290,006,415779,Carr; Jennifer Rose,9999,0,9999,0
1708254321041,PHIL 290,007,415780,Cartwright; Nancy D.,9999,0,9999,0
1708254321041,PHIL 290,008,415781,Cohen; Jonathan David,9999,0,9999,0
1708254321041,PHIL 290,009,415782,Danks; David J,9999,0,9999,0
1708254321041,PHIL 290,010,415783,Fulkerson; Matthew Todd,9999,0,9999,0
1708254321041,PHIL 290,011,415784,Grush; Rick Scott,9999,0,9999,0
1708254321041,PHIL 290,012,415785,Hardimon; Michael O.,9999,0,9999,0
1708254321041,PHIL 290,013,415786,Harrell; Maralee Mae,9999,0,9999,0
1708254321041,PHIL 290,014,415787,Johnson; Monte,9999,0,9999,0
1708254321041,PHIL 290,015,415788,Kovaka; Karenc,9999,0,9999,0
1708254321041,PHIL 290,016,415789,Lamey; Andy M.,9999,0,9999,0
1708254321041,PHIL 290,017,415790,Marechal; Patricia,9999,0,9999,0
1708254321041,PHIL 290,018,415791,McKenzie; Kerry V.,9999,0,9999,0
1708254321041,PHIL 290,019,415792,Rickless; Samuel Charles,9999,0,9999,0
1708254321041,PHIL 290,020,415793,Sher; Gila,9999,0,9999,0
1708254321041,PHIL 290,021,415794,Shields; Christopher John,9999,0,9999,0
1708254321041,PHIL 290,022,415805,Tolley; Clinton,9999,0,9999,0
1708254321041,PHIL 290,023,415806,Vargas; Manuel Rogelio,9999,0,9999,0
1708254321041,PHIL 290,024,415807,Watkins; Eric,9999,0,9999,0
1708254321041,PHIL 290,025,415815,Chen; Keming,9999,0,9999,0
1708254321570,PHIL 295,001,415816,Bazargan-Forward; Saba,9999,0,9999,0
1708254321570,PHIL 295,002,415857,Brandt; Reuven A,9999,0,9999,0
1708254321570,PHIL 295,003,415858,Brink; David O.,9999,0,9999,0
1708254321570,PHIL 295,004,415877,Callender; Craig Adam,9999,0,9999,0
1708254321570,PHIL 295,005,415878,Carr; Jennifer Rose,9999,0,9999,0
1708254321570,PHIL 295,006,415884,Cartwright; Nancy D.,9999,0,9999,0
1708254321570,PHIL 295,007,415885,Chen; Keming,9999,0,9999,0
1708254321570,PHIL 295,008,415891,Cohen; Jonathan David,9999,0,9999,0
1708254321570,PHIL 295,009,415892,Danks; David J,9999,0,9999,0
1708254321570,PHIL 295,010,415937,Fulkerson; Matthew Todd,9999,0,9999,0
1708254321570,PHIL 295,011,415940,Grush; Rick Scott,9999,0,9999,0
1708254321570,PHIL 295,012,415945,Hardimon; Michael O.,9999,0,9999,0
1708254321570,PHIL 295,013,415946,Harrell; Maralee Mae,9999,0,9999,0
1708254321570,PHIL 295,014,415953,Johnson; Monte,9999,0,9999,0
1708254321570,PHIL 295,015,415954,Kovaka; Karenc,9999,0,9999,0
1708254321570,PHIL 295,016,415957,Lamey; Andy M.,9999,0,9999,0
1708254321570,PHIL 295,017,415958,Marechal; Patricia,9999,0,9999,0
1708254321570,PHIL 295,018,415959,McKenzie; Kerry V.,9999,0,9999,0
1708254321570,PHIL 295,019,415960,Nelkin; Dana Kay,9999,0,9999,0
1708254321570,PHIL 295,020,415961,Rickless; Samuel Charles,9999,0,9999,0
1708254321570,PHIL 295,021,415987,Sher; Gila,9999,0,9999,0
1708254321570,PHIL 295,022,416027,Shields; Christopher John,9999,0,9999,0
1708254321570,PHIL 295,023,416030,Tolley; Clinton,9999,0,9999,0
1708254321570,PHIL 295,024,416033,Vargas; Manuel Rogelio,9999,0,9999,0
1708254321570,PHIL 295,025,416034,Watkins; Eric,9999,0,9999,0
1708254322097,PHYA 224,A00,442106,Sandstrom; Karin Marie,30,0,30,0
1708254322626,PHYS 1A,A00,441607,Gilbert; Dylan Paul,346,0,362,16
1708254323161,PHYS 1AL,001,441608,Arlett; Jessica Lynn & Yagil; Avi,30,0,30,0
1708254323161,PHYS 1AL,002,441609,Arlett; Jessica Lynn & Yagil; Avi,28,0,30,2
1708254323161,PHYS 1AL,003,441610,Arlett; Jessica Lynn & Yagil; Avi,26,0,30,4
1708254323161,PHYS 1AL,004,441611,Arlett; Jessica Lynn & Yagil; Avi,29,0,30,1
1708254323161,PHYS 1AL,005,441612,Arlett; Jessica Lynn & Yagil; Avi,28,0,30,2
1708254323161,PHYS 1AL,006,441616,Arlett; Jessica Lynn & Yagil; Avi,28,0,30,2
1708254323161,PHYS 1AL,007,441618,Arlett; Jessica Lynn & Yagil; Avi,26,0,30,4
1708254323161,PHYS 1AL,008,441620,Arlett; Jessica Lynn & Yagil; Avi,29,0,30,1
1708254323161,PHYS 1AL,009,441623,Arlett; Jessica Lynn & Yagil; Avi,29,0,30,1
1708254323161,PHYS 1AL,010,441625,Arlett; Jessica Lynn & Yagil; Avi,29,0,30,1
1708254323161,PHYS 1AL,011,441626,Arlett; Jessica Lynn & Yagil; Avi,29,0,30,1
1708254323161,PHYS 1AL,012,441627,Arlett; Jessica Lynn & Yagil; Avi,29,0,30,1
1708254323689,PHYS 1B,A00,441630,Groisman; Alexander,351,0,362,11
1708254324216,PHYS 1BL,001,441632,Arlett; Jessica Lynn & Yagil; Avi,28,0,30,2
1708254324216,PHYS 1BL,002,441634,Arlett; Jessica Lynn & Yagil; Avi,29,0,30,1
1708254324216,PHYS 1BL,003,441636,Arlett; Jessica Lynn & Yagil; Avi,29,0,30,1
1708254324216,PHYS 1BL,004,441637,Arlett; Jessica Lynn & Yagil; Avi,29,0,30,1
1708254324216,PHYS 1BL,005,441639,Arlett; Jessica Lynn & Yagil; Avi,29,0,30,1
1708254324216,PHYS 1BL,006,441641,Arlett; Jessica Lynn & Yagil; Avi,26,0,30,4
1708254324216,PHYS 1BL,007,441642,Arlett; Jessica Lynn & Yagil; Avi,23,0,30,7
1708254324216,PHYS 1BL,008,441643,Arlett; Jessica Lynn & Yagil; Avi,30,0,30,0
1708254324216,PHYS 1BL,009,441646,Arlett; Jessica Lynn & Yagil; Avi,29,0,30,1
1708254324216,PHYS 1BL,010,441648,Arlett; Jessica Lynn & Yagil; Avi,29,0,30,1
1708254324216,PHYS 1BL,011,441652,Arlett; Jessica Lynn & Yagil; Avi,29,0,30,1
1708254324216,PHYS 1BL,012,441654,Arlett; Jessica Lynn & Yagil; Avi,30,0,30,0
1708254324761,PHYS 1C,A00,441658,Popmintchev; Tenio,587,0,600,13
1708254324761,PHYS 1C,B00,441662,Popmintchev; Tenio,558,0,600,42
1708254325342,PHYS 1CL,001,441664,Arlett; Jessica Lynn & Yagil; Avi,29,0,30,1
1708254325342,PHYS 1CL,002,441665,Arlett; Jessica Lynn & Yagil; Avi,27,0,30,3
1708254325342,PHYS 1CL,003,441666,Arlett; Jessica Lynn & Yagil; Avi,25,0,30,5
1708254325342,PHYS 1CL,004,441667,Arlett; Jessica Lynn & Yagil; Avi,30,0,30,0
1708254325342,PHYS 1CL,005,441668,Arlett; Jessica Lynn & Yagil; Avi,28,0,30,2
1708254325342,PHYS 1CL,006,441669,Arlett; Jessica Lynn & Yagil; Avi,25,0,30,5
1708254325342,PHYS 1CL,007,441671,Arlett; Jessica Lynn & Yagil; Avi,27,0,30,3
1708254325342,PHYS 1CL,008,441673,Arlett; Jessica Lynn & Yagil; Avi,30,0,30,0
1708254325342,PHYS 1CL,009,441674,Arlett; Jessica Lynn & Yagil; Avi,26,0,30,4
1708254325342,PHYS 1CL,010,441676,Arlett; Jessica Lynn & Yagil; Avi,30,0,30,0
1708254325342,PHYS 1CL,011,441677,Arlett; Jessica Lynn & Yagil; Avi,30,0,30,0
1708254325342,PHYS 1CL,012,441683,Arlett; Jessica Lynn & Yagil; Avi,30,0,30,0
1708254325342,PHYS 1CL,013,441685,Arlett; Jessica Lynn & Yagil; Avi,28,0,30,2
1708254325342,PHYS 1CL,014,441687,Arlett; Jessica Lynn & Yagil; Avi,30,0,30,0
1708254325342,PHYS 1CL,015,441689,Arlett; Jessica Lynn & Yagil; Avi,17,0,30,13
1708254325342,PHYS 1CL,016,441692,Arlett; Jessica Lynn & Yagil; Avi,29,0,30,1
1708254325342,PHYS 1CL,017,441696,Arlett; Jessica Lynn & Yagil; Avi,24,0,30,6
1708254325342,PHYS 1CL,018,441698,Arlett; Jessica Lynn & Yagil; Avi,25,0,30,5
1708254325342,PHYS 1CL,019,441702,Arlett; Jessica Lynn & Yagil; Avi,25,0,30,5
1708254325342,PHYS 1CL,020,441705,Arlett; Jessica Lynn & Yagil; Avi,29,0,30,1
1708254325342,PHYS 1CL,021,441706,Arlett; Jessica Lynn & Yagil; Avi,30,0,30,0
1708254325342,PHYS 1CL,022,441707,Arlett; Jessica Lynn & Yagil; Avi,30,0,30,0
1708254325342,PHYS 1CL,023,441708,Arlett; Jessica Lynn & Yagil; Avi,27,0,30,3
1708254325342,PHYS 1CL,024,441710,Arlett; Jessica Lynn & Yagil; Avi,29,0,30,1
1708254325342,PHYS 1CL,025,441711,Arlett; Jessica Lynn & Yagil; Avi,28,0,30,2
1708254325342,PHYS 1CL,026,441712,Arlett; Jessica Lynn & Yagil; Avi,29,0,30,1
1708254325342,PHYS 1CL,027,441713,Arlett; Jessica Lynn & Yagil; Avi,26,0,30,4
1708254325342,PHYS 1CL,028,441714,Arlett; Jessica Lynn & Yagil; Avi,29,0,30,1
1708254325342,PHYS 1CL,029,441715,Arlett; Jessica Lynn & Yagil; Avi,25,0,30,5
1708254325342,PHYS 1CL,030,441717,Arlett; Jessica Lynn & Yagil; Avi,29,0,30,1
1708254325342,PHYS 1CL,031,441718,Arlett; Jessica Lynn & Yagil; Avi,27,0,30,3
1708254325342,PHYS 1CL,032,441721,Arlett; Jessica Lynn & Yagil; Avi,30,0,30,0
1708254325342,PHYS 1CL,033,441724,Arlett; Jessica Lynn & Yagil; Avi,28,0,30,2
1708254325342,PHYS 1CL,034,441726,Arlett; Jessica Lynn & Yagil; Avi,29,0,30,1
1708254325342,PHYS 1CL,035,441728,Arlett; Jessica Lynn & Yagil; Avi,29,0,30,1
1708254325342,PHYS 1CL,036,441729,Arlett; Jessica Lynn & Yagil; Avi,30,0,30,0
1708254325342,PHYS 1CL,037,441730,Arlett; Jessica Lynn & Yagil; Avi,27,0,30,3
1708254325342,PHYS 1CL,038,441732,Arlett; Jessica Lynn & Yagil; Avi,29,0,30,1
1708254325342,PHYS 1CL,039,441733,Arlett; Jessica Lynn & Yagil; Avi,27,0,30,3
1708254325342,PHYS 1CL,040,441734,Arlett; Jessica Lynn & Yagil; Avi,30,0,30,0
1708254325342,PHYS 1CL,041,441735,Arlett; Jessica Lynn & Yagil; Avi,29,0,30,1
1708254325342,PHYS 1CL,042,441766,Arlett; Jessica Lynn & Yagil; Avi,30,0,30,0
1708254325342,PHYS 1CL,043,441768,Arlett; Jessica Lynn & Yagil; Avi,29,0,30,1
1708254325342,PHYS 1CL,044,441770,Arlett; Jessica Lynn & Yagil; Avi,30,0,30,0
1708254325881,PHYS 2A,A01,460308,Bal; Gurleen K,28,0,30,2
1708254325881,PHYS 2A,A02,460320,Bal; Gurleen K,30,0,30,0
1708254325881,PHYS 2A,A03,460321,Bal; Gurleen K,29,0,30,1
1708254325881,PHYS 2A,A04,460325,Bal; Gurleen K,28,0,30,2
1708254325881,PHYS 2A,A05,460326,Bal; Gurleen K,29,0,30,1
1708254325881,PHYS 2A,A06,460327,Bal; Gurleen K,30,0,30,0
1708254325881,PHYS 2A,A07,460495,Bal; Gurleen K,28,0,30,2
1708254325881,PHYS 2A,A08,460535,Bal; Gurleen K,27,0,30,3
1708254325881,PHYS 2A,A09,460536,Bal; Gurleen K,30,0,30,0
1708254325881,PHYS 2A,A10,460537,Bal; Gurleen K,30,0,30,0
1708254325881,PHYS 2A,A11,460538,Bal; Gurleen K,30,0,30,0
1708254325881,PHYS 2A,A12,460539,Bal; Gurleen K,30,0,30,0
1708254326450,PHYS 2B,A01,460620,Barreiro Guerrero; Julio,30,0,30,0
1708254326450,PHYS 2B,A02,460625,Barreiro Guerrero; Julio,30,0,30,0
1708254326450,PHYS 2B,A03,460626,Barreiro Guerrero; Julio,29,0,30,1
1708254326450,PHYS 2B,A04,460716,Barreiro Guerrero; Julio,26,0,30,4
1708254326450,PHYS 2B,A05,460756,Barreiro Guerrero; Julio,29,0,30,1
1708254326450,PHYS 2B,A06,460837,Barreiro Guerrero; Julio,30,0,30,0
1708254326450,PHYS 2B,A07,460865,Barreiro Guerrero; Julio,30,0,30,0
1708254326450,PHYS 2B,A08,460866,Barreiro Guerrero; Julio,30,0,30,0
1708254326450,PHYS 2B,A09,460867,Barreiro Guerrero; Julio,29,0,30,1
1708254326450,PHYS 2B,A10,460868,Barreiro Guerrero; Julio,30,0,30,0
1708254326450,PHYS 2B,A11,460869,Barreiro Guerrero; Julio,30,0,30,0
1708254326450,PHYS 2B,A12,460874,Barreiro Guerrero; Julio,30,0,30,0
1708254326450,PHYS 2B,B01,469381,Barreiro Guerrero; Julio,30,0,30,0
1708254326450,PHYS 2B,B02,469382,Barreiro Guerrero; Julio,29,0,30,1
1708254326450,PHYS 2B,B03,469402,Barreiro Guerrero; Julio,27,0,30,3
1708254326450,PHYS 2B,B04,469403,Barreiro Guerrero; Julio,28,0,30,2
1708254326450,PHYS 2B,B05,469442,Barreiro Guerrero; Julio,30,0,30,0
1708254326450,PHYS 2B,B06,469449,Barreiro Guerrero; Julio,30,0,30,0
1708254326450,PHYS 2B,B07,469450,Barreiro Guerrero; Julio,29,0,30,1
1708254326450,PHYS 2B,B08,469451,Barreiro Guerrero; Julio,30,0,30,0
1708254326450,PHYS 2B,B09,469457,Barreiro Guerrero; Julio,29,0,30,1
1708254326450,PHYS 2B,B10,469460,Barreiro Guerrero; Julio,30,0,30,0
1708254326450,PHYS 2B,B11,469468,Barreiro Guerrero; Julio,30,0,30,0
1708254326450,PHYS 2B,B12,469475,Barreiro Guerrero; Julio,30,0,30,0
1708254326993,PHYS 2BL,A01,441779,Meyertholen; Andrew D.,21,0,24,3
1708254326993,PHYS 2BL,A02,441780,Meyertholen; Andrew D.,17,0,24,7
1708254326993,PHYS 2BL,A03,441781,Meyertholen; Andrew D.,20,0,24,4
1708254326993,PHYS 2BL,A04,441782,Meyertholen; Andrew D.,21,0,24,3
1708254326993,PHYS 2BL,A05,441784,Meyertholen; Andrew D.,23,0,24,1
1708254326993,PHYS 2BL,A06,441786,Meyertholen; Andrew D.,23,0,24,1
1708254326993,PHYS 2BL,A07,441788,Meyertholen; Andrew D.,23,0,24,1
1708254326993,PHYS 2BL,A08,441790,Meyertholen; Andrew D.,24,0,24,0
1708254326993,PHYS 2BL,A09,441792,Meyertholen; Andrew D.,24,0,24,0
1708254326993,PHYS 2BL,A10,441794,Meyertholen; Andrew D.,23,0,24,1
1708254326993,PHYS 2BL,A11,441796,Meyertholen; Andrew D.,22,0,24,2
1708254326993,PHYS 2BL,A12,441798,Meyertholen; Andrew D.,24,0,24,0
1708254326993,PHYS 2BL,A13,441800,Meyertholen; Andrew D.,24,0,24,0
1708254326993,PHYS 2BL,A14,441802,Meyertholen; Andrew D.,24,0,24,0
1708254326993,PHYS 2BL,A15,441804,Meyertholen; Andrew D.,23,0,24,1
1708254327521,PHYS 2C,A01,460540,Tan; Tzer Han,30,0,30,0
1708254327521,PHYS 2C,A02,460541,Tan; Tzer Han,28,0,30,2
1708254327521,PHYS 2C,A03,460542,Tan; Tzer Han,28,0,30,2
1708254327521,PHYS 2C,A04,460543,Tan; Tzer Han,28,0,30,2
1708254327521,PHYS 2C,A05,460544,Tan; Tzer Han,28,0,30,2
1708254327521,PHYS 2C,A06,460545,Tan; Tzer Han,29,0,30,1
1708254327521,PHYS 2C,A07,460553,Tan; Tzer Han,30,0,30,0
1708254327521,PHYS 2C,A08,460561,Tan; Tzer Han,30,0,30,0
1708254327521,PHYS 2C,A09,460562,Tan; Tzer Han,28,0,30,2
1708254327521,PHYS 2C,A10,460563,Tan; Tzer Han,29,0,30,1
1708254327521,PHYS 2C,A11,460567,Tan; Tzer Han,30,0,30,0
1708254327521,PHYS 2C,A12,460568,Tan; Tzer Han,28,0,30,2
1708254328047,PHYS 2CL,A01,441809,Ni; Kaixuan,25,0,28,3
1708254328047,PHYS 2CL,A02,441811,Ni; Kaixuan,27,0,28,1
1708254328047,PHYS 2CL,A03,441814,Ni; Kaixuan,23,0,28,5
1708254328047,PHYS 2CL,A04,441817,Ni; Kaixuan,28,0,28,0
1708254328047,PHYS 2CL,A05,441819,Ni; Kaixuan,26,0,28,2
1708254328047,PHYS 2CL,A06,441820,Ni; Kaixuan,27,0,28,1
1708254328577,PHYS 2D,A01,460569,Sharma; Vivek A.,24,0,25,1
1708254328577,PHYS 2D,A02,460574,Sharma; Vivek A.,24,0,25,1
1708254328577,PHYS 2D,A03,460575,Sharma; Vivek A.,25,0,25,0
1708254329103,PHYS 4B,A01,441829,Grinstein; Benjamin,34,0,38,4
1708254329103,PHYS 4B,A02,441831,Grinstein; Benjamin,30,0,32,2
1708254329103,PHYS 4B,A03,441832,Grinstein; Benjamin,30,0,30,0
1708254329103,PHYS 4B,A04,441833,Grinstein; Benjamin,30,0,30,0
1708254329634,PHYS 4E,A01,441907,Frano Pereira; Alex M,33,0,34,1
1708254329634,PHYS 4E,A02,441958,Frano Pereira; Alex M,34,0,34,0
1708254330158,PHYS 10,A01,441971,Burgasser; Adam Jonathan,118,0,120,2
1708254330687,PHYS 13,A01,441974,Wright; Shelley Adams,61,0,65,4
1708254331213,PHYS 87,A00,486898,Grinstein; Benjamin,19,0,20,1
1708254331739,PHYS 100C,A01,441978,Averitt; Richard Douglas,58,0,60,2
1708254332267,PHYS 105B,A01,441985,Green; Daniel Richard,37,0,40,3
1708254332808,PHYS 120,A01,441995,Arnold; Kam S,40,0,44,4
1708254332808,PHYS 120,A02,442011,Arnold; Kam S,41,0,44,3
1708254333334,PHYS 130A,A01,442032,Parker; Daniel E,74,0,75,1
1708254334099,PHYS 130B,A01,442056,Branson; James G,47,0,50,3
1708254334631,PHYS 139,A00,442057,Jun; Suckjoon,30,0,30,0
1708254334631,PHYS 139,B00,442059,Duarte; Javier Mauricio & Li; Aobo,42,0,50,8
1708254335159,PHYS 140A,A01,442065,Shotwell; Brian,49,0,50,1
1708254335701,PHYS 152B,A01,442067,Hirsch; Jorge Eduardo,16,0,20,4
1708254336242,PHYS 154,A01,442069,Jenkins; Elizabeth,29,0,30,1
1708254336767,PHYS 162,A01,442096,Keating; Brian,64,0,65,1
1708254337292,PHYS 170,A01,486870,Oh; Seungeun,39,0,40,1
1708254337817,PHYS 177,A00,442103,Dudko; Olga,20,0,20,0
1708254338343,PHYS 203B,A01,442132,Fogler; Michael M.,20,0,20,0
1708254338869,PHYS 210A,A01,442143,Hwa; Terence T.,20,0,20,0
1708254339393,PHYS 212C,A01,442200,Chivukula; Raja S,18,0,20,2
1708254339918,PHYS 215C,A00,442201,Intriligator; Kenneth Arthur,19,0,20,1
1708254340448,PHYS 225C,A01,442203,Flauger; Raphael M,19,0,20,1
1708254340974,PHYS 227,A00,442204,Tytler; David Robert,29,0,30,1
1708254341574,PHYS 230,A01,442206,McGreevy; John A.,20,0,20,0
1708254342103,PHYS 239,A00,442207,Goldenfeld; Nigel,20,0,20,0
1708254342103,PHYS 239,B00,442208,Duarte; Javier Mauricio & Li; Aobo,5,0,5,0
1708254342629,PHYS 244,A01,442280,Norman; Michael L,12,0,20,8
1708254343156,PHYS 250,A00,442300,Fogler; Michael M.,50,0,50,0
1708254343681,PHYS 251,A00,442307,Grinstein; Benjamin,20,0,20,0
1708254344207,PHYS 252,A00,442348,Diamond; Patrick H,10,0,10,0
1708254344747,PHYS 253,A00,442349,Theissen; Christopher Alexander,30,0,30,0
1708254345271,PHYS 254,A00,442352,Hwa; Terence T.,30,0,30,0
1708254345795,PHYS 255,A00,442423,Hwa; Terence T.,30,0,30,0
1708254346320,PHYS 258,A00,442426,Theissen; Christopher Alexander,30,0,30,0
1708254346846,PHYS 260,A00,442427,Frano Pereira; Alex M,50,0,50,0
1708254347374,PHYS 277,A00,442428,Dudko; Olga,20,0,20,0
1708254347902,POLI 5D,A01,419010,Dai; Yinlin,5,0,7,2
1708254347902,POLI 5D,A02,419020,Dai; Yinlin,7,0,7,0
1708254347902,POLI 5D,A03,419022,Dai; Yinlin,4,0,6,2
1708254347902,POLI 5D,A04,419040,Dai; Yinlin,5,0,5,0
1708254347902,POLI 5D,B01,419065,Dai; Yinlin,7,0,7,0
1708254347902,POLI 5D,B02,419068,Dai; Yinlin,7,0,7,0
1708254347902,POLI 5D,B03,419069,Dai; Yinlin,6,0,6,0
1708254347902,POLI 5D,B04,419070,Dai; Yinlin,5,0,5,0
1708254347902,POLI 5D,C01,487211,Staff,3,0,5,2
1708254348428,POLI 11D,A01,419072,Desposato; Scott,32,0,34,2
1708254348428,POLI 11D,A02,419073,Desposato; Scott,33,0,34,1
1708254348428,POLI 11D,A03,419082,Desposato; Scott,32,0,34,2
1708254348428,POLI 11D,A04,419123,Desposato; Scott,34,0,34,0
1708254348428,POLI 11D,A05,419124,Desposato; Scott,34,0,34,0
1708254348428,POLI 11D,A06,419125,Desposato; Scott,34,0,34,0
1708254348973,POLI 12D,A01,419127,Gartzke; Erik,29,0,34,5
1708254348973,POLI 12D,A02,419128,Gartzke; Erik,34,0,34,0
1708254348973,POLI 12D,A03,419129,Gartzke; Erik,34,0,34,0
1708254348973,POLI 12D,A04,419130,Gartzke; Erik,34,0,34,0
1708254348973,POLI 12D,A05,419131,Gartzke; Erik,32,0,34,2
1708254348973,POLI 12D,A06,419168,Gartzke; Erik,34,0,34,0
1708254349501,POLI 13DR,A01,477733,Draper; Matthew William,28,0,34,6
1708254349501,POLI 13DR,A02,477734,Draper; Matthew William,32,0,34,2
1708254349501,POLI 13DR,A03,477736,Draper; Matthew William,33,0,34,1
1708254349501,POLI 13DR,A04,477737,Draper; Matthew William,32,0,34,2
1708254349501,POLI 13DR,A05,477739,Draper; Matthew William,31,0,34,3
1708254349501,POLI 13DR,A06,477740,Draper; Matthew William,34,0,34,0
1708254350032,POLI 30D,A01,419179,Desposato; Scott,19,0,28,9
1708254350032,POLI 30D,A02,419180,Desposato; Scott,25,0,28,3
1708254350032,POLI 30D,A03,419181,Desposato; Scott,27,0,28,1
1708254350032,POLI 30D,A04,419182,Desposato; Scott,28,0,28,0
1708254350032,POLI 30D,A05,419187,Desposato; Scott,24,0,28,4
1708254350032,POLI 30D,A06,419189,Desposato; Scott,28,0,28,0
1708254350558,POLI 100E,A00,419191,Pitcher; Kennedy Anell,105,0,115,10
1708254351087,POLI 104P,A00,419192,Orfield; Michael Bennett,183,0,196,13
1708254351612,POLI 104U,A00,419193,Nichter; Maysa,88,0,115,27
1708254352140,POLI 108,A00,419194,Adida; Claire,293,0,295,2
1708254352671,POLI 110C,A00,419195,Soon; Valerie,47,0,50,3
1708254353198,POLI 120D,A00,419207,Hansen; Jan Eric,48,0,50,2
1708254353724,POLI 124A,A00,419209,Fortunato; David,48,0,50,2
1708254354250,POLI 131CR,A00,419211,Hoston; Germaine,41,0,50,9
1708254354250,POLI 131CR,B00,481592,Hoston; Germaine,10,0,10,0
1708254354775,POLI 136A,A00,419212,Roeder; Philip G,111,0,115,4
1708254355302,POLI 140D,A00,419213,Wong; Tak Kei,183,0,192,9
1708254355830,POLI 142D,A00,419214,Gartzke; Erik,227,0,230,3
1708254356355,POLI 145C,A00,419222,Fisk; David Lee,101,0,115,14
1708254356881,POLI 150A,A00,419225,Wong; Tak Kei,216,0,230,14
1708254357407,POLI 170A,A00,419226,Skillman; Rachel Diane,115,0,115,0
1708254357936,POLI 179,A00,419238,Staff,95,0,104,9
1708254358472,POLI 194,A00,455332,Hill; Seth J,0,0,0,0
1708254358997,POLI 194SD,A00,419248,Nichter; Maysa,999,0,999,0
1708254359523,POLI 197SD,001,419258,Nichter; Maysa,999,0,999,0
1708254360048,POLI 203B,A00,419265,Slantchev; Branislav,21,0,25,4
1708254360576,POLI 214R,A00,419275,Hoston; Germaine,23,0,25,2
1708254361117,POLI 219,A00,419289,Soon; Valerie,24,0,25,1
1708254361645,POLI 220A,A00,419299,Ferree; Karen E,21,0,25,4
1708254362170,POLI 233,A00,419333,Adida; Claire,23,0,25,2
1708254362695,POLI 243,A00,479118,Joseph; Michael F,23,0,25,2
1708254363220,POLI 251,A00,419334,Ban; Pamela M,23,0,25,2
1708254363745,POLI 257,A00,419335,Hill; Seth J,25,0,25,0
1708254364290,POLI 273,A00,419336,Mignozzetti; Umberto,16,0,25,9
1708254364815,POLI 280,A00,419337,Hafner-Burton; Emilie,18,0,25,7
1708254365340,POLI 281,A00,419338,Ban; Pamela M,21,0,25,4
1708254365867,POLI 282,A00,419339,Ferree; Karen E,19,0,25,6
1708254366392,POLI 283,A00,419340,Naoi; Megumi,23,0,25,2
1708254366916,POLI 285,A00,419341,Ingham; Sean,25,0,25,0
1708254367441,POLI 286,A00,419342,Mignozzetti; Umberto,23,0,25,2
1708254367967,POLI 288,A00,479174,Fowler; James,13,0,15,2
1708254368496,PSY 296,001,465760,Besterman; Aaron David,49,0,50,1
1708254368496,PSY 296,002,465765,Eyler; Lisa T.,49,0,50,1
1708254368496,PSY 296,003,465767,Patel; Ekta Himanshu,49,0,50,1
1708254369022,PSYC 3R,A00,419378,Pilegard; Celeste Cristine,314,0,325,11
1708254369549,PSYC 7,A00,419384,Powell; Lindsey Jane,288,0,295,7
1708254370092,PSYC 60,A01,460208,Lowe; Angela Beth,31,0,35,4
1708254370092,PSYC 60,A02,460209,Lowe; Angela Beth,28,0,35,7
1708254370092,PSYC 60,A03,460210,Lowe; Angela Beth,35,0,35,0
1708254370092,PSYC 60,A04,460211,Lowe; Angela Beth,33,0,35,2
1708254370092,PSYC 60,A05,460212,Lowe; Angela Beth,34,0,35,1
1708254370092,PSYC 60,A06,460213,Lowe; Angela Beth,35,0,35,0
1708254370092,PSYC 60,A07,460214,Lowe; Angela Beth,33,0,35,2
1708254370092,PSYC 60,B01,460215,Rose; Fred E.,35,0,35,0
1708254370092,PSYC 60,B02,460216,Rose; Fred E.,35,0,35,0
1708254370092,PSYC 60,B03,460218,Rose; Fred E.,35,0,35,0
1708254370092,PSYC 60,B04,460219,Rose; Fred E.,35,0,35,0
1708254370092,PSYC 60,B05,460220,Rose; Fred E.,32,0,35,3
1708254370092,PSYC 60,B06,460221,Rose; Fred E.,35,0,35,0
1708254370092,PSYC 60,B07,460222,Rose; Fred E.,35,0,35,0
1708254370636,PSYC 70,A01,460223,Pilegard; Celeste Cristine,29,0,35,6
1708254370636,PSYC 70,A02,460224,Pilegard; Celeste Cristine,32,0,35,3
1708254370636,PSYC 70,A03,460225,Pilegard; Celeste Cristine,34,0,35,1
1708254370636,PSYC 70,A04,460266,Pilegard; Celeste Cristine,33,0,35,2
1708254370636,PSYC 70,A05,460267,Pilegard; Celeste Cristine,35,0,35,0
1708254370636,PSYC 70,A06,460277,Pilegard; Celeste Cristine,34,0,35,1
1708254371163,PSYC 71,A01,419620,Staff,19,0,21,2
1708254371163,PSYC 71,A02,419662,Staff,20,0,21,1
1708254371163,PSYC 71,B01,419682,Geller; Emma Harlan,24,0,25,1
1708254371163,PSYC 71,B02,419732,Geller; Emma Harlan,26,0,26,0
1708254371707,PSYC 88,A00,419733,Dobkins; Karen R.,47,0,65,18
1708254372231,PSYC 100,A00,419734,Chapman; Eddie Nathaniel,388,0,410,22
1708254372761,PSYC 101,A00,419735,Walker; Caren Michelle,272,0,295,23
1708254373286,PSYC 102,A00,419779,Moranton; Nirelia Melbina-,292,0,295,3
1708254373812,PSYC 104,A00,419880,Fine; Rachel,267,0,295,28
1708254374357,PSYC 105,A00,419946,Lowe; Angela Beth,276,0,295,19
1708254374882,PSYC 111B,A01,419948,Geller; Emma Harlan,35,0,35,0
1708254375422,PSYC 116C,A01,420046,Lang; Ariel,25,0,25,0
1708254375952,PSYC 117,A01,420092,Bajic; Daniel Andrew,25,0,25,0
1708254376478,PSYC 118,A01,420095,Miller; Cory T.,37,0,45,8
1708254377010,PSYC 124,A00,420096,Chapman; Eddie Nathaniel,381,0,410,29
1708254377535,PSYC 127,A00,420097,Dickenson; Janna Alene,14,0,20,6
1708254378062,PSYC 132,A00,420121,Staff,114,0,120,6
1708254378594,PSYC 133R,A01,420172,Golden; Susan S. & Gorman; Michael R.,10,0,16,6
1708254378594,PSYC 133R,A02,420173,Golden; Susan S. & Gorman; Michael R.,16,0,16,0
1708254378594,PSYC 133R,A03,420175,Golden; Susan S. & Gorman; Michael R.,16,0,16,0
1708254378594,PSYC 133R,A04,420249,Golden; Susan S. & Gorman; Michael R.,13,0,16,3
1708254379120,PSYC 134,A00,420311,Kaye; Walter H.,296,0,300,4
1708254379647,PSYC 137,A00,420312,Lin; Chujun,292,0,295,3
1708254380174,PSYC 144,A00,420313,Wixted; John T,287,0,295,8
1708254380699,PSYC 147,A00,420315,Wong; Lauren Hitomi,120,0,146,26
1708254381227,PSYC 164,A00,420328,Kaplan; Paul,259,0,295,36
1708254381755,PSYC 172,A00,420336,Dickenson; Janna Alene,294,0,300,6
1708254382285,PSYC 178,A00,420337,Glaser; Dale,131,0,146,15
1708254382812,PSYC 179,A00,420338,Lacefield; Katharine I,256,0,328,72
1708254383344,PSYC 181,A00,420339,Anagnostaras; Stephan,333,0,350,17
1708254383870,PSYC 184,A00,420367,Wilson; Brent M,275,0,295,20
1708254384396,PSYC 188,A00,420368,Lacefield; Katharine I,234,0,300,66
1708254384927,PSYC 190,A00,420378,Barner; David A.,374,0,395,21
1708254385454,PSYC 193,B00,420626,Brashier; Nadia Marie,215,0,216,1
1708254385454,PSYC 193,C00,420643,Gremel; Christina M,33,0,35,2
1708254385983,PSYC 193L,A01,420817,Brown; Sandra A,65,0,65,0
1708254385983,PSYC 193L,B01,420830,Staff,26,0,30,4
1708254385983,PSYC 193L,C01,420832,Staff,49,0,49,0
1708254385983,PSYC 193L,D01,420834,Staff,27,0,30,3
1708254385983,PSYC 193L,E01,493996,Aron; Adam,24,0,24,0
1708254386512,PSYC 194C,A01,420905,Heyman; Gail D.,1,0,1,0
1708254387039,PSYC 205,A00,420906,Harris; Christine Renee,17,0,20,3
1708254387565,PSYC 218,A00,420907,Brady; Timothy Francis,11,0,20,9
1708254388094,PSYC 224,A00,420908,Gremel; Christina M,30,0,30,0
1708254388620,PSYC 242,A00,421469,Walker; Caren Michelle,27,0,30,3
1708254389148,PSYC 247,A00,421473,Walker; Caren Michelle,14,0,20,6
1708254389674,PSYC 270C,A00,421554,Dobkins; Karen R.,13,0,20,7
1708254390198,PSYC 272,A00,421561,Gentner; Tim,20,0,20,0
1708254390727,PSYC 274,A00,421564,McCullough; Michael E,29,0,30,1
1708254391251,PSYC 275,A00,421620,Staff,23,0,30,7
1708254391776,PSYC 276,A00,421622,McCullough; Michael E,14,0,20,6
1708254392305,PSYC 280,A00,421623,Serences; John Thomas,76,0,85,9
1708254392866,PSYC 296,001,421667,Anagnostaras; Stephan,9999,0,9999,0
1708254392866,PSYC 296,002,421773,Aron; Adam,9999,0,9999,0
1708254392866,PSYC 296,003,421794,Mukku; Dhananjaya,9999,0,9999,0
1708254392866,PSYC 296,004,421795,Barner; David A.,9998,0,9999,1
1708254392866,PSYC 296,005,421796,Schachner; Adena,9999,0,9999,0
1708254392866,PSYC 296,006,421797,Brown; Sandra A,9999,0,9999,0
1708254392866,PSYC 296,007,421798,Chapman; Eddie Nathaniel,9999,0,9999,0
1708254392866,PSYC 296,008,421799,Dickenson; Janna Alene,9999,0,9999,0
1708254392866,PSYC 296,009,421800,Dobkins; Karen R.,9998,0,9999,1
1708254392866,PSYC 296,010,421801,Fan; Judith Ellen,9999,0,9999,0
1708254392866,PSYC 296,011,421803,Ferreira; Victor,9999,0,9999,0
1708254392866,PSYC 296,012,421814,Geller; Emma Harlan,9998,0,9999,1
1708254392866,PSYC 296,013,422102,Gentner; Tim,9999,0,9999,0
1708254392866,PSYC 296,014,422103,Gorman; Michael R.,9999,0,9999,0
1708254392866,PSYC 296,015,422104,Gremel; Christina M,9999,0,9999,0
1708254392866,PSYC 296,016,422106,Harris; Christine Renee,9999,0,9999,0
1708254392866,PSYC 296,017,422107,Heyman; Gail D.,9999,0,9999,0
1708254392866,PSYC 296,018,422108,McCullough; Michael E,9999,0,9999,0
1708254392866,PSYC 296,019,422109,Mc Kenzie; Craig R.M.,9999,0,9999,0
1708254392866,PSYC 296,020,422122,Miller; Cory T.,9999,0,9999,0
1708254392866,PSYC 296,021,422123,Pashler; Harold E,9999,0,9999,0
1708254392866,PSYC 296,022,422124,Pilegard; Celeste Cristine,9999,0,9999,0
1708254392866,PSYC 296,023,422125,Powell; Lindsey Jane,9999,0,9999,0
1708254392866,PSYC 296,025,422127,Rickard; Timothy C.,9998,0,9999,1
1708254392866,PSYC 296,026,422128,Serences; John Thomas,9998,0,9999,1
1708254392866,PSYC 296,027,422130,Walker; Caren Michelle,9998,0,9999,1
1708254392866,PSYC 296,028,422132,Winkielman; Piotr,9999,0,9999,0
1708254392866,PSYC 296,029,422134,Wixted; John T,9996,0,9999,3
1708254392866,PSYC 296,030,422146,Brady; Timothy Francis,9998,0,9999,1
1708254392866,PSYC 296,031,422154,Carver; Leslie J.,9999,0,9999,0
1708254392866,PSYC 296,032,422161,Lin; Chujun,9999,0,9999,0
1708254392866,PSYC 296,033,422169,Brashier; Nadia Marie,9998,0,9999,1
1708254392866,PSYC 296,034,422177,Oesch; Nicholas W,9999,0,9999,0
1708254393393,RAD 296,001,465795,Staff,50,0,50,0
1708254393393,RAD 296,002,465796,Staff,50,0,50,0
1708254393393,RAD 296,003,465797,Staff,50,0,50,0
1708254393923,RELI 150,A00,419353,Rahimi; Babak,37,0,40,3
1708254394449,REV 87,A00,422721,Lyon; Antony J.,19,0,20,1
1708254395064,RMAS 296,001,465827,Murphy; James D,49,0,50,1
1708254395064,RMAS 296,002,465828,Staff,50,0,50,0
1708254395064,RMAS 296,003,465831,Staff,50,0,50,0
1708254395595,RMED 296,001,466791,Staff,50,0,50,0
1708254395595,RMED 296,002,466792,Staff,50,0,50,0
1708254395595,RMED 296,003,466793,Staff,50,0,50,0
1708254396123,SE 3,A01,446938,Van Den Einde; Yael Dahlia,50,0,52,2
1708254396123,SE 3,A02,446942,Van Den Einde; Yael Dahlia,49,0,52,3
1708254396123,SE 3,A03,446948,Van Den Einde; Yael Dahlia,52,0,53,1
1708254396123,SE 3,A04,446965,Van Den Einde; Yael Dahlia,53,0,53,0
1708254396650,SE 9,A01,447015,Kuester; Falko,30,0,34,4
1708254396650,SE 9,A02,447017,Kuester; Falko,33,0,33,0
1708254396650,SE 9,A03,447022,Kuester; Falko,31,0,33,2
1708254397179,SE 101B,A01,447040,Kosmatka; John B,55,0,56,1
1708254397708,SE 105,A01,447042,Qiao; Yu,118,0,120,2
1708254398235,SE 110A,A01,467467,Asaro; Robert J,56,0,56,0
1708254398761,SE 110B,A00,447045,Zhu; Qiang,122,0,125,3
1708254399289,SE 130B,A01,447049,Chadha; Mayank,92,0,100,8
1708254399814,SE 131A,A01,447059,Krysl; Petr,102,0,110,8
1708254400340,SE 132,A01,447078,Chen; Jiun-Shyan,48,0,50,2
1708254400866,SE 140B,A01,447086,Restrepo; Jose,29,0,34,5
1708254400866,SE 140B,A02,447123,Restrepo; Jose,21,0,33,12
1708254400866,SE 140B,A03,447124,Restrepo; Jose,30,0,33,3
1708254401394,SE 143B,A01,447133,Tehrani; Mehran,11,0,15,4
1708254401394,SE 143B,A02,447134,Tehrani; Mehran,12,0,15,3
1708254401920,SE 150A,A01,447136,Uang; Chia-Ming,94,0,100,6
1708254402449,SE 150B,A01,447214,Morrison; Machel Leigh,49,0,50,1
1708254402975,SE 151B,A00,447215,Shing; P. Benson,71,0,75,4
1708254403510,SE 160B,A01,467468,Kim; Hyunsun Alicia,91,0,100,9
1708254404039,SE 165,A00,447238,Farrar; Charles R.,9,0,10,1
1708254404565,SE 184,A00,447253,Hutchinson; Tara,20,0,20,0
1708254405095,SE 202,A00,447392,Kosmatka; John B,25,0,30,5
1708254405621,SE 204,A00,447482,Todd; Michael,12,0,20,8
1708254406148,SE 206,A00,447483,Conte; Joel P,30,0,30,0
1708254406676,SE 213,A00,447499,Palermo; Alessandro,17,0,30,13
1708254407202,SE 215,A00,447500,Zhu; Qiang,34,0,45,11
1708254407729,SE 222,A00,447507,Elgamal; Ahmed,30,0,30,0
1708254408255,SE 227,A00,447576,Hutchinson; Tara,20,0,25,5
1708254408781,SE 244,A00,447577,Elgamal; Ahmed,29,0,30,1
1708254409305,SE 247,A00,447580,Hutchinson; Tara,0,0,5,5
1708254409835,SE 251B,A00,447612,Qiao; Yu,15,0,25,10
1708254410360,SE 253B,A00,447613,Kim; Hyonny,28,0,30,2
1708254410889,SE 260B,A00,447614,Kim; Hyunsun Alicia,10,0,10,0
1708254411418,SE 265,A00,447615,Farrar; Charles R.,20,0,25,5
1708254411942,SE 266,A00,447616,Loh; Chin Hsiung,23,0,25,2
1708254412997,SE 280,A00,447650,Krysl; Petr,22,0,25,3
1708254413524,SE 281,A01,447658,Kuester; Falko,12,0,30,18
1708254414049,SE 290,A00,447659,Qiao; Yu,78,0,100,22
1708254414579,SE 296,001,447666,Asaro; Robert J,9999,0,9999,0
1708254414579,SE 296,002,447669,Chen; Jiun-Shyan,9999,0,9999,0
1708254414579,SE 296,003,447689,Conte; Joel P,9999,0,9999,0
1708254414579,SE 296,004,447690,Elgamal; Ahmed,9999,0,9999,0
1708254414579,SE 296,005,447728,Hutchinson; Tara,9999,0,9999,0
1708254414579,SE 296,006,447733,Jandaghi Semnani; Shabnam,9999,0,9999,0
1708254414579,SE 296,007,447734,Kim; Hyonny,9999,0,9999,0
1708254414579,SE 296,008,447737,Kim; Hyunsun Alicia,9999,0,9999,0
1708254414579,SE 296,009,447738,Kosmatka; John B,9999,0,9999,0
1708254414579,SE 296,010,447739,Krysl; Petr,9999,0,9999,0
1708254414579,SE 296,011,447740,Kuester; Falko,9999,0,9999,0
1708254414579,SE 296,012,447741,Lanza Di Scalea; Francesco,9999,0,9999,0
1708254414579,SE 296,013,447742,Loh; Kenneth J. H.,9999,0,9999,0
1708254414579,SE 296,014,447745,McCartney; John Scott,9999,0,9999,0
1708254414579,SE 296,015,447747,Morrison; Machel Leigh,9999,0,9999,0
1708254414579,SE 296,016,447749,Mosqueda; Gilberto,9999,0,9999,0
1708254414579,SE 296,017,447874,Qiao; Yu,9999,0,9999,0
1708254414579,SE 296,018,447875,Restrepo; Jose,9999,0,9999,0
1708254414579,SE 296,019,447886,Shing; P. Benson,9999,0,9999,0
1708254414579,SE 296,020,447887,Todd; Michael,9999,0,9999,0
1708254414579,SE 296,021,447888,Tomac; Ingrid,9999,0,9999,0
1708254414579,SE 296,022,447889,Tsampras; Georgios,9999,0,9999,0
1708254414579,SE 296,023,447890,Uang; Chia-Ming,9999,0,9999,0
1708254414579,SE 296,024,447931,Van Den Einde; Yael Dahlia,9999,0,9999,0
1708254414579,SE 296,025,447932,Zhu; Qiang,9999,0,9999,0
1708254414579,SE 296,026,448007,Tehrani; Mehran,9999,0,9999,0
1708254414579,SE 296,027,448008,Palermo; Alessandro,9999,0,9999,0
1708254414579,SE 296,028,492941,Farrar; Charles R.,9998,0,9999,1
1708254415109,SIO 10,A00,446025,Borsa; Adrian Antal,573,0,590,17
1708254415634,SIO 16,A00,446031,Gee; Jeffrey S,119,0,120,1
1708254416164,SIO 50,A01,446057,Cook; Geoffrey W,19,0,22,3
1708254416164,SIO 50,A02,446058,Cook; Geoffrey W,21,0,22,1
1708254416691,SIO 75,A00,446060,Norris; Richard D.,32,0,35,3
1708254417219,SIO 87,A00,479215,Feddersen; Falk & Morzfeld; Matthias,20,0,20,0
1708254417219,SIO 87,B00,489613,Cook; Geoffrey W,19,0,20,1
1708254417219,SIO 87,C00,489620,Cook; Geoffrey W,20,0,20,0
1708254417747,SIO 90,A00,446061,Staff,61,0,70,9
1708254418272,SIO 113,A01,446064,May; David Alexander,27,0,30,3
1708254419332,SIO 128,A00,446115,Bartlett; Douglas H,110,0,120,10
1708254419859,SIO 135,A01,446153,Fricker; Helen A.,16,0,17,1
1708254419859,SIO 135,A02,446156,Fricker; Helen A.,14,0,18,4
1708254420392,SIO 136,A01,446159,Kacev; David & Wegner; Nicholas Craig & Bartlett; Douglas H,31,0,33,2
1708254420392,SIO 136,A02,446160,Kacev; David & Wegner; Nicholas Craig & Bartlett; Douglas H,33,0,33,0
1708254420917,SIO 139,A00,446164,Kacev; David,66,0,70,4
1708254421444,SIO 141,A01,446173,Pomeroy; Robert S.,11,0,12,1
1708254421974,SIO 143,A01,446175,Andersson; Andreas Jerry,20,0,30,10
1708254422500,SIO 145,A01,446181,Choy; Carolyn Anela,6,0,18,12
1708254423033,SIO 152,A01,446184,Van Allen; Emily Joyce,8,0,10,2
1708254423033,SIO 152,A02,479204,Van Allen; Emily Joyce,10,0,10,0
1708254423566,SIO 153,A01,446188,Capaldi; Tomas,24,0,26,2
1708254424093,SIO 160,A00,446189,Stegman; David,21,0,25,4
1708254424622,SIO 164,A00,446193,Staff,27,0,35,8
1708254425147,SIO 173,A00,446194,Lutsko; Nicholas J.,28,0,30,2
1708254425673,SIO 174,A00,446197,Aluwihare; Lihini & Russell; Lynn M.,26,0,30,4
1708254426203,SIO 181,A01,446200,Tresguerres; Martin,18,0,25,7
1708254426203,SIO 181,A02,446201,Tresguerres; Martin,23,0,25,2
1708254426203,SIO 181,A03,446209,Tresguerres; Martin,24,0,25,1
1708254426203,SIO 181,A04,446211,Tresguerres; Martin,24,0,25,1
1708254426203,SIO 181,A05,446223,Tresguerres; Martin,24,0,25,1
1708254426203,SIO 181,A06,446236,Tresguerres; Martin,24,0,25,1
1708254426729,SIO 192,A00,479211,Gerwick; William Henry,20,0,20,0
1708254427257,SIO 194,A00,455340,Hill; Seth J,0,0,0,0
1708254427781,SIOB 262,A00,446243,Gerwick; William Henry,23,0,25,2
1708254428306,SIOB 269,A00,446244,Staff,19,0,20,1
1708254428835,SIOB 270,A01,446261,Allen; Andrew Ellis & Petrik; Colleen Mary,18,0,20,2
1708254429367,SIOB 278,A00,446273,Arcila; Dahiana K,13,0,15,2
1708254429367,SIOB 278,B00,481742,Aburto Oropeza; Marco Octavio,18,0,20,2
1708254429892,SIOB 279,A00,446286,Franks; Peter,31,0,35,4
1708254430416,SIOB 291,A00,446292,Hechinger; Ryan F.,20,0,20,0
1708254430946,SIOB 296,A00,446293,Mongiardino Koch; Nicolas,16,0,20,4
1708254431472,SIOB 297,A00,446294,Allen; Eric,66,0,70,4
1708254432002,SIOC 202B,A00,446312,Stramski; Dariusz & Gabriel; Anne Alice-Agnes,17,0,20,3
1708254432530,SIOC 203C,A01,446314,Young; William Roy,5,0,5,0
1708254433055,SIOC 207C,A00,492798,Vasconcelos; Manuela,5,0,5,0
1708254433584,SIOC 208,A00,446315,Merrifield; Mark A,16,0,20,4
1708254434112,SIOC 209,A00,478924,Werner; Bradley T.,11,0,15,4
1708254434112,SIOC 209,B00,479224,Watson-Parris; Duncan,15,0,25,10
1708254434112,SIOC 209,C00,480739,Ricke; Katharine L,24,0,24,0
1708254434641,SIOC 212B,A01,446324,Cessi; Paola,40,0,40,0
1708254435166,SIOC 217C,A00,446325,Lutsko; Nicholas J.,25,0,25,0
1708254435690,SIOC 220,A00,446326,Rudnick; Daniel Lars,13,0,15,2
1708254436217,SIOC 224,A00,446327,Eisenman; Ian,20,0,25,5
1708254436747,SIOC 228,A00,446328,Shi; Yuanyuan,1,0,10,9
1708254437273,SIOC 235,A00,446342,Xie; Shang-Ping,14,0,15,1
1708254437797,SIOC 251,A00,446343,Evan; Amato Tomas,19,0,20,1
1708254438325,SIOG 200B,A00,446344,Gabriel; Anne Alice-Agnes,9,0,10,1
1708254438851,SIOG 221,A00,446354,Parnell-Turner; Ross Ernes,29,0,30,1
1708254439375,SIOG 227B,A00,446355,Laske; Gabi & Shearer; Peter M,19,0,20,1
1708254439899,SIOG 228,A00,446356,Van Allen; Emily Joyce,7,0,20,13
1708254440424,SIOG 230,A00,446359,Constable; Catherine G,25,0,25,0
1708254440955,SIOG 232,A00,446360,Constable; Catherine G & Constable; Steven C,37,0,40,3
1708254441484,SIOG 234,A00,446361,Sandwell; David T,15,0,15,0
1708254442015,SIOG 236,A01,477658,Fricker; Helen A.,5,0,5,0
1708254442015,SIOG 236,A02,477685,Fricker; Helen A.,3,0,5,2
1708254442541,SIOG 239,A00,446362,Gabriel; Anne Alice-Agnes,19,0,20,1
1708254442541,SIOG 239,B00,481507,May; David Alexander,6,0,6,0
1708254442541,SIOG 239,C00,486863,Fialko; Yuri A.,15,0,15,0
1708254443067,SIOG 268,A00,446364,Barbeau; Katherine,12,0,15,3
1708254443594,SOCE 194,A00,455341,Hill; Seth J,0,0,0,0
1708254444119,SOCG 204,A00,446551,Ng; Kwai,0,0,8,8
1708254444648,SOCG 206,A00,446552,Alvarez; Camila Huerta,4,0,8,4
1708254445174,SOCG 214,A00,446553,Raudenbush; Danielle,3,0,8,5
1708254445701,SOCG 255B,A00,446602,Serlin; David,2,0,5,3
1708254446227,SOCG 255C,A00,446813,Gates; Kelly,3,0,5,2
1708254446756,SOCG 290,A00,446910,Thorpe; Charles Robert,0,0,10,10
1708254446756,SOCG 290,B00,446911,Goldman; Harvey Stern,1,0,10,9
1708254446756,SOCG 290,C00,446914,Lampland; Martha,5,0,10,5
1708254447288,SOCI 2,A01,446373,Rogers; Julia Ellen,28,0,30,2
1708254447288,SOCI 2,A02,446374,Rogers; Julia Ellen,29,0,30,1
1708254447288,SOCI 2,A03,446382,Rogers; Julia Ellen,29,0,30,1
1708254447288,SOCI 2,A04,446384,Rogers; Julia Ellen,30,0,30,0
1708254447288,SOCI 2,A05,446389,Rogers; Julia Ellen,30,0,30,0
1708254447288,SOCI 2,A06,446393,Rogers; Julia Ellen,29,0,30,1
1708254447816,SOCI 20,A01,446396,Calderon-Zaks; Michael Aar,33,0,34,1
1708254447816,SOCI 20,A02,446409,Calderon-Zaks; Michael Aar,34,0,34,0
1708254448395,SOCI 40,A01,446417,Raudenbush; Danielle,30,0,32,2
1708254448395,SOCI 40,A02,446419,Raudenbush; Danielle,31,0,32,1
1708254448395,SOCI 40,A03,446434,Raudenbush; Danielle,31,0,32,1
1708254448395,SOCI 40,A04,446436,Raudenbush; Danielle,28,0,32,4
1708254448395,SOCI 40,A05,446441,Raudenbush; Danielle,29,0,32,3
1708254448395,SOCI 40,A06,446445,Raudenbush; Danielle,32,0,32,0
1708254448923,SOCI 60,A01,446461,Sutton; April Marie,30,0,32,2
1708254448923,SOCI 60,A02,446468,Sutton; April Marie,30,0,32,2
1708254448923,SOCI 60,A03,446469,Sutton; April Marie,26,0,32,6
1708254448923,SOCI 60,A04,446471,Sutton; April Marie,31,0,32,1
1708254449449,SOCI 100,A01,446480,Payne; Christine Anna,28,0,30,2
1708254449449,SOCI 100,A02,446491,Payne; Christine Anna,29,0,30,1
1708254449449,SOCI 100,A03,446492,Payne; Christine Anna,28,0,30,2
1708254449449,SOCI 100,A04,446493,Payne; Christine Anna,27,0,30,3
1708254449977,SOCI 103M,A00,481672,Kilpatrick; Kevin,27,0,28,1
1708254450502,SOCI 104,A00,446494,Turner; Christena L.,28,0,30,2
1708254451032,SOCI 104Q,A00,446495,Rogers; Julia Ellen,27,0,30,3
1708254451558,SOCI 106,A00,446496,Payne; Christine Anna,25,0,30,5
1708254452083,SOCI 107,A00,446497,Staff,30,0,30,0
1708254452614,SOCI 109,A00,446498,Rona-Tas; Akos,20,0,25,5
1708254453139,SOCI 111,A00,446499,Ribas Norris; Janet Vanesa,54,0,56,2
1708254453664,SOCI 114,A00,446500,Lampland; Martha,73,0,75,2
1708254454196,SOCI 117,A01,446502,Jones; Gabrielle Anastasia,14,0,17,3
1708254454196,SOCI 117,A02,446516,Jones; Gabrielle Anastasia,17,0,17,0
1708254454196,SOCI 117,A03,458787,Jones; Gabrielle Anastasia,17,0,17,0
1708254454196,SOCI 117,A04,458835,Jones; Gabrielle Anastasia,19,0,19,0
1708254454723,SOCI 120T,A00,446518,Staff,56,0,56,0
1708254455249,SOCI 123,A00,446519,Staff,79,0,80,1
1708254455775,SOCI 125,A00,487186,Calderon-Zaks; Michael Aar,55,0,56,1
1708254456301,SOCI 126,A01,446532,Jones; Makeba,15,0,15,0
1708254456301,SOCI 126,A02,446533,Jones; Makeba,15,0,15,0
1708254456301,SOCI 126,A03,458839,Jones; Makeba,15,0,15,0
1708254456301,SOCI 126,A04,458840,Jones; Makeba,15,0,15,0
1708254456826,SOCI 133,A00,446534,Calderon-Zaks; Michael Aar,53,0,56,3
1708254457351,SOCI 135,A00,486886,Ruiz; Jonathan Joseph,55,0,56,1
1708254457879,SOCI 136,A00,486887,Ruiz; Jonathan Joseph,56,0,56,0
1708254458405,SOCI 139,A00,446535,Ribas Norris; Janet Vanesa,78,0,80,2
1708254458936,SOCI 140J,A00,446537,Estefan; Michel,75,0,100,25
1708254459461,SOCI 142,A00,477639,Crofts; Christine,43,0,50,7
1708254459990,SOCI 146,A00,446538,Summers; Valerie R.,113,0,120,7
1708254460516,SOCI 151,A00,446540,Goldman; Harvey Stern,56,0,56,0
1708254461043,SOCI 156,A00,446541,Ostovany; Khashayar,55,0,56,1
1708254461570,SOCI 157,A00,446542,Jules-Rosette; Bennetta W.,28,0,28,0
1708254462095,SOCI 159,A00,494493,Estefan; Michel,93,0,96,3
1708254462620,SOCI 161,A00,477638,Staff,45,0,45,0
1708254463146,SOCI 162,A00,477642,Staff,54,0,55,1
1708254463671,SOCI 165,A00,446543,Rona-Tas; Akos,49,0,56,7
1708254464202,SOCI 171,A00,446544,Thorpe; Charles Robert,56,0,56,0
1708254464727,SOCI 173,A00,482888,Crofts; Christine,92,0,100,8
1708254465252,SOCI 180,A00,446545,Ostovany; Khashayar,55,0,56,1
1708254465778,SOCI 183,A00,446546,Sutton; April Marie,43,0,45,2
1708254466308,SOCI 185,A00,494495,Staff,30,0,30,0
1708254466834,SOCI 188D,A00,446549,Kokinis; Troy Andreas,24,0,25,1
1708254467359,SOCI 198RA,001,446550,Ng; Kwai,30,0,30,0
1708254467886,SOMC 224C,A00,466928,Bhakta; Savita Ganapathi,160,0,160,0
1708254468414,SOMC 229,A00,466925,Hoang; Mai Phuong,160,0,160,0
1708254468939,SOMC 240,A00,466937,Coyne; Christopher John,150,0,150,0
1708254469464,SOMC 242,A00,466931,Kline; Ahnika Sarah,160,0,160,0
1708254469990,SOMC 244,A00,466939,Mandel; Jess,150,0,150,0
1708254470516,SOMC 245C,A01,466935,Noel; Geoffroy Pierre Jean,160,0,160,0
1708254471043,SOMC 246C,A00,487163,Eyler; Lisa T.,160,0,160,0
1708254471568,SOMC 247C,A50,466950,Calcutt; Nigel A,160,0,160,0
1708254472092,SOMC 248C,A00,466936,Joshi; Weena Erin,160,0,160,0
1708254472618,SOMC 255C,A00,466951,Allison; Matthew,160,0,160,0
1708254473145,SPPH 161R,A01,476600,Chambers; Christina D,99,0,100,1
1708254473676,SPPH 263B,A01,460901,Hook; Vivian Yuan-Ho,25,0,25,0
1708254474205,SPPS 200A,A00,460907,Luli; Alex J,99,0,99,0
1708254474730,SPPS 200B,A00,460928,Luli; Alex J,99,0,99,0
1708254475259,SPPS 200C,A00,460934,Luli; Alex J,95,0,99,4
1708254475785,SPPS 203,A00,460955,Painter; Nathan A.,83,0,99,16
1708254476314,SPPS 205,A01,460978,Bandeira; Nuno Filipe Cabrita,64,0,80,16
1708254476841,SPPS 209,A00,460979,Bounthavong; Mark,94,0,99,5
1708254477368,SPPS 210,001,460980,Gustafsson; Asa Birgitta,99,0,99,0
1708254477893,SPPS 211A,A00,460987,Ferguson; Fleur,85,0,99,14
1708254478422,SPPS 211B,A00,460991,Ferguson; Fleur,96,0,99,3
1708254478947,SPPS 211C,A00,460992,Ferguson; Fleur,95,0,99,4
1708254479477,SPPS 211D,A00,460993,Tsunoda; Shirley M.,99,0,99,0
1708254480000,SPPS 212C,A01,460995,Saunders; Ila Maewal,95,0,99,4
1708254480526,SPPS 213C,A00,460996,Awdishu; Linda,95,0,99,4
1708254481056,SPPS 218B,A00,460997,Mandyam; Chitra,95,0,99,4
1708254481583,SPPS 225,A01,460999,Reed; Chantal,83,0,99,16
1708254482110,SPPS 236,A00,461000,Reid; Erin G.,96,0,99,3
1708254482635,SPPS 237,A00,461002,Mimoto; Mizuho Stacy,96,0,99,3
1708254483163,SPPS 238,A00,461041,Beyhan; Sinem,96,0,99,3
1708254483691,SPPS 241,A01,461122,Tsunoda; Shirley M.,83,0,99,16
1708254484216,SPPS 249,A00,461123,Brandl; Katharina,96,0,99,3
1708254484745,SPPS 250,A00,461126,Tsunoda; Shirley M.,45,0,50,5
1708254485271,SPPS 251,A00,461127,Chen; Timothy,99,0,99,0
1708254485797,SPPS 252,A00,461128,Abdul-Mutakabbir; Jacinda,74,0,80,6
1708254486326,SPPS 254,A00,481670,Shapiro; Desiree Nicolette,77,0,80,3
1708254486855,SPPS 261,A00,461129,Chambers; Christina D,93,0,99,6
1708254487379,SPPS 278,A00,459983,Fricovsky; Eduardo Santiago,98,0,99,1
1708254487907,SPPS 280,A00,461259,Fricovsky; Eduardo Santiago,19,0,20,1
1708254488431,SPPS 283,A00,461283,Tsunoda; Shirley M.,96,0,99,3
1708254488957,SURG 261,A00,466973,Staff,50,0,50,0
1708254489487,SURG 296,001,467004,Agha Hosseini; Ava,49,0,50,1
1708254489487,SURG 296,002,467005,Hinchcliff; Katharine Moss,49,0,50,1
1708254489487,SURG 296,003,467006,Eliceiri; Brian,49,0,50,1
1708254490020,SYN 1,001,448577,Bishop; Graham,19,0,20,1
1708254490020,SYN 1,002,448578,Iatarola; Briana Marie,19,0,20,1
1708254490020,SYN 1,003,448579,Browne; Emily,20,0,20,0
1708254490020,SYN 1,004,448580,Vega; Adrian,20,0,20,0
1708254490020,SYN 1,005,448581,Browne; Emily,20,0,20,0
1708254490020,SYN 1,006,448582,Rock; Martin,20,0,20,0
1708254490020,SYN 1,007,448583,Rock; Martin,20,0,20,0
1708254490020,SYN 1,008,448584,Iatarola; Briana Marie,19,0,20,1
1708254490020,SYN 1,009,448585,Bishop; Graham,20,0,20,0
1708254490020,SYN 1,010,448586,Bishop; Graham,20,0,20,0
1708254490020,SYN 1,011,448587,Gladstein; Jill M,15,0,15,0
1708254490020,SYN 1,012,448588,Meyer; Leslie Rose,20,0,20,0
1708254490020,SYN 1,013,448589,Rosenberg; Ryan Glenn,20,0,20,0
1708254490020,SYN 1,014,448627,Rosenberg; Ryan Glenn,19,0,20,1
1708254490020,SYN 1,015,448630,Atkinson; Arthur Laird,20,0,20,0
1708254490020,SYN 1,016,448651,Hom; Kirstyn Courtney,20,0,20,0
1708254490020,SYN 1,017,448652,Difruscio; Mark,20,0,20,0
1708254490020,SYN 1,018,448669,Hom; Kirstyn Courtney,20,0,20,0
1708254490020,SYN 1,019,448674,Hom; Kirstyn Courtney,18,0,20,2
1708254490020,SYN 1,020,448675,Atkinson; Arthur Laird,20,0,20,0
1708254490020,SYN 1,021,448678,Gladstein; Jill M,15,0,15,0
1708254490020,SYN 1,022,448682,Iatarola; Briana Marie,20,0,20,0
1708254490020,SYN 1,023,448691,Birberick; Brittany Celest,20,0,20,0
1708254490020,SYN 1,024,448751,Birberick; Brittany Celest,20,0,20,0
1708254490020,SYN 1,027,448766,Deavenport; James Cary,19,0,20,1
1708254490020,SYN 1,028,448767,Meyer; Leslie Rose,20,0,20,0
1708254490020,SYN 1,029,448775,Tawater; Hanna Jean,20,0,20,0
1708254490020,SYN 1,030,448777,Tawater; Hanna Jean,20,0,20,0
1708254490020,SYN 1,031,448792,Deavenport; James Cary,20,0,20,0
1708254490020,SYN 1,032,480169,Tawater; Hanna Jean,18,0,20,2
1708254490550,SYN 1R,001,448793,Difruscio; Mark,20,0,20,0
1708254490550,SYN 1R,004,449146,Difruscio; Mark,20,0,20,0
1708254491076,SYN 100,A01,449148,Staff,11,0,15,4
1708254491076,SYN 100,A02,449149,Staff,15,0,15,0
1708254491076,SYN 100,B01,449164,Gladstein; Jill M,0,0,0,0
1708254491076,SYN 100,B02,449166,Gladstein; Jill M,0,0,0,1
1708254491076,SYN 100,C01,449244,Staff,7,0,15,8
1708254491076,SYN 100,C02,449274,Staff,13,0,15,2
1708254491076,SYN 100,D01,449278,Staff,20,0,20,0
1708254491076,SYN 100,D02,449279,Staff,20,0,20,0
1708254491076,SYN 100,E01,449281,Rock; Martin,9,0,15,6
1708254491076,SYN 100,E02,449282,Rock; Martin,14,0,15,1
1708254491076,SYN 100,F01,449304,Browne; Emily,12,0,15,3
1708254491076,SYN 100,F02,449306,Browne; Emily,14,0,15,1
1708254491076,SYN 100,I01,449390,Gormally; Brenna,0,0,0,0
1708254491076,SYN 100,I02,449391,Gormally; Brenna,0,0,0,0
1708254491076,SYN 100,J01,449401,Atkinson; Arthur Laird,11,0,15,4
1708254491076,SYN 100,J02,449402,Atkinson; Arthur Laird,14,0,15,1
1708254491076,SYN 100,K01,449404,Deavenport; James Cary,11,0,15,4
1708254491076,SYN 100,K02,449405,Deavenport; James Cary,14,0,15,1
1708254491076,SYN 100,L01,449408,Rosenberg; Ryan Glenn,10,0,15,5
1708254491076,SYN 100,L02,449420,Rosenberg; Ryan Glenn,15,0,15,0
1708254491603,SYN 150,001,450016,Vega; Adrian,19,0,19,0
1708254491603,SYN 150,003,450031,Birberick; Brittany Celest,20,0,20,0
1708254492128,SYN 150R,001,494950,Vega; Adrian,20,0,20,0
1708254492654,SYN 198,001,494388,Staff,9999,0,9999,0
1708254493180,TDAC 1,A00,450042,Walsh; Kim C.,14,0,20,6
1708254493180,TDAC 1,B00,450043,Walsh; Kim C.,11,0,20,9
1708254493180,TDAC 1,C00,450044,Walsh; Kim C.,15,0,20,5
1708254493180,TDAC 1,D00,486830,Basso; Beatrice,20,0,20,0
1708254493180,TDAC 1,E00,492912,Walsh; Kim C.,15,0,20,5
1708254493180,TDAC 1,F00,492936,Walsh; Kim C.,18,0,20,2
1708254493706,TDAC 101,A00,450895,Celik; Aysan Karagasli,18,0,20,2
1708254494236,TDAC 102,A00,450904,Walsh; Kim C.,20,0,20,0
1708254494236,TDAC 102,B00,450916,Harting; Carla Kelso,20,0,20,0
1708254494762,TDAC 108,A00,450917,Buescher; Stephen W.,18,0,20,2
1708254495288,TDAC 109,A00,450924,Blair; Kyle Adam,20,0,20,0
1708254495820,TDAC 122,A00,451025,Perry; Lamar,30,0,30,0
1708254495820,TDAC 122,B00,480845,Perry; Lamar,30,0,30,0
1708254496349,TDAC 123,A00,451026,Buescher; Stephen W.,30,0,30,0
1708254496349,TDAC 123,B00,451028,Celik; Aysan Karagasli,30,0,30,0
1708254496349,TDAC 123,C00,480851,Perry; Lamar,30,0,30,0
1708254496875,TDDE 101,A00,451030,Guirguis; Mark C,18,0,20,2
1708254497403,TDDE 112,A00,451032,Staff,20,0,20,0
1708254497929,TDDE 130,A00,451033,Guirguis; Mark C,19,0,20,1
1708254498458,TDDE 132,A00,451034,Guirguis; Mark C,20,0,20,0
1708254498985,TDDE 169A,A00,481304,Petrovich; Victoria A.,19,0,20,1
1708254499510,TDDM 1,A00,450045,Weinberg; Sadie,27,0,30,3
1708254500036,TDDM 101,A00,451067,Staff,29,0,30,1
1708254500562,TDDR 101,A00,451068,Powell; Lora,29,0,34,5
1708254501091,TDDR 102,A00,451069,Powell; Lora,19,0,20,1
1708254501670,TDDR 111,A00,451070,Castro; Robert Jess,15,0,16,1
1708254501670,TDDR 111,B00,451071,Castro; Robert Jess,15,0,16,1
1708254502201,TDDR 190,A00,451073,Perry; Lamar,1,0,1,0
1708254502729,TDGE 1,A01,450047,Salovey; Todd,20,0,20,0
1708254502729,TDGE 1,A02,450048,Salovey; Todd,20,0,20,0
1708254502729,TDGE 1,A03,450085,Salovey; Todd,18,0,20,2
1708254502729,TDGE 1,A04,450093,Salovey; Todd,20,0,20,0
1708254502729,TDGE 1,A05,450096,Salovey; Todd,19,0,20,1
1708254502729,TDGE 1,A06,450132,Salovey; Todd,16,0,20,4
1708254503257,TDGE 25,A00,450236,Harting; Carla Kelso,12,0,20,8
1708254503257,TDGE 25,B00,450240,Harting; Carla Kelso,16,0,20,4
1708254503257,TDGE 25,C00,450243,Harting; Carla Kelso,14,0,20,6
1708254503257,TDGE 25,D00,450388,Harting; Carla Kelso,16,0,20,4
1708254503786,TDGE 100,A01,451098,Salovey; Todd,24,0,25,1
1708254503786,TDGE 100,A02,451099,Salovey; Todd,24,0,25,1
1708254504311,TDGE 124,A00,451122,Fulton; Julia,168,0,200,32
1708254504841,TDGE 125,A00,480853,Havis; Allan,197,0,200,3
1708254504841,TDGE 125,B00,480886,Staff,216,0,220,4
1708254505366,TDGE 133,A00,481097,Brill; Robert L.,20,0,20,0
1708254505892,TDGE 196B,A00,493144,Barricelli; Marc Alexander,1,0,1,0
1708254505892,TDGE 196B,B00,493148,Buescher; Stephen W.,2,0,2,0
1708254505892,TDGE 196B,C00,493151,Burelle; Julie Sara Veronique,1,0,1,0
1708254505892,TDGE 196B,D00,493189,Castro; Robert Jess,2,0,2,0
1708254505892,TDGE 196B,E00,493190,Guirguis; Mark C,1,0,1,0
1708254505892,TDGE 196B,F00,493240,Iizuka; Naomi Hisako,1,0,1,0
1708254505892,TDGE 196B,G00,493241,Perry; Lamar,1,0,1,0
1708254505892,TDGE 196B,H00,493249,Powell; Lora,1,0,1,0
1708254505892,TDGE 196B,I00,493296,Stein; Deborah Isobel,6,0,6,0
1708254506421,TDGR 213C,A00,451385,Buescher; Stephen W.,10,0,10,0
1708254506947,TDGR 220A,A00,451386,Barricelli; Marc Alexander,10,0,10,0
1708254507474,TDGR 239,A00,451387,Blair; Kyle Adam,10,0,10,0
1708254508003,TDGR 240,A00,481306,Portes; Elizabeth Marie,5,0,5,0
1708254508531,TDGR 245,A00,451388,Perry; Lamar,7,0,7,0
1708254509059,TDGR 250,A00,451395,Iizuka; Naomi Hisako,8,0,10,2
1708254509585,TDGR 251,A00,451397,Iizuka; Naomi Hisako,9,0,10,1
1708254509585,TDGR 251,B00,451398,Stein; Deborah Isobel,9,0,10,1
1708254510109,TDGR 257B,A00,451399,Finch; Michael S,8,0,10,2
1708254510637,TDGR 278,A00,481307,Petrovich; Victoria A.,4,0,5,1
1708254511164,TDGR 279,A00,451400,Bokovikova; Alina V,9,0,10,1
1708254511164,TDGR 279,B00,451401,Brill; Robert L.,10,0,10,0
1708254511164,TDGR 279,C00,451402,Petrovich; Victoria A.,10,0,10,0
1708254511164,TDGR 279,D00,451403,McElver; Robert Harrison,10,0,10,0
1708254511164,TDGR 279,E00,451404,Kuhl; Christopher August,10,0,10,0
1708254511690,TDGR 286,A00,451405,Knox; Leila Elizabeth,9,0,10,1
1708254512220,TDGR 288,A00,451406,Powell; Lora,6,0,7,1
1708254512748,TDGR 292,A00,451407,Power; Jade Yukana,10,0,10,0
1708254512748,TDGR 292,B00,451408,Mehrishi; Rishika,10,0,10,0
1708254513278,TDGR 293,001,451417,Power; Jade Yukana,7,0,7,0
1708254513278,TDGR 293,002,451418,Burelle; Julie Sara Veronique,7,0,7,0
1708254513278,TDGR 293,003,451419,Yapp; Hentyle T,7,0,7,0
1708254513278,TDGR 293,005,451421,Anderson; Mysia Anyse,7,0,7,0
1708254513803,TDGR 294,001,451429,Burelle; Julie Sara Veronique,7,0,7,0
1708254513803,TDGR 294,002,451431,Power; Jade Yukana,7,0,7,0
1708254513803,TDGR 294,003,451432,Yapp; Hentyle T,7,0,7,0
1708254514333,TDGR 295,A00,451433,Barricelli; Marc Alexander,10,0,10,0
1708254514860,TDGR 296,A00,451489,Powell; Lora,6,0,7,1
1708254514860,TDGR 296,B00,451497,Porter; Lisa,6,0,7,1
1708254515387,TDHD 175,A00,451123,Jun; Grace Shin Hae,40,0,40,0
1708254515917,TDHD 176,A00,451124,Caligagan; Maria T.,40,0,40,0
1708254516444,TDHT 10,A00,450409,Power; Jade Yukana,20,0,20,0
1708254516444,TDHT 10,B00,450450,Power; Jade Yukana,19,0,20,1
1708254516977,TDHT 23,A01,450546,Salimi; Rana,24,0,24,0
1708254516977,TDHT 23,A02,450549,Salimi; Rana,22,0,24,2
1708254516977,TDHT 23,A03,450553,Salimi; Rana,24,0,24,0
1708254517504,TDHT 101,A00,451125,Anderson; Mysia Anyse,25,0,25,0
1708254517504,TDHT 101,B00,451126,Mehrishi; Rishika,23,0,25,2
1708254518029,TDHT 104,A00,451225,Basso; Beatrice,22,0,25,3
1708254518556,TDHT 109,A01,451227,Anderson; Mysia Anyse,25,0,25,0
1708254519082,TDHT 122,A00,451228,Power; Jade Yukana,21,0,25,4
1708254519608,TDMV 1,A00,450558,Caligagan; Maria T.,15,0,30,15
1708254520138,TDMV 2,A00,450627,Anabo; Cherry,24,0,30,6
1708254520665,TDMV 3,A00,450630,Arcidiacono; Kristin,37,0,40,3
1708254521191,TDMV 11,A00,481244,Fyall; DauntÉ Edward,30,0,30,0
1708254521720,TDMV 20,A00,450789,Smith; Alison D,38,0,40,2
1708254522245,TDMV 110,A00,451229,Caligagan; Maria T.,28,0,30,2
1708254522771,TDMV 111,A00,451234,Smith; Alison D,28,0,30,2
1708254523298,TDMV 120,A00,451260,Weinberg; Sadie,30,0,30,0
1708254523298,TDMV 120,B00,451261,Sammartano; Tonnie,30,0,30,0
1708254523823,TDMV 122,A00,451262,Staff,28,0,30,2
1708254524354,TDMV 123,A00,451263,Duran; Marcos Antonio,28,0,30,2
1708254524882,TDMV 130,A00,451272,Mack; Kara Shanai',30,0,30,0
1708254525412,TDMV 138,A00,451275,Jun; Grace Shin Hae,4,0,30,26
1708254525940,TDMV 140,A00,451276,Lima; Paulo Henrique,40,0,40,0
1708254525940,TDMV 140,B00,451308,Power; Jade Yukana,39,0,40,1
1708254525940,TDMV 140,C00,451371,Caligagan; Tony,40,0,40,0
1708254525940,TDMV 140,D00,451373,Corrales; Joseph Bernales,28,0,30,2
1708254526465,TDMV 141,A00,451374,Caligagan; Tony,26,0,30,4
1708254526995,TDMV 142,A00,451375,Blanco; Juan Carlos,26,0,40,14
1708254527521,TDMV 143,A00,451376,Fyall; DauntÉ Edward,39,0,40,1
1708254528050,TDMV 144,A00,451377,Anabo; Cherry,39,0,40,1
1708254528579,TDMV 149,A00,451378,Jun; Grace Shin Hae,36,0,40,4
1708254529107,TDPF 162,A00,451379,Alvarez; Ana Maria,40,0,40,0
1708254529635,TDPR 6,A01,450799,Guirguis; Mark C,50,0,50,0
1708254529635,TDPR 6,A02,450801,Guirguis; Mark C,50,0,50,0
1708254530163,TDPR 102,A00,451380,Guirguis; Mark C,20,0,20,0
1708254530689,TDPR 104,A00,451381,Powell; Lora,15,0,15,0
1708254531217,TDPW 1,A00,450808,Stein; Deborah Isobel,14,0,15,1
1708254531217,TDPW 1,B00,450864,Stein; Deborah Isobel,13,0,15,2
1708254531217,TDPW 1,C00,450865,Stein; Deborah Isobel,15,0,15,0
1708254531217,TDPW 1,D00,450868,Stein; Deborah Isobel,13,0,15,2
1708254531217,TDPW 1,E00,450874,Stein; Deborah Isobel,14,0,15,1
1708254531742,TDPW 102,A00,451382,Staff,18,0,20,2
1708254532272,TDPW 104,A00,481182,Staff,17,0,20,3
1708254532802,TDTR 10,A00,450881,Wilson; Terry A.,28,0,30,2
1708254533328,TDTR 15,A00,450882,Smith; Alison D,30,0,30,0
1708254533856,TMC 15,A00,479039,Hemans; Patricia Ann Benitez,25,0,25,0
1708254534385,TMC 87,A00,479049,Solomon; Amanda Lee Albaniel,20,0,20,0
1708254534915,UROL 296,001,467060,Anger; Jennifer Tash,49,0,50,1
1708254534915,UROL 296,002,467061,Staff,50,0,50,0
1708254535441,USP 3,A01,458852,Martin; Isaac,34,0,35,1
1708254535441,USP 3,A02,458853,Martin; Isaac,35,0,35,0
1708254535441,USP 3,A03,458861,Martin; Isaac,34,0,35,1
1708254535441,USP 3,A04,458862,Martin; Isaac,32,0,35,3
1708254535968,USP 4,A00,451772,Schwaller; Nora Louise,19,0,25,6
1708254536499,USP 5,A01,458863,Shenkman; Michael Thomas,33,0,35,2
1708254536499,USP 5,A02,458864,Shenkman; Michael Thomas,31,0,35,4
1708254537031,USP 15,A01,458931,Staff,33,0,35,2
1708254537031,USP 15,A02,459024,Staff,31,0,35,4
1708254537557,USP 25,A00,451786,Sun; Feiyang,57,0,60,3
1708254538084,USP 100,A00,451787,Moses; Kelema Lee,55,0,60,5
1708254538612,USP 108,A00,477594,Martin; Isaac,25,0,25,0
1708254539141,USP 119,A00,477595,Schwaller; Nora Louise,23,0,25,2
1708254539670,USP 124,A00,451790,Hinds; Juli Beth,62,0,70,8
1708254540196,USP 128B,A01,451910,Lewis; Leslie R,12,0,13,1
1708254540722,USP 142B,A01,451954,Lewis; Leslie R,24,0,25,1
1708254541251,USP 142C,A00,451977,Lerner; Amy M,0,0,0,0
1708254541781,USP 145,A00,451999,Yaghmaee; Saman,140,0,146,6
1708254542308,USP 150,A00,452165,Staff,44,0,50,6
1708254542834,USP 151,A00,452166,Staff,49,0,50,1
1708254543367,USP 152A,A01,459025,Weaver; Todd D,25,0,25,0
1708254543367,USP 152A,A02,459074,Weaver; Todd D,24,0,25,1
1708254543893,USP 152B,A00,452224,Moeder; Nathan L,21,0,25,4
1708254544422,USP 153,A00,452339,Shenkman; Michael Thomas,50,0,50,0
1708254544949,USP 158A,A00,452410,Sun; Feiyang,25,0,25,0
1708254545475,USP 159B,A00,452411,Gherini; Paul Pier-Carlo,6,0,8,2
1708254546005,USP 160,A00,452412,Wartell; Julie Dara,25,0,25,0
1708254546531,USP 164,A00,452413,Moses; Kelema Lee,22,0,25,3
1708254547058,USP 165C,A00,452442,Frank; Lawrence Douglas,20,0,20,0
1708254547588,USP 169,A00,452598,Bajaj; Ravi Siddharth,32,0,35,3
1708254548115,USP 170,A00,477593,Entezam; Maryam,60,0,60,0
1708254548645,USP 172,A00,452676,Peerson; Susan,19,0,25,6
1708254549171,USP 175,A00,452848,Velasco; Diego,18,0,20,2
1708254549699,USP 177A,A00,453084,Velasco; Diego,21,0,25,4
1708254550228,USP 177B,A00,453127,Peerson; Susan,22,0,25,3
1708254550756,USP 183,A00,453128,Sutton; April Marie,19,0,20,1
1708254551286,USP 188B,A00,453187,Pezzoli; Keith,30,0,30,0
1708254551812,USP 190,A00,453234,Pezzoli; Keith,0,0,0,1
1708254552338,USP 191B,A00,453240,Polat; Soydan Alihan,18,0,20,2
1708254552864,USP 193,A00,453251,Bussell; Mirle Rabinowitz,24,0,25,1
1708254553390,USP 194,A00,455342,Hill; Seth J,0,0,0,0
1708254553919,USP 265C,A00,453264,Frank; Lawrence Douglas,10,0,10,0
1708254554447,VIS 3,A01,453427,Staff,25,0,25,0
1708254554447,VIS 3,A02,453428,Staff,15,0,25,10
1708254554447,VIS 3,A03,453429,Staff,25,0,25,0
1708254554447,VIS 3,A04,453430,Staff,21,0,25,4
1708254554447,VIS 3,A05,453431,Staff,25,0,25,0
1708254554447,VIS 3,A06,453432,Staff,23,0,25,2
1708254554447,VIS 3,A07,453433,Staff,17,0,25,8
1708254554447,VIS 3,A08,453434,Staff,23,0,25,2
1708254554447,VIS 3,A09,453435,Staff,21,0,25,4
1708254554447,VIS 3,A10,453436,Staff,23,0,25,2
1708254555045,VIS 9,A00,453437,Camargo; William,116,0,146,30
1708254555574,VIS 10,A00,453438,Kiratli; Solen,189,0,200,11
1708254556103,VIS 21B,A01,453440,Shen; Kuiyi,31,0,32,1
1708254556103,VIS 21B,A02,453441,Shen; Kuiyi,31,0,32,1
1708254556103,VIS 21B,A03,453442,Shen; Kuiyi,31,0,32,1
1708254556103,VIS 21B,A04,453443,Shen; Kuiyi,32,0,32,0
1708254556103,VIS 21B,A05,453444,Shen; Kuiyi,32,0,32,0
1708254556103,VIS 21B,A06,453452,Shen; Kuiyi,32,0,32,0
1708254556103,VIS 21B,A07,453468,Shen; Kuiyi,30,0,32,2
1708254556103,VIS 21B,A08,453587,Shen; Kuiyi,32,0,32,0
1708254556631,VIS 22,A01,453589,Rose; Jordan M,32,0,32,0
1708254556631,VIS 22,A02,453590,Rose; Jordan M,32,0,32,0
1708254556631,VIS 22,A03,453615,Rose; Jordan M,31,0,32,1
1708254556631,VIS 22,A04,453616,Rose; Jordan M,32,0,32,0
1708254556631,VIS 22,A05,453617,Rose; Jordan M,30,0,32,2
1708254556631,VIS 22,A06,453618,Rose; Jordan M,30,0,32,2
1708254556631,VIS 22,A07,453620,Rose; Jordan M,32,0,32,0
1708254556631,VIS 22,A08,453621,Rose; Jordan M,32,0,32,0
1708254556631,VIS 22,A09,453635,Rose; Jordan M,32,0,32,0
1708254556631,VIS 22,A10,453636,Rose; Jordan M,32,0,32,0
1708254557160,VIS 31,A00,453637,Dominguez; Ricardo,133,0,146,13
1708254557688,VIS 41,A01,453644,D'Elena-Tweed; Jessica Erin,23,0,25,2
1708254557688,VIS 41,A02,453645,D'Elena-Tweed; Jessica Erin,22,0,25,3
1708254557688,VIS 41,A03,453646,D'Elena-Tweed; Jessica Erin,25,0,25,0
1708254557688,VIS 41,A04,453647,D'Elena-Tweed; Jessica Erin,18,0,25,7
1708254557688,VIS 41,A05,453648,D'Elena-Tweed; Jessica Erin,25,0,25,0
1708254557688,VIS 41,A06,453650,D'Elena-Tweed; Jessica Erin,24,0,25,1
1708254558213,VIS 70N,A01,453652,Garnett; Mariah J,21,0,22,1
1708254558213,VIS 70N,A02,453653,Garnett; Mariah J,21,0,22,1
1708254558213,VIS 70N,A03,453654,Garnett; Mariah J,22,0,22,0
1708254558213,VIS 70N,A04,453657,Garnett; Mariah J,22,0,22,0
1708254558213,VIS 70N,A05,453662,Garnett; Mariah J,20,0,22,2
1708254558213,VIS 70N,A06,453663,Garnett; Mariah J,22,0,22,0
1708254558742,VIS 83,A00,453664,Kester; Grant,137,0,146,9
1708254559271,VIS 101A,A00,453666,Cruz; Edwin Teddy,10,0,15,5
1708254559797,VIS 102,A00,453668,Cruz; Edwin Teddy,81,0,85,4
1708254560326,VIS 105A,A00,453669,Adler; Amy,29,0,30,1
1708254560852,VIS 105B,A00,453738,Herc-Balaszek; Malgorzata,25,0,30,5
1708254560852,VIS 105B,B00,453739,Staff,27,0,30,3
1708254561381,VIS 106A,A00,453740,Staff,22,0,25,3
1708254561908,VIS 106B,A00,453741,De Luca; Mara Julia,20,0,25,5
1708254562434,VIS 106C,A00,453746,Vangenderen; Monique Luise,11,0,15,4
1708254562965,VIS 107A,A00,453747,Gregoire; Mathieu,19,0,25,6
1708254563490,VIS 107B,A00,453748,Dean; Danielle Adobi,23,0,25,2
1708254564019,VIS 110A,A00,453749,Adler; Amy,13,0,15,2
1708254564543,VIS 110E,A00,453798,Gregoire; Mathieu,14,0,15,1
1708254565069,VIS 110F,A00,453799,Staff,15,0,15,0
1708254565595,VIS 110N,A00,453803,Dean; Danielle Adobi,15,0,15,0
1708254566126,VIS 123B,A00,453804,Gaines; Malik Julian,75,0,75,0
1708254566652,VIS 125BN,A00,453813,Welchman; John C.,75,0,75,0
1708254567177,VIS 126P,A00,453814,Wardwell; Mariana Razo,74,0,75,1
1708254567702,VIS 128E,A00,453815,Staff,75,0,75,0
1708254568228,VIS 129E,A00,453855,Shen; Kuiyi,12,0,15,3
1708254568760,VIS 131,A00,453859,Trigilio; Michael,12,0,15,3
1708254568760,VIS 131,B00,479342,Mangolte; Babette,15,0,15,0
1708254569301,VIS 133A,A00,454231,Barbosa; Erika Katrina,13,0,15,2
1708254569830,VIS 134,A00,454232,Yoldas; Pinar,59,0,75,16
1708254570356,VIS 141B,A00,454233,Stalbaum; Brett,12,0,15,3
1708254570884,VIS 145B,A00,454234,Alexander; Amy J,14,0,15,1
1708254570884,VIS 145B,B00,454235,Kiratli; Solen,8,0,15,7
1708254571412,VIS 147A,A01,454237,Stalbaum; Brett,20,0,22,2
1708254571412,VIS 147A,A02,454238,Stalbaum; Brett,18,0,22,4
1708254571942,VIS 157,A01,454240,Cartwright; Lisa,32,0,34,2
1708254571942,VIS 157,A02,454241,Cartwright; Lisa,32,0,34,2
1708254572469,VIS 159,A01,454243,Akten; Mehmet,34,0,34,0
1708254572469,VIS 159,A02,454244,Akten; Mehmet,32,0,34,2
1708254572469,VIS 159,A03,454300,Akten; Mehmet,30,0,34,4
1708254572469,VIS 159,A04,454301,Akten; Mehmet,33,0,34,1
1708254572469,VIS 159,A05,454302,Akten; Mehmet,30,0,34,4
1708254572469,VIS 159,A06,454307,Akten; Mehmet,33,0,34,1
1708254572469,VIS 159,A07,454308,Akten; Mehmet,34,0,34,0
1708254572469,VIS 159,A08,454309,Akten; Mehmet,33,0,34,1
1708254572996,VIS 160B,A00,454310,Alexander; Amy J,13,0,15,2
1708254572996,VIS 160B,B00,454311,Akten; Mehmet,14,0,15,1
1708254572996,VIS 160B,C00,454312,Stone; Patricia,12,0,15,3
1708254573527,VIS 164,A00,454313,Cross; Brian R,19,0,22,3
1708254573527,VIS 164,B00,454314,Camargo; William,22,0,22,0
1708254574058,VIS 165,A00,454315,Erdmann; Dean,22,0,22,0
1708254574584,VIS 167,A00,454316,Staff,18,0,22,4
1708254575350,VIS 169A,A00,454317,Mostajo; Lorena,21,0,22,1
1708254575877,VIS 171,A00,454318,Nakayama; Yue,21,0,22,1
1708254576406,VIS 174,A00,454319,Staff,19,0,22,3
1708254576936,VIS 177,A00,454320,Cho; Erica,21,0,22,1
1708254577480,VIS 178,A00,454321,Staff,0,0,0,0
1708254578009,VIS 179,A00,454322,Erdmann; Dean,22,0,22,0
1708254578536,VIS 180A,A00,454323,Nakayama; Yue,21,0,22,1
1708254579061,VIS 180B,A00,454341,Cross; Brian R,20,0,22,2
1708254579590,VIS 183A,A00,454342,Cho; Erica,17,0,22,5
1708254580116,VIS 185,A00,454343,Miller; Nicole L,18,0,22,4
1708254580643,VIS 190,A00,454360,Crandall; Jordan,15,0,15,0
1708254580643,VIS 190,B00,454361,D'Elena-Tweed; Jessica Erin,10,0,15,5
1708254581168,VIS 202,A00,454369,Miller; Nicole L,12,0,15,3
1708254581696,VIS 203,A00,454370,Garnett; Mariah J,8,0,15,7
1708254582222,VIS 206,A00,454376,Kester; Grant,10,0,15,5
1708254582748,VIS 208,A00,454377,Moss; Ceci,15,0,15,0
1708254583277,VIS 211,A00,454413,Segade; Alexandro Abraham,0,0,0,2
1708254583805,VIS 243,A00,454429,Rose; Jordan M,5,0,15,10
1708254584331,VIS 255,A00,454430,Welchman; John C.,8,0,15,7
1708254584855,VIS 262,A00,454431,Yoldas; Pinar,11,0,15,4
1708254585383,WCWP 10A,001,454442,Uriarte; Emma,17,0,20,3
1708254585383,WCWP 10A,002,454443,Uriarte; Emma,14,0,20,6
1708254585383,WCWP 10A,003,454479,Uriarte; Emma,19,0,20,1
1708254585383,WCWP 10A,004,454480,Staff,0,0,0,0
1708254585383,WCWP 10A,005,454484,Staff,0,0,0,0
1708254585383,WCWP 10A,006,454485,Staff,0,0,0,0
1708254585383,WCWP 10A,007,454487,Staff,0,0,0,0
1708254585383,WCWP 10A,008,454488,Susi; Natalie,14,0,20,6
1708254585383,WCWP 10A,009,454489,Staff,0,0,0,0
1708254585383,WCWP 10A,010,454490,Staff,0,0,0,0
1708254585927,WCWP 10B,001,454492,Ornelas; Tricia,20,0,20,0
1708254585927,WCWP 10B,002,454501,Ornelas; Tricia,20,0,20,0
1708254585927,WCWP 10B,003,454565,Gagnon; Jeffrey C,2,0,20,18
1708254585927,WCWP 10B,004,454604,Ornelas; Tricia,16,0,20,4
1708254585927,WCWP 10B,005,454668,Staff,16,0,16,0
1708254585927,WCWP 10B,006,454724,Staff,16,0,16,0
1708254585927,WCWP 10B,007,454725,Staff,14,0,16,2
1708254585927,WCWP 10B,008,454768,Staff,0,0,0,0
1708254585927,WCWP 10B,009,454769,Staff,0,0,0,0
1708254585927,WCWP 10B,010,454770,Staff,0,0,0,0
1708254585927,WCWP 10B,011,454771,Dhir; Simrita,16,0,20,4
1708254585927,WCWP 10B,012,454772,Dhir; Simrita,16,0,20,4
1708254585927,WCWP 10B,013,454773,Merryman; Walter,17,0,20,3
1708254585927,WCWP 10B,014,454774,Dhir; Simrita,18,0,20,2
1708254585927,WCWP 10B,015,454775,Merryman; Walter,17,0,20,3
1708254585927,WCWP 10B,016,454776,Merryman; Walter,18,0,20,2
1708254585927,WCWP 10B,017,454777,Welji; Haleema Nazir,14,0,16,2
1708254585927,WCWP 10B,018,478868,Staff,16,0,16,0
1708254585927,WCWP 10B,019,478869,Staff,0,0,0,0
1708254585927,WCWP 10B,020,478876,Staff,0,0,0,0
1708254585927,WCWP 10B,021,478877,Staff,0,0,0,0
1708254585927,WCWP 10B,022,478887,Staff,0,0,0,0
1708254585927,WCWP 10B,023,478889,Staff,16,0,16,0
1708254585927,WCWP 10B,024,478892,Staff,0,0,0,0
1708254585927,WCWP 10B,025,478907,Staff,0,0,0,0
1708254587488,WCWP 100,A00,454800,McCleary; Keith Long,20,0,20,0
1708254587488,WCWP 100,B00,454804,McCleary; Keith Long,20,0,20,0
1708254587488,WCWP 100,C00,454822,Twohig; Niall Ivan,19,0,20,1
1708254587488,WCWP 100,D00,454855,Young; Mark T,20,0,20,0
1708254587488,WCWP 100,E00,454860,Twohig; Niall Ivan,19,0,20,1
1708254587488,WCWP 100,F00,454932,Young; Mark T,20,0,20,0
1708254587488,WCWP 100,G00,454933,Young; Mark T,20,0,20,0
1708254588018,WES 207,A00,454941,Kastner; Ryan Charles,20,0,20,0
1708254588551,WES 265,A00,454942,Staff,19,0,20,1
1708254590897,AAS 10,A01,392963,Butler; Elizabeth Annette,34,0,34,0
1708254590897,AAS 10,A02,392965,Butler; Elizabeth Annette,33,0,34,1
1708254591423,AAS 170,A00,392977,Butler; Elizabeth Annette,31,0,32,1
1708254591953,AAS 198,001,479182,Childs; Dennis R.,20,0,20,0
1708254592482,AESE 261,A00,387945,Staff,33,0,33,0
1708254593011,AESE 278D,A00,387953,Staff,33,0,33,0
1708254593541,AESE 278E,A00,387954,Staff,33,0,33,0
1708254594068,AESE 279A,A00,387956,Staff,33,0,33,0
1708254594595,AIP 197P,001,494494,Goldfarb; Brian,9999,0,9999,0
1708254595128,ANAR 100,A00,387884,Shtienberg; Gilad,15,0,16,1
1708254595655,ANAR 104,A01,387886,Tamberino; Anthony Thomas,21,0,25,4
1708254596182,ANAR 111,A00,387888,Staff,36,0,36,0
1708254596707,ANAR 115,A00,387889,Shtienberg; Gilad,36,0,36,0
1708254597233,ANAR 120,A00,387890,Staff,36,0,36,0
1708254597764,ANAR 155,A00,387891,Braswell; Geoffrey E.,15,0,25,10
1708254598290,ANAR 164,A00,387892,Staff,32,0,35,3
1708254598817,ANBI 100,A00,489626,Fox; Patrick Keolu Ozer,39,0,40,1
1708254599344,ANBI 111,A00,387893,Hrvoj Mihic; Branka,37,0,40,3
1708254600401,ANBI 144,A00,387896,Wilder; Linnea Lorene,72,0,75,3
1708254600926,ANBI 149,A00,489628,Non; Amy L,0,0,0,0
1708254601451,ANBI 173,A00,387897,Wilder; Linnea Lorene,74,0,75,1
1708254601983,ANBI 174,A00,489627,Strum; Shirley C.,13,0,15,2
1708254602510,ANES 296,001,463968,Gabriel; Rodney A,49,0,50,1
1708254602510,ANES 296,002,463969,Staff,50,0,50,0
1708254602510,ANES 296,003,463970,Staff,50,0,50,0
1708254603041,ANSC 100,A00,387898,Bialecki; Jon Anthony,40,0,40,0
1708254603573,ANSC 101,A00,387900,Sloane; Julia Kathryn,34,0,40,6
1708254604099,ANSC 117,A00,387901,Martin Sandino; Amanda Maria Yoland,13,0,15,2
1708254604624,ANSC 134,A00,387902,Staff,38,0,40,2
1708254605155,ANSC 137,A00,387903,Stewart; Alexander B,80,0,80,0
1708254605682,ANSC 138,A00,387904,Parish; Steven Martin,14,0,15,1
1708254606210,ANSC 142,A00,387905,Stone; Annika Britt,34,0,40,6
1708254606740,ANSC 147,A00,387906,Stewart; Alexander B,40,0,40,0
1708254607270,ANSC 148,A00,387907,Olivas Hernandez; Olga Lid,92,0,92,0
1708254607801,ANSC 186,A00,387910,Hankins; Joseph D.,28,0,30,2
1708254608345,ANTH 2,A01,387863,Marchetto; Maria Carolina,37,0,40,3
1708254608345,ANTH 2,A02,387864,Marchetto; Maria Carolina,40,0,40,0
1708254608345,ANTH 2,A03,387865,Marchetto; Maria Carolina,36,0,40,4
1708254608345,ANTH 2,A04,387866,Marchetto; Maria Carolina,39,0,40,1
1708254608873,ANTH 3,A01,387868,Stroth; Luke Reyneri,28,0,30,2
1708254608873,ANTH 3,A02,387869,Stroth; Luke Reyneri,29,0,30,1
1708254608873,ANTH 3,A03,387870,Stroth; Luke Reyneri,30,0,30,0
1708254608873,ANTH 3,A04,387871,Stroth; Luke Reyneri,29,0,30,1
1708254609420,ANTH 10,A00,387872,Stewart; Alexander B,80,0,80,0
1708254609964,ANTH 21,A01,387874,Stone; Annika Britt,40,0,40,0
1708254609964,ANTH 21,A02,387875,Stone; Annika Britt,40,0,40,0
1708254609964,ANTH 21,A03,387876,Stone; Annika Britt,40,0,40,0
1708254609964,ANTH 21,A04,387877,Stone; Annika Britt,39,0,40,1
1708254610495,ANTH 23,A01,387879,Staff,40,0,40,0
1708254610495,ANTH 23,A02,387880,Staff,40,0,40,0
1708254610495,ANTH 23,A03,387881,Staff,40,0,40,0
1708254610495,ANTH 23,A04,387882,Staff,40,0,40,0
1708254611090,ANTH 24,A00,387883,Pedersen; David,40,0,40,0
1708254611617,ANTH 103,A00,387911,Staff,343,0,350,7
1708254612146,ANTH 105,A00,387912,Staff,73,0,75,2
1708254612675,ANTH 112,A00,387913,Staff,23,0,25,2
1708254613201,ANTH 120,A00,479486,Parish; Steven Martin,28,0,30,2
1708254613733,ANTH 128B,A01,387923,Lewis; Leslie R,12,0,12,0
1708254614264,ANTH 192,A00,387925,Varma; Saiba,20,0,20,0
1708254614789,ANTH 196C,A00,387927,Varma; Saiba,15,0,15,0
1708254615320,ANTH 212,A00,387931,Marchetto; Maria Carolina,25,0,25,0
1708254615320,ANTH 212,B00,479487,Semendeferi; Ekaterini,25,0,25,0
1708254615851,ANTH 220,A00,387932,Csordas; Thomas J.,9,0,12,3
1708254616377,ANTH 230,001,493297,Goldstein; Paul S,18,0,20,2
1708254616907,ANTH 260,A00,479223,Jenkins; Janis A.,25,0,25,0
1708254617434,ANTH 272,A00,387936,Serlin; David,5,0,5,0
1708254617960,ANTH 273,A00,387938,Gates; Kelly,5,0,5,0
1708254618492,ANTH 288,A00,387940,Braswell; Geoffrey E.,25,0,25,0
1708254619033,ANTH 295,001,493298,Algaze; Guillermo,3,0,3,0
1708254619033,ANTH 295,002,493299,Brenner; Suzanne A,3,0,3,0
1708254619033,ANTH 295,003,493300,Csordas; Thomas J.,3,0,3,0
1708254619033,ANTH 295,004,493422,Fox; Patrick Keolu Ozer,3,0,3,0
1708254619033,ANTH 295,005,493472,Gagneux; Pascal,3,0,3,0
1708254619033,ANTH 295,006,493515,Goldstein; Paul S,3,0,3,0
1708254619033,ANTH 295,007,493592,Hankins; Joseph D.,3,0,3,0
1708254619033,ANTH 295,008,493631,Jassal; Aftab,3,0,3,0
1708254619033,ANTH 295,009,493639,Jenkins; Janis A.,3,0,3,0
1708254619033,ANTH 295,010,493657,Kaiser; Bronwyn Nicole,3,0,3,0
1708254619033,ANTH 295,011,493692,Kang; Byung Chu,3,0,3,0
1708254619033,ANTH 295,012,493758,Marchetto; Maria Carolina,3,0,3,0
1708254619033,ANTH 295,013,493761,Non; Amy L,3,0,3,0
1708254619033,ANTH 295,014,493762,Pedersen; David,3,0,3,0
1708254619033,ANTH 295,015,493825,Rivera-Collazo; Isabel C,3,0,3,0
1708254619033,ANTH 295,016,493826,Varma; Saiba,3,0,3,0
1708254619033,ANTH 295,017,493828,Yeh; Rihan Wen Xin,3,0,3,0
1708254619562,ANTH 296,001,493830,Braswell; Geoffrey E.,3,0,3,0
1708254619562,ANTH 296,002,493836,Marchetto; Maria Carolina,3,0,3,0
1708254619562,ANTH 296,003,493838,Rivera-Collazo; Isabel C,3,0,3,0
1708254619562,ANTH 296,004,493840,Varma; Saiba,3,0,3,0
1708254619562,ANTH 296,005,493842,Algaze; Guillermo,3,0,3,0
1708254619562,ANTH 296,006,493845,Brenner; Suzanne A,3,0,3,0
1708254619562,ANTH 296,007,493846,Csordas; Thomas J.,3,0,3,0
1708254619562,ANTH 296,008,493907,Fox; Patrick Keolu Ozer,3,0,3,0
1708254619562,ANTH 296,009,493949,Gagneux; Pascal,3,0,3,0
1708254619562,ANTH 296,010,493960,Goldstein; Paul S,3,0,3,0
1708254619562,ANTH 296,011,493961,Hankins; Joseph D.,3,0,3,0
1708254619562,ANTH 296,012,493962,Jassal; Aftab,3,0,3,0
1708254619562,ANTH 296,013,493963,Jenkins; Janis A.,3,0,3,0
1708254619562,ANTH 296,014,493964,Kaiser; Bronwyn Nicole,3,0,3,0
1708254619562,ANTH 296,015,493965,Kang; Byung Chu,3,0,3,0
1708254619562,ANTH 296,016,493966,Levy; Thomas E,3,0,3,0
1708254619562,ANTH 296,017,493967,Non; Amy L,3,0,3,0
1708254619562,ANTH 296,018,493968,Pedersen; David,3,0,3,0
1708254619562,ANTH 296,019,493969,Postero; Nancy Grey,3,0,3,0
1708254619562,ANTH 296,020,493970,Semendeferi; Ekaterini,3,0,3,0
1708254619562,ANTH 296,021,493971,Yeh; Rihan Wen Xin,3,0,3,0
1708254620088,AUD 236,A00,480192,Harris; Jeffrey Paul,12,0,12,0
1708254620618,AUD 260,A00,480227,Spriggs; Meghan K,12,0,12,0
1708254621147,AUD 272,A00,480367,Zettner; Erika,12,0,12,0
1708254621674,AUD 275,A00,480369,Zettner; Erika,12,0,12,0
1708254622202,AUD 284,A00,480370,Zettner; Erika,12,0,12,0
1708254622202,AUD 284,B00,480372,Spriggs; Meghan K,12,0,12,0
1708254622729,AUD 291,A00,480374,Zettner; Erika,12,0,12,0
1708254623260,AUD 296,A00,480375,Zettner; Erika,12,0,12,0
1708254623260,AUD 296,B00,480376,Harris; Jeffrey Paul,12,0,12,0
1708254623260,AUD 296,C00,480377,Ryan; Allen F.,12,0,12,0
1708254623792,AWP 3,002,387672,Given; William Allan,9,0,9,0
1708254623792,AWP 3,003,387678,Staff,5,0,5,0
1708254623792,AWP 3,004,387681,Staff,0,0,0,0
1708254623792,AWP 3,007,387784,West; Geoffrey Scott,4,0,5,1
1708254623792,AWP 3,009,387786,Kolodezh; Samuel,5,0,5,0
1708254623792,AWP 3,010,387787,Gilbert; Peter W,5,0,5,0
1708254624318,AWP 4A,001,387791,Staff,12,0,12,0
1708254624318,AWP 4A,002,387792,Staff,0,0,0,0
1708254624878,AWP 4B,001,387793,Bolin; Jillian,0,0,0,0
1708254624878,AWP 4B,002,387794,Bolin; Jillian,0,0,0,0
1708254624878,AWP 4B,003,387795,Bauer; Holly Jean,0,0,0,0
1708254624878,AWP 4B,004,387796,Vaughn; Kelsey Sara,0,0,0,0
1708254624878,AWP 4B,005,387797,Vaughn; Kelsey Sara,0,0,0,0
1708254624878,AWP 4B,007,387799,Ajo; Frances Margaret,0,0,0,0
1708254624878,AWP 4B,008,387800,Ajo; Frances Margaret,0,0,0,0
1708254624878,AWP 4B,009,387801,Hall; Graham T,0,0,0,0
1708254624878,AWP 4B,010,387802,Hall; Graham T,0,0,0,0
1708254624878,AWP 4B,011,387803,Heiser; Jerrod A,0,0,0,0
1708254624878,AWP 4B,012,387804,Heiser; Jerrod A,0,0,0,0
1708254624878,AWP 4B,013,387805,Jones; William Jadie,0,0,0,0
1708254624878,AWP 4B,014,387806,Jones; William Jadie,0,0,0,0
1708254624878,AWP 4B,015,387807,Christie; Veronica Ann,0,0,0,0
1708254624878,AWP 4B,016,387808,Christie; Veronica Ann,0,0,0,0
1708254624878,AWP 4B,019,387820,Falcon; Jennifer A,0,0,0,0
1708254624878,AWP 4B,020,387821,Falcon; Jennifer A,0,0,0,0
1708254624878,AWP 4B,021,387822,Eastin; Schuyler E.,0,0,0,0
1708254624878,AWP 4B,023,387824,Coulter; Jane Elisabeth,0,0,0,0
1708254624878,AWP 4B,025,387826,O'Neil; Courtney L,0,0,0,0
1708254624878,AWP 4B,026,387827,O'Neil; Courtney L,0,0,0,0
1708254624878,AWP 4B,027,387828,Tsurska Svetina; Olena,0,0,0,0
1708254624878,AWP 4B,028,387829,Tsurska Svetina; Olena,0,0,0,0
1708254624878,AWP 4B,029,387830,Spicer; Jacqueline,0,0,0,0
1708254624878,AWP 4B,030,387831,Spicer; Jacqueline,0,0,0,0
1708254624878,AWP 4B,031,387832,Steinberg; Stacy A,0,0,0,0
1708254624878,AWP 4B,032,387833,Steinberg; Stacy A,0,0,0,0
1708254624878,AWP 4B,033,387834,Chandler; Bailee Daniele,0,0,0,0
1708254624878,AWP 4B,034,387835,Chandler; Bailee Daniele,0,0,0,0
1708254624878,AWP 4B,035,387836,Tiernan; Christa Michelle,0,0,0,0
1708254624878,AWP 4B,036,387837,Tiernan; Christa Michelle,0,0,0,0
1708254624878,AWP 4B,037,387840,Gardella; Alexander Drew,0,0,0,0
1708254624878,AWP 4B,038,387841,Gardella; Alexander Drew,0,0,0,0
1708254624878,AWP 4B,039,387857,Zimmerman; Guy,0,0,0,0
1708254624878,AWP 4B,040,387858,Zimmerman; Guy,0,0,0,0
1708254624878,AWP 4B,041,387859,Zroka; Amy Liane,0,0,0,0
1708254624878,AWP 4B,042,387860,Zroka; Amy Liane,0,0,0,0
1708254625412,BENG 87,A00,489656,Sah; Robert Lie-Yuan,20,0,20,0
1708254625412,BENG 87,B00,489657,Sah; Robert Lie-Yuan,20,0,20,0
1708254625412,BENG 87,C00,494754,Omens; Jeffrey Howard,20,0,20,0
1708254625947,BENG 100,A01,387959,Alexandrov; Ludmil B,26,0,28,2
1708254625947,BENG 100,A02,387960,Alexandrov; Ludmil B,26,0,28,2
1708254625947,BENG 100,A03,387984,Alexandrov; Ludmil B,26,0,28,2
1708254625947,BENG 100,A04,387985,Alexandrov; Ludmil B,25,0,28,3
1708254625947,BENG 100,A05,387986,Alexandrov; Ludmil B,27,0,28,1
1708254626474,BENG 102,A00,387987,Chapelin; Fanny,55,0,56,1
1708254627008,BENG 103B,A00,387993,Fraley; Stephanie I.,116,0,120,4
1708254627535,BENG 112B,A01,388053,Shi; Lingyan,26,0,30,4
1708254627535,BENG 112B,A02,388054,Shi; Lingyan,29,0,30,1
1708254628079,BENG 125,A00,388055,Hasty; Jeff M,120,0,160,40
1708254628609,BENG 133,A01,388866,Mali; Prashant Gulab Ram,36,0,40,4
1708254629142,BENG 140B,A01,388884,Cabrales; Pedro,28,0,30,2
1708254629142,BENG 140B,A02,388885,Cabrales; Pedro,30,0,30,0
1708254629142,BENG 140B,A03,388886,Cabrales; Pedro,26,0,30,4
1708254629675,BENG 160,A50,388889,Aguado; Brian Alberto,23,0,25,2
1708254629675,BENG 160,A51,388919,Aguado; Brian Alberto,25,0,25,0
1708254629675,BENG 160,A52,388920,Aguado; Brian Alberto,25,0,25,0
1708254630202,BENG 168,A01,388961,Khojah; Reem I,30,0,30,0
1708254630733,BENG 172,A50,389087,Omens; Jeffrey Howard & Cabrales; Pedro,15,0,20,5
1708254630733,BENG 172,A51,389088,Omens; Jeffrey Howard & Cabrales; Pedro,14,0,20,6
1708254631260,BENG 182,A01,389128,Bafna; Vineet,28,0,30,2
1708254631787,BENG 186A,A00,389130,Kwon; Ester Jihae,105,0,120,15
1708254632317,BENG 187A,A00,389289,Taylor Amos; Alyssa C,157,0,170,13
1708254632848,BENG 187D,A00,389290,Taylor Amos; Alyssa C,33,0,60,27
1708254632848,BENG 187D,B00,389300,Taylor Amos; Alyssa C,51,0,60,9
1708254632848,BENG 187D,C00,389302,Taylor Amos; Alyssa C,35,0,60,25
1708254633377,BENG 189,A00,389303,Contijoch; Francisco,26,0,30,4
1708254633905,BENG 193,A00,389328,Engler; Adam J.,0,0,0,0
1708254634435,BENG 196,A00,436038,Engler; Adam J.,9999,0,9999,0
1708254634961,BENG 197,A00,436081,Engler; Adam J.,9999,0,9999,0
1708254635504,BENG 203,A00,389385,Bafna; Vineet & Zhong; Sheng,20,0,20,0
1708254636032,BENG 207,A00,389386,Kwon; Ester Jihae,10,0,40,30
1708254636032,BENG 207,B00,389400,Taylor Amos; Alyssa C,8,0,30,22
1708254636032,BENG 207,C00,389432,Khojah; Reem I,20,0,40,20
1708254636559,BENG 209,A00,389456,Scholtes Acevedo; Claire,30,0,30,0
1708254637090,BENG 213,A00,389496,Palsson; Bernhard O.,16,0,20,4
1708254638159,BENG 224,A00,389515,Staff,0,0,0,0
1708254638690,BENG 226,A01,479043,Schmid-Schoenbein; Geert W,7,0,30,23
1708254639220,BENG 227,A00,389591,Fraley; Stephanie I.,55,0,120,65
1708254639746,BENG 230C,A00,389810,Mc Culloch; Andrew Douglas,43,0,90,47
1708254640272,BENG 232,A01,390161,Sah; Robert Lie-Yuan,6,0,50,44
1708254640800,BENG 233,A00,390290,Shah; Sameer B,33,0,50,17
1708254641330,BENG 234,A00,390291,Silva; Gabriel,20,0,56,36
1708254641856,BENG 235,A00,390318,Bintu; Bogdan,16,0,40,24
1708254642387,BENG 276,A00,390357,Mc Culloch; Andrew Douglas & Amaro; Rommie E,0,0,0,0
1708254642913,BENG 280C,A01,390443,McVeigh; Elliot R.,45,0,56,11
1708254643440,BENG 281,A00,390444,Kravets; Vira V.,50,0,110,60
1708254643971,BENG 283,A00,390445,Komives; Elizabeth A,4,0,4,0
1708254644498,BENG 292,A01,390623,Ross; Camille,20,0,20,0
1708254645024,BENG 294C,A00,390709,Engler; Adam J.,17,0,20,3
1708254645554,BENG 295,A00,436300,Watson; John Thomas,9999,0,9999,0
1708254646082,BGGN 205,A00,423656,Daugherty; Matthew Dorton,47,0,60,13
1708254646626,BGGN 207,A01,423703,Ross; Camille,0,0,0,0
1708254647156,BGGN 215,A00,423704,Petrie; Katherine Lynn,22,0,30,8
1708254647682,BGGN 216,A01,423855,Mueller; Liam O'Connor,37,0,50,13
1708254648208,BGGN 218,A00,423861,David; Michael,19,0,30,11
1708254648738,BGGN 223,A00,423862,Bier; Ethan,17,0,35,18
1708254649268,BGGN 230,A00,423863,Taylor; Susan S.,8,0,15,7
1708254649796,BGGN 232,A00,423864,Briggs; Steven & Troemel; Emily Ruth,25,0,30,5
1708254650323,BGGN 239,A01,424014,Kronenberg; Mitchell E.,30,0,30,0
1708254650854,BGGN 240,A01,424016,Juavinett; Ashley Lauren,0,0,6,6
1708254651396,BGGN 248,A00,424017,Halpain; Shelley,26,0,30,4
1708254651923,BGGN 249C,A00,424052,Staff,33,0,33,0
1708254652454,BGGN 250,A01,424091,Zou; Yimin,7,0,8,1
1708254652979,BGGN 252,A01,424093,Sejnowski; Terrence J,5,0,6,1
1708254653505,BGGN 255,A00,424094,Root; Cory Matthew,29,0,30,1
1708254654036,BGGN 262,A01,424096,Villa Rodriguez; Elizabeth,30,0,30,0
1708254654582,BGGN 267,A01,424099,Benna; Marcus K & Aljadeff; Johnatan,5,0,6,1
1708254655108,BGGN 270,A00,477483,Juavinett; Ashley Lauren,67,0,75,8
1708254655903,BGGN 271,001,481745,Ackerman; Susan,9998,0,9999,1
1708254655903,BGGN 271,002,481746,Akbari; Omar Sultan,9999,0,9999,0
1708254655903,BGGN 271,003,481747,Allen; Nicola J,9999,0,9999,0
1708254655903,BGGN 271,004,481748,Banegas; Matthew Patrick,9999,0,9999,0
1708254655903,BGGN 271,005,481749,Breen; Ellen C.,9998,0,9999,1
1708254655903,BGGN 271,006,481750,Briggs; Steven,9998,0,9999,1
1708254655903,BGGN 271,007,481751,Bui; Jack D,9999,0,9999,0
1708254655903,BGGN 271,008,481762,Busch; Wolfgang,9999,0,9999,0
1708254655903,BGGN 271,009,481763,Castle; Michael James,9999,0,9999,0
1708254655903,BGGN 271,010,481764,Chang; John Tzu-yu,9999,0,9999,0
1708254655903,BGGN 271,011,481765,Chen; Ju,9998,0,9999,1
1708254655903,BGGN 271,012,481766,Chen; Xu,9999,0,9999,0
1708254655903,BGGN 271,013,481767,Cheng; Christine Shiang-Ling,9999,0,9999,0
1708254655903,BGGN 271,014,481768,Cherqui; Stephanie,9999,0,9999,0
1708254655903,BGGN 271,015,481769,Cho; Yoshitake,9999,0,9999,0
1708254655903,BGGN 271,016,481770,Church; Kellie Breen,9998,0,9999,1
1708254655903,BGGN 271,017,481771,Cleland; Elsa Eleanor,9999,0,9999,0
1708254655903,BGGN 271,018,481779,Cohen; Shiran,9998,0,9999,1
1708254655903,BGGN 271,019,481814,Cook-Andersen; Heidi Leigh,9999,0,9999,0
1708254655903,BGGN 271,020,481815,Cooke; James Edward,9999,0,9999,0
1708254655903,BGGN 271,021,481816,Coufal; Nicole Gabriele,9998,0,9999,1
1708254655903,BGGN 271,022,481818,Crotty Alexander; Laura E,9999,0,9999,0
1708254655903,BGGN 271,023,481819,Daugherty; Matthew Dorton,9998,0,9999,1
1708254655903,BGGN 271,024,481820,De Guglielmo; Giordano,9998,0,9999,1
1708254655903,BGGN 271,025,481821,Doherty; Taylor Alan,9998,0,9999,1
1708254655903,BGGN 271,026,481822,Dulawa; Stephanie Carole,9999,0,9999,0
1708254655903,BGGN 271,027,481823,Esko; Jeffrey D.,9998,0,9999,1
1708254655903,BGGN 271,028,481824,Feldstein; Ariel E,9998,0,9999,1
1708254655903,BGGN 271,029,481825,Friedman; Rick Adam,9999,0,9999,0
1708254655903,BGGN 271,030,481826,Furnari; Frank,9999,0,9999,0
1708254655903,BGGN 271,031,481829,Ghosh; Pradipta,9998,0,9999,1
1708254655903,BGGN 271,032,481830,Gleeson; Joseph Gerard,9999,0,9999,0
1708254655903,BGGN 271,033,481831,Golden; Susan S.,9998,0,9999,1
1708254655903,BGGN 271,034,481832,Goren; Alon M,9998,0,9999,1
1708254655903,BGGN 271,035,481834,Gustafsson; Asa Birgitta,9999,0,9999,0
1708254655903,BGGN 271,036,481836,Hamdoun; Amr,9999,0,9999,0
1708254655903,BGGN 271,037,481837,Hao; Nan,9999,0,9999,0
1708254655903,BGGN 271,038,481840,Holway; David A.,9998,0,9999,1
1708254655903,BGGN 271,039,481841,Huffaker; Alisa,9998,0,9999,1
1708254655903,BGGN 271,040,481843,Sebat; Lilia Mikhailovna,9998,0,9999,1
1708254655903,BGGN 271,041,481889,Ideker; Trey,9999,0,9999,0
1708254655903,BGGN 271,042,481890,Jiang; Qingfei,9998,0,9999,1
1708254655903,BGGN 271,043,482311,Jin; Yishi,9999,0,9999,0
1708254655903,BGGN 271,044,482334,Joiner; William J.,9999,0,9999,0
1708254655903,BGGN 271,045,482353,Kaech; Susan Michelle,9998,0,9999,1
1708254655903,BGGN 271,046,482378,Karin; Michael,9999,0,9999,0
1708254655903,BGGN 271,047,482379,Kleinfeld; David,9999,0,9999,0
1708254655903,BGGN 271,048,482413,Koffler; Yacov,9999,0,9999,0
1708254655903,BGGN 271,049,482414,Komiyama; Takaki,9999,0,9999,0
1708254655903,BGGN 271,050,482415,Kryazhimskiy; Sergey A,9999,0,9999,0
1708254655903,BGGN 271,051,482416,Lawson; Mark Andrew,9999,0,9999,0
1708254655903,BGGN 271,052,482417,Lee; Yun Sok,9999,0,9999,0
1708254655903,BGGN 271,053,482451,Leutgeb; Stefan,9998,0,9999,1
1708254655903,BGGN 271,054,482452,Lo; Stanley M.,9999,0,9999,0
1708254655903,BGGN 271,055,482453,Lu; Pengzhe,9998,0,9999,1
1708254655903,BGGN 271,056,482454,Lykke-Andersen; Jens,9998,0,9999,1
1708254655903,BGGN 271,057,482456,McDonnell; Lisa Marie,9999,0,9999,0
1708254655903,BGGN 271,058,482461,McHugh; Colleen A,9998,0,9999,1
1708254655903,BGGN 271,059,482478,Meharena; Hiruy Sibhatu,9999,0,9999,0
1708254655903,BGGN 271,060,482497,Morris; Gerald P,9999,0,9999,0
1708254655903,BGGN 271,061,482499,Mukamel; Eran A,9998,0,9999,1
1708254655903,BGGN 271,062,482535,Muotri; Alysson,9999,0,9999,0
1708254655903,BGGN 271,063,482551,Muroyama; Andrew David,9999,0,9999,0
1708254655903,BGGN 271,064,482552,Neal; Sonya E,9999,0,9999,0
1708254655903,BGGN 271,065,482618,Nieh; James Charles,9999,0,9999,0
1708254655903,BGGN 271,066,482619,O'Donoghue; Anthony John,9999,0,9999,0
1708254655903,BGGN 271,067,482626,Pantham; Priyadarshini,9999,0,9999,0
1708254655903,BGGN 271,068,482633,Parast; Mana,9999,0,9999,0
1708254655903,BGGN 271,069,482634,Perry; Michael William,9999,0,9999,0
1708254655903,BGGN 271,070,482639,Pride; David Tevis,9999,0,9999,0
1708254655903,BGGN 271,071,482645,Pruneda-Paz; Jose L.,9999,0,9999,0
1708254655903,BGGN 271,072,482648,Rana; Tariq,9999,0,9999,0
1708254655903,BGGN 271,073,482650,Risbrough; Victoria Blythe,9999,0,9999,0
1708254655903,BGGN 271,074,482655,Rissman; Robert Andrew,9999,0,9999,0
1708254655903,BGGN 271,075,482656,Rosenfeld; Michael G,9999,0,9999,0
1708254655903,BGGN 271,076,482657,Saier; Milton H.,9999,0,9999,0
1708254655903,BGGN 271,077,482663,Sander; Maike,9999,0,9999,0
1708254655903,BGGN 271,078,482664,Schenk; Simon,9999,0,9999,0
1708254655903,BGGN 271,079,482665,Schoeneberg; Johannes,9998,0,9999,1
1708254655903,BGGN 271,080,482666,Schroeder; Julian I,9998,0,9999,1
1708254655903,BGGN 271,081,482667,Shaner; Nathan C.,9999,0,9999,0
1708254655903,BGGN 271,082,482668,Sheikh; Farah,9999,0,9999,0
1708254655903,BGGN 271,083,482669,Shurin; Jonathan,9999,0,9999,0
1708254655903,BGGN 271,084,482675,Sigurdson; Christina,9999,0,9999,0
1708254655903,BGGN 271,085,482676,Smith; David M.,9999,0,9999,0
1708254655903,BGGN 271,086,482677,Steinmetz; Nicole F,9999,0,9999,0
1708254655903,BGGN 271,087,482692,Su; Chih-Ying,9999,0,9999,0
1708254655903,BGGN 271,088,482694,Suel; Gurol Mehmet,9999,0,9999,0
1708254655903,BGGN 271,089,482695,Telese; Francesca,9999,0,9999,0
1708254655903,BGGN 271,090,482745,Thackray; Varykina G.,9999,0,9999,0
1708254655903,BGGN 271,091,482746,Towers; Christina Garlingt,9999,0,9999,0
1708254655903,BGGN 271,092,482747,Troemel; Emily Ruth,9997,0,9999,2
1708254655903,BGGN 271,093,482748,Tye; Kay M,9999,0,9999,0
1708254655903,BGGN 271,094,482749,Valdez-Jasso; Daniela,9998,0,9999,1
1708254655903,BGGN 271,095,482750,Wahlin; Karl Jonas,9997,0,9999,2
1708254655903,BGGN 271,096,482751,Welsbie; Derek,9999,0,9999,0
1708254655903,BGGN 271,097,482752,Wilkinson; Miles Frome,9999,0,9999,0
1708254655903,BGGN 271,098,482754,Yaksh; Tony L.,9999,0,9999,0
1708254655903,BGGN 271,099,482760,Yang; Jing,9999,0,9999,0
1708254655903,BGGN 271,100,482761,Yeo; Eugene Wei-Ming,9998,0,9999,1
1708254655903,BGGN 271,101,482763,Ying; Wei,9999,0,9999,0
1708254655903,BGGN 271,102,482764,Zarrinpar; Amir,9999,0,9999,0
1708254655903,BGGN 271,103,482765,Zengler; Karsten B,9999,0,9999,0
1708254655903,BGGN 271,104,482766,Zhang; Dong-Er,9999,0,9999,0
1708254655903,BGGN 271,105,482768,Zhao; Yunde,9999,0,9999,0
1708254655903,BGGN 271,106,482776,Zheng; Binhai,9999,0,9999,0
1708254655903,BGGN 271,107,482777,Zheng; Ye,9998,0,9999,1
1708254655903,BGGN 271,108,482806,Zuniga; Elina I,9999,0,9999,0
1708254656428,BGGN 273,A01,424101,Mueller; Liam O'Connor,43,0,50,7
1708254656958,BGGN 280,A00,424102,Ernst; Andreas,3,0,5,2
1708254656958,BGGN 280,C00,481361,Amaro; Rommie E,2,0,5,3
1708254657486,BGGN 281,A00,424103,Desai; Arshad & Oegema; Karen,0,0,5,5
1708254658013,BGGN 283,A00,424104,Rivera; Fabian Chavez,0,0,5,5
1708254658013,BGGN 283,B00,424105,Russell; Alistair B,4,0,5,1
1708254658013,BGGN 283,D00,424107,Wildonger; Jill Cathleen,1,0,5,4
1708254658543,BGGN 284,A00,424108,Glasgow; Stacey Marie,2,0,5,3
1708254659069,BGGN 285,A00,424109,Chisholm; Andrew D.,1,0,5,4
1708254659069,BGGN 285,B00,424110,Farley; Emma Kristen,2,0,5,3
1708254659613,BGGN 295,A00,424120,Tour; Ella,9,0,30,21
1708254660138,BGJC 204,A00,424138,Lu; Li-Fan & Chang; John Tzu-yu,9998,0,9999,1
1708254660665,BGJC 215,A00,424139,Cooke; James Edward & Lo; Stanley M.,10,0,10,0
1708254661571,BGRD 200,001,485528,Ackerman; Susan,9998,0,9999,1
1708254661571,BGRD 200,002,485529,Akbari; Omar Sultan,9999,0,9999,0
1708254661571,BGRD 200,003,485530,Allen; Eric,9999,0,9999,0
1708254661571,BGRD 200,004,485531,Allen; Nicola J,9999,0,9999,0
1708254661571,BGRD 200,005,485533,Amaro; Rommie E,9999,0,9999,0
1708254661571,BGRD 200,006,485535,Augustine; Vineet,9999,0,9999,0
1708254661571,BGRD 200,007,485536,Ayres; Janelle Samantha,9999,0,9999,0
1708254661571,BGRD 200,008,485538,Banegas; Matthew Patrick,9999,0,9999,0
1708254661571,BGRD 200,009,485539,Banghart; Matthew Ryan,9999,0,9999,0
1708254661571,BGRD 200,010,485542,Benna; Marcus K,9999,0,9999,0
1708254661571,BGRD 200,011,485543,Bennett; Eric J,9999,0,9999,0
1708254661571,BGRD 200,012,485545,Bloodgood; Brenda Laurie,9999,0,9999,0
1708254661571,BGRD 200,013,485546,Breen; Ellen C.,9998,0,9999,1
1708254661571,BGRD 200,014,485548,Briggs; Steven,9998,0,9999,1
1708254661571,BGRD 200,015,485549,Bui; Jack D,9999,0,9999,0
1708254661571,BGRD 200,016,485552,Busch; Wolfgang,9999,0,9999,0
1708254661571,BGRD 200,017,485621,Callaway; Edward M,9999,0,9999,0
1708254661571,BGRD 200,018,485622,Castle; Michael James,9999,0,9999,0
1708254661571,BGRD 200,019,485623,Chaim; Isaac,9999,0,9999,0
1708254661571,BGRD 200,020,485624,Chang; John Tzu-yu,9999,0,9999,0
1708254661571,BGRD 200,021,485625,Chen; Ju,9999,0,9999,0
1708254661571,BGRD 200,022,485626,Chen; Xu,9999,0,9999,0
1708254661571,BGRD 200,023,485627,Cheng; Christine Shiang-Ling,9999,0,9999,0
1708254661571,BGRD 200,024,485632,Cherqui; Stephanie,9999,0,9999,0
1708254661571,BGRD 200,025,485633,Cho; Yoshitake,9999,0,9999,0
1708254661571,BGRD 200,026,485634,Church; Kellie Breen,9999,0,9999,0
1708254661571,BGRD 200,027,485635,Cleland; Elsa Eleanor,9999,0,9999,0
1708254661571,BGRD 200,028,485636,Cohen; Shiran,9998,0,9999,1
1708254661571,BGRD 200,029,485639,Cook-Andersen; Heidi Leigh,9999,0,9999,0
1708254661571,BGRD 200,030,485686,Cooke; James Edward,9999,0,9999,0
1708254661571,BGRD 200,031,485688,Cooper; Kimberly Lynn,9999,0,9999,0
1708254661571,BGRD 200,032,485689,Coufal; Nicole Gabriele,9998,0,9999,1
1708254661571,BGRD 200,033,485690,Crotty Alexander; Laura E,9999,0,9999,0
1708254661571,BGRD 200,034,485691,Staff,9999,0,9999,0
1708254661571,BGRD 200,035,485692,De Guglielmo; Giordano,9999,0,9999,0
1708254661571,BGRD 200,036,485693,De Silva; Shermin,9999,0,9999,0
1708254661571,BGRD 200,037,485694,Desai; Arshad,9999,0,9999,0
1708254661571,BGRD 200,038,485695,Dickinson; Alexandra Jazz,9999,0,9999,0
1708254661571,BGRD 200,039,485717,Doherty; Taylor Alan,9998,0,9999,1
1708254661571,BGRD 200,040,485720,Dulawa; Stephanie Carole,9999,0,9999,0
1708254661571,BGRD 200,041,485721,Ecker; Joseph R,9999,0,9999,0
1708254661571,BGRD 200,042,485760,Engle; Dannielle D,9999,0,9999,0
1708254661571,BGRD 200,043,485761,Ernst; Andreas,9998,0,9999,1
1708254661571,BGRD 200,044,485766,Esko; Jeffrey D.,9998,0,9999,1
1708254661571,BGRD 200,045,485905,Evans; Ronald M,9999,0,9999,0
1708254661571,BGRD 200,046,485907,Staff,9999,0,9999,0
1708254661571,BGRD 200,047,485918,Feldstein; Ariel E,9998,0,9999,1
1708254661571,BGRD 200,048,485938,Friedman; Rick Adam,9999,0,9999,0
1708254661571,BGRD 200,049,485986,Furnari; Frank,9999,0,9999,0
1708254661571,BGRD 200,050,486018,Gage; Fred H,9999,0,9999,0
1708254661571,BGRD 200,051,486139,George; Monique Leana,9999,0,9999,0
1708254661571,BGRD 200,052,486140,Ghosh; Pradipta,9998,0,9999,1
1708254661571,BGRD 200,053,486141,Glass; Christopher,9998,0,9999,1
1708254661571,BGRD 200,054,486142,Gleeson; Joseph Gerard,9999,0,9999,0
1708254661571,BGRD 200,055,486143,Golden; Susan S.,9999,0,9999,0
1708254661571,BGRD 200,056,486144,Goldrath; Ananda,9999,0,9999,0
1708254661571,BGRD 200,057,486145,Goren; Alon M,9998,0,9999,1
1708254661571,BGRD 200,058,486146,Gustafsson; Asa Birgitta,9999,0,9999,0
1708254661571,BGRD 200,059,486164,Gutkind; Jorge Silvio,9999,0,9999,0
1708254661571,BGRD 200,060,486203,Hamdoun; Amr,9999,0,9999,0
1708254661571,BGRD 200,061,486204,Hampton; Randolph Y.,9999,0,9999,0
1708254661571,BGRD 200,062,486205,Hao; Nan,9999,0,9999,0
1708254661571,BGRD 200,063,486206,Staff,9999,0,9999,0
1708254661571,BGRD 200,064,486207,Hasty; Jeff M,9999,0,9999,0
1708254661571,BGRD 200,065,486208,Hollern; Daniel Patrick,9999,0,9999,0
1708254661571,BGRD 200,066,486209,Holway; David A.,9997,0,9999,2
1708254661571,BGRD 200,067,486214,Huffaker; Alisa,9998,0,9999,1
1708254661571,BGRD 200,068,486215,Hui; Enfu,9999,0,9999,0
1708254661571,BGRD 200,069,486216,Hwa; Terence T.,9999,0,9999,0
1708254661571,BGRD 200,070,486217,Sebat; Lilia Mikhailovna,9998,0,9999,1
1708254661571,BGRD 200,071,486218,Ideker; Trey,9999,0,9999,0
1708254661571,BGRD 200,072,486219,Jackrel; Sara,9998,0,9999,1
1708254661571,BGRD 200,073,486224,Jiang; Qingfei,9998,0,9999,1
1708254661571,BGRD 200,074,486225,Jin; Yishi,9999,0,9999,0
1708254661571,BGRD 200,075,486226,Joiner; William J.,9999,0,9999,0
1708254661571,BGRD 200,076,486227,Jun; Suckjoon,9999,0,9999,0
1708254661571,BGRD 200,077,486228,Kadonaga; James T,9998,0,9999,1
1708254661571,BGRD 200,078,486229,Kaech; Susan Michelle,9997,0,9999,2
1708254661571,BGRD 200,079,486237,Karin; Michael,9999,0,9999,0
1708254661571,BGRD 200,080,486238,Kleinfeld; David,9999,0,9999,0
1708254661571,BGRD 200,081,486239,Knight; Robin,9999,0,9999,0
1708254661571,BGRD 200,082,486335,Koffler; Yacov,9999,0,9999,0
1708254661571,BGRD 200,083,486336,Komiyama; Takaki,9999,0,9999,0
1708254661571,BGRD 200,084,486337,Kosuri; Pallav,9999,0,9999,0
1708254661571,BGRD 200,085,486353,Kryazhimskiy; Sergey A,9999,0,9999,0
1708254661571,BGRD 200,086,486354,Kurle; Carolyn M.,9999,0,9999,0
1708254661571,BGRD 200,087,486355,Law; Julie A,9999,0,9999,0
1708254661571,BGRD 200,088,486356,Lawson; Mark Andrew,9999,0,9999,0
1708254661571,BGRD 200,089,486357,Lee; Kuo Fen,9999,0,9999,0
1708254661571,BGRD 200,090,486376,Lee; Yun Sok,9999,0,9999,0
1708254661571,BGRD 200,091,486413,Leutgeb; Jill K.,9999,0,9999,0
1708254661571,BGRD 200,092,486414,Leutgeb; Stefan,9998,0,9999,1
1708254661571,BGRD 200,093,486415,Lim; Byungkook,9999,0,9999,0
1708254661571,BGRD 200,094,486419,Lo; Stanley M.,9999,0,9999,0
1708254661571,BGRD 200,095,486420,Looger; Loren Lee,9999,0,9999,0
1708254661571,BGRD 200,096,486422,Lovett-Barron; Matthew Rod,9999,0,9999,0
1708254661571,BGRD 200,097,486423,Lu; Li-Fan,9998,0,9999,1
1708254661571,BGRD 200,098,486424,Lu; Pengzhe,9998,0,9999,1
1708254661571,BGRD 200,099,486425,Lykke-Andersen; Jens,9998,0,9999,1
1708254661571,BGRD 200,100,486426,Lyumkis; Dmitry Evgenievich,9999,0,9999,0
1708254661571,BGRD 200,101,486427,Madigan; Cressida Ariana,9999,0,9999,0
1708254661571,BGRD 200,102,486428,Staff,9999,0,9999,0
1708254661571,BGRD 200,103,486429,Mayfield; Stephen P.,9998,0,9999,1
1708254661571,BGRD 200,104,486430,McDonnell; Lisa Marie,9999,0,9999,0
1708254661571,BGRD 200,105,486620,McHugh; Colleen A,9998,0,9999,1
1708254661571,BGRD 200,106,486621,Meharena; Hiruy Sibhatu,9999,0,9999,0
1708254661571,BGRD 200,107,486622,Staff,9999,0,9999,0
1708254661571,BGRD 200,108,486681,Morris; Gerald P,9999,0,9999,0
1708254661571,BGRD 200,109,486682,Mukamel; Eran A,9998,0,9999,1
1708254661571,BGRD 200,110,486683,Muotri; Alysson,9999,0,9999,0
1708254661571,BGRD 200,111,486684,Muroyama; Andrew David,9999,0,9999,0
1708254661571,BGRD 200,112,486687,Murre; Cornelis,9999,0,9999,0
1708254661571,BGRD 200,113,486691,Neal; Sonya E,9999,0,9999,0
1708254661571,BGRD 200,114,486692,Nieh; James Charles,9998,0,9999,1
1708254661571,BGRD 200,115,486693,Nimmerjahn; Axel,9999,0,9999,0
1708254661571,BGRD 200,116,486694,Nizet; Victor F.,9999,0,9999,0
1708254661571,BGRD 200,117,486695,O'Donoghue; Anthony John,9999,0,9999,0
1708254661571,BGRD 200,118,486706,Oegema; Karen,9999,0,9999,0
1708254661571,BGRD 200,119,486708,O'Shea; Clodagh,9999,0,9999,0
1708254661571,BGRD 200,120,486709,Pantham; Priyadarshini,9999,0,9999,0
1708254661571,BGRD 200,121,486715,Parast; Mana,9999,0,9999,0
1708254661571,BGRD 200,122,486716,Pasquinelli; Amy,9998,0,9999,1
1708254661571,BGRD 200,123,486718,Pekkurnaz Banghart; Gulcin,9999,0,9999,0
1708254661571,BGRD 200,124,486720,Perry; Michael William,9999,0,9999,0
1708254661571,BGRD 200,125,486721,Pfaff; Samuel,9999,0,9999,0
1708254661571,BGRD 200,126,486723,Pogliano; Joseph,9999,0,9999,0
1708254661571,BGRD 200,127,486724,Pogliano; Kit J.,9999,0,9999,0
1708254661571,BGRD 200,128,486727,Pride; David Tevis,9999,0,9999,0
1708254661571,BGRD 200,129,486728,Pruneda-Paz; Jose L.,9999,0,9999,0
1708254661571,BGRD 200,130,486733,Staff,9999,0,9999,0
1708254661571,BGRD 200,131,486734,Rana; Tariq,9999,0,9999,0
1708254661571,BGRD 200,132,486736,Reck-Peterson; Samara L,9999,0,9999,0
1708254661571,BGRD 200,133,486738,Rennison; Diana,9999,0,9999,0
1708254661571,BGRD 200,134,486741,Rifkin; Scott,9999,0,9999,0
1708254661571,BGRD 200,135,486743,Risbrough; Victoria Blythe,9999,0,9999,0
1708254661571,BGRD 200,136,486749,Rissman; Robert Andrew,9999,0,9999,0
1708254661571,BGRD 200,137,486750,Rivera; Fabian Chavez,9999,0,9999,0
1708254661571,BGRD 200,138,486753,Root; Cory Matthew,9999,0,9999,0
1708254661571,BGRD 200,139,486760,Rosenfeld; Michael G,9998,0,9999,1
1708254661571,BGRD 200,140,486763,Russell; Alistair B,9999,0,9999,0
1708254661571,BGRD 200,141,486766,Saier; Milton H.,9999,0,9999,0
1708254661571,BGRD 200,142,486768,Sander; Maike,9999,0,9999,0
1708254661571,BGRD 200,143,486770,Saphire; Erica Ollmann,9999,0,9999,0
1708254661571,BGRD 200,144,486771,Schenk; Simon,9999,0,9999,0
1708254661571,BGRD 200,145,486774,Schoeneberg; Johannes,9999,0,9999,0
1708254661571,BGRD 200,146,486777,Schroeder; Julian I,9998,0,9999,1
1708254661571,BGRD 200,147,486783,Shah; Sameer B,9999,0,9999,0
1708254661571,BGRD 200,148,486784,Shaner; Nathan C.,9999,0,9999,0
1708254661571,BGRD 200,149,486785,Shaw; Reuben,9999,0,9999,0
1708254661571,BGRD 200,150,486786,Sheikh; Farah,9999,0,9999,0
1708254661571,BGRD 200,151,486787,Staff,9999,0,9999,0
1708254661571,BGRD 200,152,486788,Signer; Robert,9999,0,9999,0
1708254661571,BGRD 200,153,486789,Sigurdson; Christina,9999,0,9999,0
1708254661571,BGRD 200,154,486790,Smith; David M.,9999,0,9999,0
1708254661571,BGRD 200,155,486791,Soncin; Francesca,9999,0,9999,0
1708254661571,BGRD 200,156,486792,Steinmetz; Nicole F,9999,0,9999,0
1708254661571,BGRD 200,157,486793,Su; Chih-Ying,9999,0,9999,0
1708254661571,BGRD 200,158,486794,Suel; Gurol Mehmet,9999,0,9999,0
1708254661571,BGRD 200,159,486795,Sun; Xin,9999,0,9999,0
1708254661571,BGRD 200,160,486796,Telese; Francesca,9999,0,9999,0
1708254661571,BGRD 200,161,486797,Thackray; Varykina G.,9999,0,9999,0
1708254661571,BGRD 200,162,486798,Towers; Christina Garlingt,9999,0,9999,0
1708254661571,BGRD 200,163,486799,Traver; David,9999,0,9999,0
1708254661571,BGRD 200,164,486800,Troemel; Emily Ruth,9998,0,9999,1
1708254661571,BGRD 200,165,486801,Tye; Kay M,9999,0,9999,0
1708254661571,BGRD 200,166,486802,Valdez-Jasso; Daniela,9998,0,9999,1
1708254661571,BGRD 200,167,486803,Vijayanand; Pandurangan,9999,0,9999,0
1708254661571,BGRD 200,168,486804,Villa Rodriguez; Elizabeth,9999,0,9999,0
1708254661571,BGRD 200,169,486805,Wahlin; Karl Jonas,9997,0,9999,2
1708254661571,BGRD 200,170,486806,Wang; Jean Yin Jen,9999,0,9999,0
1708254661571,BGRD 200,171,486807,Welsbie; Derek,9999,0,9999,0
1708254661571,BGRD 200,172,486808,Wildonger; Jill Cathleen,9998,0,9999,1
1708254661571,BGRD 200,173,486809,Wilkinson; Miles Frome,9999,0,9999,0
1708254661571,BGRD 200,174,486810,Winzeler; Elizabeth A,9999,0,9999,0
1708254661571,BGRD 200,175,486811,Yaksh; Tony L.,9999,0,9999,0
1708254661571,BGRD 200,176,486812,Yang; Jing,9999,0,9999,0
1708254661571,BGRD 200,177,486813,Staff,9999,0,9999,0
1708254661571,BGRD 200,178,486814,Yeo; Eugene Wei-Ming,9998,0,9999,1
1708254661571,BGRD 200,179,486815,Ying; Wei,9999,0,9999,0
1708254661571,BGRD 200,180,486816,Zarrinpar; Amir,9999,0,9999,0
1708254661571,BGRD 200,181,486817,Zengler; Karsten B,9999,0,9999,0
1708254661571,BGRD 200,182,486818,Zhang; Dong-Er,9999,0,9999,0
1708254661571,BGRD 200,183,486819,Zhao; Yunde,9999,0,9999,0
1708254661571,BGRD 200,184,486820,Zheng; Binhai,9999,0,9999,0
1708254661571,BGRD 200,185,486821,Zheng; Ye,9998,0,9999,1
1708254661571,BGRD 200,186,486822,Zuniga; Elina I,9999,0,9999,0
1708254662097,BGSE 200,A00,424140,Tour; Ella & Petrie; Katherine Lynn,9995,0,9999,4
1708254662625,BGSE 205,A00,424177,Bennett; Eric J,49,0,50,1
1708254662625,BGSE 205,B00,424179,Bennett; Eric J,48,0,50,2
1708254662625,BGSE 205,C00,424182,Bennett; Eric J,47,0,50,3
1708254662625,BGSE 205,D00,424184,Bennett; Eric J,46,0,50,4
1708254662625,BGSE 205,E00,424185,Bennett; Eric J,50,0,50,0
1708254663169,BIBC 100,A01,425401,Corbett; Kevin Daniel,150,0,158,8
1708254663169,BIBC 100,B01,477769,Amaro; Rommie E,156,0,158,2
1708254663713,BIBC 102,A01,425425,Bozinovic; Goran,255,0,256,1
1708254663713,BIBC 102,B01,425440,Hampton; Randolph Y.,250,0,256,6
1708254663713,BIBC 102,C01,486849,Flagg; Matthew Paul,61,0,120,59
1708254664243,BIBC 103,A01,425476,Grossman; Emily N,17,0,24,7
1708254664243,BIBC 103,A02,425509,Grossman; Emily N,21,0,24,3
1708254664243,BIBC 103,A03,425530,Grossman; Emily N,18,0,24,6
1708254664243,BIBC 103,A04,425536,Grossman; Emily N,22,0,24,2
1708254664243,BIBC 103,B01,425538,Boumechache; Miyyada,20,0,24,4
1708254664243,BIBC 103,B02,425539,Boumechache; Miyyada,24,0,24,0
1708254664243,BIBC 103,B03,425548,Boumechache; Miyyada,24,0,24,0
1708254664243,BIBC 103,B04,425549,Boumechache; Miyyada,24,0,24,0
1708254664772,BIBC 120,A01,425592,Coleman; Aaron B.,242,0,256,14
1708254665361,BIBC 194,A00,425609,Ernst; Andreas,21,0,27,6
1708254665361,BIBC 194,B00,477632,Saier; Milton H.,26,0,27,1
1708254665361,BIBC 194,C00,481360,Amaro; Rommie E,23,0,27,4
1708254665361,BIBC 194,D00,486852,Flagg; Matthew Paul,21,0,32,11
1708254665899,BICD 100,A01,470377,Troemel; Emily Ruth,127,0,128,1
1708254665899,BICD 100,A02,470378,Troemel; Emily Ruth,126,0,128,2
1708254665899,BICD 100,B01,470409,Reinagel; Pam,59,0,64,5
1708254665899,BICD 100,B02,470413,Reinagel; Pam,62,0,64,2
1708254665899,BICD 100,B03,470464,Reinagel; Pam,64,0,64,0
1708254665899,BICD 100,B04,470468,Reinagel; Pam,63,0,64,1
1708254665899,BICD 100,C01,470469,Beyhan; Sinem,51,0,64,13
1708254665899,BICD 100,C02,470605,Beyhan; Sinem,58,0,64,6
1708254665899,BICD 100,C03,470606,Beyhan; Sinem,60,0,64,4
1708254665899,BICD 100,C04,470607,Beyhan; Sinem,63,0,64,1
1708254665899,BICD 100,D01,477465,Nguyen; Vu Quang,158,0,160,2
1708254666427,BICD 100R,A01,425674,Smith; Laurie,29,0,34,5
1708254666427,BICD 100R,A02,425675,Smith; Laurie,30,0,34,4
1708254666427,BICD 100R,A03,425676,Smith; Laurie,30,0,34,4
1708254666958,BICD 104,A01,425696,Greenspan; Ralph J.,60,0,64,4
1708254667484,BICD 110,A01,470608,Muroyama; Andrew David,264,0,275,11
1708254667484,BICD 110,B01,425721,Ernst; Andreas,245,0,275,30
1708254668012,BICD 112,A01,458177,Cooper; Kimberly Lynn & Traver; David,10,0,32,22
1708254668012,BICD 112,A02,458180,Cooper; Kimberly Lynn & Traver; David,28,0,32,4
1708254668537,BICD 123,A01,425725,Zhao; Yunde,24,0,32,8
1708254669063,BICD 140,A01,425728,Lu; Li-Fan,227,0,240,13
1708254669589,BICD 158,A01,425730,Bier; Ethan,136,0,145,9
1708254670116,BICD 194,A00,425731,Desai; Arshad & Oegema; Karen,18,0,27,9
1708254670116,BICD 194,B00,481735,Wilhelm; James E.,29,0,32,3
1708254670647,BIEB 121,A00,425732,Butler; Shannon Rhey,21,0,32,11
1708254670647,BIEB 121,B00,425733,Butler; Shannon Rhey,24,0,32,8
1708254671173,BIEB 130,A01,425735,Kurle; Carolyn M.,243,0,295,52
1708254671701,BIEB 146,A01,425737,Petrie; Katherine Lynn,365,0,395,30
1708254672227,BIEB 148,A01,470637,Rose; Noah Hartmann,59,0,63,4
1708254672227,BIEB 148,A02,470638,Rose; Noah Hartmann,61,0,63,2
1708254672755,BIEB 154,A01,458184,Stockwell; Sarah R,29,0,30,1
1708254672755,BIEB 154,A02,458186,Stockwell; Sarah R,29,0,30,1
1708254673284,BIEB 176,A01,425741,De Silva; Shermin,56,0,64,8
1708254673815,BIEB 182,A01,458194,Roy; Kaustuv,25,0,32,7
1708254673815,BIEB 182,A02,458215,Roy; Kaustuv,31,0,32,1
1708254674358,BILD 1,A01,424267,Patrick; Gentry,249,0,250,1
1708254674358,BILD 1,B01,424272,Burg; Michael,231,0,250,19
1708254674358,BILD 1,C01,424293,Pickett; Brooke Elizabeth,245,0,250,5
1708254674358,BILD 1,D01,458292,Gonzalez Gamboa; Ivonne,48,0,50,2
1708254674358,BILD 1,D02,458295,Gonzalez Gamboa; Ivonne,50,0,50,0
1708254674358,BILD 1,D03,458296,Gonzalez Gamboa; Ivonne,50,0,50,0
1708254674358,BILD 1,D04,458297,Gonzalez Gamboa; Ivonne,49,0,50,1
1708254674358,BILD 1,D05,458303,Gonzalez Gamboa; Ivonne,50,0,50,0
1708254674887,BILD 2,A01,458304,Reyes Gonzalez; Catalina,53,0,56,3
1708254674887,BILD 2,A02,458307,Reyes Gonzalez; Catalina,55,0,56,1
1708254674887,BILD 2,A03,458313,Reyes Gonzalez; Catalina,55,0,56,1
1708254674887,BILD 2,A04,458320,Reyes Gonzalez; Catalina,56,0,56,0
1708254674887,BILD 2,B01,458324,Reyes Gonzalez; Catalina,47,0,56,9
1708254674887,BILD 2,B02,458327,Reyes Gonzalez; Catalina,54,0,56,2
1708254674887,BILD 2,B03,458339,Reyes Gonzalez; Catalina,56,0,56,0
1708254674887,BILD 2,B04,458340,Reyes Gonzalez; Catalina,56,0,56,0
1708254674887,BILD 2,C01,458387,Park; Ji Young,44,0,49,5
1708254674887,BILD 2,C02,458544,Park; Ji Young,46,0,49,3
1708254674887,BILD 2,C03,458557,Park; Ji Young,47,0,49,2
1708254674887,BILD 2,C04,458563,Park; Ji Young,46,0,49,3
1708254675414,BILD 3,A01,424312,Hammond; LaTisha Marie,331,0,350,19
1708254675414,BILD 3,B01,470107,Stockwell; Sarah R,66,0,70,4
1708254675414,BILD 3,B02,470110,Stockwell; Sarah R,70,0,70,0
1708254675414,BILD 3,B03,470116,Stockwell; Sarah R,70,0,70,0
1708254675414,BILD 3,B04,470123,Stockwell; Sarah R,67,0,70,3
1708254675414,BILD 3,B05,470150,Stockwell; Sarah R,70,0,70,0
1708254675414,BILD 3,C01,470159,Cooper; Kimberly Lynn,67,0,70,3
1708254675414,BILD 3,C02,470160,Cooper; Kimberly Lynn,69,0,70,1
1708254675414,BILD 3,C03,470164,Cooper; Kimberly Lynn,70,0,70,0
1708254675414,BILD 3,C04,470165,Cooper; Kimberly Lynn,69,0,70,1
1708254675414,BILD 3,C05,470374,Cooper; Kimberly Lynn,68,0,70,2
1708254675948,BILD 4,A01,424318,Staff,22,0,24,2
1708254675948,BILD 4,A02,424324,Staff,24,0,24,0
1708254675948,BILD 4,A03,424325,Staff,24,0,24,0
1708254675948,BILD 4,A04,424326,Staff,22,0,24,2
1708254675948,BILD 4,A05,424327,Staff,24,0,24,0
1708254675948,BILD 4,A06,424330,Staff,24,0,24,0
1708254675948,BILD 4,A07,424331,Staff,24,0,24,0
1708254675948,BILD 4,A08,424342,Staff,24,0,24,0
1708254675948,BILD 4,B01,424462,Pickett; Brooke Elizabeth,23,0,24,1
1708254675948,BILD 4,B02,424466,Pickett; Brooke Elizabeth,24,0,24,0
1708254675948,BILD 4,B03,424469,Pickett; Brooke Elizabeth,23,0,24,1
1708254675948,BILD 4,B04,424470,Pickett; Brooke Elizabeth,22,0,24,2
1708254675948,BILD 4,B05,424700,Pickett; Brooke Elizabeth,23,0,24,1
1708254675948,BILD 4,B06,424723,Pickett; Brooke Elizabeth,24,0,24,0
1708254675948,BILD 4,B07,424730,Pickett; Brooke Elizabeth,24,0,24,0
1708254675948,BILD 4,B08,424929,Pickett; Brooke Elizabeth,22,0,24,2
1708254675948,BILD 4,C01,424947,Gonzalez Gamboa; Ivonne,22,0,24,2
1708254675948,BILD 4,C02,424951,Gonzalez Gamboa; Ivonne,23,0,24,1
1708254675948,BILD 4,C03,424991,Gonzalez Gamboa; Ivonne,23,0,24,1
1708254675948,BILD 4,C04,424993,Gonzalez Gamboa; Ivonne,24,0,24,0
1708254675948,BILD 4,C05,424994,Gonzalez Gamboa; Ivonne,24,0,24,0
1708254675948,BILD 4,C06,425209,Gonzalez Gamboa; Ivonne,24,0,24,0
1708254675948,BILD 4,C07,425233,Gonzalez Gamboa; Ivonne,24,0,24,0
1708254675948,BILD 4,C08,425247,Gonzalez Gamboa; Ivonne,24,0,24,0
1708254676473,BILD 60,A01,425326,Hammond; LaTisha Marie,62,0,64,2
1708254676997,BILD 83,A00,425347,Pogliano; Joseph,25,0,30,5
1708254677527,BILD 87,A00,425368,Saier; Milton H.,20,0,20,0
1708254678054,BIMM 100,A01,425744,Cooper; Andrew Michael,303,0,320,17
1708254678054,BIMM 100,B01,425746,Cooper; Andrew Michael,315,0,320,5
1708254678584,BIMM 101,A01,425748,McDonnell; Lisa Marie,8,0,24,16
1708254678584,BIMM 101,A02,425749,McDonnell; Lisa Marie,23,0,24,1
1708254678584,BIMM 101,B01,425751,Day; Christopher D,22,0,24,2
1708254678584,BIMM 101,B02,425752,Day; Christopher D,24,0,24,0
1708254678584,BIMM 101,B03,425753,Day; Christopher D,22,0,24,2
1708254678584,BIMM 101,B04,425754,Day; Christopher D,24,0,24,0
1708254678584,BIMM 101,C01,425756,Rusert; Jessica Marie,16,0,24,8
1708254678584,BIMM 101,C02,425757,Rusert; Jessica Marie,23,0,24,1
1708254678584,BIMM 101,C03,425758,Rusert; Jessica Marie,23,0,24,1
1708254678584,BIMM 101,C04,425759,Rusert; Jessica Marie,23,0,24,1
1708254679116,BIMM 110,A01,425764,Niwa; Maho,55,0,56,1
1708254679116,BIMM 110,A02,425765,Niwa; Maho,56,0,56,0
1708254679116,BIMM 110,A03,425766,Niwa; Maho,56,0,56,0
1708254679116,BIMM 110,A04,425767,Niwa; Maho,55,0,56,1
1708254679645,BIMM 116R,A01,425771,Golden; Susan S. & Gorman; Michael R.,55,0,72,17
1708254679645,BIMM 116R,A02,425772,Golden; Susan S. & Gorman; Michael R.,53,0,72,19
1708254679645,BIMM 116R,A03,425773,Golden; Susan S. & Gorman; Michael R.,66,0,72,6
1708254679645,BIMM 116R,A04,425774,Golden; Susan S. & Gorman; Michael R.,70,0,72,2
1708254680175,BIMM 118,A01,425779,David; Michael,83,0,96,13
1708254680708,BIMM 120,A01,425792,Pirino; Giorgia,203,0,216,13
1708254680708,BIMM 120,B01,470639,Saier; Milton H.,201,0,216,15
1708254681235,BIMM 121,A01,425830,Gustafson-Brown; Cindy,18,0,24,6
1708254681235,BIMM 121,A02,425831,Gustafson-Brown; Cindy,21,0,24,3
1708254681235,BIMM 121,A03,425832,Gustafson-Brown; Cindy,24,0,24,0
1708254681235,BIMM 121,A04,425833,Gustafson-Brown; Cindy,23,0,24,1
1708254681235,BIMM 121,B01,425835,Pirino; Giorgia,17,0,24,7
1708254681235,BIMM 121,B02,425836,Pirino; Giorgia,24,0,24,0
1708254681235,BIMM 121,C01,425838,Park; Ji Young,6,0,24,18
1708254681235,BIMM 121,C02,425839,Park; Ji Young,20,0,24,4
1708254681765,BIMM 134,A01,425841,Burg; Michael,393,0,416,23
1708254682292,BIMM 143,A01,425843,Grant; Barry J,17,0,40,23
1708254682292,BIMM 143,B01,425845,Bozinovic; Goran,33,0,40,7
1708254682818,BIMM 182,A01,455012,Bafna; Vineet,28,0,50,22
1708254683351,BIMM 194,A00,425847,Rivera; Fabian Chavez,24,0,27,3
1708254683351,BIMM 194,B00,425868,Russell; Alistair B,16,0,27,11
1708254683351,BIMM 194,D00,425870,Wildonger; Jill Cathleen,14,0,27,13
1708254683877,BIOM 202,A00,390710,Corbett; Kevin Daniel,93,0,100,7
1708254684405,BIOM 219,A00,390713,Ross; Camille,0,0,0,7
1708254684937,BIOM 231,A00,455099,Furnari; Frank,0,0,0,0
1708254684937,BIOM 231,B00,455100,Lopez Ramirez; Miguel Alej,0,0,0,0
1708254685466,BIOM 242,A00,390714,Hamilton; Bruce Alan,20,0,20,0
1708254686002,BIOM 246,A00,492784,Gordts; Philip & Varki; Ajit P & Lewis; Amanda Lark & Godula; Kamil & Gagneux; Pascal & Esko; Jeffrey D. & Bode; Lars,0,0,0,0
1708254686529,BIOM 252,A00,390715,Ayyagari; Radha,27,0,28,1
1708254687055,BIOM 254,A00,390718,Corbett; Kevin Daniel,14,0,20,6
1708254687585,BIOM 272,A00,390722,Hangauer; Matthew John,16,0,20,4
1708254688116,BIOM 274,A00,390725,Sun; Bryan Kee-Hong,7,0,15,8
1708254688643,BIOM 283,A00,390728,Komives; Elizabeth A,2,0,2,0
1708254689172,BIOM 285,A00,390730,Gaulton; Kyle J,10,0,20,10
1708254689705,BIOM 295,A00,455083,Brown; Joan Heller,0,0,0,0
1708254690232,BIPN 100,A01,425872,Augustine; Vineet,240,0,245,5
1708254690232,BIPN 100,B01,425874,George; Monique Leana,240,0,245,5
1708254690232,BIPN 100,C01,458640,Maita; Isabella Vincenza,44,0,49,5
1708254690232,BIPN 100,C02,458646,Maita; Isabella Vincenza,48,0,49,1
1708254690232,BIPN 100,C03,458714,Maita; Isabella Vincenza,48,0,49,1
1708254690232,BIPN 100,C04,458716,Maita; Isabella Vincenza,48,0,49,1
1708254690232,BIPN 100,C05,458717,Maita; Isabella Vincenza,46,0,49,3
1708254690763,BIPN 105,A01,425877,Armour; Jon Christopher,12,0,21,9
1708254690763,BIPN 105,A02,425878,Armour; Jon Christopher,21,0,21,0
1708254690763,BIPN 105,A03,425879,Armour; Jon Christopher,10,0,21,11
1708254690763,BIPN 105,A04,425880,Armour; Jon Christopher,20,0,21,1
1708254691289,BIPN 120,A01,425882,Cooke; James Edward,370,0,395,25
1708254691814,BIPN 140,A01,425884,Hibbs; Ryan E.,183,0,192,9
1708254692347,BIPN 144,A01,425886,Zou; Yimin,153,0,158,5
1708254692874,BIPN 145,A01,425888,Maita; Isabella Vincenza,41,0,42,1
1708254692874,BIPN 145,B01,425918,Marino; Marc J,37,0,42,5
1708254692874,BIPN 145,B02,425954,Marino; Marc J,40,0,42,2
1708254693401,BIPN 147,A01,426086,Sejnowski; Terrence J,53,0,64,11
1708254693931,BIPN 152,A01,426112,Halpain; Shelley,97,0,128,31
1708254694462,BIPN 162,A01,426120,Juavinett; Ashley Lauren,17,0,30,13
1708254694989,BIPN 164,A01,455010,Benna; Marcus K & Aljadeff; Johnatan,120,0,120,0
1708254695518,BIPN 194,A00,426122,Glasgow; Stacey Marie,20,0,27,7
1708254696045,BISP 170,A00,426158,French; Kathleen Ann,26,0,30,4
1708254696570,BISP 182,A00,426168,Pogliano; Joseph,9999,0,9999,0
1708254697099,BISP 194,A00,426240,Chisholm; Andrew D.,11,0,27,16
1708254697099,BISP 194,B00,426241,Farley; Emma Kristen,25,0,27,2
1708254697625,BNFO 281,A00,427175,Gaasterland; Theresa,85,0,100,15
1708254698152,BNFO 283,A00,427211,Carter; Hannah Kathryn & Chavez; Alejandro,39,0,50,11
1708254698152,BNFO 283,B00,480483,Amariuta-Bartell; Tiffany & Dorrestein; Pieter,21,0,30,9
1708254698681,BNFO 294,B01,427269,Ross; Camille,47,0,50,3
1708254699222,CAT 3,A01,396994,Glaser; Amelia,15,0,15,0
1708254699222,CAT 3,A02,396995,Glaser; Amelia,15,0,15,0
1708254699222,CAT 3,A03,396996,Glaser; Amelia,7,0,15,8
1708254699222,CAT 3,A04,396997,Glaser; Amelia,12,0,15,3
1708254699222,CAT 3,A05,397004,Glaser; Amelia,15,0,15,0
1708254699222,CAT 3,A06,397039,Glaser; Amelia,11,0,15,4
1708254699222,CAT 3,A07,397040,Glaser; Amelia,13,0,15,2
1708254699222,CAT 3,A08,397084,Glaser; Amelia,15,0,15,0
1708254699222,CAT 3,A09,397269,Glaser; Amelia,13,0,15,2
1708254699222,CAT 3,A10,397270,Glaser; Amelia,0,0,15,15
1708254699222,CAT 3,A11,397271,Glaser; Amelia,9,0,15,6
1708254699222,CAT 3,A12,397272,Glaser; Amelia,12,0,15,3
1708254699222,CAT 3,A13,397273,Glaser; Amelia,15,0,15,0
1708254699222,CAT 3,A14,397274,Glaser; Amelia,14,0,15,1
1708254699222,CAT 3,B01,397276,Porter; Lisa,15,0,15,0
1708254699222,CAT 3,B02,397277,Porter; Lisa,15,0,15,0
1708254699222,CAT 3,B03,397278,Porter; Lisa,14,0,15,1
1708254699222,CAT 3,B04,397279,Porter; Lisa,15,0,15,0
1708254699222,CAT 3,B06,397281,Porter; Lisa,15,0,15,0
1708254699222,CAT 3,B07,397291,Porter; Lisa,15,0,15,0
1708254699222,CAT 3,B09,397293,Porter; Lisa,15,0,15,0
1708254699222,CAT 3,B10,397294,Porter; Lisa,15,0,15,0
1708254699222,CAT 3,B11,397295,Porter; Lisa,12,0,15,3
1708254699222,CAT 3,B12,397296,Porter; Lisa,14,0,15,1
1708254699222,CAT 3,B13,397297,Porter; Lisa,11,0,15,4
1708254699222,CAT 3,B14,397298,Porter; Lisa,15,0,15,0
1708254699222,CAT 3,B15,397299,Porter; Lisa,15,0,15,0
1708254699222,CAT 3,B16,397300,Porter; Lisa,15,0,15,0
1708254699222,CAT 3,C01,397302,Marchisotto; Jennifer Anne,13,0,15,2
1708254699222,CAT 3,C02,397308,Marchisotto; Jennifer Anne,9,0,15,6
1708254699222,CAT 3,C03,397309,Marchisotto; Jennifer Anne,9,0,15,6
1708254699222,CAT 3,C04,397315,Marchisotto; Jennifer Anne,11,0,15,4
1708254699222,CAT 3,C05,397316,Marchisotto; Jennifer Anne,14,0,15,1
1708254699222,CAT 3,C06,397322,Marchisotto; Jennifer Anne,15,0,15,0
1708254699222,CAT 3,C07,397323,Marchisotto; Jennifer Anne,15,0,15,0
1708254699222,CAT 3,C08,397329,Marchisotto; Jennifer Anne,15,0,15,0
1708254699222,CAT 3,C09,397333,Marchisotto; Jennifer Anne,15,0,15,0
1708254699222,CAT 3,C10,397336,Marchisotto; Jennifer Anne,15,0,15,0
1708254699222,CAT 3,C11,397354,Marchisotto; Jennifer Anne,13,0,15,2
1708254699222,CAT 3,C12,397357,Marchisotto; Jennifer Anne,15,0,15,0
1708254699222,CAT 3,C13,397364,Marchisotto; Jennifer Anne,14,0,15,1
1708254699222,CAT 3,C14,397367,Marchisotto; Jennifer Anne,14,0,15,1
1708254699222,CAT 3,C15,397369,Marchisotto; Jennifer Anne,15,0,15,0
1708254699222,CAT 3,C16,397373,Marchisotto; Jennifer Anne,15,0,15,0
1708254699222,CAT 3,C17,397374,Marchisotto; Jennifer Anne,15,0,15,0
1708254699222,CAT 3,C18,397380,Marchisotto; Jennifer Anne,14,0,15,1
1708254699222,CAT 3,D02,397405,Rahimi; Babak,13,0,15,2
1708254699222,CAT 3,D03,397408,Rahimi; Babak,14,0,15,1
1708254699222,CAT 3,D04,397415,Rahimi; Babak,15,0,15,0
1708254699222,CAT 3,D05,397416,Rahimi; Babak,15,0,15,0
1708254699222,CAT 3,D06,397422,Rahimi; Babak,15,0,15,0
1708254699222,CAT 3,D07,397426,Rahimi; Babak,14,0,15,1
1708254699222,CAT 3,D09,397447,Rahimi; Babak,11,0,15,4
1708254699222,CAT 3,D10,397450,Rahimi; Babak,13,0,15,2
1708254699222,CAT 3,D11,397625,Rahimi; Babak,13,0,15,2
1708254699222,CAT 3,D12,397630,Rahimi; Babak,15,0,15,0
1708254699222,CAT 3,D13,397631,Rahimi; Babak,14,0,15,1
1708254699222,CAT 3,D14,397635,Rahimi; Babak,14,0,15,1
1708254699751,CAT 3CE,A01,397642,Bronstein; Phoebe Malan,25,0,25,0
1708254700281,CAT 87,A00,397645,Bronstein; Phoebe Malan,19,0,20,1
1708254700807,CAT 90,A00,480731,Bronstein; Phoebe Malan,20,0,20,0
1708254701338,CAT 124,A01,397662,Knight; Amy,5,0,5,0
1708254701338,CAT 124,A02,397722,Knight; Amy,5,0,5,0
1708254701338,CAT 124,A03,397726,Knight; Amy,5,0,5,0
1708254701338,CAT 124,A04,397829,Knight; Amy,4,0,5,1
1708254701869,CAT 125,001,397832,Popko; Elizabeth Ashley,20,0,20,0
1708254701869,CAT 125,002,397833,Delaville; Romain,20,0,20,0
1708254701869,CAT 125,003,397834,Marchisotto; Jennifer Anne,18,0,20,2
1708254701869,CAT 125,004,397835,Bigham; David Joseph,20,0,20,0
1708254701869,CAT 125,005,397836,Bigham; David Joseph,19,0,20,1
1708254701869,CAT 125,006,397837,Bigham; David Joseph,16,0,20,4
1708254701869,CAT 125,007,397838,Vanderschuit; Maya Alysia,20,0,20,0
1708254701869,CAT 125,008,397839,Vanderschuit; Maya Alysia,20,0,20,0
1708254701869,CAT 125,009,397840,Vanderschuit; Maya Alysia,20,0,20,0
1708254701869,CAT 125,010,397841,Morales; Celeste Georgianna,15,0,16,1
1708254701869,CAT 125,011,397842,Morales; Celeste Georgianna,16,0,16,0
1708254701869,CAT 125,012,397881,Morales; Celeste Georgianna,19,0,20,1
1708254701869,CAT 125,013,397954,Rose; Becca Rae,18,0,20,2
1708254701869,CAT 125,014,397956,Rose; Becca Rae,20,0,20,0
1708254701869,CAT 125,015,397998,Rose; Becca Rae,19,0,20,1
1708254701869,CAT 125,016,397999,Tosun; Adriana,20,0,20,0
1708254701869,CAT 125,017,398001,Tosun; Adriana,20,0,20,0
1708254701869,CAT 125,018,398009,Irwin; Matthew Joseph,19,0,20,1
1708254701869,CAT 125,019,398010,Irwin; Matthew Joseph,18,0,20,2
1708254701869,CAT 125,020,398014,Irwin; Matthew Joseph,20,0,20,0
1708254702395,CAT 125R,A00,398015,Smith; Lauryn Alissa,19,0,20,1
1708254702395,CAT 125R,B00,398016,Smith; Lauryn Alissa,17,0,20,3
1708254702395,CAT 125R,C00,398017,Smith; Lauryn Alissa,19,0,20,1
1708254702395,CAT 125R,D00,398019,Tosun; Adriana,19,0,20,1
1708254702395,CAT 125R,E00,398020,Hyland; Tina Mae,12,0,20,8
1708254702395,CAT 125R,F00,398027,Hyland; Tina Mae,18,0,20,2
1708254702395,CAT 125R,G00,398028,Hyland; Tina Mae,18,0,20,2
1708254702929,CCE 1,A01,396087,Kenley Grounds; Nicole,40,0,40,0
1708254702929,CCE 1,B01,396142,Quijada; David,39,0,40,1
1708254702929,CCE 1,C01,396159,Bigley; Michele Heather,39,0,40,1
1708254702929,CCE 1,D01,396164,Bigley; Michele Heather,40,0,40,0
1708254702929,CCE 1,E01,396166,Lee; Kassandra,40,0,40,0
1708254702929,CCE 1,F01,396168,Lee; Kassandra,40,0,40,0
1708254702929,CCE 1,G01,396170,Staff,40,0,40,0
1708254702929,CCE 1,H01,396172,Staff,40,0,40,0
1708254703463,CENG 101B,A00,392993,Chen; Shaochen,44,0,45,1
1708254703990,CENG 101C,A00,392997,Li; Yanran,148,0,150,2
1708254704517,CENG 113,A00,393000,Chen; Zheng,69,0,70,1
1708254704517,CENG 113,B00,393001,Li; Wan-Lu,69,0,70,1
1708254705047,CENG 124B,A00,393036,Powell; Alyssa & Russ; Benjamin Edward,113,0,120,7
1708254705573,CENG 157,A00,393220,Opatkiewicz; Justin Paul,50,0,57,7
1708254706099,CENG 160,A00,393231,Powell; Alyssa,70,0,80,10
1708254706625,CENG 170,A01,393238,Drews; Aaron,27,0,30,3
1708254707156,CENG 175,A00,393239,Steinmetz; Nicole F,34,0,35,1
1708254707681,CENG 176B,A01,393285,Opatkiewicz; Justin Paul,46,0,52,6
1708254707681,CENG 176B,B01,393629,Zhang; Liangfang,40,0,49,9
1708254708208,CENG 205,A00,393681,Jahed Motlagh; Zeinab,53,0,60,7
1708254708736,CENG 257,A00,393682,Opatkiewicz; Justin Paul,10,0,13,3
1708254709264,CGS 87,A00,489609,Wesling; Megan E.,20,0,20,0
1708254709793,CGS 100B,A00,396181,Whitley; Leila Marie,28,0,30,2
1708254710319,CGS 109,A00,396194,Whitley; Leila Marie,19,0,20,1
1708254710845,CGS 112,A00,396220,Martin Sandino; Amanda Maria Yoland,22,0,25,3
1708254711371,CGS 114,A00,396223,Steelman; Katherine Wallis,14,0,16,2
1708254711901,CGS 116,A00,396295,Staff,19,0,20,1
1708254712430,CGS 117,A00,396306,Martin Sandino; Amanda Maria Yoland,14,0,15,1
1708254712963,CGS 118,A00,396314,Hankins; Joseph D.,28,0,29,1
1708254713489,CGS 128,A00,396366,Whitley; Leila Marie,14,0,15,1
1708254714017,CGS 137,A00,396865,Martin Sandino; Amanda Maria Yoland,16,0,19,3
1708254714544,CGS 150,A00,396901,Taylor-Garcia; Daphne,18,0,18,0
1708254715070,CGS 196B,A00,396904,Lo; Stanley M.,7,0,7,0
1708254715070,CGS 196B,B00,396973,Brenner; Suzanne A,7,0,7,0
1708254715070,CGS 196B,C00,396985,Jones; Makeba,7,0,7,0
1708254715601,CGS 198,001,396987,Anderson; Patrick W.,0,0,0,0
1708254715601,CGS 198,002,396988,Anderson; Patrick W.,0,0,0,0
1708254715601,CGS 198,003,396989,Anderson; Patrick W.,0,0,0,0
1708254715601,CGS 198,004,396990,Anderson; Patrick W.,0,0,0,0
1708254716130,CGS 200,A00,396991,Perez; Roy,0,0,0,3
1708254716657,CHEM 6A,A01,459563,Deshmukh; Lalit,40,0,40,0
1708254716657,CHEM 6A,A02,459564,Deshmukh; Lalit,35,0,40,5
1708254716657,CHEM 6A,A03,459565,Deshmukh; Lalit,31,0,40,9
1708254716657,CHEM 6A,A04,459566,Deshmukh; Lalit,30,0,38,8
1708254716657,CHEM 6A,A05,459567,Deshmukh; Lalit,40,0,40,0
1708254716657,CHEM 6A,A06,459568,Deshmukh; Lalit,37,0,40,3
1708254716657,CHEM 6A,A07,459569,Deshmukh; Lalit,37,0,40,3
1708254716657,CHEM 6A,A08,459570,Deshmukh; Lalit,0,0,0,0
1708254717191,CHEM 6B,A01,467314,Ortony; Julia Helen,39,0,40,1
1708254717191,CHEM 6B,A02,467322,Ortony; Julia Helen,32,0,40,8
1708254717191,CHEM 6B,A03,467323,Ortony; Julia Helen,40,0,40,0
1708254717191,CHEM 6B,A04,467325,Ortony; Julia Helen,31,0,40,9
1708254717191,CHEM 6B,A05,467326,Ortony; Julia Helen,39,0,40,1
1708254717191,CHEM 6B,A06,467346,Ortony; Julia Helen,40,0,40,0
1708254717191,CHEM 6B,B01,467360,Hopkins; Patrycja Anna,35,0,40,5
1708254717191,CHEM 6B,B02,467363,Hopkins; Patrycja Anna,38,0,40,2
1708254717191,CHEM 6B,B03,467364,Hopkins; Patrycja Anna,35,0,40,5
1708254717191,CHEM 6B,B04,467380,Hopkins; Patrycja Anna,40,0,40,0
1708254717191,CHEM 6B,B05,467381,Hopkins; Patrycja Anna,40,0,40,0
1708254717191,CHEM 6B,B06,467382,Hopkins; Patrycja Anna,39,0,40,1
1708254717722,CHEM 6C,A01,468994,Ternansky; Robert J.,39,0,40,1
1708254717722,CHEM 6C,A02,469054,Ternansky; Robert J.,38,0,40,2
1708254717722,CHEM 6C,A03,469065,Ternansky; Robert J.,39,0,40,1
1708254717722,CHEM 6C,A04,469069,Ternansky; Robert J.,40,0,40,0
1708254717722,CHEM 6C,A05,469080,Ternansky; Robert J.,40,0,40,0
1708254717722,CHEM 6C,B01,469318,Ternansky; Robert J.,39,0,40,1
1708254717722,CHEM 6C,B02,469319,Ternansky; Robert J.,40,0,40,0
1708254717722,CHEM 6C,B03,469320,Ternansky; Robert J.,39,0,40,1
1708254717722,CHEM 6C,B04,469321,Ternansky; Robert J.,40,0,40,0
1708254717722,CHEM 6C,B05,469322,Ternansky; Robert J.,40,0,40,0
1708254717722,CHEM 6C,C01,469323,Schurmeier; Kimberly,38,0,40,2
1708254717722,CHEM 6C,C02,469324,Schurmeier; Kimberly,36,0,40,4
1708254717722,CHEM 6C,C03,469325,Schurmeier; Kimberly,38,0,40,2
1708254717722,CHEM 6C,C04,469326,Schurmeier; Kimberly,36,0,40,4
1708254717722,CHEM 6C,C05,469327,Schurmeier; Kimberly,40,0,40,0
1708254717722,CHEM 6C,D01,460183,Schurmeier; Kimberly,39,0,40,1
1708254717722,CHEM 6C,D02,460184,Schurmeier; Kimberly,32,0,40,8
1708254717722,CHEM 6C,D03,460185,Schurmeier; Kimberly,26,0,40,14
1708254717722,CHEM 6C,D04,460186,Schurmeier; Kimberly,38,0,40,2
1708254717722,CHEM 6C,D05,460187,Schurmeier; Kimberly,40,0,40,0
1708254717722,CHEM 6C,E01,460188,Stallings; Dontarie M,24,0,40,16
1708254717722,CHEM 6C,E02,460190,Stallings; Dontarie M,25,0,40,15
1708254717722,CHEM 6C,E03,460191,Stallings; Dontarie M,3,0,20,17
1708254717722,CHEM 6C,E04,460192,Stallings; Dontarie M,36,0,40,4
1708254717722,CHEM 6C,E05,460193,Stallings; Dontarie M,37,0,40,3
1708254718249,CHEM 6CH,A01,459630,Tezcan; Faik,40,0,40,0
1708254718847,CHEM 7L,A01,393998,Jazzar; Rodolphe,0,0,0,3
1708254718847,CHEM 7L,A02,393999,Jazzar; Rodolphe,10,0,24,14
1708254718847,CHEM 7L,A03,394000,Jazzar; Rodolphe,21,0,24,3
1708254718847,CHEM 7L,A04,394001,Jazzar; Rodolphe,22,0,24,2
1708254718847,CHEM 7L,A05,394002,Jazzar; Rodolphe,18,0,24,6
1708254718847,CHEM 7L,A06,394003,Jazzar; Rodolphe,22,0,24,2
1708254718847,CHEM 7L,A07,394004,Jazzar; Rodolphe,18,0,21,3
1708254718847,CHEM 7L,A08,394005,Jazzar; Rodolphe,0,0,0,0
1708254718847,CHEM 7L,A09,394006,Jazzar; Rodolphe,20,0,24,4
1708254718847,CHEM 7L,A10,394007,Jazzar; Rodolphe,24,0,24,0
1708254718847,CHEM 7L,B01,394009,Jazzar; Rodolphe,0,0,0,1
1708254718847,CHEM 7L,B02,394010,Jazzar; Rodolphe,1,0,6,5
1708254718847,CHEM 7L,B03,394011,Jazzar; Rodolphe,15,0,24,9
1708254718847,CHEM 7L,B04,394012,Jazzar; Rodolphe,18,0,21,3
1708254718847,CHEM 7L,B05,394013,Jazzar; Rodolphe,0,0,0,0
1708254718847,CHEM 7L,B06,394014,Jazzar; Rodolphe,15,0,24,9
1708254718847,CHEM 7L,B07,394015,Jazzar; Rodolphe,18,0,24,6
1708254718847,CHEM 7L,B08,394016,Jazzar; Rodolphe,23,0,24,1
1708254718847,CHEM 7L,B09,394017,Jazzar; Rodolphe,24,0,24,0
1708254718847,CHEM 7L,B10,394018,Jazzar; Rodolphe,24,0,24,0
1708254718847,CHEM 7L,C01,394020,Staff,0,0,0,0
1708254718847,CHEM 7L,C02,394021,Staff,21,0,24,3
1708254718847,CHEM 7L,C03,394022,Staff,23,0,24,1
1708254718847,CHEM 7L,C04,394023,Staff,24,0,24,0
1708254718847,CHEM 7L,C05,394024,Staff,0,0,0,0
1708254718847,CHEM 7L,C06,394025,Staff,20,0,24,4
1708254718847,CHEM 7L,C07,394026,Staff,22,0,24,2
1708254718847,CHEM 7L,C08,394027,Staff,23,0,24,1
1708254718847,CHEM 7L,C09,394028,Staff,24,0,24,0
1708254718847,CHEM 7L,C10,394029,Staff,23,0,24,1
1708254719374,CHEM 11,A01,459661,Staff,42,0,44,2
1708254719374,CHEM 11,A02,459664,Staff,44,0,44,0
1708254719374,CHEM 11,A03,459702,Staff,42,0,44,2
1708254719374,CHEM 11,A04,459707,Staff,44,0,44,0
1708254719374,CHEM 11,A05,459708,Staff,43,0,44,1
1708254719374,CHEM 11,A06,459711,Staff,41,0,44,3
1708254719907,CHEM 40A,A01,459576,Albizati; Kim F.,36,0,40,4
1708254719907,CHEM 40A,A02,459577,Albizati; Kim F.,33,0,40,7
1708254719907,CHEM 40A,A03,459578,Albizati; Kim F.,37,0,40,3
1708254719907,CHEM 40A,A04,459579,Albizati; Kim F.,38,0,40,2
1708254719907,CHEM 40A,A05,459580,Albizati; Kim F.,40,0,40,0
1708254719907,CHEM 40A,A06,459581,Albizati; Kim F.,37,0,40,3
1708254719907,CHEM 40A,A07,459582,Albizati; Kim F.,38,0,40,2
1708254719907,CHEM 40A,A08,459588,Albizati; Kim F.,39,0,40,1
1708254720434,CHEM 40B,A01,467442,Weizman; Haim,29,0,40,11
1708254720434,CHEM 40B,A02,467443,Weizman; Haim,33,0,40,7
1708254720434,CHEM 40B,A03,467444,Weizman; Haim,39,0,40,1
1708254720434,CHEM 40B,A04,467445,Weizman; Haim,38,0,40,2
1708254720434,CHEM 40B,A05,467446,Weizman; Haim,39,0,40,1
1708254720434,CHEM 40B,A06,467447,Weizman; Haim,37,0,40,3
1708254720434,CHEM 40B,A07,467448,Weizman; Haim,31,0,40,9
1708254720434,CHEM 40B,A08,467449,Weizman; Haim,40,0,40,0
1708254720434,CHEM 40B,B01,467383,Molinski; Tadeusz,40,0,40,0
1708254720434,CHEM 40B,B02,467384,Molinski; Tadeusz,40,0,40,0
1708254720434,CHEM 40B,B03,467385,Molinski; Tadeusz,40,0,40,0
1708254720434,CHEM 40B,B04,467399,Molinski; Tadeusz,40,0,40,0
1708254720434,CHEM 40B,B05,467400,Molinski; Tadeusz,40,0,40,0
1708254720434,CHEM 40B,B06,467401,Molinski; Tadeusz,40,0,40,0
1708254720434,CHEM 40B,B07,467402,Molinski; Tadeusz,40,0,40,0
1708254720434,CHEM 40B,B08,467404,Molinski; Tadeusz,39,0,40,1
1708254720963,CHEM 41B,A01,459571,Klosterman; Jeremy K,40,0,40,0
1708254720963,CHEM 41B,A02,459572,Klosterman; Jeremy K,36,0,37,1
1708254720963,CHEM 41B,A03,459573,Klosterman; Jeremy K,40,0,40,0
1708254721495,CHEM 41C,A01,459589,Tor; Yitzhak,40,0,40,0
1708254721495,CHEM 41C,A02,459624,Tor; Yitzhak,38,0,40,2
1708254721495,CHEM 41C,A03,459625,Tor; Yitzhak,40,0,40,0
1708254721495,CHEM 41C,A04,459626,Tor; Yitzhak,40,0,40,0
1708254721495,CHEM 41C,A05,459627,Tor; Yitzhak,29,0,29,0
1708254721495,CHEM 41C,A06,459628,Tor; Yitzhak,38,0,40,2
1708254721495,CHEM 41C,A07,459629,Tor; Yitzhak,40,0,40,0
1708254722028,CHEM 43A,A01,394068,Lam; Tin Yiu,12,0,24,12
1708254722028,CHEM 43A,A02,394088,Lam; Tin Yiu,23,0,24,1
1708254722028,CHEM 43A,A03,394092,Lam; Tin Yiu,23,0,24,1
1708254722028,CHEM 43A,A04,394093,Lam; Tin Yiu,21,0,24,3
1708254722028,CHEM 43A,A05,394094,Lam; Tin Yiu,23,0,24,1
1708254722028,CHEM 43A,A06,394096,Lam; Tin Yiu,15,0,24,9
1708254722028,CHEM 43A,A07,394115,Lam; Tin Yiu,20,0,24,4
1708254722028,CHEM 43A,A08,394116,Lam; Tin Yiu,22,0,24,2
1708254722028,CHEM 43A,A09,394117,Lam; Tin Yiu,22,0,24,2
1708254722028,CHEM 43A,A10,394118,Lam; Tin Yiu,20,0,24,4
1708254722028,CHEM 43A,A11,394119,Lam; Tin Yiu,8,0,13,5
1708254722028,CHEM 43A,A12,394120,Lam; Tin Yiu,24,0,24,0
1708254722028,CHEM 43A,A13,394132,Lam; Tin Yiu,24,0,24,0
1708254722028,CHEM 43A,B01,394134,Lam; Tin Yiu,24,0,24,0
1708254722028,CHEM 43A,B02,394135,Lam; Tin Yiu,16,0,24,8
1708254722028,CHEM 43A,B03,394136,Lam; Tin Yiu,13,0,24,11
1708254722028,CHEM 43A,B04,394137,Lam; Tin Yiu,17,0,24,7
1708254722028,CHEM 43A,B05,394138,Lam; Tin Yiu,20,0,24,4
1708254722028,CHEM 43A,B06,394139,Lam; Tin Yiu,19,0,24,5
1708254722028,CHEM 43A,B07,394140,Lam; Tin Yiu,20,0,24,4
1708254722028,CHEM 43A,B08,394141,Lam; Tin Yiu,24,0,24,0
1708254722028,CHEM 43A,B09,394142,Lam; Tin Yiu,20,0,24,4
1708254722028,CHEM 43A,B10,394143,Lam; Tin Yiu,24,0,24,0
1708254722028,CHEM 43A,B11,394145,Lam; Tin Yiu,22,0,24,2
1708254722028,CHEM 43A,B12,394146,Lam; Tin Yiu,23,0,24,1
1708254722557,CHEM 96,A00,394159,Bussey; Thomas J,24,0,25,1
1708254723083,CHEM 100A,A01,394161,Li; Shaowei,16,0,22,6
1708254723083,CHEM 100A,A02,394162,Li; Shaowei,20,0,24,4
1708254723083,CHEM 100A,A03,394163,Li; Shaowei,22,0,24,2
1708254723083,CHEM 100A,A04,394164,Li; Shaowei,24,0,24,0
1708254723083,CHEM 100A,A05,394165,Li; Shaowei,24,0,24,0
1708254723083,CHEM 100A,A06,394166,Li; Shaowei,20,0,22,2
1708254723613,CHEM 100B,A01,394175,Pomeroy; Robert S.,19,0,25,6
1708254724140,CHEM 105A,A01,394177,Young; Mark,31,0,39,8
1708254724140,CHEM 105A,B01,394179,Young; Mark,0,0,0,0
1708254724666,CHEM 108,A01,394181,Staff,14,0,20,6
1708254724666,CHEM 108,A02,394182,Staff,23,0,24,1
1708254724666,CHEM 108,B01,394184,Staff,4,0,20,16
1708254724666,CHEM 108,B02,394185,Staff,23,0,24,1
1708254725199,CHEM 109,A01,394187,Piercy; Marc Anthony,17,0,20,3
1708254725199,CHEM 109,A02,394188,Piercy; Marc Anthony,22,0,24,2
1708254725199,CHEM 109,B01,394193,Piercy; Marc Anthony,12,0,20,8
1708254725199,CHEM 109,B02,394194,Piercy; Marc Anthony,23,0,24,1
1708254725728,CHEM 111,A00,394195,Thiemens; Mark H,97,0,100,3
1708254726257,CHEM 114B,A01,459574,Piercy; Marc Anthony,39,0,45,6
1708254726257,CHEM 114B,A02,459575,Piercy; Marc Anthony,40,0,45,5
1708254726783,CHEM 114C,A01,467286,Komives; Elizabeth A,32,0,44,12
1708254726783,CHEM 114C,A02,467287,Komives; Elizabeth A,42,0,44,2
1708254726783,CHEM 114C,A03,467290,Komives; Elizabeth A,42,0,44,2
1708254726783,CHEM 114C,A04,467295,Komives; Elizabeth A,43,0,44,1
1708254727314,CHEM 114D,A00,394198,Ghosh; Gourisankar,29,0,30,1
1708254727840,CHEM 118,A01,459788,Donoghue; Daniel J.,37,0,40,3
1708254727840,CHEM 118,A02,459800,Donoghue; Daniel J.,37,0,40,3
1708254727840,CHEM 118,A03,459807,Donoghue; Daniel J.,36,0,40,4
1708254727840,CHEM 118,A04,459809,Donoghue; Daniel J.,38,0,40,2
1708254727840,CHEM 118,A05,459811,Donoghue; Daniel J.,37,0,40,3
1708254727840,CHEM 118,A06,459826,Donoghue; Daniel J.,39,0,40,1
1708254728370,CHEM 119,A01,467427,Joseph; Simpson,35,0,40,5
1708254728370,CHEM 119,A02,467441,Joseph; Simpson,0,0,0,0
1708254728897,CHEM 120B,A01,467450,Griffith; Kent,37,0,40,3
1708254728897,CHEM 120B,A02,467451,Griffith; Kent,34,0,40,6
1708254728897,CHEM 120B,A03,467452,Griffith; Kent,35,0,40,5
1708254729426,CHEM 123,A00,394211,Schimpf; Alina M,0,0,0,1
1708254729953,CHEM 125,A00,394217,Tezcan; Faik,18,0,20,2
1708254730483,CHEM 126A,A01,459715,Yong; Haiwang,39,0,40,1
1708254730483,CHEM 126A,A02,459725,Yong; Haiwang,36,0,40,4
1708254731009,CHEM 126B,A01,467405,Tauber; Michael,36,0,40,4
1708254731009,CHEM 126B,A02,467406,Tauber; Michael,39,0,40,1
1708254731009,CHEM 126B,A03,467426,Tauber; Michael,39,0,40,1
1708254731542,CHEM 132,A01,460181,Galperin; Michael,42,0,45,3
1708254731542,CHEM 132,A02,460182,Galperin; Michael,37,0,45,8
1708254732068,CHEM 135,A01,394222,Tauber; Michael,15,0,15,0
1708254732595,CHEM 143B,A01,394229,Klosterman; Jeremy K,16,0,24,8
1708254732595,CHEM 143B,A02,394230,Klosterman; Jeremy K,21,0,24,3
1708254733126,CHEM 156,A00,394231,Romero; Erik Anthony,30,0,30,0
1708254733650,CHEM 157,A00,394232,Tor; Yitzhak,74,0,80,6
1708254734176,CHEM 165,A01,460194,Herzik; Mark Anthony,21,0,25,4
1708254734707,CHEM 167,A01,467296,Deshmukh; Lalit,39,0,40,1
1708254734707,CHEM 167,A02,467297,Deshmukh; Lalit,33,0,40,7
1708254734707,CHEM 167,A03,467298,Deshmukh; Lalit,37,0,40,3
1708254734707,CHEM 167,A04,467312,Deshmukh; Lalit,37,0,40,3
1708254735233,CHEM 173,A00,394284,Young; Mark,48,0,50,2
1708254735761,CHEM 174,A01,455015,Pomeroy; Robert S.,45,0,50,5
1708254736288,CHEM 186,A00,477716,Paesani; Francesco & Gilson; Michael K.,6,0,12,6
1708254736813,CHEM 188,A00,394294,Bussey; Thomas J,19,0,20,1
1708254737342,CHEM 214,A00,394336,Ghosh; Gourisankar,12,0,20,8
1708254737867,CHEM 217,A00,394341,Joseph; Simpson,25,0,30,5
1708254738395,CHEM 221,A00,394425,Taylor; Susan S.,10,0,20,10
1708254738920,CHEM 225,A00,394429,Tezcan; Faik,4,0,10,6
1708254739445,CHEM 227,A00,394430,Schimpf; Alina M,26,0,30,4
1708254739970,CHEM 229,A00,394431,Stauber; Julia Megan,13,0,20,7
1708254740501,CHEM 235,A01,394433,Tauber; Michael,20,0,20,0
1708254741028,CHEM 236,A00,394434,Kummel; Andrew C,14,0,15,1
1708254741557,CHEM 241,A00,394435,Pokorski; Jonathan Kyle,14,0,15,1
1708254742084,CHEM 250,A00,394436,Weizman; Haim,0,0,0,16
1708254742612,CHEM 256,A00,394437,Romero; Erik Anthony,15,0,20,5
1708254743138,CHEM 257,A00,394438,Tor; Yitzhak,23,0,30,7
1708254743665,CHEM 265,A01,460195,Herzik; Mark Anthony,13,0,20,7
1708254744196,CHEM 273,A00,394440,Young; Mark,13,0,20,7
1708254744724,CHEM 276,A00,394441,Mc Culloch; Andrew Douglas & Amaro; Rommie E,0,0,0,0
1708254745249,CHEM 283,A00,394443,Komives; Elizabeth A,2,0,4,2
1708254745776,CHEM 286,A00,477693,Paesani; Francesco & Gilson; Michael K.,26,0,34,8
1708254746306,CHEM 291,A00,394446,Komives; Elizabeth A,20,0,20,0
1708254746832,CHEM 294,A00,394447,Romero; Erik Anthony,50,0,50,0
1708254747362,CHIN 10CD,A01,394453,Liu; Mingming,17,0,17,0
1708254747362,CHIN 10CD,A02,394457,Liu; Mingming,18,0,18,0
1708254747888,CHIN 10CM,A01,394465,Chen; Pei-Chia,11,0,12,1
1708254747888,CHIN 10CM,A02,394466,Chen; Pei-Chia,12,0,12,0
1708254747888,CHIN 10CM,B01,394468,Liu; Mingming,11,0,13,2
1708254747888,CHIN 10CM,B02,394469,Liu; Mingming,13,0,13,0
1708254748415,CHIN 10CN,A01,394581,Xu; Li,14,0,14,0
1708254748415,CHIN 10CN,A02,394582,Xu; Li,14,0,14,0
1708254748415,CHIN 10CN,B01,394585,Xu; Li,14,0,14,0
1708254748415,CHIN 10CN,B02,394586,Xu; Li,13,0,14,1
1708254748946,CHIN 20CD,A01,394591,Wang; Xiao,11,0,12,1
1708254748946,CHIN 20CD,A02,394592,Wang; Xiao,11,0,12,1
1708254749472,CHIN 20CN,A01,394597,Anderson; Qin-Hong,7,0,8,1
1708254749472,CHIN 20CN,A02,394599,Anderson; Qin-Hong,8,0,8,0
1708254749472,CHIN 20CN,B01,394601,Anderson; Qin-Hong,14,0,15,1
1708254750002,CHIN 100CM,A00,394602,Anderson; Qin-Hong,19,0,20,1
1708254750527,CHIN 100CN,A00,394603,Chen; Pei-Chia,24,0,24,0
1708254751052,CHIN 169B,A00,394623,Wang; Xiao,19,0,20,1
1708254751582,CLAS 87,A00,394669,Herbst; Matthew,19,0,20,1
1708254752109,CLAS 121R,A01,394671,Herbst; Matthew,11,0,12,1
1708254752109,CLAS 121R,B01,486854,Herbst; Matthew,8,0,8,0
1708254752639,CLIN 294C,A00,476856,Wierenga; Christina E & Banks; Sarah Jane,20,0,20,0
1708254753166,CLIN 296,001,476768,Brookman; Lauren Irene,94,0,100,6
1708254753166,CLIN 296,002,476855,Brookman; Lauren Irene,10,0,10,0
1708254753694,CLRE 238R,A00,394675,Mehta; Ravindra L.,9998,0,9999,1
1708254754223,CLRE 254,A00,394678,Vaida; Florin,9999,0,9999,0
1708254754749,CLRE 256,A00,394685,Morris; Sheldon,9999,0,9999,0
1708254755276,CLRE 258,A00,394692,Mehta; Ravindra L.,9999,0,9999,0
1708254755803,CLRE 260,A00,394693,Cuomo; Raphael Eduardo,9999,0,9999,0
1708254756332,CLRE 264,A00,394696,Mehta; Ravindra L.,9999,0,9999,0
1708254756857,CLRE 267,A00,394703,Vaida; Florin,9999,0,9999,0
1708254757382,CLRE 297,001,394705,Cuomo; Raphael Eduardo,9999,0,9999,0
1708254757917,CMM 246,A00,492783,Gordts; Philip & Varki; Ajit P & Lewis; Amanda Lark & Godula; Kamil & Gagneux; Pascal & Esko; Jeffrey D. & Bode; Lars,9,0,10,1
1708254758444,CMM 250,A00,492943,Willert; Karl Heinrich,31,0,40,9
1708254758972,COGR 200B,A00,395746,Jack; Caroline Sarah,2,0,5,3
1708254759498,COGR 225B,A00,395750,Serlin; David,1,0,5,4
1708254760024,COGR 225C,A00,395753,Gates; Kelly,1,0,5,4
1708254760553,COGR 275,A00,395943,Goldfarb; Brian,6,0,10,4
1708254760553,COGR 275,B00,396046,Fattal; Alexander Leor,4,0,10,6
1708254760553,COGR 275,C00,396047,Kidman; Shawna F,4,0,10,6
1708254761079,COGR 280,A00,396048,Ahn; Patricia Jeehyun,6,0,10,4
1708254761606,COGS 1,A01,407484,Boyle; Mary E. T.,52,0,60,8
1708254761606,COGS 1,A02,407498,Boyle; Mary E. T.,54,0,60,6
1708254761606,COGS 1,A03,407504,Boyle; Mary E. T.,59,0,60,1
1708254761606,COGS 1,A04,407512,Boyle; Mary E. T.,57,0,60,3
1708254761606,COGS 1,A05,407513,Boyle; Mary E. T.,60,0,60,0
1708254761606,COGS 1,A06,407514,Boyle; Mary E. T.,58,0,60,2
1708254761606,COGS 1,A07,407515,Boyle; Mary E. T.,57,0,57,0
1708254762135,COGS 9,A01,407520,Shannon; Kyle Michael,54,0,60,6
1708254762135,COGS 9,A02,407521,Shannon; Kyle Michael,60,0,60,0
1708254762135,COGS 9,A03,407522,Shannon; Kyle Michael,59,0,60,1
1708254762135,COGS 9,A04,407524,Shannon; Kyle Michael,57,0,60,3
1708254762135,COGS 9,A05,407525,Shannon; Kyle Michael,59,0,60,1
1708254762663,COGS 10,A01,407527,Morgan; Eric,45,0,50,5
1708254762663,COGS 10,A02,407530,Morgan; Eric,46,0,50,4
1708254762663,COGS 10,A03,407531,Morgan; Eric,46,0,50,4
1708254762663,COGS 10,A04,407532,Morgan; Eric,47,0,50,3
1708254762663,COGS 10,A05,407534,Morgan; Eric,47,0,50,3
1708254762663,COGS 10,A06,407539,Morgan; Eric,50,0,50,0
1708254762663,COGS 10,A07,407628,Morgan; Eric,50,0,50,0
1708254763192,COGS 11,A01,407699,Boroditsky; Lera,179,0,180,1
1708254763717,COGS 12,A00,407702,Boroditsky; Lera,75,0,75,0
1708254764243,COGS 14A,A01,407706,Barrera; Steven James,51,0,57,6
1708254764243,COGS 14A,A02,407707,Barrera; Steven James,54,0,57,3
1708254764243,COGS 14A,A03,407712,Barrera; Steven James,0,0,0,1
1708254764243,COGS 14A,A04,407715,Barrera; Steven James,57,0,57,0
1708254764243,COGS 14A,A05,407717,Barrera; Steven James,55,0,56,1
1708254764243,COGS 14A,A06,407718,Barrera; Steven James,52,0,55,3
1708254764243,COGS 14A,A07,407720,Barrera; Steven James,49,0,55,6
1708254764772,COGS 14B,A01,407723,Hoffman; Drew Ellen,52,0,57,5
1708254764772,COGS 14B,A02,407726,Hoffman; Drew Ellen,48,0,55,7
1708254764772,COGS 14B,A03,407727,Hoffman; Drew Ellen,52,0,55,3
1708254764772,COGS 14B,A04,407729,Hoffman; Drew Ellen,52,0,55,3
1708254764772,COGS 14B,A05,407730,Hoffman; Drew Ellen,50,0,55,5
1708254765300,COGS 17,A01,407733,Johnson; Christine M.,50,0,50,0
1708254765300,COGS 17,A02,407734,Johnson; Christine M.,48,0,50,2
1708254765300,COGS 17,A03,407735,Johnson; Christine M.,46,0,50,4
1708254765300,COGS 17,A04,407740,Johnson; Christine M.,47,0,50,3
1708254765300,COGS 17,A05,407745,Johnson; Christine M.,48,0,50,2
1708254765300,COGS 17,A06,407824,Johnson; Christine M.,48,0,50,2
1708254765300,COGS 17,A07,407878,Johnson; Christine M.,50,0,55,5
1708254765300,COGS 17,A08,408015,Johnson; Christine M.,52,0,55,3
1708254765833,COGS 18,A01,408118,Ellis; Shannon Elizabeth,27,0,35,8
1708254765833,COGS 18,A02,408119,Ellis; Shannon Elizabeth,31,0,35,4
1708254765833,COGS 18,A03,408120,Ellis; Shannon Elizabeth,23,0,35,12
1708254765833,COGS 18,A04,408136,Ellis; Shannon Elizabeth,33,0,35,2
1708254765833,COGS 18,A05,408141,Ellis; Shannon Elizabeth,35,0,35,0
1708254765833,COGS 18,A06,408143,Ellis; Shannon Elizabeth,34,0,35,1
1708254765833,COGS 18,A07,408144,Ellis; Shannon Elizabeth,35,0,35,0
1708254765833,COGS 18,A08,408145,Ellis; Shannon Elizabeth,34,0,35,1
1708254765833,COGS 18,A09,408146,Ellis; Shannon Elizabeth,35,0,35,0
1708254765833,COGS 18,B01,408148,Ellis; Shannon Elizabeth,30,0,32,2
1708254765833,COGS 18,B02,408149,Ellis; Shannon Elizabeth,26,0,32,6
1708254765833,COGS 18,B03,408151,Ellis; Shannon Elizabeth,27,0,33,6
1708254765833,COGS 18,B04,408154,Ellis; Shannon Elizabeth,32,0,33,1
1708254765833,COGS 18,B05,408163,Ellis; Shannon Elizabeth,29,0,33,4
1708254765833,COGS 18,B06,408176,Ellis; Shannon Elizabeth,33,0,33,0
1708254765833,COGS 18,B07,408177,Ellis; Shannon Elizabeth,31,0,33,2
1708254765833,COGS 18,B08,408178,Ellis; Shannon Elizabeth,32,0,33,1
1708254765833,COGS 18,B09,408195,Ellis; Shannon Elizabeth,31,0,33,2
1708254766360,COGS 87,A00,408196,Deak; Gedeon O.,20,0,20,0
1708254766360,COGS 87,B00,479478,Fleischer; Jason G,20,0,20,0
1708254766886,COGS 100,A01,408262,Allen; Michael Gordon,54,0,56,2
1708254766886,COGS 100,A02,408263,Allen; Michael Gordon,52,0,56,4
1708254766886,COGS 100,A03,408264,Allen; Michael Gordon,55,0,56,1
1708254766886,COGS 100,A04,408265,Allen; Michael Gordon,56,0,56,0
1708254766886,COGS 100,A05,408266,Allen; Michael Gordon,56,0,56,0
1708254766886,COGS 100,A06,408349,Allen; Michael Gordon,55,0,56,1
1708254767411,COGS 101A,A01,408352,Morgan; Eric,60,0,60,0
1708254767411,COGS 101A,A02,408353,Morgan; Eric,58,0,60,2
1708254767411,COGS 101A,A03,408354,Morgan; Eric,57,0,60,3
1708254767411,COGS 101A,A04,408355,Morgan; Eric,59,0,60,1
1708254767939,COGS 101B,A01,408373,Barrera; Steven James,47,0,50,3
1708254767939,COGS 101B,A02,408380,Barrera; Steven James,46,0,50,4
1708254767939,COGS 101B,A03,408384,Barrera; Steven James,38,0,50,12
1708254767939,COGS 101B,A04,408385,Barrera; Steven James,37,0,50,13
1708254768465,COGS 101C,A01,408387,Trott; Sean Thomas,48,0,50,2
1708254768465,COGS 101C,A02,408388,Trott; Sean Thomas,43,0,50,7
1708254768465,COGS 101C,A03,408389,Trott; Sean Thomas,45,0,50,5
1708254768993,COGS 107A,A01,408396,Boyle; Mary E. T.,54,0,56,2
1708254768993,COGS 107A,A02,408397,Boyle; Mary E. T.,54,0,56,2
1708254768993,COGS 107A,A03,408399,Boyle; Mary E. T.,51,0,56,5
1708254768993,COGS 107A,A04,408409,Boyle; Mary E. T.,50,0,56,6
1708254768993,COGS 107A,A05,408410,Boyle; Mary E. T.,51,0,56,5
1708254768993,COGS 107A,A06,408411,Boyle; Mary E. T.,55,0,56,1
1708254769519,COGS 107B,A01,408413,Mooshagian; Eric Frederick,46,0,50,4
1708254769519,COGS 107B,A02,408414,Mooshagian; Eric Frederick,43,0,50,7
1708254769519,COGS 107B,A03,408428,Mooshagian; Eric Frederick,43,0,50,7
1708254769519,COGS 107B,A04,408434,Mooshagian; Eric Frederick,46,0,50,4
1708254769519,COGS 107B,A05,408435,Mooshagian; Eric Frederick,50,0,50,0
1708254769519,COGS 107B,A06,408446,Mooshagian; Eric Frederick,49,0,50,1
1708254770049,COGS 107C,A01,408500,Chiba; Andrea,51,0,60,9
1708254770049,COGS 107C,A02,408519,Chiba; Andrea,55,0,60,5
1708254770049,COGS 107C,A03,408524,Chiba; Andrea,56,0,60,4
1708254770577,COGS 108,A01,408532,Fleischer; Jason G,45,0,60,15
1708254770577,COGS 108,A02,408543,Fleischer; Jason G,58,0,60,2
1708254770577,COGS 108,A03,408544,Fleischer; Jason G,59,0,60,1
1708254770577,COGS 108,A04,408552,Fleischer; Jason G,32,0,60,28
1708254770577,COGS 108,A05,408554,Fleischer; Jason G,47,0,60,13
1708254770577,COGS 108,A06,408574,Fleischer; Jason G,43,0,60,17
1708254770577,COGS 108,A07,408576,Fleischer; Jason G,56,0,60,4
1708254771102,COGS 112,A01,408682,Hoffman; Drew Ellen,32,0,50,18
1708254771102,COGS 112,A02,408683,Hoffman; Drew Ellen,38,0,50,12
1708254771102,COGS 112,A03,408684,Hoffman; Drew Ellen,48,0,60,12
1708254771627,COGS 122,A01,408695,Dow; Steven P,21,0,50,29
1708254772222,COGS 125,A00,408697,Klemmer; Scott R,35,0,50,15
1708254772748,COGS 126,A01,408787,Hollan; James D.,44,0,50,6
1708254773275,COGS 138,A01,408866,Khosla; Meenakshi,71,0,75,4
1708254773802,COGS 142,A01,408868,Rossano; Federico,49,0,50,1
1708254774328,COGS 144,A01,408950,Rossano; Federico,48,0,50,2
1708254774855,COGS 155,A01,408993,Staff,49,0,50,1
1708254775384,COGS 157,A00,408994,Creel; Sarah,0,0,0,0
1708254775908,COGS 160,A00,409031,Deak; Gedeon O.,20,0,20,0
1708254776435,COGS 175,A01,409035,Rill; Bryan,67,0,75,8
1708254776962,COGS 178,A00,409274,Jernigan; Terry Lynne,68,0,70,2
1708254777488,COGS 179,A00,409278,Staff,40,0,40,0
1708254778016,COGS 184,A01,409317,Johnson; Christine M.,42,0,50,8
1708254778542,COGS 185,A01,409476,Tu; Zhuowen,33,0,50,17
1708254778542,COGS 185,A02,409525,Tu; Zhuowen,45,0,50,5
1708254779068,COGS 188,A01,409527,Fleischer; Jason G,44,0,75,31
1708254779601,COGS 190C,001,409528,Chiba; Andrea,9999,0,9999,0
1708254779601,COGS 190C,002,409530,Fleischer; Jason G,9999,0,9999,0
1708254779601,COGS 190C,003,409531,Boyle; Mary E. T.,9999,0,9999,0
1708254779601,COGS 190C,004,409532,Nitz; Douglas A.,9999,0,9999,0
1708254779601,COGS 190C,005,409535,Rangel; Lara M,9999,0,9999,0
1708254779601,COGS 190C,006,409536,Rossano; Federico,9999,0,9999,0
1708254779601,COGS 190C,007,409537,Deak; Gedeon O.,9999,0,9999,0
1708254779601,COGS 190C,008,409538,Trott; Sean Thomas,9999,0,9999,0
1708254779601,COGS 190C,009,409540,Creel; Sarah,9999,0,9999,0
1708254779601,COGS 190C,010,409541,Voytek; Bradley Thomas,9999,0,9999,0
1708254779601,COGS 190C,011,409542,Greene; Deanna Jacquelyn,9999,0,9999,0
1708254779601,COGS 190C,012,409543,Ellis; Shannon Elizabeth,9999,0,9999,0
1708254779601,COGS 190C,013,409546,Kirsh; David Joel,9999,0,9999,0
1708254780127,COGS 190D,A00,409547,Voytek; Bradley Thomas,20,0,20,0
1708254780659,COGS 194,A00,409548,Hill; Seth J,9999,0,9999,0
1708254782201,COGS 200,A01,406697,Creel; Sarah,0,0,0,0
1708254782730,COGS 205,A00,406698,Chiba; Andrea,20,0,20,0
1708254783256,COGS 209,A00,406699,Mukamel; Eran A,41,0,68,27
1708254783814,COGS 210C,001,406700,Kirsh; David Joel,9999,0,9999,0
1708254783814,COGS 210C,002,406701,Greene; Deanna Jacquelyn,9998,0,9999,1
1708254783814,COGS 210C,003,406702,Xia; Haijun,9999,0,9999,0
1708254783814,COGS 210C,004,406703,Nitz; Douglas A.,9998,0,9999,1
1708254783814,COGS 210C,005,406710,Hollan; James D.,9999,0,9999,0
1708254783814,COGS 210C,006,406713,De Sa; Virginia,9999,0,9999,0
1708254783814,COGS 210C,007,406714,Rossano; Federico,9999,0,9999,0
1708254783814,COGS 210C,008,406740,Kiyonaga; Anastasia,9999,0,9999,0
1708254783814,COGS 210C,009,406745,Guo; Philip J,9998,0,9999,1
1708254783814,COGS 210C,010,406746,Dow; Steven P,9999,0,9999,0
1708254783814,COGS 210C,011,406747,Bergen; Benjamin,9999,0,9999,0
1708254783814,COGS 210C,012,406758,Coulson; Seana M,9999,0,9999,0
1708254784342,COGS 211C,A00,406763,Coulson; Seana M,17,0,20,3
1708254784868,COGS 229,A00,406788,Hollan; James D. & Xia; Haijun,4,0,10,6
1708254786412,COGS 238,A00,406789,Bergen; Benjamin,17,0,20,3
1708254786938,COGS 278,A00,406794,Jernigan; Terry Lynne,18,0,20,2
1708254787497,COMM 10,A01,394711,Schmidt; Thomas Rainer,20,0,24,4
1708254787497,COMM 10,A02,394714,Schmidt; Thomas Rainer,24,0,24,0
1708254787497,COMM 10,A03,394716,Schmidt; Thomas Rainer,24,0,24,0
1708254787497,COMM 10,A04,394717,Schmidt; Thomas Rainer,22,0,24,2
1708254787497,COMM 10,A05,394731,Schmidt; Thomas Rainer,24,0,24,0
1708254787497,COMM 10,A06,394733,Schmidt; Thomas Rainer,24,0,24,0
1708254787497,COMM 10,A07,394740,Schmidt; Thomas Rainer,24,0,24,0
1708254787497,COMM 10,A08,394741,Schmidt; Thomas Rainer,24,0,24,0
1708254787497,COMM 10,A09,394751,Schmidt; Thomas Rainer,23,0,24,1
1708254787497,COMM 10,A10,394779,Schmidt; Thomas Rainer,24,0,24,0
1708254787497,COMM 10,A11,394809,Schmidt; Thomas Rainer,24,0,24,0
1708254787497,COMM 10,A12,394811,Schmidt; Thomas Rainer,24,0,24,0
1708254787497,COMM 10,A13,394818,Schmidt; Thomas Rainer,24,0,24,0
1708254787497,COMM 10,A14,394825,Schmidt; Thomas Rainer,23,0,24,1
1708254787497,COMM 10,A15,394828,Schmidt; Thomas Rainer,24,0,24,0
1708254787497,COMM 10,A16,394829,Schmidt; Thomas Rainer,0,0,0,0
1708254787497,COMM 10,A17,486828,Schmidt; Thomas Rainer,20,0,21,1
1708254788024,COMM 20,A01,394834,McKenna; Denise,69,0,70,1
1708254788554,COMM 80,A01,394849,Campbell; Robert Harold,120,0,120,0
1708254789096,COMM 100C,A01,394957,Kidman; Shawna F,24,0,25,1
1708254789096,COMM 100C,A02,394972,Kidman; Shawna F,25,0,25,0
1708254789096,COMM 100C,A03,394977,Kidman; Shawna F,22,0,25,3
1708254789096,COMM 100C,A04,394981,Kidman; Shawna F,25,0,25,0
1708254789096,COMM 100C,A05,394985,Kidman; Shawna F,24,0,25,1
1708254789096,COMM 100C,A06,394989,Kidman; Shawna F,23,0,25,2
1708254789096,COMM 100C,A07,394993,Kidman; Shawna F,24,0,25,1
1708254789096,COMM 100C,A08,394997,Kidman; Shawna F,23,0,25,2
1708254789096,COMM 100C,A09,394999,Kidman; Shawna F,25,0,25,0
1708254789096,COMM 100C,A10,395018,Kidman; Shawna F,25,0,25,0
1708254789096,COMM 100C,A11,395041,Kidman; Shawna F,24,0,25,1
1708254789096,COMM 100C,A12,395080,Kidman; Shawna F,24,0,25,1
1708254789628,COMM 101,A01,395135,Halm; Gavin Patrick,15,0,15,0
1708254789628,COMM 101,A02,395252,Halm; Gavin Patrick,15,0,15,0
1708254789628,COMM 101,A03,395253,Halm; Gavin Patrick,15,0,15,0
1708254789628,COMM 101,A04,395263,Halm; Gavin Patrick,15,0,15,0
1708254790154,COMM 101D,A00,395264,Martinico; Daniel J,13,0,16,3
1708254790681,COMM 101K,A00,395266,Ahn; Patricia Jeehyun,16,0,18,2
1708254791210,COMM 101N,A00,395267,Martinico; Daniel J,16,0,16,0
1708254791736,COMM 102C,A01,395270,Campion; Camille E,5,0,6,1
1708254791736,COMM 102C,A02,395271,Campion; Camille E,6,0,6,0
1708254791736,COMM 102C,A03,395272,Campion; Camille E,5,0,6,1
1708254792265,COMM 102M,A01,395285,Davis; Zeinabu I.,9,0,10,1
1708254792265,COMM 102M,A02,395288,Davis; Zeinabu I.,8,0,10,2
1708254792796,COMM 103D,A00,395343,Gates; Kelly,34,0,35,1
1708254793327,COMM 107,A00,395461,Serlin; David,33,0,35,2
1708254793853,COMM 109D,A00,395462,Halm; Gavin Patrick,72,0,75,3
1708254794382,COMM 110G,A00,395481,Whitworth-Smith; Andrew C,32,0,35,3
1708254794908,COMM 110M,A00,395482,Harb; Anthony Joseph,34,0,35,1
1708254795435,COMM 111A,A00,487217,Pavon Aramburu; Maria Laur,34,0,35,1
1708254795964,COMM 113T,A00,395516,Fields; Gary,35,0,35,0
1708254796491,COMM 114A,A00,395517,Zilberg; Elana,32,0,35,3
1708254797019,COMM 114B,A00,395523,Zilberg; Elana,19,0,20,1
1708254797548,COMM 114E,A00,487218,Pavon Aramburu; Maria Laur,34,0,35,1
1708254798075,COMM 114W,A00,395524,Walkover; Lillian B,17,0,18,1
1708254798605,COMM 126,A00,479341,Staff,26,0,30,4
1708254799131,COMM 132,A00,481491,Rojo Solis; Juan Jose,0,0,0,0
1708254799657,COMM 134,A00,395578,Abuelhiga; Soraya Jill,28,0,30,2
1708254800182,COMM 143,A00,395579,Rojo Solis; Juan Jose,28,0,30,2
1708254800712,COMM 146,A00,395584,Jack; Caroline Sarah,29,0,30,1
1708254801237,COMM 168,A00,395592,Harb; Anthony Joseph,29,0,30,1
1708254801765,COMM 170,A00,395608,Pavon Aramburu; Maria Laur,30,0,30,0
1708254802292,COMM 173,A00,395609,Alac; Morana,29,0,30,1
1708254802818,COMM 174,A00,395679,Alac; Morana,30,0,30,0
1708254803347,COMM 190,A00,395682,Abuelhiga; Soraya Jill,19,0,23,4
1708254803347,COMM 190,B00,395696,Staff,21,0,23,2
1708254803347,COMM 190,C00,395697,Fattal; Alexander Leor,22,0,23,1
1708254803881,CSE 8A,A50,459200,Miranda; Gregory Joseph,34,0,35,1
1708254803881,CSE 8A,A51,459205,Miranda; Gregory Joseph,34,0,35,1
1708254803881,CSE 8A,A52,459206,Miranda; Gregory Joseph,34,0,35,1
1708254803881,CSE 8A,A53,459212,Miranda; Gregory Joseph,34,0,35,1
1708254803881,CSE 8A,A54,459213,Miranda; Gregory Joseph,34,0,35,1
1708254803881,CSE 8A,A55,459232,Miranda; Gregory Joseph,34,0,35,1
1708254804407,CSE 11,A01,470735,Ochoa; Benjamin Lawrence,180,0,195,15
1708254804935,CSE 12,A01,470744,Cao; Yingjun,189,0,200,11
1708254804935,CSE 12,B01,470752,Miranda; Gregory Joseph,71,0,100,29
1708254804935,CSE 12,B02,470760,Miranda; Gregory Joseph,93,0,100,7
1708254805470,CSE 15L,A01,410174,Solares; Edwin A,6,0,10,4
1708254805470,CSE 15L,B01,410215,Solares; Edwin A,7,0,10,3
1708254805470,CSE 15L,C01,410305,Solares; Edwin A,3,0,10,7
1708254805470,CSE 15L,D01,410400,Solares; Edwin A,1,0,10,9
1708254805996,CSE 20,A01,470765,Minnes Kemp; Mor Mia,145,0,150,5
1708254806527,CSE 21,A01,470776,Jones; Miles E,68,0,73,5
1708254806527,CSE 21,A02,482889,Jones; Miles E,68,0,72,4
1708254807055,CSE 29,A01,494014,Soosai Raj; Adalbert Geral,48,0,50,2
1708254807055,CSE 29,A02,494016,Soosai Raj; Adalbert Geral,40,0,50,10
1708254807055,CSE 29,B01,494018,Shalev; Aaron D,16,0,20,4
1708254807583,CSE 30,A01,470784,Cao; Yingjun,141,0,150,9
1708254807583,CSE 30,B01,467469,Muller; P Keith,98,0,120,22
1708254808109,CSE 87,A00,410528,Moshiri; Niema,20,0,20,0
1708254808634,CSE 90,A00,486885,Minnes Kemp; Mor Mia,0,0,0,0
1708254809165,CSE 91,A00,486872,Minnes Kemp; Mor Mia,0,0,0,0
1708254809165,CSE 91,B00,486873,Minnes Kemp; Mor Mia,0,0,0,0
1708254809692,CSE 95,A00,410529,Minnes Kemp; Mor Mia,50,0,50,0
1708254810220,CSE 100,A01,470792,Sahoo; Debashis,54,0,70,16
1708254810746,CSE 100R,A01,410556,Moshiri; Niema,1,0,40,39
1708254811277,CSE 101,A01,470797,Jones; Miles E,14,0,44,30
1708254811277,CSE 101,A02,482892,Jones; Miles E,31,0,43,12
1708254811804,CSE 105,A01,470800,Micciancio; Daniele,85,0,98,13
1708254812336,CSE 107,A01,467479,Bellare; Mihir,141,0,146,5
1708254812863,CSE 109,A01,459538,Shang; Jingbo,0,0,25,25
1708254813395,CSE 110,A50,459395,Powell; Thomas Allan,49,0,50,1
1708254813395,CSE 110,A51,459512,Powell; Thomas Allan,37,0,50,13
1708254813395,CSE 110,A52,459513,Powell; Thomas Allan,46,0,50,4
1708254813395,CSE 110,A53,459514,Powell; Thomas Allan,48,0,50,2
1708254813395,CSE 110,A54,459515,Powell; Thomas Allan,47,0,50,3
1708254813395,CSE 110,A55,459516,Powell; Thomas Allan,45,0,50,5
1708254813395,CSE 110,A56,459517,Powell; Thomas Allan,47,0,48,1
1708254813922,CSE 112,A50,459518,Powell; Thomas Allan,132,0,146,14
1708254814452,CSE 120,A01,470808,Zhou; Yuan-Yuan,167,0,200,33
1708254814979,CSE 125,A00,410564,Voelker; Geoffrey M.,30,0,30,0
1708254815505,CSE 127,A01,467484,Fernandes; Earlence T,175,0,196,21
1708254816035,CSE 130,A01,467485,Polikarpova; Nadezhda,176,0,192,16
1708254816561,CSE 131,A01,459522,Ding; Yufei,36,0,50,14
1708254817086,CSE 132B,A01,470816,Deutsch; Alin Bernard,60,0,70,10
1708254817614,CSE 140,A01,410606,Orailoglu; Alex,99,0,100,1
1708254817614,CSE 140,B01,410622,Eldon; John,130,0,146,16
1708254818140,CSE 140L,A01,410655,Orailoglu; Alex,99,0,100,1
1708254818140,CSE 140L,B01,410658,Eldon; John,122,0,146,24
1708254818670,CSE 141,A01,467486,Zhao; Jishen,173,0,196,23
1708254819197,CSE 141L,A01,410685,Eldon; John,162,0,196,34
1708254819724,CSE 145,A01,410713,Kastner; Ryan Charles,25,0,25,0
1708254820253,CSE 150B,A01,470824,Gao; Sicun,310,0,362,52
1708254820778,CSE 156,A01,467487,Nakashole; Ndapandula,138,0,192,54
1708254821305,CSE 165,A01,410757,Weibel; Nadir & Schulze; Jurgen P.,40,0,50,10
1708254821833,CSE 168,A01,410759,Ramamoorthi; Ravi,24,0,25,1
1708254821833,CSE 168,A02,410761,Ramamoorthi; Ravi,24,0,25,1
1708254822357,CSE 175,A01,410764,Kumar; Rakesh,48,0,50,2
1708254822884,CSE 182,A01,455011,Bafna; Vineet,47,0,50,3
1708254823411,CSE 185,A01,410895,Gymrek; Melissa Ann,41,0,57,16
1708254823411,CSE 185,A02,479240,Gymrek; Melissa Ann,53,0,58,5
1708254823945,CSE 190,A00,410982,Grier; Daniel T,48,0,50,2
1708254823945,CSE 190,B00,410983,Riek; Laurel D,50,0,50,0
1708254823945,CSE 190,C00,410984,Staff,36,0,50,14
1708254823945,CSE 190,D00,481666,Saha; Barna & Impagliazzo; Russell,27,0,28,1
1708254824473,CSE 203A,A00,410985,Saha; Barna & Impagliazzo; Russell,0,0,0,0
1708254825003,CSE 209A,A00,410986,Grier; Daniel T,0,0,0,0
1708254825545,CSE 209B,A00,410987,Bellare; Mihir,0,0,0,0
1708254826071,CSE 217,A01,459553,Weibel; Nadir,0,0,0,0
1708254826597,CSE 218,A00,410989,Griswold; William G.,0,0,0,0
1708254827126,CSE 219,A00,410990,Hollan; James D. & Xia; Haijun,0,0,0,0
1708254827708,CSE 224,A01,470832,Snoeren; Alex C.,0,0,0,0
1708254828236,CSE 229A,A00,410993,Shalev; Aaron D,0,0,0,0
1708254828762,CSE 229C,A00,410994,Fernandes; Earlence T,0,0,0,0
1708254829293,CSE 231,A01,467488,Jhala; Ranjit,0,0,0,0
1708254829818,CSE 233,A00,410996,Vianu; Victor Dan,0,0,0,0
1708254830343,CSE 237D,A00,410998,Kastner; Ryan Charles,0,0,0,0
1708254830873,CSE 239A,A00,410999,Vianu; Victor Dan,0,0,0,0
1708254831400,CSE 239B,A00,411000,Coblenz; Michael J,0,0,0,0
1708254831926,CSE 240A,A00,411001,Chin; Bryan W.,0,0,0,0
1708254832452,CSE 252D,A00,411004,Chandraker; Manmohan Krishna,0,0,0,0
1708254832981,CSE 256,A00,411005,Nakashole; Ndapandula,0,0,0,0
1708254833507,CSE 260,A01,467491,Chin; Bryan W.,0,0,0,0
1708254834036,CSE 276B,A00,411007,Riek; Laurel D,0,0,0,0
1708254834564,CSE 276F,A01,459554,Su; Hao,0,0,0,0
1708254835092,CSE 283,A00,411009,Bafna; Vineet & Zhong; Sheng,0,0,0,0
1708254835620,CSE 290,A00,411010,Gao; Sicun,0,0,0,0
1708254835620,CSE 290,B00,411011,Chern; Albert Ren-Haur,0,0,0,0
1708254835620,CSE 290,C00,411012,Swanson; Steven James,0,0,0,0
1708254835620,CSE 290,E00,411013,Su; Hao,0,0,0,0
1708254835620,CSE 290,F00,411014,Riek; Laurel D,0,0,0,0
1708254835620,CSE 290,G00,411015,Gymrek; Melissa Ann,0,0,0,0
1708254835620,CSE 290,H00,479239,Dasgupta; Sanjoy & Gymrek; Melissa Ann,0,0,0,0
1708254835620,CSE 290,I00,481669,Bafna; Vineet,0,0,0,0
1708254835620,CSE 290,J00,494949,Paturi; Ramamohan,0,0,0,0
1708254836149,CSE 291,A00,411016,Li; Tzumao,0,0,0,0
1708254836149,CSE 291,B00,411017,Heninger; Nadia A,0,0,0,0
1708254836149,CSE 291,C00,411114,Chern; Albert Ren-Haur,0,0,0,0
1708254836149,CSE 291,D00,411115,Zhang; Yiying,0,0,0,0
1708254836149,CSE 291,E00,411116,Cheng; Chung Kuan,0,0,0,0
1708254836149,CSE 291,G00,411118,Lerner; Sorin,0,0,0,0
1708254836149,CSE 291,I00,481509,Shang; Jingbo,0,0,0,0
1708254836149,CSE 291,J00,494844,Savage; Stefan & Stefan; Deian,50,0,50,0
1708254836697,CSE 293,001,487239,Bafna; Vineet,9999,0,9999,0
1708254836697,CSE 293,002,487240,Bellare; Mihir,9999,0,9999,0
1708254836697,CSE 293,003,487241,Berg-Kirkpatrick; Taylor D,9999,0,9999,0
1708254836697,CSE 293,004,487242,Chandraker; Manmohan Krishna,9999,0,9999,0
1708254836697,CSE 293,005,487243,Cheng; Chung Kuan,9999,0,9999,0
1708254836697,CSE 293,006,487244,Christensen; Henrik I,9999,0,9999,0
1708254836697,CSE 293,007,487245,Coblenz; Michael J,9999,0,9999,0
1708254836697,CSE 293,008,487363,Cottrell; Garrison W,9999,0,9999,0
1708254836697,CSE 293,009,487366,Deutsch; Alin Bernard,9999,0,9999,0
1708254836697,CSE 293,010,487433,Esmaeilzadeh; Hadi,9999,0,9999,0
1708254836697,CSE 293,011,487434,Freund; Yoav,9999,0,9999,0
1708254836697,CSE 293,012,487455,Griswold; William G.,9999,0,9999,0
1708254836697,CSE 293,013,487469,Gymrek; Melissa Ann,9999,0,9999,0
1708254836697,CSE 293,014,487470,Heninger; Nadia A,9999,0,9999,0
1708254836697,CSE 293,015,487471,Impagliazzo; Russell,9999,0,9999,0
1708254836697,CSE 293,016,487472,Jhala; Ranjit,9999,0,9999,0
1708254836697,CSE 293,017,487473,Kahng; Andrew Byun,9999,0,9999,0
1708254836697,CSE 293,018,487474,Kane; Daniel Mertz,9999,0,9999,0
1708254836697,CSE 293,019,487475,Kriegman; David J,9999,0,9999,0
1708254836697,CSE 293,020,487476,Kumar; Arun Kumar,9999,0,9999,0
1708254836697,CSE 293,021,487477,Lerner; Sorin,9999,0,9999,0
1708254836697,CSE 293,022,487478,Lovett; Shachar,9999,0,9999,0
1708254836697,CSE 293,023,487520,McAuley; Julian John,9999,0,9999,0
1708254836697,CSE 293,024,487522,Micciancio; Daniele,9999,0,9999,0
1708254836697,CSE 293,025,487577,Orailoglu; Alex,9999,0,9999,0
1708254836697,CSE 293,026,487586,Pannuto; Patrick William,9999,0,9999,0
1708254836697,CSE 293,027,487598,Paturi; Ramamohan,9999,0,9999,0
1708254836697,CSE 293,028,487604,Polikarpova; Nadezhda,9999,0,9999,0
1708254836697,CSE 293,029,487609,Politz; Joseph Gibbs,9999,0,9999,0
1708254836697,CSE 293,030,487642,Porter; George M,9999,0,9999,0
1708254836697,CSE 293,031,487665,Porter; Leonard Emerson,9999,0,9999,0
1708254836697,CSE 293,032,487689,Ramamoorthi; Ravi,9999,0,9999,0
1708254836697,CSE 293,033,487698,Riek; Laurel D,9999,0,9999,0
1708254836697,CSE 293,034,487712,Sahoo; Debashis,9999,0,9999,0
1708254836697,CSE 293,035,487721,Saul; Lawrence,9999,0,9999,0
1708254836697,CSE 293,036,487735,Savage; Stefan,9999,0,9999,0
1708254836697,CSE 293,037,487744,Schulze; Jurgen P.,9999,0,9999,0
1708254836697,CSE 293,038,487758,Snoeren; Alex C.,9999,0,9999,0
1708254836697,CSE 293,039,487767,Shang; Jingbo,9999,0,9999,0
1708254836697,CSE 293,040,487790,Stefan; Deian,9999,0,9999,0
1708254836697,CSE 293,041,487817,Su; Hao,9999,0,9999,0
1708254836697,CSE 293,042,487827,Swanson; Steven James,9999,0,9999,0
1708254836697,CSE 293,043,487830,Tullsen; Dean Michael,9999,0,9999,0
1708254836697,CSE 293,044,487837,Vaccaro; Kristen Marie,9999,0,9999,0
1708254836697,CSE 293,045,487838,Voelker; Geoffrey M.,9999,0,9999,0
1708254836697,CSE 293,046,487842,Zhao; Jishen,9999,0,9999,0
1708254836697,CSE 293,047,487847,Zhou; Yuan-Yuan,9999,0,9999,0
1708254836697,CSE 293,048,487852,Gao; Sicun,9999,0,9999,0
1708254836697,CSE 293,049,487853,Weibel; Nadir,9999,0,9999,0
1708254836697,CSE 293,050,487854,Gupta; Rajesh K.,9999,0,9999,0
1708254836697,CSE 293,051,487855,Soosai Raj; Adalbert Geral,9999,0,9999,0
1708254836697,CSE 293,052,494373,Zhang; Hao,9999,0,9999,0
1708254837221,CSE 294,A00,411124,Voelker; Geoffrey M.,15,0,15,0
1708254837754,CSS 100,A01,396053,Trott; Sean Thomas,43,0,50,7
1708254838283,CSS 120,A01,479237,Mignozzetti; Umberto,47,0,50,3
1708254838283,CSS 120,A02,479238,Mignozzetti; Umberto,50,0,50,0
1708254838809,CSS 209,A00,396054,Styler; William Francis,21,0,35,14
1708254839336,CSS 296,001,396055,Mignozzetti; Umberto,0,0,0,1
1708254839336,CSS 296,002,396056,Styler; William Francis,0,0,0,1
1708254839336,CSS 296,003,396057,Broz; James Lawrence,0,0,0,2
1708254839336,CSS 296,004,396058,Elliott; Graham,0,0,0,5
1708254839336,CSS 296,005,396059,Sun; Feiyang,0,0,0,0
1708254839336,CSS 296,006,396060,Dewaard; Andrew Michael,0,0,0,0
1708254839868,DDPM 210,A00,400652,Ma; Joseph David,36,0,36,0
1708254840392,DDPM 211,A00,400653,Ma; Joseph David,36,0,36,0
1708254840920,DDPM 214,A00,400720,Ma; Joseph David,36,0,36,0
1708254841447,DERM 296,001,464131,Staff,50,0,50,0
1708254841447,DERM 296,002,464178,Staff,50,0,50,0
1708254841447,DERM 296,003,464181,Staff,50,0,50,0
1708254841978,DOC 3,A01,399409,Strom; Megan C.,0,0,0,0
1708254841978,DOC 3,A02,399414,Strom; Megan C.,0,0,0,0
1708254841978,DOC 3,A03,399432,Strom; Megan C.,0,0,0,0
1708254841978,DOC 3,A04,399461,Strom; Megan C.,0,0,0,0
1708254841978,DOC 3,A05,399470,Strom; Megan C.,0,0,0,0
1708254841978,DOC 3,A06,399476,Strom; Megan C.,0,0,0,0
1708254841978,DOC 3,A07,399547,Strom; Megan C.,0,0,0,0
1708254841978,DOC 3,A08,399548,Strom; Megan C.,0,0,0,0
1708254841978,DOC 3,A09,399675,Strom; Megan C.,0,0,0,0
1708254841978,DOC 3,A10,399687,Strom; Megan C.,0,0,0,0
1708254841978,DOC 3,A11,399704,Strom; Megan C.,0,0,0,0
1708254841978,DOC 3,A12,399707,Strom; Megan C.,0,0,0,0
1708254841978,DOC 3,A13,399714,Strom; Megan C.,0,0,0,0
1708254841978,DOC 3,A14,399721,Strom; Megan C.,0,0,0,0
1708254841978,DOC 3,A15,399765,Strom; Megan C.,0,0,0,0
1708254841978,DOC 3,A16,399766,Strom; Megan C.,0,0,0,0
1708254841978,DOC 3,B01,399786,Strom; Megan C.,0,0,0,0
1708254841978,DOC 3,B02,399787,Strom; Megan C.,0,0,0,0
1708254841978,DOC 3,B03,399788,Strom; Megan C.,0,0,0,0
1708254841978,DOC 3,B04,399845,Strom; Megan C.,0,0,0,0
1708254841978,DOC 3,B05,399846,Strom; Megan C.,0,0,0,0
1708254841978,DOC 3,B06,399895,Strom; Megan C.,0,0,0,0
1708254841978,DOC 3,B07,399916,Strom; Megan C.,0,0,0,0
1708254841978,DOC 3,B08,400073,Strom; Megan C.,0,0,0,0
1708254841978,DOC 3,B09,400074,Strom; Megan C.,0,0,0,0
1708254841978,DOC 3,B10,400076,Strom; Megan C.,0,0,0,0
1708254841978,DOC 3,B11,400077,Strom; Megan C.,0,0,0,0
1708254841978,DOC 3,B12,400078,Strom; Megan C.,0,0,0,0
1708254841978,DOC 3,B13,400079,Strom; Megan C.,0,0,0,0
1708254841978,DOC 3,B14,400080,Strom; Megan C.,0,0,0,0
1708254841978,DOC 3,B15,400081,Strom; Megan C.,0,0,0,0
1708254841978,DOC 3,B16,400082,Strom; Megan C.,0,0,0,0
1708254841978,DOC 3,C01,400084,Chapman; Dillon,0,0,0,0
1708254841978,DOC 3,C02,400085,Chapman; Dillon,0,0,0,0
1708254841978,DOC 3,C03,400086,Chapman; Dillon,0,0,0,0
1708254841978,DOC 3,C04,400087,Chapman; Dillon,0,0,0,0
1708254841978,DOC 3,C05,400113,Chapman; Dillon,0,0,0,0
1708254841978,DOC 3,C06,400114,Chapman; Dillon,0,0,0,0
1708254841978,DOC 3,C07,400117,Chapman; Dillon,0,0,0,0
1708254841978,DOC 3,C08,400118,Chapman; Dillon,0,0,0,0
1708254841978,DOC 3,C09,400119,Chapman; Dillon,0,0,0,0
1708254841978,DOC 3,C10,400121,Chapman; Dillon,0,0,0,0
1708254841978,DOC 3,C11,400122,Chapman; Dillon,0,0,0,0
1708254841978,DOC 3,C12,400126,Chapman; Dillon,0,0,0,0
1708254841978,DOC 3,C13,400157,Chapman; Dillon,0,0,0,0
1708254841978,DOC 3,C14,400240,Chapman; Dillon,0,0,0,0
1708254841978,DOC 3,C15,400241,Chapman; Dillon,0,0,0,0
1708254841978,DOC 3,C16,400242,Chapman; Dillon,0,0,0,0
1708254841978,DOC 3,D01,400253,Chapman; Dillon,0,0,0,0
1708254841978,DOC 3,D02,400294,Chapman; Dillon,0,0,0,0
1708254841978,DOC 3,D03,400295,Chapman; Dillon,0,0,0,0
1708254841978,DOC 3,D04,400430,Chapman; Dillon,0,0,0,0
1708254841978,DOC 3,D05,400438,Chapman; Dillon,0,0,0,0
1708254841978,DOC 3,D06,400439,Chapman; Dillon,0,0,0,0
1708254841978,DOC 3,D07,400441,Chapman; Dillon,0,0,0,0
1708254841978,DOC 3,D08,400442,Chapman; Dillon,0,0,0,0
1708254841978,DOC 3,D09,400443,Chapman; Dillon,0,0,0,0
1708254841978,DOC 3,D10,400445,Chapman; Dillon,0,0,0,0
1708254841978,DOC 3,D11,400446,Chapman; Dillon,0,0,0,0
1708254841978,DOC 3,D12,400447,Chapman; Dillon,0,0,0,0
1708254841978,DOC 3,D13,400448,Chapman; Dillon,0,0,0,0
1708254841978,DOC 3,D14,400646,Chapman; Dillon,0,0,0,0
1708254841978,DOC 3,D15,400647,Chapman; Dillon,0,0,0,0
1708254841978,DOC 3,D16,400648,Chapman; Dillon,0,0,0,0
1708254842509,DOC 100D,A00,400649,Pass; Natalye Joann,22,0,25,3
1708254842509,DOC 100D,B00,400650,Pass; Natalye Joann,25,0,25,0
1708254843038,DSC 10,A01,398041,Tiefenbruck; Janine LoBue,142,0,147,5
1708254843038,DSC 10,B01,398180,Tiefenbruck; Janine LoBue,144,0,147,3
1708254843038,DSC 10,C01,398400,Tiefenbruck; Janine LoBue,143,0,147,4
1708254843572,DSC 20,A01,398415,Langlois; Marina,200,0,200,0
1708254844100,DSC 30,A01,398436,Langlois; Marina,156,0,158,2
1708254844100,DSC 30,B01,398439,Langlois; Marina,144,0,150,6
1708254844628,DSC 40A,A01,398441,Rampure; Suraj,123,0,125,2
1708254844628,DSC 40A,B01,398443,Rampure; Suraj,125,0,125,0
1708254845159,DSC 40B,A01,398445,Staff,150,0,150,0
1708254845687,DSC 80,A01,398470,Lau; Samuel Ethan,70,0,70,0
1708254845687,DSC 80,B01,398541,Lau; Samuel Ethan,68,0,70,2
1708254846212,DSC 95,A01,398650,Rampure; Suraj,50,0,50,0
1708254846742,DSC 100,A01,398683,Salimi; Babak,147,0,150,3
1708254847269,DSC 102,A01,398708,Jin; Haojian,145,0,150,5
1708254847798,DSC 106,A01,398711,Wilber; Jared Dane,146,0,149,3
1708254848326,DSC 140A,A01,398724,Eldridge; Justin Matthew,98,0,100,2
1708254848326,DSC 140A,B01,479346,Ustun; Tevfik Berk,50,0,50,0
1708254848855,DSC 140B,A01,398726,Weng; Tsui-Wei (lily),144,0,150,6
1708254849381,DSC 190,A01,398738,Silberman; Jack,20,0,20,0
1708254849381,DSC 190,B01,479475,Ustun; Tevfik Berk,29,0,30,1
1708254849381,DSC 190,C01,481341,Rahman; Tauhidur,50,0,50,0
1708254849910,DSC 197,001,494360,Eldridge; Justin Matthew,9999,0,9999,0
1708254850437,DSC 214,A00,477322,Staff,21,0,60,39
1708254850967,DSC 231,A01,398863,Gupta; Rajesh K.,60,0,60,0
1708254851493,DSC 232R,A01,487133,Solares; Edwin A,38,0,60,22
1708254852023,DSC 240,A00,398957,Belkin; Mikhail,74,0,90,16
1708254853080,DSC 243,A00,398958,Ma; Yian,59,0,60,1
1708254853606,DSC 245,A00,398959,Huang; Biwei,41,0,60,19
1708254854133,DSC 253,A00,398960,Shang; Jingbo,0,0,30,30
1708254854663,DSC 258R,A01,398962,Shang; Jingbo,42,0,60,18
1708254855190,DSC 267R,A01,398964,Staff,56,0,60,4
1708254855724,DSC 291,A00,398965,Belkin; Mikhail,90,0,90,0
1708254855724,DSC 291,B00,398966,Weng; Tsui-Wei (lily),90,0,90,0
1708254855724,DSC 291,C00,398997,Staff,60,0,60,0
1708254855724,DSC 291,D00,398998,Zhang; Hao,40,0,40,0
1708254855724,DSC 291,E00,477386,Staff,50,0,50,0
1708254856250,DSC 293,A00,477388,Ustun; Tevfik Berk,9989,0,9999,10
1708254856777,DSC 295,A00,480826,Danks; David J,30,0,40,10
1708254857302,DSE 220,A00,398034,Dasgupta; Sanjoy,20,0,20,0
1708254857832,DSE 230,A00,398035,Nguyen; Mai Huong,20,0,20,0
1708254858362,DSE 260B,A00,398037,Altintas De Callaf; Ilkay,20,0,20,0
1708254858888,DSGN 1,A01,408210,Klemmer; Scott R,46,0,50,4
1708254858888,DSGN 1,A02,408245,Klemmer; Scott R,47,0,50,3
1708254859415,DSGN 119,A00,407467,Hollan; James D. & Xia; Haijun,76,0,90,14
1708254859946,DSGN 160,A00,494371,Aronoff-Spencer; Eliah Sea,15,0,20,5
1708254860475,DSGN 219,A00,474323,Hollan; James D. & Xia; Haijun,15,0,15,0
1708254861001,ECE 5,A01,428645,Morris; Karcher William,21,0,24,3
1708254861001,ECE 5,A02,428646,Morris; Karcher William,24,0,24,0
1708254861001,ECE 5,A03,428647,Morris; Karcher William,24,0,24,0
1708254861001,ECE 5,A04,428648,Morris; Karcher William,24,0,24,0
1708254861527,ECE 15,A01,428650,Sahay; Rajeev,119,0,120,1
1708254862053,ECE 16,A01,428652,Wang; Edward Jay,22,0,30,8
1708254862582,ECE 17,A01,428654,Sahay; Rajeev,48,0,60,12
1708254863108,ECE 25,A50,428657,Dey; Sujit,30,0,30,0
1708254863108,ECE 25,A51,428658,Dey; Sujit,30,0,30,0
1708254863633,ECE 30,A50,428674,Mir Arabbaygi; Siavash,27,0,30,3
1708254863633,ECE 30,A51,428675,Mir Arabbaygi; Siavash,28,0,30,2
1708254863633,ECE 30,A52,428676,Mir Arabbaygi; Siavash,28,0,30,2
1708254863633,ECE 30,A53,428679,Mir Arabbaygi; Siavash,29,0,30,1
1708254863633,ECE 30,A54,428680,Mir Arabbaygi; Siavash,30,0,30,0
1708254864164,ECE 35,A50,428684,Taur; Yuan,29,0,30,1
1708254864164,ECE 35,A51,428685,Taur; Yuan,30,0,30,0
1708254864164,ECE 35,A52,428686,Taur; Yuan,30,0,30,0
1708254864164,ECE 35,A53,428687,Taur; Yuan,29,0,30,1
1708254864690,ECE 45,A01,428689,Zeger; Kenneth A.,137,0,150,13
1708254865221,ECE 65,A50,428701,Baghdadchi; Saharnaz,28,0,30,2
1708254865221,ECE 65,A51,428742,Baghdadchi; Saharnaz,29,0,30,1
1708254865221,ECE 65,A52,428743,Baghdadchi; Saharnaz,30,0,30,0
1708254865221,ECE 65,A53,428754,Baghdadchi; Saharnaz,26,0,30,4
1708254865221,ECE 65,A54,428796,Baghdadchi; Saharnaz,30,0,30,0
1708254865221,ECE 65,A55,428797,Baghdadchi; Saharnaz,29,0,30,1
1708254865221,ECE 65,A56,428803,Baghdadchi; Saharnaz,30,0,30,0
1708254865749,ECE 100,A01,428978,Baghdadchi; Saharnaz,29,0,30,1
1708254865749,ECE 100,A02,428988,Baghdadchi; Saharnaz,30,0,30,0
1708254865749,ECE 100,A03,428989,Baghdadchi; Saharnaz,29,0,30,1
1708254865749,ECE 100,A04,429008,Baghdadchi; Saharnaz,29,0,30,1
1708254866279,ECE 101,A01,429017,Bharadia; Dinesh,57,0,60,3
1708254866279,ECE 101,A02,429019,Bharadia; Dinesh,60,0,60,0
1708254866804,ECE 103,A01,429027,Kuzum; Duygu,74,0,75,1
1708254867333,ECE 107,A01,429055,Fullerton; Eric E,73,0,75,2
1708254867860,ECE 108,A01,429068,Kang; Mingu,53,0,60,7
1708254868388,ECE 109,A01,429085,Orlitsky; Alon,98,0,100,2
1708254868388,ECE 109,A02,429098,Orlitsky; Alon,96,0,100,4
1708254868917,ECE 111,A01,429132,Turakhia; Yatish Girish,173,0,180,7
1708254869445,ECE 115,A01,429314,Yip; Michael,22,0,26,4
1708254869971,ECE 123,A01,429327,Sievenpiper; Daniel F.,56,0,60,4
1708254870501,ECE 125B,A50,429397,Esmaili; Gholamreza,23,0,24,1
1708254870501,ECE 125B,A51,429627,Esmaili; Gholamreza,23,0,24,1
1708254871028,ECE 134,A00,429630,Ng; Tse Nga,50,0,50,0
1708254871554,ECE 136L,A01,429634,Dayeh; Shadi Ahmad,3,0,5,2
1708254871554,ECE 136L,A02,429636,Dayeh; Shadi Ahmad,3,0,5,2
1708254871554,ECE 136L,A03,429637,Dayeh; Shadi Ahmad,5,0,5,0
1708254871554,ECE 136L,A04,429641,Dayeh; Shadi Ahmad,5,0,5,0
1708254872083,ECE 139,A00,429642,Nomura; Kenji,17,0,20,3
1708254872608,ECE 140B,A01,455349,Khoshabeh; Ramsin & Gessner; Richard K.,19,0,24,5
1708254872608,ECE 140B,A02,455351,Khoshabeh; Ramsin & Gessner; Richard K.,23,0,24,1
1708254872608,ECE 140B,A03,455354,Khoshabeh; Ramsin & Gessner; Richard K.,21,0,22,1
1708254873137,ECE 141B,A01,455355,Gessner; Richard K.,48,0,50,2
1708254873663,ECE 148,A01,492803,Silberman; Jack,0,0,0,0
1708254874189,ECE 153,A01,429655,Naghizadeh Ardabili; Parin,94,0,100,6
1708254874716,ECE 157A,A01,429657,Bharadia; Dinesh,22,0,25,3
1708254875244,ECE 158B,A01,429659,Zhang; Xinyu,14,0,20,6
1708254875769,ECE 161C,A00,429660,Cosman; Pamela C.,58,0,60,2
1708254876297,ECE 163,A00,429664,Hsueh; Tzu-Chien,95,0,100,5
1708254876829,ECE 165,A51,429672,Mercier; Patrick Philip,20,0,30,10
1708254876829,ECE 165,A52,429673,Mercier; Patrick Philip,22,0,30,8
1708254876829,ECE 165,A53,429674,Mercier; Patrick Philip,30,0,30,0
1708254876829,ECE 165,A54,429675,Mercier; Patrick Philip,30,0,30,0
1708254877356,ECE 171A,A01,429813,Zheng; Yang,96,0,100,4
1708254877881,ECE 175B,A01,429886,Xie; Pengtao,72,0,75,3
1708254878407,ECE 183,A01,430023,Mookherjea; Shayan,26,0,30,4
1708254878932,ECE 185,A01,430025,Papen; George C.,19,0,20,1
1708254879458,ECE 191,A00,430039,Zhang; Xinyu,30,0,30,0
1708254879984,ECE 196,A00,430040,Morris; Karcher William,18,0,24,6
1708254879984,ECE 196,B00,430045,Morris; Karcher William,23,0,24,1
1708254880513,ECE 198,001,430052,Nguyen; Truong Quang,9999,0,9999,0
1708254881134,ECE 200,001,438659,Atanasov; Nikolay A.,9999,0,9999,0
1708254881134,ECE 200,002,438660,Bharadia; Dinesh,9999,0,9999,0
1708254881134,ECE 200,003,438668,Cheng; Chung Kuan,9999,0,9999,0
1708254881134,ECE 200,004,438845,Cosman; Pamela C.,9999,0,9999,0
1708254881134,ECE 200,005,438846,Dayeh; Shadi Ahmad,9999,0,9999,0
1708254881134,ECE 200,006,438847,Fainman; Yeshaiahu,9999,0,9999,0
1708254881134,ECE 200,007,438848,Ford; Joseph Earl,9999,0,9999,0
1708254881134,ECE 200,008,438849,Franceschetti; Massimo,9999,0,9999,0
1708254881134,ECE 200,009,438850,Fullerton; Eric E,9999,0,9999,0
1708254881134,ECE 200,010,438851,Galton; Ian A,9999,0,9999,0
1708254881134,ECE 200,011,438852,Gilja; Vikash,9999,0,9999,0
1708254881134,ECE 200,012,438853,Hall; Drew A.,9999,0,9999,0
1708254881134,ECE 200,013,438854,Hsueh; Tzu-Chien,9999,0,9999,0
1708254881134,ECE 200,014,438855,Javidi; Tara,9999,0,9999,0
1708254881134,ECE 200,015,438865,Kahng; Andrew Byun,9999,0,9999,0
1708254881134,ECE 200,016,438866,Kim; Young-Han,9999,0,9999,0
1708254881134,ECE 200,017,438876,Koushanfar; Farinaz,9999,0,9999,0
1708254881134,ECE 200,018,438877,Kuzum; Duygu,9999,0,9999,0
1708254881134,ECE 200,019,438934,Le; Hanh-Phuc,9999,0,9999,0
1708254881134,ECE 200,020,438954,Lin; Bill,9999,0,9999,0
1708254881134,ECE 200,021,438955,Liu; Zhaowei,9999,0,9999,0
1708254881134,ECE 200,022,438957,Lo; Yu-Hwa,9999,0,9999,0
1708254881134,ECE 200,023,439086,Lomakin; Vitaliy,9999,0,9999,0
1708254881134,ECE 200,024,439087,Mercier; Patrick Philip,9999,0,9999,0
1708254881134,ECE 200,025,439088,Meyer; Florian,9999,0,9999,0
1708254881134,ECE 200,026,439090,Milstein; Laurence B.,9999,0,9999,0
1708254881134,ECE 200,027,439208,Mir Arabbaygi; Siavash,9999,0,9999,0
1708254881134,ECE 200,028,439209,Mookherjea; Shayan,9999,0,9999,0
1708254881134,ECE 200,029,439210,Morris; Karcher William,9999,0,9999,0
1708254881134,ECE 200,030,439211,Ng; Tse Nga,9999,0,9999,0
1708254881134,ECE 200,031,439219,Nguyen; Truong Quang,9999,0,9999,0
1708254881134,ECE 200,032,439220,Nomura; Kenji,9999,0,9999,0
1708254881134,ECE 200,033,439221,Orlitsky; Alon,9999,0,9999,0
1708254881134,ECE 200,034,439222,Pal; Piya,9999,0,9999,0
1708254881134,ECE 200,035,439223,Papen; George C.,9999,0,9999,0
1708254881134,ECE 200,036,439224,Radic; Stojan,9999,0,9999,0
1708254881134,ECE 200,037,439225,Rao; Bhaskar D.,9999,0,9999,0
1708254881134,ECE 200,038,439227,Rao; Ramesh R,9999,0,9999,0
1708254881134,ECE 200,039,439231,Rebeiz; Gabriel,9999,0,9999,0
1708254881134,ECE 200,040,439232,Sanford; John R,9999,0,9999,0
1708254881134,ECE 200,041,439302,Siegel; Paul H.,9999,0,9999,0
1708254881134,ECE 200,042,439303,Sievenpiper; Daniel F.,9999,0,9999,0
1708254881134,ECE 200,043,439305,Sworder; David D.,9999,0,9999,0
1708254881134,ECE 200,044,439306,Taur; Yuan,9999,0,9999,0
1708254881134,ECE 200,045,439419,Touri; Behrouz,9999,0,9999,0
1708254881134,ECE 200,046,439425,Trivedi; Mohan M.,9999,0,9999,0
1708254881134,ECE 200,047,439538,Vasconcelos; Nuno,9999,0,9999,0
1708254881134,ECE 200,048,439546,Wang; Xiaolong,9999,0,9999,0
1708254881134,ECE 200,049,439549,Xie; Pengtao,9999,0,9999,0
1708254881134,ECE 200,050,439551,Yip; Michael,9999,0,9999,0
1708254881134,ECE 200,051,439553,Zeger; Kenneth A.,9999,0,9999,0
1708254881134,ECE 200,052,439554,Zhang; Xinyu,9999,0,9999,0
1708254881134,ECE 200,053,439555,Zheng; Yang,9999,0,9999,0
1708254881134,ECE 200,054,439557,Turakhia; Yatish Girish,9999,0,9999,0
1708254881134,ECE 200,055,439558,Kang; Mingu,9999,0,9999,0
1708254881134,ECE 200,056,439560,Shi; Yuanyuan,9999,0,9999,0
1708254881134,ECE 200,057,439564,Wang; Edward Jay,9999,0,9999,0
1708254881134,ECE 200,058,439565,Antipa; Nicholas A,9999,0,9999,0
1708254881134,ECE 200,059,439566,Zheng; Yang,9999,0,9999,0
1708254881134,ECE 200,060,492991,Yu; Paul K L,9999,0,9999,0
1708254881134,ECE 200,061,492992,Ndao; Abdoulaye,9999,0,9999,0
1708254881134,ECE 200,062,493019,Naghizadeh Ardabili; Parin,9999,0,9999,0
1708254881134,ECE 200,063,493033,Sahay; Rajeev,9999,0,9999,0
1708254881661,ECE 208,A00,430053,Mir Arabbaygi; Siavash,0,0,0,0
1708254882190,ECE 212CN,A00,430054,Liu; Zhaowei,0,0,0,0
1708254882718,ECE 222C,A00,430055,Lomakin; Vitaliy,0,0,0,0
1708254883244,ECE 227,A00,430057,Franceschetti; Massimo,0,0,0,0
1708254883788,ECE 228,A00,430078,Shi; Yuanyuan,0,0,0,0
1708254884314,ECE 230C,A00,430079,Yu; Paul K L,0,0,0,0
1708254884844,ECE 235,A00,430081,Taur; Yuan,0,0,0,0
1708254885373,ECE 236B,A00,430082,Lo; Yu-Hwa,0,0,0,0
1708254885903,ECE 240C,A00,430083,Mookherjea; Shayan,0,0,0,0
1708254886429,ECE 250,A00,430115,Touri; Behrouz,0,0,0,0
1708254886956,ECE 251B,A00,430166,Vasconcelos; Manuela,0,0,0,0
1708254887488,ECE 258B,A00,430167,Milstein; Laurence B.,0,0,0,0
1708254888014,ECE 260C,A00,430168,Eldon; John,0,0,0,0
1708254888540,ECE 264B,A00,430169,Galton; Ian A,0,0,0,0
1708254889072,ECE 265B,A00,430170,Gudem; Prasad S.S.,0,0,0,0
1708254889601,ECE 266,A01,430273,Hall; Drew A.,0,0,0,0
1708254890131,ECE 271C,A00,430283,Vasconcelos; Nuno,0,0,0,0
1708254890672,ECE 272A,A01,430340,Poveda Fonseca; Jorge,0,0,0,0
1708254891201,ECE 273,A00,430352,Wang; Jun-Kun,0,0,0,0
1708254891727,ECE 276B,A00,430353,Atanasov; Nikolay A.,0,0,0,0
1708254892253,ECE 284,A00,430385,Wang; Edward,0,0,0,0
1708254892780,ECE 285,A00,430386,Wang; Xiaolong,0,0,0,0
1708254892780,ECE 285,B00,430387,Antipa; Nicholas A,0,0,0,0
1708254893307,ECON 1,A01,409576,Crane; Meredith Helen,87,0,100,13
1708254893307,ECON 1,A02,409577,Crane; Meredith Helen,96,0,100,4
1708254893307,ECON 1,A03,409578,Crane; Meredith Helen,97,0,100,3
1708254893837,ECON 2,A01,409580,Candido; Maria Teresa,70,0,75,5
1708254894364,ECON 3,A01,409582,Crane; Meredith Helen,109,0,120,11
1708254894364,ECON 3,A02,409583,Crane; Meredith Helen,114,0,115,1
1708254894364,ECON 3,A03,409584,Crane; Meredith Helen,110,0,115,5
1708254894891,ECON 4,A01,409586,Levkoff; Steven B.,88,0,92,4
1708254894891,ECON 4,A02,409587,Levkoff; Steven B.,89,0,90,1
1708254895426,ECON 5,A01,409589,Dai; Yinlin,53,0,58,5
1708254895426,ECON 5,A02,409590,Dai; Yinlin,56,0,58,2
1708254895426,ECON 5,A03,409591,Dai; Yinlin,54,0,54,0
1708254895426,ECON 5,A04,409593,Dai; Yinlin,55,0,55,0
1708254895426,ECON 5,B01,409595,Dai; Yinlin,57,0,58,1
1708254895426,ECON 5,B02,409596,Dai; Yinlin,49,0,49,0
1708254895426,ECON 5,B03,409597,Dai; Yinlin,59,0,59,0
1708254895426,ECON 5,B04,409598,Dai; Yinlin,55,0,55,0
1708254895426,ECON 5,C01,487209,Staff,40,0,45,5
1708254895954,ECON 100A,A01,409600,Famulari; Melissa,94,0,100,6
1708254895954,ECON 100A,A02,409601,Famulari; Melissa,98,0,100,2
1708254895954,ECON 100A,A03,409604,Famulari; Melissa,98,0,100,2
1708254895954,ECON 100A,B01,409610,Famulari; Melissa,76,0,80,4
1708254896480,ECON 100AH,A00,409612,Famulari; Melissa,19,0,20,1
1708254897007,ECON 100B,A01,409614,Grigoryan; Aram,109,0,120,11
1708254897007,ECON 100B,A02,409616,Grigoryan; Aram,117,0,120,3
1708254897007,ECON 100B,B01,409626,Grigoryan; Aram,47,0,50,3
1708254897007,ECON 100B,B02,409627,Grigoryan; Aram,49,0,50,1
1708254897538,ECON 100C,A01,409629,Levkoff; Steven B.,143,0,146,3
1708254897538,ECON 100C,B01,409632,Levkoff; Steven B.,143,0,146,3
1708254898065,ECON 106,A00,409633,Bowen; T. Renee,90,0,90,0
1708254898592,ECON 109T,A00,409634,Trevino; Isabel,18,0,20,2
1708254899118,ECON 110A,A01,409637,Staff,68,0,75,7
1708254899645,ECON 110B,A01,409663,Herreno Lopera; Juan,119,0,125,6
1708254899645,ECON 110B,A02,409682,Herreno Lopera; Juan,125,0,125,0
1708254899645,ECON 110B,B01,409734,Herreno Lopera; Juan,99,0,100,1
1708254900174,ECON 120A,A01,409739,Candido; Maria Teresa,84,0,90,6
1708254900174,ECON 120A,A02,409740,Candido; Maria Teresa,87,0,90,3
1708254900174,ECON 120A,B01,409742,Candido; Maria Teresa,85,0,90,5
1708254900174,ECON 120A,B02,409743,Candido; Maria Teresa,90,0,90,0
1708254900702,ECON 120B,A01,409748,Ma; Xinwei,128,0,130,2
1708254900702,ECON 120B,A02,409754,Ma; Xinwei,128,0,130,2
1708254900702,ECON 120B,B01,409756,Ma; Xinwei,25,0,40,15
1708254901227,ECON 120C,A01,409758,Sun; Yixiao,141,0,146,5
1708254901227,ECON 120C,B01,409762,Sun; Yixiao,144,0,146,2
1708254901752,ECON 129,A00,409763,Eckert; Fabian Paul,44,0,50,6
1708254902276,ECON 134,A00,409764,Gelber; Alexander Michael,45,0,50,5
1708254902276,ECON 134,B00,409765,Gelber; Alexander Michael,49,0,50,1
1708254902806,ECON 137,A00,409766,Niehaus; Paul,19,0,20,1
1708254903348,ECON 142,A00,409767,Trevino; Isabel,39,0,40,1
1708254903348,ECON 142,B00,409768,Trevino; Isabel,38,0,40,2
1708254903875,ECON 164,A00,409771,Muralidharan; Karthik,118,0,120,2
1708254904407,ECON 172A,A01,409773,Newhouse; Herbert S,67,0,75,8
1708254904936,ECON 172B,A01,409775,Newhouse; Herbert S,74,0,75,1
1708254904936,ECON 172B,B01,409777,Newhouse; Herbert S,71,0,75,4
1708254905988,ECON 191A,A00,409780,Cullen; Julie,20,0,20,0
1708254906515,ECON 200C,A00,409782,Du; Songzi,34,0,35,1
1708254907063,ECON 210C,A00,409784,Herreno Lopera; Juan & Wieland; Johannes Friedrich,35,0,35,0
1708254907589,ECON 220C,A00,409785,Sun; Yixiao,35,0,35,0
1708254908117,ECON 220F,A00,409786,Carson; Richard T,27,0,30,3
1708254908642,ECON 221,A00,409787,Zhu; Ying,25,0,25,0
1708254909169,ECON 241,A00,409788,Muralidharan; Karthik,18,0,20,2
1708254909699,ECON 243,A00,409789,Niehaus; Paul,18,0,20,2
1708254910225,ECON 248,A00,409790,Eckert; Fabian Paul,18,0,20,2
1708254910755,ECON 250C,A00,409791,Arnold; David Hall & Betts; Julian,25,0,25,0
1708254911282,ECON 268,A00,409792,Jacobsen; Mark,24,0,25,1
1708254911813,ECON 281,A00,409793,Meckel; Katherine Hunter,19,0,20,1
1708254911813,ECON 281,B00,409794,Herreno Lopera; Juan & Wieland; Johannes Friedrich,19,0,20,1
1708254911813,ECON 281,C00,477854,Herreno Lopera; Juan & Wieland; Johannes Friedrich,18,0,20,2
1708254912339,ECON 285,A00,409795,Eckert; Fabian Paul,20,0,20,0
1708254912865,ECON 286,A00,409796,Ma; Xinwei,15,0,15,0
1708254912865,ECON 286,B00,409797,Hamilton; James D.,15,0,15,0
1708254912865,ECON 286,C00,409798,Grigoryan; Aram,15,0,15,0
1708254912865,ECON 286,D00,409799,Niehaus; Paul,15,0,15,0
1708254913395,ECON 296,A00,409800,Eckert; Fabian Paul,20,0,20,0
1708254913921,EDS 31,A00,409801,Bussey; Thomas J,9,0,10,1
1708254914450,EDS 38,A01,409803,Chung; Luz Marina,25,0,25,0
1708254914976,EDS 39,A01,409805,Heinzman; Erica M.,24,0,25,1
1708254915504,EDS 102,A01,409807,Ambo; Theresa Jean,37,0,45,8
1708254916033,EDS 110R,A01,409809,Staff,42,0,50,8
1708254916033,EDS 110R,B01,481358,Staff,20,0,20,0
1708254916561,EDS 111,A00,479044,Wishard Guerra; Alison G.,56,0,60,4
1708254917088,EDS 117,A01,409818,Jones; Gabrielle Anastasia,21,0,23,2
1708254917088,EDS 117,A02,409819,Jones; Gabrielle Anastasia,23,0,23,0
1708254917088,EDS 117,A03,409820,Jones; Gabrielle Anastasia,22,0,23,1
1708254917088,EDS 117,A04,409821,Jones; Gabrielle Anastasia,21,0,21,0
1708254917615,EDS 118,A00,409828,Warstadt; Melissa Fawn,46,0,50,4
1708254918147,EDS 123,A00,409831,Bussey; Thomas J,10,0,10,0
1708254918677,EDS 124AR,A00,419352,Simon; Elizabeth A,81,0,100,19
1708254918677,EDS 124AR,B00,419377,Simon; Elizabeth A,97,0,100,3
1708254918677,EDS 124AR,C00,481485,Simon; Elizabeth A,25,0,25,0
1708254918677,EDS 124AR,D00,481490,Simon; Elizabeth A,25,0,25,0
1708254919203,EDS 124BR,A00,409838,Eguchi; Emi,52,0,75,23
1708254919203,EDS 124BR,B00,481363,Eguchi; Emi,25,0,25,0
1708254919732,EDS 125,A00,409839,Aragon; Maria Jose,48,0,50,2
1708254920260,EDS 126,A01,409843,Jones; Makeba,19,0,25,6
1708254920260,EDS 126,A02,409844,Jones; Makeba,25,0,25,0
1708254920260,EDS 126,A03,409846,Jones; Makeba,25,0,25,0
1708254920260,EDS 126,A04,409847,Jones; Makeba,25,0,25,0
1708254920786,EDS 128B,A01,409851,Pappas; Elizabeth,49,0,50,1
1708254921314,EDS 129C,A01,409906,Millstone; Rachel Diana,44,0,50,6
1708254921843,EDS 130,A01,409954,Mendez; Kathrina Mendoza,14,0,15,1
1708254921843,EDS 130,A02,409955,Mendez; Kathrina Mendoza,24,0,25,1
1708254921843,EDS 130,A03,409956,Mendez; Kathrina Mendoza,20,0,20,0
1708254922376,EDS 133,A01,409961,Bintliff; Amy S.V.,15,0,20,5
1708254922376,EDS 133,A02,409962,Bintliff; Amy S.V.,20,0,20,0
1708254922376,EDS 133,A03,489636,Bintliff; Amy S.V.,15,0,15,0
1708254922903,EDS 136,A01,409964,Chung; Luz Marina,30,0,30,0
1708254922903,EDS 136,A02,409977,Chung; Luz Marina,30,0,30,0
1708254923434,EDS 139,A00,479197,Millstone; Rachel Diana,42,0,50,8
1708254923434,EDS 139,B00,479198,Pappas; Elizabeth,49,0,50,1
1708254923434,EDS 139,C00,479199,Mendez; Kathrina Mendoza,58,0,60,2
1708254923434,EDS 139,D00,479200,Bintliff; Amy S.V.,56,0,60,4
1708254923434,EDS 139,E00,479201,Chung; Luz Marina,59,0,60,1
1708254923434,EDS 139,F00,479202,Bintliff; Amy S.V.,15,0,15,0
1708254923434,EDS 139,G00,479203,Mamas; Christoforos,27,0,30,3
1708254923434,EDS 139,H00,493997,Choi; Bailey Miyeon,28,0,30,2
1708254923958,EDS 141,A00,409979,Mamas; Christoforos,38,0,40,2
1708254924483,EDS 145,A01,409989,Choi; Bailey Miyeon,13,0,15,2
1708254924483,EDS 145,A02,409990,Choi; Bailey Miyeon,15,0,15,0
1708254925011,EDS 180,A00,409991,Chapman; Thandeka K,30,0,30,0
1708254925011,EDS 180,B00,409992,Ambo; Theresa Jean,24,0,25,1
1708254925011,EDS 180,C00,409993,Jones; Gabrielle Anastasia,20,0,20,0
1708254925011,EDS 180,D00,409994,Phuong; Andrew,24,0,24,0
1708254925540,EDS 198,001,487216,Eguchi; Emi,20,0,20,0
1708254926085,EDS 205B,A00,409995,Staff,40,0,45,5
1708254926085,EDS 205B,B00,409997,Staff,42,0,45,3
1708254926611,EDS 232,A00,409999,Hopkins; Megan Beth,9,0,12,3
1708254927138,EDS 255,A00,410001,Phuong; Andrew,14,0,15,1
1708254927667,EDS 257,A00,410003,Datnow; Amanda Lee,14,0,15,1
1708254928197,EDS 282,A00,479192,Daly; Alan J.,16,0,16,0
1708254928721,EDS 287B,A00,479193,Daly; Alan J.,16,0,16,0
1708254929248,EDS 288A,A00,410005,Staff,18,0,18,0
1708254929774,EDS 288C,A00,410007,Staff,18,0,18,0
1708254930298,EDS 289B,A01,410009,Daly; Alan J.,18,0,18,0
1708254930828,EDS 290,A00,410010,Black; Alison Michelle,30,0,30,0
1708254930828,EDS 290,B00,410012,Choi; Bailey Miyeon,29,0,30,1
1708254930828,EDS 290,C00,479205,Heinzman; Erica M.,0,0,0,0
1708254931355,EDS 291B,A01,479195,Daly; Alan J.,16,0,16,0
1708254931884,EDS 293B,A01,410016,Staff,18,0,18,0
1708254932409,EDS 294B,A00,479196,Burrell; Sade Renee,16,0,16,0
1708254932959,EDS 296,001,478927,Ambo; Theresa Jean,0,0,0,0
1708254932959,EDS 296,002,478935,Aragon; Maria Jose,0,0,0,1
1708254932959,EDS 296,003,478936,Chapman; Thandeka K,0,0,0,0
1708254932959,EDS 296,004,478942,Bintliff; Amy S.V.,0,0,0,0
1708254932959,EDS 296,005,478943,Clarke; Sherice Nicole,0,0,0,0
1708254932959,EDS 296,006,478967,Cohen; Shana R,0,0,0,1
1708254932959,EDS 296,007,478968,Datnow; Amanda Lee,0,0,0,0
1708254932959,EDS 296,008,478969,Daly; Alan J.,0,0,0,0
1708254932959,EDS 296,009,478970,Eguchi; Emi,0,0,0,0
1708254932959,EDS 296,010,478971,Fine; Sarah,0,0,0,0
1708254932959,EDS 296,011,478972,Jones; Gabrielle Anastasia,0,0,0,0
1708254932959,EDS 296,012,479020,Jones; Makeba,0,0,0,0
1708254932959,EDS 296,013,479021,Halter; Christopher P.,0,0,0,0
1708254932959,EDS 296,014,479027,Hofstetter; Carolyn,0,0,0,0
1708254932959,EDS 296,015,479028,Hopkins; Megan Beth,0,0,0,0
1708254932959,EDS 296,016,479034,Mamas; Christoforos,0,0,0,0
1708254932959,EDS 296,017,479035,Pollock; Mica,0,0,0,0
1708254932959,EDS 296,018,479036,Wishard Guerra; Alison G.,0,0,0,0
1708254932959,EDS 296,019,494549,Phuong; Andrew,0,0,0,0
1708254933485,EMED 296,001,464428,Singh; Sukhdeep,49,0,50,1
1708254933485,EMED 296,002,464438,Subramony; Rachna,49,0,50,1
1708254933485,EMED 296,003,464490,Staff,50,0,50,0
1708254934012,ENG 10,A00,399006,Evdokimenko; Ekaterina,30,0,30,0
1708254934599,ENG 100D,A00,399084,Ngo; Anh-Thu T.,33,0,50,17
1708254935125,ENG 100DR,A00,479230,Ngo; Anh-Thu T.,29,0,40,11
1708254935652,ENG 100L,A00,399163,Kleissl; Jan,6,0,6,0
1708254935652,ENG 100L,B00,399217,Bratton; Maryann,8,0,8,0
1708254935652,ENG 100L,C00,399218,Yu; Paul K L,8,0,8,0
1708254935652,ENG 100L,D00,399257,Bratton; Maryann,6,0,6,0
1708254935652,ENG 100L,E00,399258,de Oliveira; Mauricio,9,0,10,1
1708254935652,ENG 100L,F00,399314,Bratton; Maryann,7,0,7,0
1708254935652,ENG 100L,G00,399394,Boyle; Mary E. T.,14,0,15,1
1708254936181,ENVR 102,A00,400777,Daly; Heather Marie,19,0,20,1
1708254936181,ENVR 102,B00,400778,Montejo; Carolina,24,0,25,1
1708254936181,ENVR 102,C00,400791,Staff,23,0,25,2
1708254936711,ENVR 140,A01,400813,Siapno; Jacqueline A,12,0,15,3
1708254936711,ENVR 140,A02,400870,Siapno; Jacqueline A,15,0,15,0
1708254936711,ENVR 140,A03,400889,Siapno; Jacqueline A,15,0,15,0
1708254936711,ENVR 140,A04,400890,Siapno; Jacqueline A,15,0,15,0
1708254937238,ENVR 144,A01,400929,Herbst; Matthew,20,0,20,0
1708254937765,ERC 20,A00,400722,Evans; Ivan T,30,0,30,0
1708254938293,ESYS 103,A01,400931,Lerner; Amy M,32,0,34,2
1708254938293,ESYS 103,A02,400934,Lerner; Amy M,34,0,34,0
1708254938293,ESYS 103,A03,400938,Lerner; Amy M,28,0,34,6
1708254938293,ESYS 103,A04,400939,Lerner; Amy M,33,0,34,1
1708254938293,ESYS 103,A05,400940,Lerner; Amy M,34,0,34,0
1708254938293,ESYS 103,A06,400941,Lerner; Amy M,33,0,34,1
1708254938820,ESYS 187C,A01,400945,Hetherington; Elizabeth Dorsey,28,0,40,12
1708254938820,ESYS 187C,A02,400946,Hetherington; Elizabeth Dorsey,39,0,40,1
1708254939352,ETHN 3R,A01,400948,Streeby; Shelley,21,0,25,4
1708254939352,ETHN 3R,A02,401220,Streeby; Shelley,24,0,25,1
1708254939352,ETHN 3R,A03,401231,Streeby; Shelley,22,0,25,3
1708254939352,ETHN 3R,A04,401236,Streeby; Shelley,23,0,25,2
1708254939352,ETHN 3R,A05,401241,Streeby; Shelley,21,0,25,4
1708254939352,ETHN 3R,A06,401311,Streeby; Shelley,21,0,25,4
1708254939352,ETHN 3R,A07,401318,Streeby; Shelley,25,0,25,0
1708254939352,ETHN 3R,A08,401319,Streeby; Shelley,25,0,25,0
1708254939352,ETHN 3R,A09,401397,Streeby; Shelley,25,0,25,0
1708254939352,ETHN 3R,A10,401398,Streeby; Shelley,25,0,25,0
1708254939352,ETHN 3R,A11,401399,Streeby; Shelley,24,0,25,1
1708254939352,ETHN 3R,A12,401518,Streeby; Shelley,25,0,25,0
1708254939352,ETHN 3R,A13,401551,Streeby; Shelley,24,0,25,1
1708254939352,ETHN 3R,A14,401552,Streeby; Shelley,23,0,25,2
1708254939878,ETHN 30,A01,401554,Fuste; Jose Ignacio,24,0,25,1
1708254939878,ETHN 30,A02,401555,Fuste; Jose Ignacio,25,0,25,0
1708254939878,ETHN 30,A03,401556,Fuste; Jose Ignacio,25,0,25,0
1708254939878,ETHN 30,A04,401557,Fuste; Jose Ignacio,25,0,25,0
1708254940405,ETHN 100C,A00,401558,Museus; Samuel David,36,0,40,4
1708254940931,ETHN 101TV,A01,401560,Marez; Curtis F.,21,0,25,4
1708254940931,ETHN 101TV,A02,401564,Marez; Curtis F.,25,0,25,0
1708254941458,ETHN 108,A00,401584,Hankins; Sarah E.,25,0,29,4
1708254941988,ETHN 113A,A00,401657,Werner; Bradley T.,15,0,15,0
1708254942516,ETHN 114B,A00,401724,Frank; Ross H.,19,0,20,1
1708254943042,ETHN 120D,A01,401848,Alvarez; Luis A,8,0,10,2
1708254943042,ETHN 120D,A02,401853,Alvarez; Luis A,10,0,10,0
1708254943573,ETHN 125R,A00,401858,Sasaki; Christen T,39,0,50,11
1708254944098,ETHN 126,A00,401865,Tran; Ly Thi Hai,39,0,40,1
1708254944626,ETHN 127,A00,401866,Martin Sandino; Amanda Maria Yoland,24,0,25,1
1708254945150,ETHN 137,A00,401867,Martin Sandino; Amanda Maria Yoland,19,0,19,0
1708254945680,ETHN 139,A00,401992,Perreira; Christopher Michael,25,0,25,0
1708254946206,ETHN 143,A00,402059,Marez; Curtis F.,39,0,40,1
1708254946732,ETHN 144M,A00,402060,Jolivette; Andrew J,62,0,65,3
1708254947266,ETHN 150,A00,402158,Taylor-Garcia; Daphne,16,0,18,2
1708254947793,ETHN 153,A00,402160,Martinez-Matsuda; Veronica,24,0,25,1
1708254948318,ETHN 179,A00,402165,Richards; Stephanie F,23,0,25,2
1708254948848,ETHN 183,A00,402217,Steelman; Katherine Wallis,16,0,16,0
1708254949376,ETHN 186,A00,402313,Perez; Roy,15,0,15,0
1708254949906,ETHN 189,A00,479226,Museus; Samuel David,29,0,30,1
1708254950433,ETHN 196H,A00,402314,Espiritu; Yen,0,0,0,0
1708254950433,ETHN 196H,B00,402325,Perreira; Christopher Michael,0,0,0,0
1708254950433,ETHN 196H,C00,402344,Perez; Roy,0,0,0,0
1708254950433,ETHN 196H,D00,402345,Streeby; Shelley,0,0,0,0
1708254950433,ETHN 196H,E00,402346,Taylor-Garcia; Daphne,0,0,0,0
1708254950962,ETHN 200C,A00,402358,Fuste; Jose Ignacio,19,0,20,1
1708254951487,ETHN 230,A00,402359,Streeby; Shelley,16,0,20,4
1708254952014,ETHN 291,A00,402363,Perreira; Christopher Michael,16,0,20,4
1708254952540,EXPR 100,A00,477778,Staff,9999,0,9999,0
1708254953065,EXPR 105,A00,477779,Staff,9999,0,9999,0
1708254953595,EXPR 201,A00,477780,Staff,9999,0,9999,0
1708254954121,EXPR 205,A00,477781,Staff,9999,0,9999,0
1708254954647,FILM 87,A00,402794,Rahimi; Babak,19,0,20,1
1708254954647,FILM 87,B00,402796,Rahimi; Babak,20,0,20,0
1708254954647,FILM 87,C00,402821,Havis; Allan,19,0,20,1
1708254955175,FMPH 95,A00,481734,Larsen; Britta Ann,0,0,0,2
1708254955700,FMPH 101,A00,404648,Tan; Gene Brian,31,0,40,9
1708254956226,FMPH 102,A01,404692,Rana; Brinda Kanti,25,0,28,3
1708254956226,FMPH 102,A02,404714,Rana; Brinda Kanti,28,0,28,0
1708254956226,FMPH 102,B01,404739,Rana; Brinda Kanti,26,0,28,2
1708254956226,FMPH 102,B02,404746,Rana; Brinda Kanti,28,0,28,0
1708254956757,FMPH 110,A00,404747,Campbell; Chadwick Karl,52,0,55,3
1708254956757,FMPH 110,B00,404789,Zoumas-Morse; Christine E.,24,0,30,6
1708254957286,FMPH 120,A00,404792,Nguyen-Grozavu; France T.,48,0,60,12
1708254957818,FMPH 130,A00,404859,Gould; Carlos Francisco,49,0,55,6
1708254957818,FMPH 130,B00,479047,Ciborowski; Haley Minae,52,0,55,3
1708254958345,FMPH 155,A00,404864,Fielding-Miller; Rebecca,65,0,65,0
1708254958873,FMPH 161,A00,404865,Zoumas-Morse; Christine E.,27,0,35,8
1708254959402,FMPH 191,A00,404866,Eikey; Elizabeth Victoria,35,0,35,0
1708254959930,FMPH 194,A00,404938,Larsen; Britta Ann,0,0,0,0
1708254959930,FMPH 194,B00,404939,Marquez; Becky,0,0,0,0
1708254959930,FMPH 194,C00,404949,Nguyen-Grozavu; France T.,0,0,0,0
1708254959930,FMPH 194,D00,404950,Stone; Matthew David,0,0,0,0
1708254959930,FMPH 194,E00,404958,White; Anne Elizabeth Clar,0,0,0,0
1708254959930,FMPH 194,F00,404969,Zoumas-Morse; Christine E.,0,0,0,0
1708254960457,FMPH 223,A00,404977,Vaida; Florin,7,0,26,19
1708254960984,FMPH 225,A00,404978,Zou; Jingjing,0,0,0,0
1708254961518,FMPH 291,A00,404992,Salem; Rany Mansour,15,0,15,0
1708254961518,FMPH 291,C00,405005,Schwartzman; Armin,0,0,0,11
1708254961518,FMPH 291,D00,479113,Shadyab; Aladdin Hassan,0,0,0,0
1708254961518,FMPH 291,E00,479114,Shadyab; Aladdin Hassan,0,0,0,0
1708254961518,FMPH 291,F00,479115,Wynn; Adriane Michelle,0,0,0,3
1708254961518,FMPH 291,G00,479116,Xu; Ronghui,0,0,0,10
1708254961518,FMPH 291,H00,479119,Vaida; Florin,0,0,0,2
1708254962047,FPM 258C,A00,405129,Chen; Brian Hwa-Yang,11,0,15,4
1708254962575,FPM 259C,A00,405130,Nguyen; Annie Lu & Araneta; Maria Rosario Gorrez,4,0,5,1
1708254963101,FPM 278,A00,405131,Strong; David R,13,0,15,2
1708254963629,FPM 280C,A01,405133,Banegas; Matthew Patrick,10,0,10,0
1708254964156,FPM 296,001,464651,Johnson; Michelle Lee,49,0,50,1
1708254964156,FPM 296,002,464652,Staff,50,0,50,0
1708254964156,FPM 296,003,464653,Staff,50,0,50,0
1708254964688,FPM 297,001,479175,Vaida; Florin,9999,0,9999,0
1708254964688,FPM 297,002,494007,Strong; David R,9999,0,9999,0
1708254964688,FPM 297,003,494364,Bazzi; Angela Robertson,9999,0,9999,0
1708254965213,GLBH 20,A00,405134,Elwardani; Nile Regina,143,0,146,3
1708254965740,GLBH 100,A00,405135,Bhavsar; Radhika,68,0,70,2
1708254965740,GLBH 100,B00,477773,Villarino; Margarita,39,0,44,5
1708254965740,GLBH 100,C00,477855,Jenkins; Janis A.,20,0,20,0
1708254965740,GLBH 100,D00,481337,Mishra; Jyoti,40,0,40,0
1708254966268,GLBH 101,A00,405136,Sloane; Julia Kathryn,40,0,40,0
1708254966794,GLBH 107,A00,405137,Wilson; Brenda K,63,0,70,7
1708254967325,GLBH 111,A01,486865,Burgos; Jose L.,0,0,0,0
1708254967325,GLBH 111,B01,486867,Burgos; Jose L.,0,0,0,0
1708254967852,GLBH 114W,A00,405138,Walkover; Lillian B,17,0,17,0
1708254968380,GLBH 118,A00,405140,Wilson; Brenda K,31,0,32,1
1708254968906,GLBH 147,A00,405141,Stewart; Alexander B,40,0,40,0
1708254969435,GLBH 148,A00,405142,Olivas Hernandez; Olga Lid,93,0,100,7
1708254969965,GLBH 150B,A00,486855,Sanchez; Giselle,0,0,0,0
1708254970492,GLBH 181,A00,405154,Burgos; Jose L.,211,0,216,5
1708254971017,GLBH 215,A00,479241,Walkover; Lillian B,18,0,18,0
1708254971543,GLBH 260,A00,480722,Elwardani; Nile Regina,18,0,18,0
1708254972069,GSS 20,A00,405155,Siapno; Jacqueline A,25,0,30,5
1708254972599,GSS 25,A00,405156,Batarseh; Amanda Alicia,24,0,30,6
1708254973125,HDS 1,A01,405160,Reese; Clarissa Jane,25,0,25,0
1708254973125,HDS 1,A02,405168,Reese; Clarissa Jane,25,0,25,0
1708254973125,HDS 1,A03,405169,Reese; Clarissa Jane,22,0,25,3
1708254973125,HDS 1,A04,405170,Reese; Clarissa Jane,24,0,25,1
1708254973125,HDS 1,A05,405171,Reese; Clarissa Jane,23,0,25,2
1708254973125,HDS 1,A06,405172,Reese; Clarissa Jane,24,0,25,1
1708254973125,HDS 1,A07,405173,Reese; Clarissa Jane,24,0,25,1
1708254973654,HDS 60,A01,405175,Warstadt; Melissa Fawn,34,0,35,1
1708254973654,HDS 60,A02,405176,Warstadt; Melissa Fawn,33,0,35,2
1708254974180,HDS 95,A00,405177,Staff,38,0,40,2
1708254974707,HDS 120,A00,405178,Staff,0,0,0,0
1708254975234,HDS 122,A00,405179,Rodriguez; Victoria Calip,64,0,75,11
1708254975760,HDS 150,A00,405180,Staff,20,0,20,0
1708254975760,HDS 150,B00,405181,Staff,20,0,20,0
1708254975760,HDS 150,C00,405182,Staff,20,0,20,0
1708254976286,HDS 181,A01,405185,Bjorklund; Peter,30,0,30,0
1708254976818,HDS 191,A01,405187,Reese; Clarissa Jane,40,0,40,0
1708254976818,HDS 191,B01,405194,Staff,25,0,25,0
1708254977345,HIAF 113,A00,403736,Prestholdt; Jeremy,74,0,75,1
1708254977874,HIAF 114,A00,403738,Gyamfi; Bright,49,0,50,1
1708254978401,HIEA 132,A00,403740,Kletzer; Benjamin Nathan,25,0,30,5
1708254978928,HIEA 154,A00,403741,Henry; Todd A.,62,0,64,2
1708254979458,HIEU 139,A00,403742,Strasser; Ulrike,52,0,56,4
1708254979984,HIEU 171,A00,403743,Hansen; Jan Eric,62,0,64,2
1708254980509,HIEU 176,A00,403744,Hertz; Deborah,14,0,15,1
1708254981037,HIEU 183,A00,403800,Gallant; Thomas W.,15,0,15,0
1708254981562,HIEU 276,A00,403862,Hertz; Deborah,0,0,0,0
1708254982088,HIGL 127,A00,403802,Ivey; James Alexander,56,0,56,0
1708254982618,HIGR 201,A00,494372,Pineda De Avila; Nydia,9,0,10,1
1708254983145,HIGR 205,A00,403863,Strasser; Ulrike,11,0,15,4
1708254983676,HIGR 217C,A00,403864,Lu; Weijing,9,0,10,1
1708254984203,HIGR 239,A00,403865,Serlin; David,4,0,5,1
1708254984729,HIGR 240,A00,403875,Gates; Kelly,2,0,5,3
1708254985261,HILA 101,A00,403818,LeNeave; Kimiko Nicole,62,0,64,2
1708254985790,HILA 119,A00,403819,Kozameh; Sara J,47,0,50,3
1708254986316,HILA 144,A00,403821,Kozameh; Sara J,50,0,50,0
1708254986842,HILD 2C,A01,402843,Hendrickson; Gerald M.,31,0,32,1
1708254986842,HILD 2C,A02,403030,Hendrickson; Gerald M.,31,0,32,1
1708254986842,HILD 2C,A03,403042,Hendrickson; Gerald M.,32,0,32,0
1708254986842,HILD 2C,A04,403048,Hendrickson; Gerald M.,30,0,32,2
1708254986842,HILD 2C,A05,403049,Hendrickson; Gerald M.,32,0,32,0
1708254986842,HILD 2C,A06,403098,Hendrickson; Gerald M.,32,0,32,0
1708254987374,HILD 7C,A01,403501,Bermudez; Rosie Cano,27,0,32,5
1708254987374,HILD 7C,A02,403513,Bermudez; Rosie Cano,30,0,32,2
1708254987374,HILD 7C,A03,403570,Bermudez; Rosie Cano,32,0,32,0
1708254987374,HILD 7C,A04,403572,Bermudez; Rosie Cano,32,0,32,0
1708254987374,HILD 7C,A05,403587,Bermudez; Rosie Cano,32,0,32,0
1708254987374,HILD 7C,A06,403588,Bermudez; Rosie Cano,32,0,32,0
1708254987374,HILD 7C,A07,403589,Bermudez; Rosie Cano,29,0,32,3
1708254987374,HILD 7C,A08,403590,Bermudez; Rosie Cano,32,0,32,0
1708254987374,HILD 7C,A09,403601,Bermudez; Rosie Cano,30,0,32,2
1708254987374,HILD 7C,A10,403602,Bermudez; Rosie Cano,32,0,32,0
1708254987374,HILD 7C,A11,403603,Bermudez; Rosie Cano,32,0,32,0
1708254987374,HILD 7C,A12,403604,Bermudez; Rosie Cano,32,0,32,0
1708254987972,HILD 12,A01,403607,Henry; Todd A.,32,0,32,0
1708254987972,HILD 12,A02,403608,Henry; Todd A.,31,0,32,1
1708254987972,HILD 12,A03,403609,Henry; Todd A.,32,0,32,0
1708254987972,HILD 12,A04,403699,Henry; Todd A.,32,0,32,0
1708254987972,HILD 12,A05,403700,Henry; Todd A.,32,0,32,0
1708254987972,HILD 12,A06,403701,Henry; Todd A.,32,0,32,0
1708254989518,HILD 30,A01,403703,Soleiman; Matthew Teymour,29,0,32,3
1708254989518,HILD 30,A02,403704,Soleiman; Matthew Teymour,30,0,32,2
1708254990051,HINE 118,A00,403822,Kayali; Hasan,50,0,50,0
1708254990579,HISC 119,A00,403823,Golan; Tal,26,0,30,4
1708254991106,HISC 123,A00,403839,Pineda De Avila; Nydia,44,0,50,6
1708254991635,HITO 87,A00,403707,Patterson; Patrick H.,15,0,15,0
1708254991635,HITO 87,B00,403709,Patterson; Patrick H.,15,0,15,0
1708254991635,HITO 87,C00,403735,Schneewind; Sarah,15,0,15,0
1708254992161,HITO 100,B00,403841,Klann; Mary Cameron,24,0,25,1
1708254992690,HITO 170,A00,403842,Watts; Edward J.,8,0,10,2
1708254993216,HITO 193,A00,455333,Hill; Seth J,0,0,0,0
1708254993743,HIUS 114A,A00,403843,Lewandoski; Julia Mavis,52,0,56,4
1708254994272,HIUS 120D,A01,403854,Alvarez; Luis A,8,0,10,2
1708254994272,HIUS 120D,A02,403855,Alvarez; Luis A,10,0,10,0
1708254994799,HIUS 136,A00,403857,Martinez-Matsuda; Veronica,21,0,25,4
1708254995341,HIUS 144,A00,403858,Martinez-Matsuda; Veronica,55,0,56,1
1708254995341,HIUS 144,B00,403859,Vandevelde; Kenneth Joseph,54,0,56,2
1708254995341,HIUS 144,C00,403860,Klann; Mary Cameron,52,0,56,4
1708254995341,HIUS 144,D00,403861,Lewandoski; Julia Mavis,55,0,56,1
1708254995982,HUM 2,A01,422723,Watts; Edward J.,16,0,16,0
1708254995982,HUM 2,A02,422735,Watts; Edward J.,15,0,16,1
1708254995982,HUM 2,A03,422736,Watts; Edward J.,15,0,16,1
1708254995982,HUM 2,A04,422737,Watts; Edward J.,16,0,16,0
1708254995982,HUM 2,A05,422738,Watts; Edward J.,15,0,16,1
1708254995982,HUM 2,A06,422760,Watts; Edward J.,15,0,16,1
1708254995982,HUM 2,A07,422778,Watts; Edward J.,16,0,16,0
1708254995982,HUM 2,A08,422793,Watts; Edward J.,16,0,16,0
1708254995982,HUM 2,A09,422794,Watts; Edward J.,16,0,16,0
1708254995982,HUM 2,A10,422795,Watts; Edward J.,16,0,16,0
1708254995982,HUM 2,B01,422805,Markman; Kristina,13,0,16,3
1708254995982,HUM 2,B02,422806,Markman; Kristina,14,0,16,2
1708254995982,HUM 2,B03,422807,Markman; Kristina,14,0,16,2
1708254995982,HUM 2,B04,422808,Markman; Kristina,16,0,16,0
1708254995982,HUM 2,B05,422809,Markman; Kristina,16,0,16,0
1708254995982,HUM 2,B06,422842,Markman; Kristina,16,0,16,0
1708254995982,HUM 2,B07,422843,Markman; Kristina,15,0,16,1
1708254995982,HUM 2,B08,422848,Markman; Kristina,16,0,16,0
1708254995982,HUM 2,B09,422850,Markman; Kristina,15,0,16,1
1708254995982,HUM 2,B10,422851,Markman; Kristina,12,0,16,4
1708254995982,HUM 2,B11,422852,Markman; Kristina,15,0,16,1
1708254995982,HUM 2,B12,422853,Markman; Kristina,16,0,16,0
1708254995982,HUM 2,C01,422855,Rodriguez; Bretton Sigfred,15,0,16,1
1708254995982,HUM 2,C02,422856,Rodriguez; Bretton Sigfred,16,0,16,0
1708254995982,HUM 2,C03,422859,Rodriguez; Bretton Sigfred,15,0,16,1
1708254995982,HUM 2,C04,423106,Rodriguez; Bretton Sigfred,12,0,16,4
1708254995982,HUM 2,C05,423107,Rodriguez; Bretton Sigfred,15,0,16,1
1708254995982,HUM 2,C06,423108,Rodriguez; Bretton Sigfred,14,0,16,2
1708254995982,HUM 2,C07,423109,Rodriguez; Bretton Sigfred,15,0,16,1
1708254995982,HUM 2,C08,423110,Rodriguez; Bretton Sigfred,15,0,16,1
1708254995982,HUM 2,C09,423133,Rodriguez; Bretton Sigfred,14,0,16,2
1708254995982,HUM 2,C10,423134,Rodriguez; Bretton Sigfred,14,0,16,2
1708254995982,HUM 2,C11,423135,Rodriguez; Bretton Sigfred,16,0,16,0
1708254995982,HUM 2,C12,423136,Rodriguez; Bretton Sigfred,15,0,16,1
1708254995982,HUM 2,C13,423137,Rodriguez; Bretton Sigfred,16,0,16,0
1708254995982,HUM 2,C14,423138,Rodriguez; Bretton Sigfred,16,0,16,0
1708254995982,HUM 2,D01,423140,West; Geoffrey Scott,13,0,16,3
1708254995982,HUM 2,D02,423141,West; Geoffrey Scott,15,0,16,1
1708254995982,HUM 2,D03,423142,West; Geoffrey Scott,15,0,16,1
1708254995982,HUM 2,D04,423143,West; Geoffrey Scott,14,0,16,2
1708254995982,HUM 2,D05,423144,West; Geoffrey Scott,16,0,16,0
1708254995982,HUM 2,D06,423145,West; Geoffrey Scott,16,0,16,0
1708254995982,HUM 2,D07,423146,West; Geoffrey Scott,16,0,16,0
1708254995982,HUM 2,D08,423158,West; Geoffrey Scott,16,0,16,0
1708254995982,HUM 2,D09,423169,West; Geoffrey Scott,16,0,16,0
1708254995982,HUM 2,D10,423174,West; Geoffrey Scott,16,0,16,0
1708254995982,HUM 2,D11,423175,West; Geoffrey Scott,16,0,16,0
1708254995982,HUM 2,D12,423179,West; Geoffrey Scott,15,0,16,1
1708254995982,HUM 2,D13,423188,West; Geoffrey Scott,15,0,16,1
1708254995982,HUM 2,D14,423204,West; Geoffrey Scott,16,0,16,0
1708254996528,HUM 5,A01,423221,Lyon; Antony J.,26,0,30,4
1708254996528,HUM 5,A02,423232,Lyon; Antony J.,24,0,30,6
1708254996528,HUM 5,A03,423237,Lyon; Antony J.,18,0,30,12
1708254996528,HUM 5,A04,423240,Lyon; Antony J.,25,0,30,5
1708254996528,HUM 5,A05,423242,Lyon; Antony J.,28,0,30,2
1708254996528,HUM 5,A06,423244,Lyon; Antony J.,23,0,30,7
1708254996528,HUM 5,A07,423247,Lyon; Antony J.,27,0,30,3
1708254996528,HUM 5,A08,423254,Lyon; Antony J.,27,0,30,3
1708254996528,HUM 5,B01,423286,Patterson; Patrick H.,28,0,30,2
1708254996528,HUM 5,B02,423291,Patterson; Patrick H.,29,0,30,1
1708254996528,HUM 5,B03,423294,Patterson; Patrick H.,28,0,30,2
1708254996528,HUM 5,B04,423297,Patterson; Patrick H.,29,0,30,1
1708254996528,HUM 5,B05,423313,Patterson; Patrick H.,30,0,30,0
1708254996528,HUM 5,B06,423318,Patterson; Patrick H.,30,0,30,0
1708254996528,HUM 5,B07,423362,Patterson; Patrick H.,29,0,30,1
1708254996528,HUM 5,B08,423363,Patterson; Patrick H.,29,0,30,1
1708254996528,HUM 5,C01,423365,Caldwell; Michael Alan,22,0,30,8
1708254996528,HUM 5,C02,423474,Caldwell; Michael Alan,24,0,30,6
1708254996528,HUM 5,C03,423528,Caldwell; Michael Alan,30,0,30,0
1708254996528,HUM 5,C04,423529,Caldwell; Michael Alan,27,0,30,3
1708254996528,HUM 5,C05,423545,Caldwell; Michael Alan,30,0,30,0
1708254996528,HUM 5,C06,423546,Caldwell; Michael Alan,30,0,30,0
1708254996528,HUM 5,C07,423547,Caldwell; Michael Alan,29,0,30,1
1708254996528,HUM 5,C08,423548,Caldwell; Michael Alan,28,0,30,2
1708254997055,INTL 101,A01,404350,Day; Joel Keith,23,0,25,2
1708254997055,INTL 101,A02,404356,Day; Joel Keith,25,0,25,0
1708254997055,INTL 101,A03,404357,Day; Joel Keith,24,0,25,1
1708254997055,INTL 101,A04,404360,Day; Joel Keith,25,0,25,0
1708254997587,INTL 102,A01,404375,Fisk; David Lee,25,0,25,0
1708254997587,INTL 102,A02,404376,Fisk; David Lee,22,0,25,3
1708254997587,INTL 102,A03,404377,Fisk; David Lee,20,0,25,5
1708254997587,INTL 102,A04,404381,Fisk; David Lee,25,0,25,0
1708254998114,INTL 190,A00,404396,Samphantharak; Krislert,24,0,25,1
1708254998114,INTL 190,B00,404402,McIntosh; Justin Daniel,24,0,25,1
1708254998114,INTL 190,C00,404403,Vos; Stacie N.,24,0,25,1
1708254998114,INTL 190,D00,404404,Nadkarni; Vidya,24,0,25,1
1708254998114,INTL 190,E00,404407,Scott; Jeffrey F,25,0,25,0
1708254998114,INTL 190,F00,404409,Auerbach; Bradford C,25,0,25,0
1708254998114,INTL 190,G00,404442,Auerbach; Bradford C,25,0,25,0
1708254998114,INTL 190,H00,404465,Segui; Alan S,25,0,25,0
1708254998114,INTL 190,I00,404481,Segui; Alan S,25,0,25,0
1708254998680,JAPN 10C,A01,403881,Iwamoto; Naoki,15,0,15,0
1708254998680,JAPN 10C,B01,403884,McKee; Mayumi Mochizuki,15,0,15,0
1708254998680,JAPN 10C,C01,403887,Sato; Kyoko,10,0,10,0
1708254998680,JAPN 10C,C02,403888,Sato; Kyoko,10,0,10,0
1708254998680,JAPN 10C,D01,403890,Inada; Minori,8,0,10,2
1708254998680,JAPN 10C,D02,403891,Inada; Minori,10,0,10,0
1708254998680,JAPN 10C,E01,403893,Sato; Kyoko,10,0,10,0
1708254998680,JAPN 10C,E02,403894,Sato; Kyoko,10,0,10,0
1708254998680,JAPN 10C,F01,403896,McKee; Mayumi Mochizuki,10,0,10,0
1708254998680,JAPN 10C,F02,403897,McKee; Mayumi Mochizuki,10,0,10,0
1708254998680,JAPN 10C,G01,403899,Homma; Kunihiko,10,0,10,0
1708254998680,JAPN 10C,G02,403900,Homma; Kunihiko,10,0,10,0
1708254998680,JAPN 10C,H01,403902,Maruyama; Rie,10,0,10,0
1708254998680,JAPN 10C,H02,403903,Maruyama; Rie,9,0,10,1
1708254998680,JAPN 10C,I01,403905,Inada; Minori,10,0,10,0
1708254998680,JAPN 10C,I02,403906,Inada; Minori,9,0,10,1
1708254998680,JAPN 10C,J01,403915,Iwamoto; Naoki,10,0,10,0
1708254998680,JAPN 10C,J02,403916,Iwamoto; Naoki,9,0,10,1
1708254998680,JAPN 10C,K01,403918,Ross; Kayoko F,10,0,10,0
1708254998680,JAPN 10C,K02,403928,Ross; Kayoko F,10,0,10,0
1708254998680,JAPN 10C,L01,403935,Homma; Kunihiko,9,0,10,1
1708254998680,JAPN 10C,L02,403936,Homma; Kunihiko,10,0,10,0
1708254998680,JAPN 10C,M02,403939,Kamioka; Sachiko,13,0,15,2
1708254998680,JAPN 10C,N01,479041,Iwamoto; Naoki,15,0,15,0
1708254999210,JAPN 10CR,A01,403982,Inada; Minori,12,0,12,0
1708254999210,JAPN 10CR,A02,403983,Inada; Minori,12,0,12,0
1708254999737,JAPN 20C,A01,403988,Homma; Kunihiko,10,0,12,2
1708254999737,JAPN 20C,B02,404029,Kamioka; Sachiko,10,0,12,2
1708254999737,JAPN 20C,C01,404033,Takeda; Izumi,8,0,12,4
1708254999737,JAPN 20C,D02,404114,Kamioka; Sachiko,11,0,12,1
1708254999737,JAPN 20C,E01,404135,Simpson; Junko Tokuda,12,0,12,0
1708255000507,JAPN 130C,A01,404144,Maruyama; Rie,9,0,9,0
1708255000507,JAPN 130C,A02,404145,Maruyama; Rie,9,0,9,0
1708255000507,JAPN 130C,B01,404147,Simpson; Junko Tokuda,8,0,9,1
1708255000507,JAPN 130C,B02,404148,Simpson; Junko Tokuda,9,0,9,0
1708255001037,JAPN 135C,A00,404176,Ross; Kayoko F,16,0,16,0
1708255001037,JAPN 135C,B00,404253,Takeda; Izumi,14,0,16,2
1708255001567,JAPN 140C,A00,404255,Sato; Kyoko,18,0,20,2
1708255002092,JAPN 150C,A00,404258,McKee; Mayumi Mochizuki,14,0,14,0
1708255002623,JAPN 190,A00,404260,Miyao; Daisuke,17,0,20,3
1708255003149,JAPN 196B,001,487237,Turner; Christena L.,9999,0,9999,0
1708255003678,JWSP 3,A01,404485,Shuster; Alana,20,0,20,0
1708255004205,LATI 10,A01,405201,Kennemore; Amy Michelle,27,0,30,3
1708255004205,LATI 10,A02,405202,Kennemore; Amy Michelle,27,0,30,3
1708255004205,LATI 10,A03,405208,Kennemore; Amy Michelle,28,0,30,2
1708255004731,LATI 50,A01,405214,Kokinis; Troy Andreas,34,0,35,1
1708255004731,LATI 50,A02,405215,Kokinis; Troy Andreas,34,0,35,1
1708255005259,LATI 130,A01,482880,Alvarez; Camila Huerta,29,0,30,1
1708255005784,LATI 160,A01,477482,Kokinis; Troy Andreas,30,0,30,0
1708255006315,LATI 180,A00,405221,Kennemore; Amy Michelle,28,0,30,2
1708255006315,LATI 180,B00,405222,Mostajo; Lorena,30,0,30,0
1708255006842,LIAB 1C,A00,405278,Saab; Dima,13,0,14,1
1708255006842,LIAB 1C,B00,405279,Saab; Dima,11,0,14,3
1708255007369,LIAB 1CX,A00,405281,Akjeje; Abdelhak,19,0,20,1
1708255007369,LIAB 1CX,B00,405291,Akjeje; Abdelhak,20,0,20,0
1708255007917,LIAB 1F,A00,482814,El Cheddadi; Youniss,14,0,14,0
1708255008460,LIDS 19,001,492979,Goodall; Grant Todd,9999,0,9999,0
1708255008460,LIDS 19,002,492980,Goodall; Grant Todd,9999,0,9999,0
1708255008460,LIDS 19,003,492981,Goodall; Grant Todd,9999,0,9999,0
1708255008460,LIDS 19,004,492982,Goodall; Grant Todd,9999,0,9999,0
1708255008460,LIDS 19,005,492983,Goodall; Grant Todd,9999,0,9999,0
1708255008460,LIDS 19,006,492984,Goodall; Grant Todd,9999,0,9999,0
1708255008460,LIDS 19,007,492985,Goodall; Grant Todd,9999,0,9999,0
1708255008460,LIDS 19,008,492986,Goodall; Grant Todd,9999,0,9999,0
1708255008460,LIDS 19,009,492987,Goodall; Grant Todd,9999,0,9999,0
1708255008460,LIDS 19,010,492988,Goodall; Grant Todd,9999,0,9999,0
1708255008460,LIDS 19,011,492989,Goodall; Grant Todd,9999,0,9999,0
1708255008460,LIDS 19,012,492990,Goodall; Grant Todd,9999,0,9999,0
1708255008998,LIFR 1A,A00,405299,Van Moer; Vinciane G,13,0,14,1
1708255008998,LIFR 1A,B00,405300,Van Moer; Vinciane G,13,0,14,1
1708255008998,LIFR 1A,C00,405301,Van Moer; Vinciane G,13,0,14,1
1708255008998,LIFR 1A,D00,405307,Van Moer; Vinciane G,14,0,14,0
1708255009524,LIFR 1AX,A00,405308,Van Moer; Vinciane G,27,0,28,1
1708255009524,LIFR 1AX,B00,405309,Van Moer; Vinciane G,27,0,28,1
1708255010051,LIFR 1C,A00,405310,Van Moer; Vinciane G,14,0,14,0
1708255010051,LIFR 1C,B00,405311,Van Moer; Vinciane G,12,0,14,2
1708255010051,LIFR 1C,C00,405325,Van Moer; Vinciane G,13,0,14,1
1708255010051,LIFR 1C,D00,405326,Van Moer; Vinciane G,11,0,14,3
1708255010581,LIFR 1CX,A00,405332,Van Moer; Vinciane G,25,0,28,3
1708255010581,LIFR 1CX,B00,405333,Van Moer; Vinciane G,27,0,28,1
1708255011107,LIFR 1D,A00,405334,Van Moer; Vinciane G,13,0,14,1
1708255011107,LIFR 1D,B00,405335,Van Moer; Vinciane G,13,0,14,1
1708255011107,LIFR 1D,C00,405336,Van Moer; Vinciane G,13,0,14,1
1708255011107,LIFR 1D,D00,405337,Van Moer; Vinciane G,13,0,14,1
1708255011633,LIFR 1DX,A00,405338,Van Moer; Vinciane G,25,0,28,3
1708255011633,LIFR 1DX,B00,405394,Van Moer; Vinciane G,27,0,28,1
1708255012159,LIFR 11,001,405395,Goodall; Grant Todd,999,0,999,0
1708255012685,LIGM 1C,A00,405398,Fischer-Grunski; Eva K,12,0,14,2
1708255012685,LIGM 1C,B00,405400,Fischer-Grunski; Eva K,13,0,14,1
1708255012685,LIGM 1C,C00,405403,Fischer-Grunski; Eva K,13,0,14,1
1708255012685,LIGM 1C,D00,405404,Fischer-Grunski; Eva K,13,0,14,1
1708255013212,LIGM 1CX,A00,405407,Fischer-Grunski; Eva K,27,0,28,1
1708255013212,LIGM 1CX,B00,405408,Fischer-Grunski; Eva K,26,0,28,2
1708255013740,LIGM 11,001,405464,Goodall; Grant Todd,999,0,999,0
1708255014287,LIGN 8,A00,411133,McIntosh; Justin Daniel,232,0,240,8
1708255014814,LIGN 17,A00,411141,Kehler; Andrew Scott,287,0,300,13
1708255015340,LIGN 101,A01,411144,Staff,28,0,30,2
1708255015340,LIGN 101,A02,411147,Staff,29,0,30,1
1708255015340,LIGN 101,A03,411154,Staff,27,0,30,3
1708255015340,LIGN 101,A04,411163,Staff,29,0,30,1
1708255015865,LIGN 120,A01,411165,Ackerman; Farrell,28,0,30,2
1708255015865,LIGN 120,A02,411177,Ackerman; Farrell,23,0,27,4
1708255016391,LIGN 130,A01,411223,Staff,29,0,30,1
1708255016391,LIGN 130,A02,411231,Staff,30,0,30,0
1708255016391,LIGN 130,A03,411232,Staff,29,0,30,1
1708255016936,LIGN 141,A00,411276,Rose; Sharon,37,0,40,3
1708255017461,LIGN 144,A00,411277,Lott; Margaret S.,22,0,24,2
1708255017991,LIGN 148,A00,411278,Mayberry; Rachel,71,0,75,4
1708255018517,LIGN 165,A00,411279,Bergen; Leon,41,0,70,29
1708255019043,LIGN 168,A01,411281,Styler; William Francis,65,0,70,5
1708255019573,LIGN 175,A00,482816,Rodriguez Aispuro; Alejandro,35,0,40,5
1708255020098,LIGN 230,A00,411293,Caponigro; Ivano,19,0,20,1
1708255020624,LIGN 238,A00,411308,Bergen; Benjamin,20,0,20,0
1708255021150,LIGN 252,A00,411309,Bergen; Leon,28,0,30,2
1708255021680,LIGN 256,A00,411310,Nakashole; Ndapandula,0,0,5,5
1708255022221,LIGN 272,A00,482887,Kluender; Robert,10,0,10,0
1708255022748,LIHL 112P,A00,405228,Pagkalinawan; Leticia Cant,27,0,28,1
1708255023279,LIHL 114P,A00,405229,Nguyen; Hoan Thi,26,0,28,2
1708255023805,LIHL 117P,A00,405256,Sadegholvad; Elham,27,0,28,1
1708255024331,LIHL 118,A00,405257,Chen; Areana Yen,28,0,28,0
1708255024857,LIHL 124P,A00,405262,Nguyen; Hoan Thi,28,0,28,0
1708255025384,LIHL 132P,A00,405263,Pagkalinawan; Leticia Cant,28,0,28,0
1708255025911,LIHL 134P,A00,405269,Nguyen; Hoan Thi,28,0,28,0
1708255026440,LIHL 138,A00,405270,Chen; Areana Yen,27,0,28,1
1708255026983,LIIT 1C,A00,405465,Carnelos; Chiara,12,0,14,2
1708255026983,LIIT 1C,B00,405466,Carnelos; Chiara,14,0,14,0
1708255027508,LIIT 1CX,A00,405594,Carnelos; Chiara,28,0,28,0
1708255028037,LIPO 1C,A00,405595,Paladini; Denise,13,0,14,1
1708255028037,LIPO 1C,B00,405596,Paladini; Denise,14,0,14,0
1708255028583,LIPO 1CX,A00,405597,De Abreu; Cassia,28,0,28,0
1708255029125,LISL 1A,C00,405600,Lott; Margaret S.,13,0,14,1
1708255029125,LISL 1A,D00,405601,Lott; Margaret S.,10,0,14,4
1708255029125,LISL 1A,E00,405602,Lott; Margaret S.,13,0,14,1
1708255029125,LISL 1A,F00,405603,Lott; Margaret S.,13,0,14,1
1708255029652,LISL 1AR,A00,480605,Lott; Margaret S.,13,0,15,2
1708255029652,LISL 1AR,B00,480606,Lott; Margaret S.,14,0,15,1
1708255030181,LISL 1AX,A00,405754,Lott; Margaret S.,26,0,28,2
1708255030181,LISL 1AX,B00,405755,Lott; Margaret S.,23,0,28,5
1708255030708,LISL 1C,A00,405776,Lott; Margaret S.,13,0,14,1
1708255030708,LISL 1C,B00,405779,Lott; Margaret S.,14,0,14,0
1708255030708,LISL 1C,C00,405785,Lott; Margaret S.,14,0,14,0
1708255030708,LISL 1C,D00,405787,Lott; Margaret S.,9,0,14,5
1708255030708,LISL 1C,E00,405827,Lott; Margaret S.,12,0,14,2
1708255030708,LISL 1C,F00,405830,Lott; Margaret S.,13,0,14,1
1708255031234,LISL 1CX,A00,405844,Lott; Margaret S.,25,0,28,3
1708255031234,LISL 1CX,B00,405848,Lott; Margaret S.,25,0,28,3
1708255031234,LISL 1CX,C00,405849,Lott; Margaret S.,28,0,28,0
1708255031760,LISL 1D,A00,405850,Lott; Margaret S.,8,0,14,6
1708255031760,LISL 1D,B00,405851,Lott; Margaret S.,13,0,14,1
1708255031760,LISL 1D,C00,405852,Lott; Margaret S.,10,0,14,4
1708255032289,LISL 1DX,A00,405854,Lott; Margaret S.,17,0,22,5
1708255032289,LISL 1DX,B00,405855,Lott; Margaret S.,18,0,22,4
1708255032832,LISP 1A,001,405856,Munoz Sanchez; Alicia,11,0,14,3
1708255032832,LISP 1A,002,405857,Munoz Sanchez; Alicia,13,0,14,1
1708255032832,LISP 1A,003,405858,Munoz Sanchez; Alicia,14,0,14,0
1708255032832,LISP 1A,004,405861,Munoz Sanchez; Alicia,14,0,14,0
1708255033358,LISP 1AX,001,405862,Munoz Sanchez; Alicia,28,0,28,0
1708255033358,LISP 1AX,002,405863,Munoz Sanchez; Alicia,25,0,28,3
1708255033922,LISP 1C,001,405864,Munoz Sanchez; Alicia,13,0,14,1
1708255033922,LISP 1C,002,405865,Munoz Sanchez; Alicia,12,0,14,2
1708255033922,LISP 1C,003,405879,Munoz Sanchez; Alicia,12,0,14,2
1708255033922,LISP 1C,004,405880,Munoz Sanchez; Alicia,13,0,14,1
1708255033922,LISP 1C,005,405881,Munoz Sanchez; Alicia,12,0,14,2
1708255033922,LISP 1C,006,405882,Munoz Sanchez; Alicia,12,0,14,2
1708255033922,LISP 1C,007,405904,Munoz Sanchez; Alicia,14,0,14,0
1708255033922,LISP 1C,008,405905,Munoz Sanchez; Alicia,14,0,14,0
1708255033922,LISP 1C,009,405908,Munoz Sanchez; Alicia,14,0,14,0
1708255033922,LISP 1C,010,405917,Munoz Sanchez; Alicia,13,0,14,1
1708255034449,LISP 1CX,001,405922,Munoz Sanchez; Alicia,24,0,28,4
1708255034449,LISP 1CX,002,405990,Munoz Sanchez; Alicia,26,0,28,2
1708255034449,LISP 1CX,003,406007,Munoz Sanchez; Alicia,27,0,28,1
1708255034449,LISP 1CX,004,406008,Munoz Sanchez; Alicia,25,0,28,3
1708255034449,LISP 1CX,005,406015,Munoz Sanchez; Alicia,26,0,28,2
1708255035002,LISP 1D,001,406016,Munoz Sanchez; Alicia,12,0,14,2
1708255035002,LISP 1D,002,406017,Munoz Sanchez; Alicia,13,0,14,1
1708255035002,LISP 1D,003,406018,Munoz Sanchez; Alicia,14,0,14,0
1708255035002,LISP 1D,004,406019,Munoz Sanchez; Alicia,11,0,14,3
1708255035002,LISP 1D,005,406020,Munoz Sanchez; Alicia,13,0,14,1
1708255035002,LISP 1D,006,406021,Munoz Sanchez; Alicia,10,0,14,4
1708255035002,LISP 1D,007,406022,Munoz Sanchez; Alicia,12,0,14,2
1708255035002,LISP 1D,008,406023,Munoz Sanchez; Alicia,13,0,14,1
1708255035002,LISP 1D,009,406024,Munoz Sanchez; Alicia,11,0,14,3
1708255035002,LISP 1D,010,406025,Munoz Sanchez; Alicia,12,0,14,2
1708255035002,LISP 1D,011,406026,Munoz Sanchez; Alicia,13,0,14,1
1708255035002,LISP 1D,012,406027,Munoz Sanchez; Alicia,13,0,14,1
1708255035002,LISP 1D,013,406028,Munoz Sanchez; Alicia,12,0,14,2
1708255035002,LISP 1D,014,406029,Munoz Sanchez; Alicia,12,0,14,2
1708255035002,LISP 1D,015,406030,Munoz Sanchez; Alicia,10,0,14,4
1708255035002,LISP 1D,016,406031,Munoz Sanchez; Alicia,14,0,14,0
1708255035002,LISP 1D,017,406032,Munoz Sanchez; Alicia,14,0,14,0
1708255035002,LISP 1D,018,406033,Munoz Sanchez; Alicia,12,0,14,2
1708255035002,LISP 1D,019,406034,Munoz Sanchez; Alicia,13,0,14,1
1708255035002,LISP 1D,020,406035,Munoz Sanchez; Alicia,14,0,14,0
1708255035002,LISP 1D,021,406036,Munoz Sanchez; Alicia,13,0,14,1
1708255035002,LISP 1D,022,406037,Munoz Sanchez; Alicia,14,0,14,0
1708255035002,LISP 1D,023,406038,Munoz Sanchez; Alicia,14,0,14,0
1708255035002,LISP 1D,024,406039,Munoz Sanchez; Alicia,13,0,14,1
1708255035546,LISP 1DX,001,406040,Munoz Sanchez; Alicia,28,0,28,0
1708255035546,LISP 1DX,002,406041,Munoz Sanchez; Alicia,27,0,28,1
1708255035546,LISP 1DX,003,406127,Munoz Sanchez; Alicia,24,0,28,4
1708255035546,LISP 1DX,004,406128,Munoz Sanchez; Alicia,17,0,28,11
1708255035546,LISP 1DX,005,406418,Munoz Sanchez; Alicia,24,0,28,4
1708255035546,LISP 1DX,006,406536,Munoz Sanchez; Alicia,27,0,28,1
1708255035546,LISP 1DX,007,406561,Munoz Sanchez; Alicia,23,0,28,5
1708255035546,LISP 1DX,008,406576,Munoz Sanchez; Alicia,25,0,28,3
1708255035546,LISP 1DX,009,406679,Munoz Sanchez; Alicia,28,0,28,0
1708255035546,LISP 1DX,010,406691,Munoz Sanchez; Alicia,26,0,28,2
1708255035546,LISP 1DX,011,406692,Munoz Sanchez; Alicia,28,0,28,0
1708255035546,LISP 1DX,012,406693,Munoz Sanchez; Alicia,28,0,28,0
1708255036073,LISP 17,001,406694,Munoz Sanchez; Alicia,18,0,20,2
1708255036601,LISP 18,001,406695,Munoz Sanchez; Alicia,20,0,20,0
1708255037128,LTAM 105,A00,412520,Ruiz; Ariana,28,0,40,12
1708255037657,LTCH 101,A00,479214,Zhu; Ping,39,0,40,1
1708255038187,LTCS 87,A00,492906,Nguyen; Hoang Tan,20,0,20,0
1708255038187,LTCS 87,B00,492907,Nguyen; Hoang Tan,20,0,20,0
1708255038713,LTCS 150,A00,412543,Liao; Ping H,39,0,40,1
1708255039238,LTCS 225,A00,412819,Mendoza; Andrea,14,0,15,1
1708255039768,LTCS 250,A00,412821,Lee; Jin-Kyung,15,0,15,0
1708255040294,LTEA 110B,A00,412548,Liao; Ping H,60,0,60,0
1708255040834,LTEA 120A,A00,479216,Zhu; Ping,36,0,40,4
1708255041364,LTEA 120C,A00,412552,Fiss; Geraldine Anna,295,0,300,5
1708255041893,LTEA 132,A00,412561,Mendoza; Andrea,51,0,60,9
1708255042420,LTEA 141,A00,412565,Lee; Jin-Kyung,37,0,40,3
1708255043000,LTEN 23,A01,411317,Vijay; Ameeth Varma,24,0,25,1
1708255043000,LTEN 23,A02,411318,Vijay; Ameeth Varma,24,0,25,1
1708255043000,LTEN 23,A03,411371,Vijay; Ameeth Varma,25,0,25,0
1708255043000,LTEN 23,A04,411375,Vijay; Ameeth Varma,24,0,25,1
1708255043534,LTEN 28,A01,411632,Blanco; John D,25,0,25,0
1708255043534,LTEN 28,A02,411697,Blanco; John D,25,0,25,0
1708255043534,LTEN 28,A03,411698,Blanco; John D,25,0,25,0
1708255043534,LTEN 28,A04,411709,Blanco; John D,25,0,25,0
1708255043534,LTEN 28,A05,411719,Blanco; John D,25,0,25,0
1708255043534,LTEN 28,A06,411744,Blanco; John D,25,0,25,0
1708255043534,LTEN 28,A07,411780,Blanco; John D,25,0,25,0
1708255043534,LTEN 28,A08,411820,Blanco; John D,25,0,25,0
1708255044060,LTEN 110,A00,486891,Vitkus; Daniel J.,38,0,40,2
1708255044588,LTEN 144,A00,412570,Vijay; Ameeth Varma,39,0,40,1
1708255045118,LTEN 180,A00,412581,Perreira; Christopher Michael,18,0,25,7
1708255045648,LTEN 181,A00,412582,Mukherjee; Silpa,55,0,60,5
1708255046177,LTEN 245,A00,412824,Johnson; Sara E.,13,0,15,2
1708255046708,LTEN 259,A00,412825,Streeby; Shelley,13,0,15,2
1708255047235,LTEU 111,A00,412588,Kontje; Todd Curtis,38,0,40,2
1708255047761,LTEU 140,A00,480172,De Marchi Gherini; Adriana,36,0,37,1
1708255049305,LTEU 141,A00,412592,Cohen; Alain J. J.,40,0,40,0
1708255049836,LTFR 2A,A01,411996,Ploye; Catherine,25,0,25,0
1708255050360,LTFR 2C,A00,411997,Ploye; Catherine,24,0,25,1
1708255050885,LTFR 142,A00,412597,Zhiri; Oumelbanine,20,0,20,0
1708255051416,LTGK 3,A00,412001,Murray; Kourtney Kristine,30,0,30,0
1708255051941,LTGM 2C,A00,412002,Fischer-Grunski; Eva K,25,0,25,0
1708255052468,LTKO 1C,A01,412029,Cho; Hye Jin,24,0,25,1
1708255052468,LTKO 1C,B01,412164,Cho; Hye Jin,23,0,25,2
1708255052468,LTKO 1C,C01,412168,Cho; Hye Jin,25,0,25,0
1708255052468,LTKO 1C,D01,412353,Yim; Nancy,24,0,25,1
1708255052468,LTKO 1C,E01,412372,Yim; Nancy,25,0,25,0
1708255052998,LTKO 2C,A01,412374,Yim; Nancy,21,0,25,4
1708255053524,LTKO 130P,A00,412601,Lee; Jeyseon,25,0,25,0
1708255054053,LTKO 135,A00,412606,Lee; Jeyseon,25,0,25,0
1708255054580,LTLA 3,A00,412375,Murray; Kourtney Kristine,36,0,40,4
1708255055106,LTRU 1C,A01,412491,Wells; Patricia Rebecca,24,0,25,1
1708255055651,LTRU 104A,A01,412614,Wells; Patricia Rebecca,20,0,20,0
1708255056177,LTSP 2A,A01,412493,Lampell; Toni,24,0,25,1
1708255056707,LTSP 2B,A01,412497,Lampell; Toni,22,0,25,3
1708255056707,LTSP 2B,B01,479218,Lampell; Toni,24,0,25,1
1708255057237,LTSP 2C,A01,412499,Mastromartino; Alexandra L,23,0,25,2
1708255057762,LTSP 2D,A00,412500,Dominguez; Noelia,24,0,25,1
1708255058291,LTSP 2E,A00,412501,Mastromartino; Alexandra L,24,0,25,1
1708255058291,LTSP 2E,B00,412502,Mastromartino; Alexandra L,25,0,25,0
1708255058821,LTSP 87,A00,479212,Bessett; Ryan Matthew,20,0,20,0
1708255059348,LTSP 100B,A00,412619,Dominguez; Noelia,25,0,25,0
1708255059348,LTSP 100B,B00,412623,Dominguez; Noelia,24,0,25,1
1708255059878,LTSP 116,A00,412628,Blanco; John D,28,0,30,2
1708255060407,LTSP 135A,A00,412631,Parra; Max,27,0,30,3
1708255060935,LTSP 174,A00,479213,Staff,28,0,30,2
1708255061462,LTTH 115,A00,412632,Kontje; Todd Curtis,35,0,40,5
1708255061987,LTTH 210C,A00,412826,Batarseh; Amanda Alicia,14,0,15,1
1708255062511,LTTH 255,A00,412827,Ali; Mohammad Kazim,13,0,15,2
1708255063039,LTTH 260,A00,412828,Kim; Joo Ok,30,0,30,0
1708255063565,LTWL 19C,A00,412503,Kelting; Edward William,40,0,40,0
1708255064091,LTWL 101,A00,412633,Kelting; Edward William,39,0,40,1
1708255064618,LTWL 114,A00,412656,Fiss; Geraldine Anna,60,0,60,0
1708255065146,LTWL 123,A00,412674,Lampert-Weissig; Lisa,31,0,40,9
1708255065674,LTWL 172,A00,412729,De Marchi Gherini; Adriana,37,0,40,3
1708255066200,LTWL 183,A00,412731,Cohen; Alain J. J.,38,0,40,2
1708255066726,LTWL 184,A00,479219,Mukherjee; Silpa,38,0,40,2
1708255067258,LTWL 194A,A00,489635,Vijay; Ameeth Varma,27,0,31,4
1708255067787,LTWR 8A,A01,412505,Springer; Anna Joy,24,0,25,1
1708255067787,LTWR 8A,A02,412506,Springer; Anna Joy,24,0,25,1
1708255067787,LTWR 8A,A03,412507,Springer; Anna Joy,25,0,25,0
1708255067787,LTWR 8A,A04,412508,Springer; Anna Joy,23,0,25,2
1708255068333,LTWR 8C,A01,412511,Forbes; Camille,23,0,25,2
1708255068333,LTWR 8C,A02,412512,Forbes; Camille,25,0,25,0
1708255068333,LTWR 8C,A03,412514,Forbes; Camille,25,0,25,0
1708255068333,LTWR 8C,A04,412519,Forbes; Camille,24,0,25,1
1708255068859,LTWR 100,A00,412734,Forbes; Camille,7,0,15,8
1708255069389,LTWR 113,A00,412816,Carroll; Amy Sara,28,0,30,2
1708255069914,LTWR 114,A00,412817,Springer; Anna Joy,23,0,30,7
1708255070439,LTWR 126,A00,412818,Hoang; Lily Kim,25,0,30,5
1708255070969,LTWR 215,A00,412880,Carroll; Amy Sara,19,0,20,1
1708255071513,MAE 3,A01,435606,Qi; Huihui,16,0,20,4
1708255071513,MAE 3,A02,435607,Qi; Huihui,15,0,20,5
1708255071513,MAE 3,A03,435608,Qi; Huihui,19,0,20,1
1708255071513,MAE 3,B01,435618,Delson; Nathan Joseph & Mullin; Jennifer S,20,0,20,0
1708255071513,MAE 3,B02,435626,Delson; Nathan Joseph & Mullin; Jennifer S,20,0,20,0
1708255071513,MAE 3,B03,435666,Delson; Nathan Joseph & Mullin; Jennifer S,20,0,20,0
1708255071513,MAE 3,B04,435679,Delson; Nathan Joseph & Mullin; Jennifer S,20,0,20,0
1708255071513,MAE 3,B05,494545,Delson; Nathan Joseph & Mullin; Jennifer S,20,0,20,0
1708255072044,MAE 8,A01,435688,Pham; Hieu Tan,197,0,200,3
1708255072575,MAE 30B,A00,435689,Lubarda; Marko,128,0,130,2
1708255072575,MAE 30B,B00,435701,Ghazinejad; Maziar,117,0,130,13
1708255073105,MAE 101B,A00,435702,Saintillan; David,146,0,150,4
1708255073105,MAE 101B,B00,435703,Nomura; Keiko K.,138,0,146,8
1708255073631,MAE 101C,A00,435704,Sadeghizadeh; Zahra,53,0,65,12
1708255074156,MAE 101D,A00,435705,Chen; Renkun,14,0,20,6
1708255074687,MAE 105,A00,435706,Becker; Janet Maria,115,0,120,5
1708255075218,MAE 107,A00,435707,Lindsey; Stephanie,48,0,50,2
1708255075218,MAE 107,B00,435708,Davidson; Michael R,55,0,60,5
1708255075745,MAE 119,A00,435710,Hidalgo-Gonzalez; Patricia,100,0,120,20
1708255076274,MAE 120,A00,435722,Arefiev; Alexey,49,0,65,16
1708255076801,MAE 125,A00,435723,Kleissl; Jan,60,0,65,5
1708255077334,MAE 131A,A00,435724,Qi; Huihui,119,0,125,6
1708255077334,MAE 131A,B00,435725,Meyers; Marc,123,0,125,2
1708255077860,MAE 143B,A00,435726,Morimoto; Tania,114,0,120,6
1708255077860,MAE 143B,B00,435727,Herbert; Sylvia Lee,117,0,120,3
1708255077860,MAE 143B,C00,435728,Diagne; Mamadou Lamine,107,0,120,13
1708255078385,MAE 145,A00,435729,Martinez; Sonia,41,0,60,19
1708255078913,MAE 148,A01,492802,Silberman; Jack,14,0,24,10
1708255079440,MAE 150,A00,435730,Pham; Hieu Tan,51,0,60,9
1708255079966,MAE 152,A00,435731,Llewellyn Smith; Stefan G.,14,0,14,0
1708255079966,MAE 152,B00,435747,Llewellyn Smith; Stefan G.,12,0,14,2
1708255079966,MAE 152,C00,435748,Llewellyn Smith; Stefan G.,12,0,14,2
1708255079966,MAE 152,D00,435749,Llewellyn Smith; Stefan G.,8,0,14,6
1708255079966,MAE 152,E00,435750,Llewellyn Smith; Stefan G.,13,0,14,1
1708255080498,MAE 155B,A01,435752,Hwang; John T,36,0,50,14
1708255080498,MAE 155B,B01,435768,Anderson; Mark Ronald,27,0,50,23
1708255080498,MAE 155B,C01,494006,Saha; Abhishek,0,0,0,0
1708255081025,MAE 156B,A01,435770,Tustaniwskyj; Jerry I,32,0,40,8
1708255081025,MAE 156B,B01,435772,Ghazinejad; Maziar,35,0,40,5
1708255081025,MAE 156B,C01,435774,Delson; Nathan Joseph,38,0,40,2
1708255081025,MAE 156B,D01,435776,Saha; Abhishek,31,0,40,9
1708255081550,MAE 166,A00,435777,Fullerton; Eric E,44,0,50,6
1708255082081,MAE 170,A01,435779,Lubarda; Marko,30,0,32,2
1708255082081,MAE 170,A02,435780,Lubarda; Marko,27,0,32,5
1708255082081,MAE 170,A03,435781,Lubarda; Marko,32,0,32,0
1708255082081,MAE 170,A04,435782,Lubarda; Marko,31,0,32,1
1708255082081,MAE 170,A05,435783,Lubarda; Marko,29,0,32,3
1708255082081,MAE 170,A06,435784,Lubarda; Marko,30,0,32,2
1708255082081,MAE 170,B01,435786,Evdokimenko; Ekaterina,23,0,24,1
1708255082081,MAE 170,B02,435787,Evdokimenko; Ekaterina,20,0,24,4
1708255082081,MAE 170,B03,435788,Evdokimenko; Ekaterina,23,0,24,1
1708255082081,MAE 170,B04,435789,Evdokimenko; Ekaterina,23,0,24,1
1708255082081,MAE 170,B05,435790,Evdokimenko; Ekaterina,19,0,24,5
1708255082081,MAE 170,B06,435791,Evdokimenko; Ekaterina,23,0,24,1
1708255082608,MAE 180,A00,479477,Sadeghizadeh; Zahra,55,0,60,5
1708255083137,MAE 184,A00,435792,Anderson; Mark Ronald,6,0,50,44
1708255083665,MAE 190,A00,435793,Beg; Farhat N.,17,0,20,3
1708255083665,MAE 190,B00,479209,Gerardo; Hortense Flotilde,12,0,15,3
1708255084191,MAE 202,A00,435794,Bandaru; Prabhakar,32,0,70,38
1708255084717,MAE 205,A00,435804,Hwang; John T & Tynan; George Robert & Seshadri; Kalyanasundaram & Rangamani; Padmini & Bandaru; Prabhakar,9990,0,9999,9
1708255085248,MAE 207,A00,435805,Beg; Farhat N.,9,0,10,1
1708255085248,MAE 207,B00,435815,Campbell; Edward Michael,6,0,10,4
1708255085248,MAE 207,C00,477499,Gerardo; Hortense Flotilde,6,0,30,24
1708255085776,MAE 209,A00,435816,Scholtes Acevedo; Claire,25,0,30,5
1708255086301,MAE 210C,A00,435817,Becker; Janet Maria,22,0,30,8
1708255086828,MAE 211,A00,435818,Seshadri; Kalyanasundaram,20,0,30,10
1708255087353,MAE 214A,A00,435819,Sarkar; Sutanu,27,0,35,8
1708255087878,MAE 217C,A00,435820,Marinoni; Alessandro,10,0,10,0
1708255088404,MAE 221C,A00,435821,Seshadri; Kalyanasundaram,9,0,15,6
1708255088933,MAE 221D,A00,435822,Poulikakos; Lisa Voula,23,0,30,7
1708255089462,MAE 224A,A00,435823,Pawlak; Geno Ronald,5,0,10,5
1708255089988,MAE 227,A00,435824,Hidalgo-Gonzalez; Patricia,21,0,35,14
1708255090515,MAE 231A,A00,435825,Boechler; Nicholas Sebastia,14,0,30,16
1708255091046,MAE 240,A00,435826,Rosengren; Aaron,19,0,30,11
1708255091572,MAE 242,A00,435827,Martinez; Sonia,0,0,45,45
1708255092096,MAE 249,A00,435842,Tolley; Michael Thomas,0,0,35,35
1708255092641,MAE 253,A00,435891,Staff,24,0,25,1
1708255093167,MAE 256,A00,435949,Coimbra; Carlos F.,6,0,10,4
1708255093692,MAE 263,A00,435987,Rangamani; Padmini,10,0,10,0
1708255094218,MAE 266,A00,435988,Evdokimenko; Ekaterina,7,0,30,23
1708255094746,MAE 271C,A00,435990,Arzt; Eduard,10,0,10,0
1708255095271,MAE 281B,A00,435991,Cortes; Jorge,9,0,25,16
1708255095798,MAE 288A,A00,435998,McEneaney; William Michael,6,0,40,34
1708255096327,MAE 288B,A00,435999,Bitmead; Robert R.,41,0,45,4
1708255096855,MAE 290C,A00,436008,Schmidt; Oliver,26,0,30,4
1708255097434,MAE 294C,A01,436010,Young; William Roy,19,0,20,1
1708255097964,MATH 2,A01,431271,Staff,31,0,35,4
1708255097964,MATH 2,B01,431273,Staff,29,0,35,6
1708255097964,MATH 2,C01,431275,Staff,31,0,35,4
1708255098490,MATH 3C,A01,431277,Safii; Soheil,12,0,15,3
1708255098490,MATH 3C,A02,431278,Safii; Soheil,12,0,15,3
1708255098490,MATH 3C,A03,431279,Safii; Soheil,12,0,15,3
1708255098490,MATH 3C,A04,431280,Safii; Soheil,15,0,15,0
1708255098490,MATH 3C,A05,431281,Safii; Soheil,14,0,15,1
1708255098490,MATH 3C,A06,431282,Safii; Soheil,15,0,15,0
1708255099016,MATH 10A,A01,431284,Bowers; Adam R.,20,0,30,10
1708255099016,MATH 10A,A02,431285,Bowers; Adam R.,18,0,30,12
1708255099016,MATH 10A,A03,431369,Bowers; Adam R.,28,0,30,2
1708255099016,MATH 10A,A04,431395,Bowers; Adam R.,27,0,30,3
1708255099016,MATH 10A,A05,431450,Bowers; Adam R.,28,0,30,2
1708255099016,MATH 10A,A06,431508,Bowers; Adam R.,30,0,30,0
1708255099016,MATH 10A,B01,431572,Kowalenko; Ethan J,24,0,30,6
1708255099016,MATH 10A,B02,431573,Kowalenko; Ethan J,29,0,30,1
1708255099016,MATH 10A,B03,431574,Kowalenko; Ethan J,30,0,30,0
1708255099016,MATH 10A,B04,431576,Kowalenko; Ethan J,30,0,30,0
1708255099016,MATH 10A,B05,431577,Kowalenko; Ethan J,30,0,30,0
1708255099016,MATH 10A,B06,431583,Kowalenko; Ethan J,30,0,30,0
1708255099552,MATH 10B,A01,431595,Habib; Yousaf,29,0,36,7
1708255099552,MATH 10B,A02,431597,Habib; Yousaf,35,0,36,1
1708255099552,MATH 10B,A03,431669,Habib; Yousaf,37,0,37,0
1708255099552,MATH 10B,A04,431670,Habib; Yousaf,36,0,37,1
1708255099552,MATH 10B,A05,431671,Habib; Yousaf,70,0,70,0
1708255099552,MATH 10B,B01,431673,Habib; Yousaf,25,0,33,8
1708255099552,MATH 10B,B02,431712,Habib; Yousaf,33,0,33,0
1708255099552,MATH 10B,B03,431713,Habib; Yousaf,33,0,33,0
1708255099552,MATH 10B,B04,431714,Habib; Yousaf,33,0,33,0
1708255099552,MATH 10B,B05,431715,Habib; Yousaf,60,0,60,0
1708255099552,MATH 10B,C01,431717,Bach; Quang Tran,57,0,60,3
1708255099552,MATH 10B,C02,431718,Bach; Quang Tran,18,0,34,16
1708255099552,MATH 10B,C03,431719,Bach; Quang Tran,34,0,34,0
1708255099552,MATH 10B,C04,431720,Bach; Quang Tran,33,0,34,1
1708255099552,MATH 10B,C05,431721,Bach; Quang Tran,32,0,34,2
1708255099552,MATH 10B,D01,431723,Staff,28,0,34,6
1708255099552,MATH 10B,D02,431724,Staff,34,0,34,0
1708255099552,MATH 10B,D03,431725,Staff,34,0,34,0
1708255099552,MATH 10B,D04,431726,Staff,34,0,34,0
1708255099552,MATH 10B,D05,431727,Staff,57,0,60,3
1708255100079,MATH 10C,A01,431741,Staff,94,0,96,2
1708255100079,MATH 10C,A02,431742,Staff,39,0,40,1
1708255100079,MATH 10C,B01,431744,Staff,95,0,96,1
1708255100079,MATH 10C,B02,431746,Staff,27,0,40,13
1708255100079,MATH 10C,C01,431748,Pardo Guerra; Sebastian,30,0,40,10
1708255100079,MATH 10C,C02,431885,Pardo Guerra; Sebastian,40,0,40,0
1708255100079,MATH 10C,C03,431895,Pardo Guerra; Sebastian,32,0,33,1
1708255100079,MATH 10C,C04,431896,Pardo Guerra; Sebastian,32,0,32,0
1708255100612,MATH 11,A01,431933,Rava; Denise,82,0,100,18
1708255100612,MATH 11,A02,431960,Rava; Denise,66,0,70,4
1708255100612,MATH 11,A03,431971,Rava; Denise,39,0,40,1
1708255100612,MATH 11,B01,432053,Staff,99,0,100,1
1708255100612,MATH 11,B02,432064,Staff,37,0,45,8
1708255100612,MATH 11,B03,432073,Staff,44,0,45,1
1708255101141,MATH 18,A01,432082,Mackall; Eoin Travis,65,0,70,5
1708255101141,MATH 18,A02,432086,Mackall; Eoin Travis,68,0,70,2
1708255101141,MATH 18,B01,432089,Suk; Andrew Hoon,39,0,40,1
1708255101141,MATH 18,B02,432090,Suk; Andrew Hoon,35,0,40,5
1708255101141,MATH 18,B03,432091,Suk; Andrew Hoon,33,0,40,7
1708255101141,MATH 18,B04,432092,Suk; Andrew Hoon,30,0,40,10
1708255101141,MATH 18,B05,432093,Suk; Andrew Hoon,34,0,35,1
1708255101141,MATH 18,B06,432094,Suk; Andrew Hoon,33,0,35,2
1708255101141,MATH 18,B07,432095,Suk; Andrew Hoon,98,0,100,2
1708255101141,MATH 18,B08,432096,Suk; Andrew Hoon,100,0,100,0
1708255101141,MATH 18,B09,432097,Suk; Andrew Hoon,98,0,100,2
1708255101141,MATH 18,B10,432098,Suk; Andrew Hoon,69,0,70,1
1708255101667,MATH 20A,A01,432101,Briones; Jor-el Thomas Caparas,30,0,40,10
1708255101667,MATH 20A,A02,432102,Briones; Jor-el Thomas Caparas,98,0,100,2
1708255101667,MATH 20A,B01,432104,Briones; Jor-el Thomas Caparas,99,0,100,1
1708255101667,MATH 20A,B02,432105,Briones; Jor-el Thomas Caparas,40,0,40,0
1708255102198,MATH 20B,A01,432107,Quarfoot; David James,33,0,35,2
1708255102198,MATH 20B,A02,432108,Quarfoot; David James,18,0,35,17
1708255102198,MATH 20B,A03,432109,Quarfoot; David James,32,0,35,3
1708255102198,MATH 20B,A04,432110,Quarfoot; David James,34,0,35,1
1708255102198,MATH 20B,A05,432331,Quarfoot; David James,26,0,32,6
1708255102198,MATH 20B,A06,432411,Quarfoot; David James,31,0,32,1
1708255102198,MATH 20B,B01,432413,Mackall; Eoin Travis,62,0,65,3
1708255102198,MATH 20B,B02,432443,Mackall; Eoin Travis,65,0,65,0
1708255102198,MATH 20B,B03,432444,Mackall; Eoin Travis,60,0,60,0
1708255102198,MATH 20B,B04,432471,Mackall; Eoin Travis,60,0,60,0
1708255102728,MATH 20C,A01,432473,Ohm; Ko Woon,26,0,38,12
1708255102728,MATH 20C,A02,432474,Ohm; Ko Woon,36,0,38,2
1708255102728,MATH 20C,A03,432475,Ohm; Ko Woon,34,0,37,3
1708255102728,MATH 20C,A04,432546,Ohm; Ko Woon,36,0,37,1
1708255102728,MATH 20C,A05,432550,Ohm; Ko Woon,88,0,90,2
1708255102728,MATH 20C,B01,432568,Ohm; Ko Woon,43,0,45,2
1708255102728,MATH 20C,B02,432594,Ohm; Ko Woon,40,0,45,5
1708255102728,MATH 20C,B03,432609,Ohm; Ko Woon,85,0,90,5
1708255102728,MATH 20C,C01,432613,Cheng; Hsiao-Bing,67,0,70,3
1708255102728,MATH 20C,C02,432614,Cheng; Hsiao-Bing,68,0,70,2
1708255102728,MATH 20C,C03,432615,Cheng; Hsiao-Bing,70,0,70,0
1708255102728,MATH 20C,D01,432617,Cheng; Hsiao-Bing,69,0,70,1
1708255102728,MATH 20C,D02,432618,Cheng; Hsiao-Bing,68,0,70,2
1708255102728,MATH 20C,D03,432619,Cheng; Hsiao-Bing,70,0,70,0
1708255103264,MATH 20D,A01,432622,Hammock; Frances H,58,0,60,2
1708255103264,MATH 20D,A02,432623,Hammock; Frances H,58,0,60,2
1708255103264,MATH 20D,A03,432658,Hammock; Frances H,35,0,35,0
1708255103264,MATH 20D,A04,432660,Hammock; Frances H,35,0,35,0
1708255103264,MATH 20D,B01,432702,Hammock; Frances H,66,0,70,4
1708255103264,MATH 20D,B02,432703,Hammock; Frances H,70,0,70,0
1708255103264,MATH 20D,B03,432766,Hammock; Frances H,30,0,30,0
1708255103264,MATH 20D,B04,432782,Hammock; Frances H,20,0,30,10
1708255103264,MATH 20D,C01,432811,Sheng; Hongyi,60,0,60,0
1708255103264,MATH 20D,C02,432931,Sheng; Hongyi,60,0,60,0
1708255103264,MATH 20D,C03,432945,Sheng; Hongyi,27,0,30,3
1708255103264,MATH 20D,C04,432949,Sheng; Hongyi,30,0,30,0
1708255103791,MATH 20E,A01,433007,Eggers; John Dietrich,70,0,80,10
1708255103791,MATH 20E,A02,433070,Eggers; John Dietrich,77,0,80,3
1708255103791,MATH 20E,A03,433079,Eggers; John Dietrich,32,0,35,3
1708255103791,MATH 20E,B01,433092,Staff,86,0,90,4
1708255103791,MATH 20E,B02,433093,Staff,90,0,90,0
1708255103791,MATH 20E,C01,433237,Bach; Quang Tran,52,0,60,8
1708255103791,MATH 20E,C02,433238,Bach; Quang Tran,69,0,70,1
1708255103791,MATH 20E,C03,433239,Bach; Quang Tran,70,0,70,0
1708255104315,MATH 31CH,A01,433241,Rabin; Jeffrey Mark,35,0,35,0
1708255104841,MATH 95,A00,433242,Stevens; Laura Jeanne,30,0,30,0
1708255105366,MATH 100C,A01,433244,Pollack; Aaron,31,0,35,4
1708255105366,MATH 100C,A02,433245,Pollack; Aaron,35,0,35,0
1708255105893,MATH 102,A01,433298,Ophir; Amit,29,0,30,1
1708255105893,MATH 102,A02,433369,Ophir; Amit,30,0,30,0
1708255105893,MATH 102,A03,433373,Ophir; Amit,30,0,30,0
1708255105893,MATH 102,A04,433374,Ophir; Amit,29,0,30,1
1708255105893,MATH 102,B01,433572,Zhang; Ming,28,0,30,2
1708255105893,MATH 102,B02,433732,Zhang; Ming,30,0,30,0
1708255105893,MATH 102,B03,433733,Zhang; Ming,30,0,30,0
1708255105893,MATH 102,B04,433734,Zhang; Ming,29,0,30,1
1708255106428,MATH 103B,A01,433793,Lu; Yunze,23,0,30,7
1708255106428,MATH 103B,A02,433795,Lu; Yunze,30,0,30,0
1708255106428,MATH 103B,A03,433830,Lu; Yunze,28,0,30,2
1708255106428,MATH 103B,B01,433845,Lahiri; Aranya,24,0,30,6
1708255106428,MATH 103B,B02,433846,Lahiri; Aranya,28,0,30,2
1708255106428,MATH 103B,B03,433847,Lahiri; Aranya,27,0,30,3
1708255106957,MATH 109,A01,433849,Aycock; Jon Merrill,6,0,10,4
1708255106957,MATH 109,A02,433850,Aycock; Jon Merrill,9,0,10,1
1708255106957,MATH 109,B01,433852,Klevdal; Christian Sleek,10,0,10,0
1708255106957,MATH 109,B02,433859,Klevdal; Christian Sleek,10,0,10,0
1708255106957,MATH 109,C01,433861,Treuer; John N,5,0,10,5
1708255106957,MATH 109,C02,433862,Treuer; John N,10,0,10,0
1708255106957,MATH 109,D01,433864,Treuer; John N,8,0,10,2
1708255106957,MATH 109,D02,433865,Treuer; John N,8,0,10,2
1708255106957,MATH 109,E01,433868,Sheng; Hongyi,10,0,10,0
1708255106957,MATH 109,E02,433869,Sheng; Hongyi,19,0,20,1
1708255107485,MATH 110,A01,433871,Pillai; Mohandas K,24,0,35,11
1708255107485,MATH 110,A02,433872,Pillai; Mohandas K,33,0,35,2
1708255108015,MATH 112B,A01,480683,Komarova; Natalia,27,0,27,0
1708255108546,MATH 120B,A01,433885,Xiao; Ming,32,0,35,3
1708255108546,MATH 120B,A02,433886,Xiao; Ming,34,0,35,1
1708255109075,MATH 121B,A01,433888,Stevens; Laura Jeanne,29,0,30,1
1708255109601,MATH 140B,A01,433890,Seward; Brandon M.,31,0,35,4
1708255109601,MATH 140B,A02,433891,Seward; Brandon M.,35,0,35,0
1708255110130,MATH 140C,A01,433895,Spolaor; Luca,32,0,35,3
1708255110130,MATH 140C,A02,433896,Spolaor; Luca,35,0,35,0
1708255110657,MATH 142B,A01,433966,Eggers; John Dietrich,25,0,35,10
1708255110657,MATH 142B,A02,434063,Eggers; John Dietrich,32,0,35,3
1708255110657,MATH 142B,B01,434071,Sanchez; Anthony,32,0,35,3
1708255110657,MATH 142B,B02,434083,Sanchez; Anthony,34,0,35,1
1708255110657,MATH 142B,C01,434094,Kunnawalkam Elayavalli; Sr,31,0,35,4
1708255110657,MATH 142B,C02,434095,Kunnawalkam Elayavalli; Sr,34,0,35,1
1708255111183,MATH 144,A01,434097,Cloninger; Alexander,30,0,30,0
1708255111712,MATH 150B,A01,434104,Parise; Davide,33,0,35,2
1708255112239,MATH 152,A01,434107,Grier; Daniel T,20,0,40,20
1708255112767,MATH 154,A01,434109,Wesley; William J,31,0,35,4
1708255112767,MATH 154,A02,434119,Wesley; William J,35,0,35,0
1708255112767,MATH 154,A03,434120,Wesley; William J,35,0,35,0
1708255112767,MATH 154,A04,434121,Wesley; William J,34,0,35,1
1708255112767,MATH 154,B01,434126,Aliabadi Sr.; Mohsen,26,0,35,9
1708255112767,MATH 154,B02,434127,Aliabadi Sr.; Mohsen,34,0,35,1
1708255112767,MATH 154,B03,434138,Aliabadi Sr.; Mohsen,35,0,35,0
1708255112767,MATH 154,B04,434139,Aliabadi Sr.; Mohsen,35,0,35,0
1708255113298,MATH 163,A01,434144,Bowers; Adam R.,0,0,5,5
1708255113824,MATH 170A,A01,434148,Nag; Panchali,36,0,36,0
1708255113824,MATH 170A,A02,434149,Nag; Panchali,36,0,36,0
1708255113824,MATH 170A,A03,434150,Nag; Panchali,36,0,37,1
1708255113824,MATH 170A,A04,434151,Nag; Panchali,36,0,36,0
1708255114352,MATH 170B,A01,434155,Huang; Lei,31,0,35,4
1708255114352,MATH 170B,A02,434160,Huang; Lei,35,0,35,0
1708255114352,MATH 170B,A03,434161,Huang; Lei,35,0,35,0
1708255114352,MATH 170B,A04,434162,Huang; Lei,35,0,35,0
1708255114882,MATH 170C,A01,434176,Leok; Melvin,30,0,35,5
1708255114882,MATH 170C,A02,434300,Leok; Melvin,34,0,35,1
1708255115410,MATH 171B,A01,434576,Nie; Jiawang,24,0,35,11
1708255115410,MATH 171B,A02,434583,Nie; Jiawang,35,0,35,0
1708255115410,MATH 171B,A03,434584,Nie; Jiawang,35,0,35,0
1708255115410,MATH 171B,A04,434609,Nie; Jiawang,35,0,35,0
1708255115946,MATH 180A,A01,434638,Gartland; Christopher John,29,0,30,1
1708255115946,MATH 180A,A02,434821,Gartland; Christopher John,28,0,30,2
1708255115946,MATH 180A,A03,434833,Gartland; Christopher John,24,0,30,6
1708255115946,MATH 180A,A04,434839,Gartland; Christopher John,30,0,30,0
1708255115946,MATH 180A,A05,434843,Gartland; Christopher John,30,0,30,0
1708255115946,MATH 180A,A06,434895,Gartland; Christopher John,30,0,30,0
1708255116473,MATH 180B,A01,435085,Gartland; Christopher John,30,0,35,5
1708255116473,MATH 180B,A02,435086,Gartland; Christopher John,35,0,35,0
1708255116473,MATH 180B,A03,435087,Gartland; Christopher John,34,0,35,1
1708255116473,MATH 180B,A04,435088,Gartland; Christopher John,35,0,35,0
1708255117000,MATH 180C,A01,435090,Carfagnini; Marco,29,0,35,6
1708255117000,MATH 180C,A02,435091,Carfagnini; Marco,35,0,35,0
1708255117000,MATH 180C,A03,435092,Carfagnini; Marco,32,0,35,3
1708255117000,MATH 180C,A04,435113,Carfagnini; Marco,35,0,35,0
1708255117527,MATH 181A,A01,435279,Zhang; Danna,30,0,35,5
1708255117527,MATH 181A,A02,435300,Zhang; Danna,35,0,35,0
1708255117527,MATH 181A,A03,435301,Zhang; Danna,21,0,35,14
1708255117527,MATH 181A,A04,435302,Zhang; Danna,31,0,35,4
1708255118053,MATH 181B,A01,435315,Rava; Denise,33,0,35,2
1708255118053,MATH 181B,A02,435316,Rava; Denise,32,0,35,3
1708255118053,MATH 181B,A03,435317,Rava; Denise,33,0,35,2
1708255118053,MATH 181B,A04,435318,Rava; Denise,35,0,35,0
1708255118580,MATH 183,A01,435320,Quarfoot; David James,26,0,35,9
1708255118580,MATH 183,A02,435321,Quarfoot; David James,35,0,35,0
1708255118580,MATH 183,A03,435322,Quarfoot; David James,32,0,35,3
1708255118580,MATH 183,A04,435323,Quarfoot; David James,34,0,35,1
1708255118580,MATH 183,A05,435327,Quarfoot; David James,34,0,35,1
1708255118580,MATH 183,A06,435329,Quarfoot; David James,33,0,35,2
1708255119108,MATH 184,A01,435337,Verstraete; Jacques Allan,32,0,35,3
1708255119108,MATH 184,A02,435338,Verstraete; Jacques Allan,35,0,35,0
1708255119108,MATH 184,A03,435339,Verstraete; Jacques Allan,34,0,35,1
1708255119108,MATH 184,A04,435347,Verstraete; Jacques Allan,30,0,35,5
1708255119640,MATH 185,A01,435432,Arias-Castro; Ery,15,0,30,15
1708255119640,MATH 185,A02,435436,Arias-Castro; Ery,30,0,30,0
1708255119640,MATH 185,A03,435437,Arias-Castro; Ery,30,0,30,0
1708255119640,MATH 185,A04,435438,Arias-Castro; Ery,30,0,30,0
1708255120170,MATH 187A,A01,435443,Agrawal; Shishir,15,0,30,15
1708255120170,MATH 187A,A02,435444,Agrawal; Shishir,30,0,30,0
1708255120170,MATH 187A,A03,435503,Agrawal; Shishir,28,0,30,2
1708255120170,MATH 187A,A04,435507,Agrawal; Shishir,30,0,30,0
1708255120170,MATH 187A,A05,435554,Agrawal; Shishir,22,0,30,8
1708255120170,MATH 187A,A06,435558,Agrawal; Shishir,28,0,30,2
1708255120700,MATH 187B,A01,435570,Bucur; Alina Ioana,24,0,35,11
1708255120700,MATH 187B,A02,435571,Bucur; Alina Ioana,35,0,35,0
1708255121229,MATH 188,A01,435573,Kunnawalkam Elayavalli; Sr,35,0,35,0
1708255121757,MATH 189,A01,435577,Vishwanath; Siddharth,0,0,10,10
1708255121757,MATH 189,A02,435594,Vishwanath; Siddharth,0,0,10,10
1708255121757,MATH 189,A03,435595,Vishwanath; Siddharth,0,0,10,10
1708255121757,MATH 189,A04,435596,Vishwanath; Siddharth,0,0,10,10
1708255121757,MATH 189,A05,480706,Vishwanath; Siddharth,2,0,10,8
1708255121757,MATH 189,A06,481362,Vishwanath; Siddharth,6,0,10,4
1708255122288,MATH 200C,A00,430388,Bucur; Alina Ioana,15,0,15,0
1708255122814,MATH 202C,A00,430389,Rhoades; Brendon Patrick,15,0,15,0
1708255123341,MATH 203C,A00,430390,Izadi; Elham,15,0,15,0
1708255123871,MATH 204C,A00,430391,Sorensen; Claus M,15,0,15,0
1708255124397,MATH 208,A00,430392,Izadi; Elham,8,0,10,2
1708255124923,MATH 209,A00,430393,Pollack; Aaron,10,0,10,0
1708255125451,MATH 211A,A00,430394,Salehi Golsefidy; Alireza,10,0,10,0
1708255125977,MATH 211B,A00,430395,Seward; Brandon M.,10,0,10,0
1708255126503,MATH 212B,A01,480692,Komarova; Natalia,5,0,5,0
1708255127029,MATH 216C,A00,430429,Saab; Rayan,13,0,15,2
1708255127559,MATH 217,A00,430430,Li; Bo,13,0,15,2
1708255128083,MATH 218,A00,430431,Li; Bo,8,0,10,2
1708255128611,MATH 220C,A00,430432,Xiao; Ming,15,0,15,0
1708255129139,MATH 240C,A00,430433,Ebenfelt; Peter F,14,0,15,1
1708255129666,MATH 241B,A00,430434,Ioana; Adrian,14,0,15,1
1708255130194,MATH 243,A00,430435,Kunnawalkam Elayavalli; Sr,9,0,10,1
1708255130720,MATH 248,A00,430436,Bejenaru; Ioan,9,0,10,1
1708255131245,MATH 251C,A00,430437,Wenzl; Hans G,15,0,15,0
1708255131770,MATH 258,A00,430438,Spolaor; Luca,10,0,10,0
1708255132300,MATH 261C,A00,430439,Manners; Frederick,14,0,15,1
1708255132830,MATH 262A,A00,430440,Warnke; Lutz Peter,14,0,15,1
1708255133358,MATH 268,A00,430441,Buss; Samuel R,10,0,10,0
1708255133883,MATH 269,A00,430442,Rhoades; Brendon Patrick & Warnke; Lutz Peter,10,0,10,0
1708255134410,MATH 270C,A00,430445,Cheng; Li-Tien,15,0,15,0
1708255134941,MATH 273B,A00,430452,Zhu; Yuhua,15,0,15,0
1708255135472,MATH 276,A00,430458,Mc Culloch; Andrew Douglas & Amaro; Rommie E,0,0,0,0
1708255136002,MATH 277A,A00,430464,Dumitriu; Ioana,14,0,15,1
1708255136530,MATH 278A,A00,430470,Cheng; Li-Tien,9,0,10,1
1708255137056,MATH 278B,A00,430471,Cloninger; Alexander,10,0,10,0
1708255137584,MATH 278C,A00,430472,Nie; Jiawang,9,0,10,1
1708255138109,MATH 280C,A00,430485,Schweinsberg; Jason,13,0,15,2
1708255138636,MATH 281C,A00,430496,Arias-Castro; Ery,8,0,15,7
1708255139166,MATH 284,A00,430503,Xu; Ronghui,11,0,15,4
1708255139695,MATH 287C,A00,430520,Zhang; Danna,14,0,15,1
1708255140220,MATH 288,A00,430527,Carfagnini; Marco,9,0,10,1
1708255140746,MATH 289A,A00,430541,Novak; Jonathan I,14,0,15,1
1708255141272,MATH 290C,A00,430548,Roberts; Justin Deritter,13,0,15,2
1708255141800,MATH 292,A00,430660,Lu; Yunze,10,0,10,0
1708255142327,MATH 294,A00,430678,Fitzsimmons; Patrick J,11,0,15,4
1708255142853,MATH 295,A00,430692,Bejenaru; Ioan,15,0,15,0
1708255143384,MATH 297,001,430721,Gamst; Anthony Collins,0,0,0,0
1708255143912,MATS 200,A00,414457,Graeve; Olivia A,9995,0,9999,4
1708255144443,MATS 201C,A00,414465,Arzt; Eduard,38,0,50,12
1708255144972,MATS 236,A00,414466,Staff,17,0,20,3
1708255145499,MATS 252,A00,414467,Evdokimenko; Ekaterina,42,0,45,3
1708255146029,MATS 261B,A00,414468,Qiao; Yu,17,0,25,8
1708255146556,MATS 295,A00,414469,Graeve; Olivia A,9999,0,9999,0
1708255146556,MATS 295,B00,478858,Kummel; Andrew C,9999,0,9999,0
1708255147084,MCWP 40,001,414476,Montejo; Carolina,19,0,20,1
1708255147084,MCWP 40,004,414480,Wastal; Carrie King,13,0,15,2
1708255147084,MCWP 40,005,414481,Wastal; Carrie King,10,0,15,5
1708255147084,MCWP 40,006,414482,Wastal; Carrie King,12,0,15,3
1708255147084,MCWP 40,007,414483,Wastal; Carrie King,13,0,15,2
1708255147084,MCWP 40,008,414484,Wastal; Carrie King,15,0,15,0
1708255147084,MCWP 40,009,414487,Wastal; Carrie King,12,0,15,3
1708255147084,MCWP 40,014,414505,Staff,20,0,20,0
1708255147084,MCWP 40,015,494362,Wastal; Carrie King,14,0,15,1
1708255147626,MCWP 50,002,414534,Bartulis; Jason Michael,20,0,20,0
1708255147626,MCWP 50,003,414536,Bartulis; Jason Michael,20,0,20,0
1708255147626,MCWP 50,004,414538,Krone; Jarret,16,0,20,4
1708255147626,MCWP 50,005,414539,Krone; Jarret,19,0,20,1
1708255147626,MCWP 50,006,414540,Smith; Haydee Marie,16,0,20,4
1708255147626,MCWP 50,007,414544,Compas; Sean Matthew,14,0,20,6
1708255147626,MCWP 50,008,414549,Redela; Pamela Morgan,20,0,20,0
1708255147626,MCWP 50,011,414557,Carter; Andrea L,16,0,20,4
1708255147626,MCWP 50,012,414592,Silva; Kelly B,20,0,20,0
1708255147626,MCWP 50,013,414593,Silva; Kelly B,19,0,20,1
1708255147626,MCWP 50,014,414594,Carter; Andrea L,20,0,20,0
1708255147626,MCWP 50,016,414596,Morshed; Michael James,14,0,20,6
1708255147626,MCWP 50,017,414598,Morshed; Michael James,17,0,20,3
1708255147626,MCWP 50,019,414601,Redela; Pamela Morgan,17,0,20,3
1708255147626,MCWP 50,020,414606,Carter; Jennifer A,20,0,20,0
1708255147626,MCWP 50,021,414607,Carter; Jennifer A,19,0,20,1
1708255147626,MCWP 50,022,414649,Compas; Sean Matthew,11,0,20,9
1708255147626,MCWP 50,023,414650,Smith; Haydee Marie,20,0,20,0
1708255147626,MCWP 50,024,414651,Nies; Laurie Elizabeth,19,0,20,1
1708255147626,MCWP 50,025,414655,Nies; Laurie Elizabeth,18,0,20,2
1708255147626,MCWP 50,026,414656,Pham; Vincent Minhduc,19,0,20,1
1708255147626,MCWP 50,027,414657,Pham; Vincent Minhduc,20,0,20,0
1708255147626,MCWP 50,028,414668,Morshed; Michael James,16,0,20,4
1708255147626,MCWP 50,029,414669,Morshed; Michael James,19,0,20,1
1708255148152,MCWP 50R,A00,486838,Miller; Elizabeth Deen,19,0,20,1
1708255148152,MCWP 50R,B00,486843,Miller; Elizabeth Deen,16,0,20,4
1708255148152,MCWP 50R,C00,486844,Miller; Elizabeth Deen,19,0,20,1
1708255148682,MCWP 125,A00,414670,Wilson; Marion E.,20,0,20,0
1708255148682,MCWP 125,B00,414674,Guillen; Melinda,20,0,20,0
1708255148682,MCWP 125,C00,414678,Guillen; Melinda,20,0,20,0
1708255148682,MCWP 125,D00,414682,Guillen; Melinda,20,0,20,0
1708255149210,MED 231,A00,476440,Hurst; Samantha,7,0,7,0
1708255149737,MED 246,A00,492785,Gordts; Philip & Varki; Ajit P & Lewis; Amanda Lark & Godula; Kamil & Gagneux; Pascal & Esko; Jeffrey D. & Bode; Lars,10,0,10,0
1708255150267,MED 262,A00,492942,Koola; Jejo David,28,0,30,2
1708255150849,MED 267,A01,492789,Hogarth; Michael Andrew,25,0,30,5
1708255151378,MED 275,A00,464684,Liu; George Yenhsi,10,0,10,0
1708255151903,MED 276,A00,492786,Sitapati; Amy,23,0,25,2
1708255152428,MED 278,A00,492787,Carter; Hannah Kathryn & Mesirov; Jill P. & Curtius; Kathleen Mary,20,0,20,0
1708255153972,MED 296,001,464685,Chi; Neil C.,48,0,50,2
1708255153972,MED 296,002,464686,Hong; Kimberly N,49,0,50,1
1708255153972,MED 296,003,464687,Staff,50,0,50,0
1708255154499,MGT 3,A00,442429,Wagner; Timothy Ryan,95,0,98,3
1708255155026,MGT 4,A01,442443,Levkoff; Steven B.,0,0,5,5
1708255155026,MGT 4,A02,442444,Levkoff; Steven B.,4,0,5,1
1708255155552,MGT 5,A00,442446,Molloie Jr.; William H,184,0,196,12
1708255156079,MGT 12,A00,442447,Lindenberger; Wade Douglas,83,0,100,17
1708255156079,MGT 12,B00,442448,Lindenberger; Wade Douglas,71,0,100,29
1708255156079,MGT 12,C00,442449,Pecore; Joseph P.,88,0,100,12
1708255156611,MGT 16,A00,442452,Buchanan; Harold G,97,0,100,3
1708255156611,MGT 16,B00,442459,Buchanan; Harold G,92,0,100,8
1708255156611,MGT 16,C00,442461,Campbell; Robert Harold,113,0,120,7
1708255156611,MGT 16,D00,442475,Campbell; Robert Harold,118,0,120,2
1708255157171,MGT 18,A00,442477,McKay; Michael J,98,0,98,0
1708255157171,MGT 18,B00,442491,McKay; Michael J,96,0,98,2
1708255157171,MGT 18,C00,442493,McKay; Michael J,98,0,98,0
1708255157171,MGT 18,D00,442503,Chamberlain; Travis Dean,98,0,98,0
1708255157697,MGT 45,A00,442508,Pecore; Joseph P.,146,0,150,4
1708255157697,MGT 45,B00,442510,Pecore; Joseph P.,142,0,150,8
1708255158221,MGT 71,A00,442524,Lee; Hyun Seok,77,0,98,21
1708255158749,MGT 71R,A00,442526,Phiroz; Zal Navroze,77,0,98,21
1708255159276,MGT 100,A00,442541,Wilbur; Kenneth C,82,0,98,16
1708255159276,MGT 100,B00,442542,Wilbur; Kenneth C,89,0,98,9
1708255159819,MGT 103,A00,442543,Eberhard; Craig A,98,0,98,0
1708255159819,MGT 103,B00,442544,Eberhard; Craig A,95,0,98,3
1708255159819,MGT 103,C00,442545,Ehrich; Kristine R,90,0,98,8
1708255159819,MGT 103,D00,442547,Ehrich; Kristine R,96,0,98,2
1708255159819,MGT 103,E00,442548,Ehrich; Kristine R,97,0,98,1
1708255159819,MGT 103,F00,442549,Demill; Burritt,92,0,98,6
1708255159819,MGT 103,G00,442550,Bates; Kenneth Walter,97,0,98,1
1708255160349,MGT 105,A00,442558,Bates; Kenneth Walter,86,0,98,12
1708255160875,MGT 106,A00,442560,Eberhard; Craig A,95,0,98,3
1708255161404,MGT 109,A00,442574,Campbell; Colin Leslie,90,0,98,8
1708255161928,MGT 112,A00,442576,Somasundaram; Tyagarajan,96,0,98,2
1708255161928,MGT 112,B00,442590,Somasundaram; Tyagarajan,94,0,98,4
1708255161928,MGT 112,C00,442592,Zimmermann; Carsten,87,0,98,11
1708255162455,MGT 119,A00,442602,Staff,97,0,98,1
1708255162455,MGT 119,B00,442603,Anderson; Jon Marcus,96,0,98,2
1708255162984,MGT 121B,A00,442606,Klaas; Jeffrey David,94,0,98,4
1708255163509,MGT 128R,A00,442607,Krishnan; Viswanathan,84,0,98,14
1708255164037,MGT 131A,A00,442608,Houskeeper; Robert,148,0,150,2
1708255164567,MGT 131B,A00,442609,Houskeeper; Robert,100,0,100,0
1708255165109,MGT 132,A00,442610,Blakley; Bruce,97,0,98,1
1708255165633,MGT 137,A00,442611,Lindenberger; Wade Douglas,85,0,98,13
1708255166161,MGT 147,A00,442612,Anderson; John Charles,31,0,40,9
1708255166685,MGT 151R,A00,442613,Phiroz; Zal Navroze,92,0,98,6
1708255167212,MGT 153,A00,442650,Perols; Johan Lars,55,0,80,25
1708255167744,MGT 162,A00,442652,Demill; Burritt,81,0,98,17
1708255167744,MGT 162,B00,442654,Demill; Burritt,88,0,98,10
1708255167744,MGT 162,C00,442776,Staff,95,0,98,3
1708255167744,MGT 162,D00,442778,Staff,96,0,98,2
1708255168270,MGT 164,A00,442780,McKay; Mary A,97,0,98,1
1708255168270,MGT 164,B00,442849,McKay; Mary A,96,0,98,2
1708255168270,MGT 164,C00,442917,McKay; Mary A,97,0,98,1
1708255168270,MGT 164,D00,442949,Meyer; Alison Bloomfield,90,0,98,8
1708255168801,MGT 166,A00,443017,Moran; Cathleen L.,95,0,98,3
1708255168801,MGT 166,B00,443045,Moran; Cathleen L.,97,0,98,1
1708255168801,MGT 166,C00,443046,Moran; Cathleen L.,98,0,98,0
1708255169326,MGT 167,A00,443047,Klaas; Jeffrey David,93,0,98,5
1708255169852,MGT 171R,A00,443048,Phiroz; Zal Navroze,86,0,98,12
1708255170397,MGT 172,A00,443049,Hedges; Kathleen & Royal; Rebecca,116,0,120,4
1708255170397,MGT 172,B00,443050,Hedges; Kathleen,95,0,98,3
1708255170397,MGT 172,C00,443051,Zimmermann; Carsten,96,0,98,2
1708255170923,MGT 173,A00,443052,Hayes; Sherry Lorine,92,0,100,8
1708255171450,MGT 175,A00,443053,Gopal; Christopher S.,98,0,98,0
1708255171975,MGT 180,A00,443055,Bliss; Barbara Ann,139,0,150,11
1708255171975,MGT 180,B00,443069,Bliss; Barbara Ann,145,0,150,5
1708255172516,MGT 181,A00,443120,Buchanan; Harold G,147,0,150,3
1708255173041,MGT 183,A00,443121,Banerjee; Snehal,88,0,98,10
1708255173568,MGT 185,A00,443122,Dunn; Louis Jean,90,0,98,8
1708255174094,MGT 187,A00,443133,Dunn; Louis Jean,95,0,100,5
1708255174624,MGT 189,A00,443134,Avenancio-Leon; Carlos,98,0,98,0
1708255175149,MGT 227,A00,479242,Serra Garcia; Marta,19,0,20,1
1708255175676,MGT 259,A00,443135,Oveis; Christopher S,19,0,20,1
1708255176216,MGT 296,001,481416,Gneezy; Ayelet,3,0,3,0
1708255176216,MGT 296,002,481420,Amir; On,3,0,3,0
1708255176216,MGT 296,003,481466,Amir; On & Karmarkar; Uma R,3,0,3,0
1708255176216,MGT 296,004,481468,Liu; Jun,3,0,3,0
1708255176216,MGT 296,005,481469,Misra; Kanishka,3,0,3,0
1708255176216,MGT 296,006,481470,Erat; Sanjiv,3,0,3,0
1708255176216,MGT 296,007,481473,Timmermann; Allan,3,0,3,0
1708255176216,MGT 296,008,481474,Smith; Pamela Karen,3,0,3,0
1708255176216,MGT 296,009,481477,Zhang; Zhe,3,0,3,0
1708255176216,MGT 296,010,481478,Oveis; Christopher S,3,0,3,0
1708255176216,MGT 296,011,481479,Amir; On & Gneezy; Ayelet,3,0,3,0
1708255176216,MGT 296,012,481481,Wilbur; Kenneth C,3,0,3,0
1708255176895,MMW 13,A01,412918,Chang; Edmond Yi-Teh,15,0,16,1
1708255176895,MMW 13,A02,412928,Chang; Edmond Yi-Teh,16,0,16,0
1708255176895,MMW 13,A03,413017,Chang; Edmond Yi-Teh,16,0,16,0
1708255176895,MMW 13,A04,413018,Chang; Edmond Yi-Teh,16,0,16,0
1708255176895,MMW 13,A05,413019,Chang; Edmond Yi-Teh,15,0,16,1
1708255176895,MMW 13,A06,413020,Chang; Edmond Yi-Teh,16,0,16,0
1708255176895,MMW 13,A07,413021,Chang; Edmond Yi-Teh,15,0,16,1
1708255176895,MMW 13,A08,413023,Chang; Edmond Yi-Teh,16,0,16,0
1708255176895,MMW 13,A09,413024,Chang; Edmond Yi-Teh,16,0,16,0
1708255176895,MMW 13,A10,413025,Chang; Edmond Yi-Teh,16,0,16,0
1708255176895,MMW 13,A11,413026,Chang; Edmond Yi-Teh,16,0,16,0
1708255176895,MMW 13,A12,413027,Chang; Edmond Yi-Teh,16,0,16,0
1708255176895,MMW 13,A13,413028,Chang; Edmond Yi-Teh,0,0,0,0
1708255176895,MMW 13,A14,413029,Chang; Edmond Yi-Teh,0,0,0,0
1708255176895,MMW 13,A15,413030,Chang; Edmond Yi-Teh,14,0,16,2
1708255176895,MMW 13,A16,413031,Chang; Edmond Yi-Teh,15,0,16,1
1708255176895,MMW 13,A17,413032,Chang; Edmond Yi-Teh,16,0,16,0
1708255176895,MMW 13,A18,413034,Chang; Edmond Yi-Teh,14,0,16,2
1708255176895,MMW 13,A19,413035,Chang; Edmond Yi-Teh,16,0,16,0
1708255176895,MMW 13,A20,413036,Chang; Edmond Yi-Teh,16,0,16,0
1708255176895,MMW 13,A21,413037,Chang; Edmond Yi-Teh,0,0,0,0
1708255176895,MMW 13,A22,413038,Chang; Edmond Yi-Teh,0,0,0,0
1708255176895,MMW 13,B01,413290,Zhiri; Oumelbanine,15,0,16,1
1708255176895,MMW 13,B02,413291,Zhiri; Oumelbanine,15,0,16,1
1708255176895,MMW 13,B03,413308,Zhiri; Oumelbanine,14,0,16,2
1708255176895,MMW 13,B04,413322,Zhiri; Oumelbanine,14,0,16,2
1708255176895,MMW 13,B05,413343,Zhiri; Oumelbanine,12,0,16,4
1708255176895,MMW 13,B06,413344,Zhiri; Oumelbanine,14,0,16,2
1708255176895,MMW 13,B07,413524,Zhiri; Oumelbanine,16,0,16,0
1708255176895,MMW 13,B08,413584,Zhiri; Oumelbanine,16,0,16,0
1708255176895,MMW 13,B09,413588,Zhiri; Oumelbanine,15,0,16,1
1708255176895,MMW 13,B10,413590,Zhiri; Oumelbanine,16,0,16,0
1708255176895,MMW 13,B11,413779,Zhiri; Oumelbanine,12,0,16,4
1708255176895,MMW 13,B12,413780,Zhiri; Oumelbanine,9,0,16,7
1708255176895,MMW 13,B13,413781,Zhiri; Oumelbanine,0,0,0,0
1708255176895,MMW 13,B14,413782,Zhiri; Oumelbanine,0,0,0,0
1708255176895,MMW 13,B15,413808,Zhiri; Oumelbanine,16,0,16,0
1708255176895,MMW 13,B16,413815,Zhiri; Oumelbanine,15,0,16,1
1708255176895,MMW 13,B17,413816,Zhiri; Oumelbanine,15,0,16,1
1708255176895,MMW 13,B18,413817,Zhiri; Oumelbanine,12,0,16,4
1708255176895,MMW 13,B19,413822,Zhiri; Oumelbanine,16,0,16,0
1708255176895,MMW 13,B20,413823,Zhiri; Oumelbanine,14,0,16,2
1708255176895,MMW 13,B21,413825,Zhiri; Oumelbanine,0,0,0,0
1708255176895,MMW 13,B22,413826,Zhiri; Oumelbanine,0,0,0,0
1708255176895,MMW 13,B23,413827,Zhiri; Oumelbanine,16,0,16,0
1708255176895,MMW 13,B24,413834,Zhiri; Oumelbanine,15,0,16,1
1708255176895,MMW 13,C01,413859,Vitkus; Daniel J.,16,0,16,0
1708255176895,MMW 13,C02,413860,Vitkus; Daniel J.,16,0,16,0
1708255176895,MMW 13,C04,413868,Vitkus; Daniel J.,0,0,0,0
1708255176895,MMW 13,C05,413869,Vitkus; Daniel J.,16,0,16,0
1708255176895,MMW 13,C06,413871,Vitkus; Daniel J.,16,0,16,0
1708255176895,MMW 13,C07,413886,Vitkus; Daniel J.,16,0,16,0
1708255176895,MMW 13,C08,413908,Vitkus; Daniel J.,16,0,16,0
1708255176895,MMW 13,C09,413930,Vitkus; Daniel J.,16,0,16,0
1708255176895,MMW 13,C10,413952,Vitkus; Daniel J.,15,0,16,1
1708255176895,MMW 13,C11,413972,Vitkus; Daniel J.,16,0,16,0
1708255176895,MMW 13,C12,413991,Vitkus; Daniel J.,16,0,16,0
1708255176895,MMW 13,C13,414007,Vitkus; Daniel J.,0,0,0,0
1708255176895,MMW 13,C14,414017,Vitkus; Daniel J.,0,0,0,0
1708255176895,MMW 13,C15,414030,Vitkus; Daniel J.,16,0,16,0
1708255176895,MMW 13,C16,414032,Vitkus; Daniel J.,16,0,16,0
1708255176895,MMW 13,C17,414033,Vitkus; Daniel J.,15,0,16,1
1708255176895,MMW 13,C18,414034,Vitkus; Daniel J.,16,0,16,0
1708255176895,MMW 13,C19,414041,Vitkus; Daniel J.,16,0,16,0
1708255176895,MMW 13,C20,414056,Vitkus; Daniel J.,16,0,16,0
1708255176895,MMW 13,C21,414057,Vitkus; Daniel J.,15,0,16,1
1708255176895,MMW 13,C22,414059,Vitkus; Daniel J.,16,0,16,0
1708255177464,MMW 15,A01,414065,Chang; Edmond Yi-Teh,28,0,28,0
1708255177464,MMW 15,A02,414067,Chang; Edmond Yi-Teh,27,0,28,1
1708255177464,MMW 15,A03,414092,Chang; Edmond Yi-Teh,26,0,28,2
1708255177464,MMW 15,A04,414104,Chang; Edmond Yi-Teh,28,0,28,0
1708255177464,MMW 15,A05,414121,Chang; Edmond Yi-Teh,0,0,0,0
1708255177464,MMW 15,A06,414122,Chang; Edmond Yi-Teh,0,0,0,0
1708255177464,MMW 15,A07,414123,Chang; Edmond Yi-Teh,27,0,28,1
1708255177464,MMW 15,A08,414124,Chang; Edmond Yi-Teh,28,0,28,0
1708255177464,MMW 15,A09,414125,Chang; Edmond Yi-Teh,0,0,0,0
1708255177464,MMW 15,A10,414130,Chang; Edmond Yi-Teh,0,0,0,0
1708255177464,MMW 15,B01,414132,Radcliff; Pamela B.,27,0,28,1
1708255177464,MMW 15,B02,414134,Radcliff; Pamela B.,27,0,28,1
1708255177464,MMW 15,B03,414135,Radcliff; Pamela B.,26,0,28,2
1708255177464,MMW 15,B04,414136,Radcliff; Pamela B.,27,0,28,1
1708255177464,MMW 15,B05,414137,Radcliff; Pamela B.,28,0,28,0
1708255177464,MMW 15,B06,414138,Radcliff; Pamela B.,27,0,28,1
1708255177464,MMW 15,B07,414140,Radcliff; Pamela B.,26,0,28,2
1708255177464,MMW 15,B08,414141,Radcliff; Pamela B.,28,0,28,0
1708255177464,MMW 15,C01,414143,Prestholdt; Jeremy,0,0,0,0
1708255177464,MMW 15,C02,414144,Prestholdt; Jeremy,0,0,0,0
1708255177464,MMW 15,C03,414145,Prestholdt; Jeremy,24,0,28,4
1708255177464,MMW 15,C04,414147,Prestholdt; Jeremy,17,0,28,11
1708255177464,MMW 15,C05,414148,Prestholdt; Jeremy,28,0,28,0
1708255177464,MMW 15,C06,414149,Prestholdt; Jeremy,26,0,28,2
1708255177464,MMW 15,C07,414152,Prestholdt; Jeremy,25,0,28,3
1708255177464,MMW 15,C08,414153,Prestholdt; Jeremy,23,0,28,5
1708255177989,MSED 295,A00,477850,Rabin; Jeffrey Mark,5,0,5,0
1708255177989,MSED 295,B00,477852,Lo; Stanley M.,5,0,5,0
1708255178515,MSED 296C,A00,477853,Staff,14,0,15,1
1708255179044,MUS 1C,A01,416488,Ishov; Alexander Alexandrovich,24,0,25,1
1708255179044,MUS 1C,A02,416502,Ishov; Alexander Alexandrovich,25,0,25,0
1708255179044,MUS 1C,A03,416519,Ishov; Alexander Alexandrovich,25,0,25,0
1708255179044,MUS 1C,A04,416520,Ishov; Alexander Alexandrovich,25,0,25,0
1708255179044,MUS 1C,A05,416521,Ishov; Alexander Alexandrovich,25,0,25,0
1708255179574,MUS 2C,A01,416523,Richards; Stephanie F,30,0,30,0
1708255180103,MUS 2CK,A00,416524,Ohnishi; Takae,15,0,15,0
1708255180103,MUS 2CK,B00,416547,Ohnishi; Takae,15,0,15,0
1708255180632,MUS 2JK,A00,416548,Kenyatta; Kamau,15,0,15,0
1708255181160,MUS 4,A01,416562,Staff,25,0,25,0
1708255181160,MUS 4,A02,416634,Staff,24,0,25,1
1708255181160,MUS 4,A03,416644,Staff,25,0,25,0
1708255181160,MUS 4,A04,416659,Staff,24,0,25,1
1708255181160,MUS 4,A05,416667,Staff,25,0,25,0
1708255181160,MUS 4,A06,416757,Staff,25,0,25,0
1708255181160,MUS 4,A07,416830,Staff,25,0,25,0
1708255181160,MUS 4,A08,416953,Staff,23,0,25,2
1708255181160,MUS 4,A09,417005,Staff,25,0,25,0
1708255181160,MUS 4,A10,417007,Staff,24,0,25,1
1708255181704,MUS 7,A01,417048,Staff,23,0,24,1
1708255181704,MUS 7,A02,417102,Staff,23,0,24,1
1708255181704,MUS 7,A03,417103,Staff,23,0,24,1
1708255181704,MUS 7,A04,417114,Staff,22,0,24,2
1708255182230,MUS 8,A01,417119,Staff,14,0,20,6
1708255182230,MUS 8,A02,417163,Staff,16,0,20,4
1708255182230,MUS 8,A03,417164,Staff,16,0,20,4
1708255182230,MUS 8,A04,417165,Staff,17,0,20,3
1708255182230,MUS 8,A05,417194,Staff,18,0,20,2
1708255182230,MUS 8,A06,417198,Staff,20,0,20,0
1708255182778,MUS 11,A01,417201,Terrazas Perez; Wilfrido D,21,0,25,4
1708255182778,MUS 11,A02,417219,Terrazas Perez; Wilfrido D,23,0,25,2
1708255182778,MUS 11,A03,417220,Terrazas Perez; Wilfrido D,25,0,25,0
1708255182778,MUS 11,A04,417222,Terrazas Perez; Wilfrido D,25,0,25,0
1708255182778,MUS 11,A05,417223,Terrazas Perez; Wilfrido D,24,0,25,1
1708255182778,MUS 11,A06,417295,Terrazas Perez; Wilfrido D,23,0,25,2
1708255182778,MUS 11,A07,417297,Terrazas Perez; Wilfrido D,24,0,25,1
1708255182778,MUS 11,A08,417298,Terrazas Perez; Wilfrido D,25,0,25,0
1708255183304,MUS 12,A01,417300,Guy; Nancy,25,0,25,0
1708255183304,MUS 12,A02,417301,Guy; Nancy,25,0,25,0
1708255183304,MUS 12,A03,417302,Guy; Nancy,25,0,25,0
1708255183304,MUS 12,A04,417303,Guy; Nancy,25,0,25,0
1708255183834,MUS 13,A01,417305,Leslie Santana; Myrta,25,0,25,0
1708255183834,MUS 13,A02,417306,Leslie Santana; Myrta,25,0,25,0
1708255183834,MUS 13,A03,417307,Leslie Santana; Myrta,25,0,25,0
1708255183834,MUS 13,A04,417308,Leslie Santana; Myrta,25,0,25,0
1708255184366,MUS 15,A01,417327,Schaffer; Max Benjamin,18,0,20,2
1708255184366,MUS 15,A02,417331,Schaffer; Max Benjamin,19,0,20,1
1708255184366,MUS 15,A03,417358,Schaffer; Max Benjamin,19,0,20,1
1708255184366,MUS 15,A04,417359,Schaffer; Max Benjamin,17,0,20,3
1708255184366,MUS 15,A05,417360,Schaffer; Max Benjamin,20,0,20,0
1708255184366,MUS 15,A06,417370,Schaffer; Max Benjamin,20,0,20,0
1708255184366,MUS 15,A07,417371,Schaffer; Max Benjamin,17,0,20,3
1708255184366,MUS 15,A08,417372,Schaffer; Max Benjamin,18,0,20,2
1708255184366,MUS 15,A09,417378,Schaffer; Max Benjamin,19,0,20,1
1708255184366,MUS 15,A10,417379,Schaffer; Max Benjamin,19,0,20,1
1708255185907,MUS 17,A01,417381,Staff,22,0,25,3
1708255185907,MUS 17,A02,417406,Staff,24,0,25,1
1708255185907,MUS 17,A03,417420,Staff,24,0,25,1
1708255185907,MUS 17,A04,417594,Staff,24,0,25,1
1708255185907,MUS 17,A05,417595,Staff,25,0,25,0
1708255185907,MUS 17,A06,417605,Staff,21,0,25,4
1708255185907,MUS 17,A07,417606,Staff,25,0,25,0
1708255185907,MUS 17,A08,417627,Staff,25,0,25,0
1708255185907,MUS 17,A09,417628,Staff,21,0,25,4
1708255185907,MUS 17,A10,417629,Staff,24,0,25,1
1708255185907,MUS 17,A11,417630,Staff,25,0,25,0
1708255185907,MUS 17,A12,417631,Staff,24,0,25,1
1708255185907,MUS 17,A13,417632,Staff,25,0,25,0
1708255185907,MUS 17,A14,417633,Staff,25,0,25,0
1708255186450,MUS 32,001,418855,Dresser; Mark Stuart,10,0,10,0
1708255186450,MUS 32,002,418856,Kenyatta; Kamau,9,0,10,1
1708255186450,MUS 32,003,418864,Curtis; Charles Rector,10,0,10,0
1708255186450,MUS 32,004,418865,Carlstrom; Mitchell Kraig,9,0,10,1
1708255186450,MUS 32,005,418868,Terrazas Perez; Wilfrido D,10,0,10,0
1708255186450,MUS 32,006,418869,Ohnishi; Takae,10,0,10,0
1708255186450,MUS 32,007,418872,Burr; Anthony I,10,0,10,0
1708255186450,MUS 32,008,418873,Carlson; Erik Norman,10,0,10,0
1708255186450,MUS 32,009,418874,Blair; Kyle Adam,10,0,10,0
1708255186450,MUS 32,010,418875,Richards; Stephanie F,10,0,10,0
1708255186976,MUS 32V,A00,417634,Narucki; Susan M,10,0,10,0
1708255186976,MUS 32V,B00,417635,Staff,10,0,10,0
1708255187502,MUS 32VM,A00,417636,Staff,15,0,15,0
1708255188032,MUS 33C,A00,417637,Taylor; Alexander Lawther,20,0,20,0
1708255188558,MUS 43,A00,417647,Burr; Anthony I,83,0,90,7
1708255189087,MUS 95D,A00,417919,Staff,40,0,40,0
1708255189612,MUS 95E,A00,417933,Henson; Matthew Alexander,55,0,55,0
1708255190153,MUS 95G,A00,417935,Anderson; Kenneth,387,0,395,8
1708255190153,MUS 95G,B00,417937,Anderson; Kenneth,394,0,395,1
1708255190684,MUS 95JC,A00,417939,Kenyatta; Kamau,30,0,30,0
1708255191210,MUS 95L,A00,417940,Jones; Michael David,50,0,50,0
1708255191739,MUS 95W,A00,417946,Seshadri; Kartik,29,0,30,1
1708255191739,MUS 95W,B00,417948,Seshadri; Kartik,30,0,30,0
1708255192266,MUS 101C,A01,417951,Burr; Anthony I,33,0,35,2
1708255192807,MUS 103C,A00,417952,Davis; Anthony Curtis,14,0,15,1
1708255193337,MUS 103F,A00,417959,Obermueller; Karola,1,0,1,0
1708255193863,MUS 113,A00,418015,Narucki; Susan M,13,0,15,2
1708255194390,MUS 120C,A01,418032,Leslie Santana; Myrta,25,0,25,0
1708255194920,MUS 127,A00,418037,Richards; Stephanie F,92,0,100,8
1708255195445,MUS 130,A00,418047,Ohnishi; Takae,30,0,30,0
1708255195976,MUS 131,A00,418065,Roberts; Matana,30,0,30,0
1708255196520,MUS 132,001,418883,Dresser; Mark Stuart,10,0,10,0
1708255196520,MUS 132,002,418885,Kenyatta; Kamau,10,0,10,0
1708255196520,MUS 132,003,418886,Curtis; Charles Rector,10,0,10,0
1708255196520,MUS 132,004,418887,Carlstrom; Mitchell Kraig,10,0,10,0
1708255196520,MUS 132,005,418888,Jones; Michael David,10,0,10,0
1708255196520,MUS 132,006,418889,Terrazas Perez; Wilfrido D,10,0,10,0
1708255196520,MUS 132,007,418893,Ohnishi; Takae,10,0,10,0
1708255196520,MUS 132,008,418894,Burr; Anthony I,10,0,10,0
1708255196520,MUS 132,009,418896,Carlson; Erik Norman,10,0,10,0
1708255196520,MUS 132,010,418900,Blair; Kyle Adam,10,0,10,0
1708255196520,MUS 132,011,418932,Richards; Stephanie F,10,0,10,0
1708255196520,MUS 132,012,418933,Nourai; Keyarash,10,0,10,0
1708255197051,MUS 132R,A00,418067,Burr; Anthony I,5,0,5,0
1708255197051,MUS 132R,B00,418078,Jones; Michael David,5,0,5,0
1708255197598,MUS 132V,A00,418092,Narucki; Susan M,15,0,15,0
1708255197598,MUS 132V,B00,418096,Staff,15,0,15,0
1708255198124,MUS 134,A00,418098,Staff,40,0,40,0
1708255198650,MUS 137C,A00,418109,Kenyatta; Kamau,25,0,25,0
1708255199175,MUS 143,A00,418123,Burr; Anthony I,33,0,40,7
1708255199704,MUS 150,A00,418127,Davis; Anthony Curtis,28,0,30,2
1708255200235,MUS 151,A00,418129,Hankins; Sarah E.,20,0,30,10
1708255200764,MUS 160B,A00,418172,Staff,11,0,15,4
1708255200764,MUS 160B,B00,418175,Dubnov; Shlomo,14,0,15,1
1708255201289,MUS 172,A01,418178,Staff,36,0,40,4
1708255201819,MUS 174C,A00,418179,Erbe; Tom,24,0,27,3
1708255202346,MUS 175,A00,418247,Smyth; Tamara R.,28,0,30,2
1708255202872,MUS 177,A00,418265,Erbe; Tom,11,0,15,4
1708255203401,MUS 201A,A00,418267,Narucki; Susan M,15,0,15,0
1708255203401,MUS 201A,B00,418268,Dresser; Mark Stuart,13,0,15,2
1708255203927,MUS 203C,A00,418269,Lou; Michelle Siulai,15,0,15,0
1708255204458,MUS 203D,A00,418272,Davis; Anthony Curtis,4,0,5,1
1708255204458,MUS 203D,B00,418275,Obermueller; Karola,5,0,5,0
1708255204458,MUS 203D,C00,418277,Liang; Lei,5,0,5,0
1708255204458,MUS 203D,D00,418323,Lou; Michelle Siulai,5,0,5,0
1708255204983,MUS 204,A00,418324,Obermueller; Karola,24,0,25,1
1708255205511,MUS 205,A00,418325,Cimini; Amy Marie,22,0,25,3
1708255206040,MUS 206,A00,418326,Liang; Lei,13,0,15,2
1708255206040,MUS 206,B00,418327,Roberts; Matana,13,0,15,2
1708255206622,MUS 215C,A00,418328,Cimini; Amy Marie,14,0,15,1
1708255207150,MUS 232,001,418937,Dresser; Mark Stuart,9,0,10,1
1708255207150,MUS 232,002,418969,Kenyatta; Kamau,10,0,10,0
1708255207150,MUS 232,003,418971,Curtis; Charles Rector,10,0,10,0
1708255207150,MUS 232,004,418974,Terrazas Perez; Wilfrido D,10,0,10,0
1708255207150,MUS 232,005,418979,Ohnishi; Takae,10,0,10,0
1708255207150,MUS 232,006,418980,Burr; Anthony I,10,0,10,0
1708255207150,MUS 232,007,418981,Carlson; Erik Norman,10,0,10,0
1708255207150,MUS 232,008,418982,Richards; Stephanie F,10,0,10,0
1708255207150,MUS 232,009,418985,Narucki; Susan M,10,0,10,0
1708255207680,MUS 234,A00,418329,Staff,15,0,15,0
1708255208205,MUS 245,A00,418330,Carlson; Erik Norman,14,0,15,1
1708255208734,MUS 267,A00,418331,Erbe; Tom,15,0,15,0
1708255209259,MUS 270B,A00,418332,Staff,15,0,15,0
1708255209784,MUS 270D,A00,479231,Smyth; Tamara R.,15,0,15,0
1708255210313,NANO 103,A00,414714,Jahed Motlagh; Zeinab,40,0,40,0
1708255210841,NANO 108,A00,414740,Lubarda; Vlado,70,0,70,0
1708255211368,NANO 112,A01,414825,Vazquez Mena; Oscar,70,0,70,0
1708255211899,NANO 115L,A01,414830,Yang; Kesong,37,0,38,1
1708255211899,NANO 115L,B01,414832,Xu; Sheng,35,0,38,3
1708255212426,NANO 120B,A01,414835,Vecchio; Kenneth S,33,0,35,2
1708255212426,NANO 120B,B01,414841,Fenning; David,30,0,35,5
1708255212952,NANO 156,A00,414843,Fullerton; Eric E,24,0,30,6
1708255213484,NANO 158,A00,414844,Luo; Jian,29,0,30,1
1708255214050,NANO 175,A00,414850,Steinmetz; Nicole F,30,0,35,5
1708255214579,NANO 200,A00,414852,Jahed Motlagh; Zeinab,118,0,120,2
1708255215104,NANO 241,A00,414854,Pokorski; Jonathan Kyle,18,0,25,7
1708255215632,NANO 262,A00,414858,Wang; Joseph,50,0,50,0
1708255216162,NANO 271,A00,414862,Cubukcu; Ertugrul,22,0,25,3
1708255216689,NANO 272,A00,414877,Xu; Sheng,42,0,50,8
1708255217218,NANO 279,A00,414878,Liu; Ping,32,0,40,8
1708255217746,NANO 282,A00,414879,Steinmetz; Nicole F,30,0,30,0
1708255218270,NEU 200C,A00,455013,Staff,0,0,0,1
1708255218799,NEU 276,A01,479489,Staff,35,0,36,1
1708255219328,NEU 277,A00,479492,Risbrough; Victoria Blythe,0,0,0,0
1708255219855,NEU 296,001,464921,Evans; Sean Jeffrey,48,0,50,2
1708255219855,NEU 296,002,464922,Staff,50,0,50,0
1708255219855,NEU 296,003,464925,Staff,50,0,50,0
1708255220400,NEUG 221,A00,479490,Zheng; Binhai,15,0,15,0
1708255220925,NEUG 280,A00,479491,Chen; Xu,0,0,0,0
1708255221454,NEUG 296,A00,479493,Bloodgood; Brenda Laurie,9998,0,9999,1
1708255221981,OPTH 296,001,465054,Baxter; Sally Liu,49,0,50,1
1708255221981,OPTH 296,002,465068,Afshari; Natalie,49,0,50,1
1708255221981,OPTH 296,003,465074,Staff,50,0,50,0
1708255222524,ORTH 296,A00,465104,Staff,50,0,50,0
1708255222524,ORTH 296,001,465111,Staff,50,0,50,0
1708255222524,ORTH 296,002,465120,Staff,50,0,50,0
1708255224071,PATH 224,A01,494386,Ross; Camille,11,0,12,1
1708255224598,PATH 296,001,465373,Calcutt; Nigel A,49,0,50,1
1708255224598,PATH 296,002,465374,Staff,50,0,50,0
1708255224598,PATH 296,003,465375,Staff,50,0,50,0
1708255225128,PEDS 296,001,465527,Weiss; Katherine Jean,49,0,50,1
1708255225128,PEDS 296,002,465528,Staff,50,0,50,0
1708255225128,PEDS 296,003,465529,Staff,50,0,50,0
1708255225655,PH 196BH,A01,405158,Binkin; Nancy Jeanne,20,0,20,0
1708255226182,PHAR 219,A00,415016,Ross; Camille,1,0,1,0
1708255226726,PHAR 231,A00,415017,Furnari; Frank,20,0,20,0
1708255226726,PHAR 231,B00,415018,Lopez Ramirez; Miguel Alej,20,0,20,0
1708255227253,PHAR 276,A00,415020,Mc Culloch; Andrew Douglas & Amaro; Rommie E,1,0,1,0
1708255227780,PHAR 295,A00,415022,Brown; Joan Heller,15,0,15,0
1708255228307,PHIL 1,A00,415023,Harrell; Maralee Mae,58,0,60,2
1708255228856,PHIL 10,A01,415026,Grush; Rick Scott,40,0,44,4
1708255228856,PHIL 10,A02,415028,Grush; Rick Scott,42,0,44,2
1708255228856,PHIL 10,A03,415029,Grush; Rick Scott,0,0,0,0
1708255228856,PHIL 10,A04,415031,Grush; Rick Scott,0,0,0,0
1708255228856,PHIL 10,A05,415113,Grush; Rick Scott,43,0,44,1
1708255228856,PHIL 10,A06,415114,Grush; Rick Scott,43,0,44,1
1708255228856,PHIL 10,A07,415116,Grush; Rick Scott,44,0,44,0
1708255228856,PHIL 10,A08,415118,Grush; Rick Scott,43,0,44,1
1708255229385,PHIL 12,A01,415120,McKenzie; Kerry V.,28,0,30,2
1708255229385,PHIL 12,A02,415136,McKenzie; Kerry V.,30,0,30,0
1708255229385,PHIL 12,A03,415137,McKenzie; Kerry V.,27,0,30,3
1708255229385,PHIL 12,A04,415142,McKenzie; Kerry V.,30,0,30,0
1708255229931,PHIL 13,A01,415165,Brink; David O.,25,0,25,0
1708255229931,PHIL 13,A02,415179,Brink; David O.,22,0,25,3
1708255229931,PHIL 13,A03,415185,Brink; David O.,24,0,25,1
1708255229931,PHIL 13,A04,415201,Brink; David O.,25,0,25,0
1708255229931,PHIL 13,A05,415204,Brink; David O.,25,0,25,0
1708255229931,PHIL 13,A06,415220,Brink; David O.,25,0,25,0
1708255230457,PHIL 15,A01,415250,Fulkerson; Matthew Todd,26,0,30,4
1708255230457,PHIL 15,A02,415281,Fulkerson; Matthew Todd,29,0,30,1
1708255231001,PHIL 27,A01,415293,Brandt; Reuven A,20,0,25,5
1708255231001,PHIL 27,A02,415296,Brandt; Reuven A,0,0,0,0
1708255231001,PHIL 27,A03,415332,Brandt; Reuven A,22,0,25,3
1708255231001,PHIL 27,A04,415333,Brandt; Reuven A,22,0,25,3
1708255231001,PHIL 27,A05,415342,Brandt; Reuven A,20,0,25,5
1708255231001,PHIL 27,A06,415384,Brandt; Reuven A,24,0,25,1
1708255231001,PHIL 27,A07,415385,Brandt; Reuven A,25,0,25,0
1708255231001,PHIL 27,A08,415391,Brandt; Reuven A,0,0,0,0
1708255231001,PHIL 27,A09,415406,Brandt; Reuven A,0,0,0,0
1708255231001,PHIL 27,A10,415407,Brandt; Reuven A,0,0,0,0
1708255232565,PHIL 28,A01,415412,Lamey; Andy M.,24,0,25,1
1708255232565,PHIL 28,A02,415470,Lamey; Andy M.,20,0,25,5
1708255232565,PHIL 28,A03,415474,Lamey; Andy M.,0,0,0,0
1708255232565,PHIL 28,A04,415475,Lamey; Andy M.,22,0,25,3
1708255232565,PHIL 28,A05,415487,Lamey; Andy M.,24,0,25,1
1708255232565,PHIL 28,A06,415506,Lamey; Andy M.,21,0,25,4
1708255232565,PHIL 28,A07,415507,Lamey; Andy M.,25,0,25,0
1708255232565,PHIL 28,A08,415508,Lamey; Andy M.,24,0,25,1
1708255232565,PHIL 28,A09,415509,Lamey; Andy M.,24,0,25,1
1708255232565,PHIL 28,A10,415510,Lamey; Andy M.,0,0,0,0
1708255233105,PHIL 33,A01,415521,Hardimon; Michael O.,35,0,35,0
1708255233105,PHIL 33,A02,415522,Hardimon; Michael O.,35,0,35,0
1708255233640,PHIL 60,A00,415523,Marechal; Patricia,55,0,60,5
1708255234166,PHIL 102,A00,415524,Johnson; Monte,37,0,40,3
1708255234693,PHIL 106,A00,415544,Watkins; Eric,40,0,40,0
1708255235223,PHIL 112,A00,415545,Watkins; Eric,34,0,40,6
1708255235753,PHIL 115,A00,415548,Nelkin; Dana Kay,20,0,20,0
1708255236277,PHIL 120,A00,415549,Carr; Jennifer Rose,64,0,65,1
1708255236804,PHIL 134,A00,415552,Carr; Jennifer Rose,40,0,40,0
1708255237334,PHIL 150,A00,415553,Cohen; Jonathan David,38,0,40,2
1708255237864,PHIL 171,A00,415561,Brink; David O.,39,0,40,1
1708255238390,PHIL 172,A00,415563,Lamey; Andy M.,40,0,40,0
1708255238917,PHIL 174,A01,415576,Danks; David J,21,0,25,4
1708255238917,PHIL 174,A02,415582,Danks; David J,22,0,25,3
1708255238917,PHIL 174,A03,415583,Danks; David J,24,0,25,1
1708255238917,PHIL 174,A04,415584,Danks; David J,25,0,25,0
1708255239445,PHIL 175,A00,415585,Shields; Christopher John,40,0,40,0
1708255239970,PHIL 181,A00,415601,Tolley; Clinton,34,0,40,6
1708255240516,PHIL 209B,A00,415655,Serlin; David,4,0,5,1
1708255241042,PHIL 209C,A00,415658,Gates; Kelly,5,0,5,0
1708255241568,PHIL 210,A00,415659,Marechal; Patricia,20,0,20,0
1708255242094,PHIL 230,A00,415661,Grush; Rick Scott,20,0,20,0
1708255242621,PHIL 232,A00,415662,Sher; Gila,20,0,20,0
1708255243152,PHIL 260,A00,415675,Bazargan-Forward; Saba,20,0,20,0
1708255243679,PHIL 277,A00,479176,Tolley; Clinton,9,0,10,1
1708255244205,PHIL 285,A00,415685,Kovaka; Karenc,20,0,20,0
1708255244733,PHIL 287,A00,415697,Marechal; Patricia,5,0,5,0
1708255245291,PHIL 290,001,415701,Nelkin; Dana Kay,9999,0,9999,0
1708255245291,PHIL 290,002,415721,Bazargan-Forward; Saba,9999,0,9999,0
1708255245291,PHIL 290,003,415731,Brandt; Reuven A,9999,0,9999,0
1708255245291,PHIL 290,004,415743,Brink; David O.,9999,0,9999,0
1708255245291,PHIL 290,005,415747,Callender; Craig Adam,9999,0,9999,0
1708255245291,PHIL 290,006,415779,Carr; Jennifer Rose,9999,0,9999,0
1708255245291,PHIL 290,007,415780,Cartwright; Nancy D.,9999,0,9999,0
1708255245291,PHIL 290,008,415781,Cohen; Jonathan David,9999,0,9999,0
1708255245291,PHIL 290,009,415782,Danks; David J,9999,0,9999,0
1708255245291,PHIL 290,010,415783,Fulkerson; Matthew Todd,9999,0,9999,0
1708255245291,PHIL 290,011,415784,Grush; Rick Scott,9999,0,9999,0
1708255245291,PHIL 290,012,415785,Hardimon; Michael O.,9999,0,9999,0
1708255245291,PHIL 290,013,415786,Harrell; Maralee Mae,9999,0,9999,0
1708255245291,PHIL 290,014,415787,Johnson; Monte,9999,0,9999,0
1708255245291,PHIL 290,015,415788,Kovaka; Karenc,9999,0,9999,0
1708255245291,PHIL 290,016,415789,Lamey; Andy M.,9999,0,9999,0
1708255245291,PHIL 290,017,415790,Marechal; Patricia,9999,0,9999,0
1708255245291,PHIL 290,018,415791,McKenzie; Kerry V.,9999,0,9999,0
1708255245291,PHIL 290,019,415792,Rickless; Samuel Charles,9999,0,9999,0
1708255245291,PHIL 290,020,415793,Sher; Gila,9999,0,9999,0
1708255245291,PHIL 290,021,415794,Shields; Christopher John,9999,0,9999,0
1708255245291,PHIL 290,022,415805,Tolley; Clinton,9999,0,9999,0
1708255245291,PHIL 290,023,415806,Vargas; Manuel Rogelio,9999,0,9999,0
1708255245291,PHIL 290,024,415807,Watkins; Eric,9999,0,9999,0
1708255245291,PHIL 290,025,415815,Chen; Keming,9999,0,9999,0
1708255245836,PHIL 295,001,415816,Bazargan-Forward; Saba,9999,0,9999,0
1708255245836,PHIL 295,002,415857,Brandt; Reuven A,9999,0,9999,0
1708255245836,PHIL 295,003,415858,Brink; David O.,9999,0,9999,0
1708255245836,PHIL 295,004,415877,Callender; Craig Adam,9999,0,9999,0
1708255245836,PHIL 295,005,415878,Carr; Jennifer Rose,9999,0,9999,0
1708255245836,PHIL 295,006,415884,Cartwright; Nancy D.,9999,0,9999,0
1708255245836,PHIL 295,007,415885,Chen; Keming,9999,0,9999,0
1708255245836,PHIL 295,008,415891,Cohen; Jonathan David,9999,0,9999,0
1708255245836,PHIL 295,009,415892,Danks; David J,9999,0,9999,0
1708255245836,PHIL 295,010,415937,Fulkerson; Matthew Todd,9999,0,9999,0
1708255245836,PHIL 295,011,415940,Grush; Rick Scott,9999,0,9999,0
1708255245836,PHIL 295,012,415945,Hardimon; Michael O.,9999,0,9999,0
1708255245836,PHIL 295,013,415946,Harrell; Maralee Mae,9999,0,9999,0
1708255245836,PHIL 295,014,415953,Johnson; Monte,9999,0,9999,0
1708255245836,PHIL 295,015,415954,Kovaka; Karenc,9999,0,9999,0
1708255245836,PHIL 295,016,415957,Lamey; Andy M.,9999,0,9999,0
1708255245836,PHIL 295,017,415958,Marechal; Patricia,9999,0,9999,0
1708255245836,PHIL 295,018,415959,McKenzie; Kerry V.,9999,0,9999,0
1708255245836,PHIL 295,019,415960,Nelkin; Dana Kay,9999,0,9999,0
1708255245836,PHIL 295,020,415961,Rickless; Samuel Charles,9999,0,9999,0
1708255245836,PHIL 295,021,415987,Sher; Gila,9999,0,9999,0
1708255245836,PHIL 295,022,416027,Shields; Christopher John,9999,0,9999,0
1708255245836,PHIL 295,023,416030,Tolley; Clinton,9999,0,9999,0
1708255245836,PHIL 295,024,416033,Vargas; Manuel Rogelio,9999,0,9999,0
1708255245836,PHIL 295,025,416034,Watkins; Eric,9999,0,9999,0
1708255246365,PHYA 224,A00,442106,Sandstrom; Karin Marie,30,0,30,0
1708255246893,PHYS 1A,A00,441607,Gilbert; Dylan Paul,346,0,362,16
1708255247428,PHYS 1AL,001,441608,Arlett; Jessica Lynn & Yagil; Avi,30,0,30,0
1708255247428,PHYS 1AL,002,441609,Arlett; Jessica Lynn & Yagil; Avi,28,0,30,2
1708255247428,PHYS 1AL,003,441610,Arlett; Jessica Lynn & Yagil; Avi,26,0,30,4
1708255247428,PHYS 1AL,004,441611,Arlett; Jessica Lynn & Yagil; Avi,29,0,30,1
1708255247428,PHYS 1AL,005,441612,Arlett; Jessica Lynn & Yagil; Avi,28,0,30,2
1708255247428,PHYS 1AL,006,441616,Arlett; Jessica Lynn & Yagil; Avi,28,0,30,2
1708255247428,PHYS 1AL,007,441618,Arlett; Jessica Lynn & Yagil; Avi,26,0,30,4
1708255247428,PHYS 1AL,008,441620,Arlett; Jessica Lynn & Yagil; Avi,29,0,30,1
1708255247428,PHYS 1AL,009,441623,Arlett; Jessica Lynn & Yagil; Avi,29,0,30,1
1708255247428,PHYS 1AL,010,441625,Arlett; Jessica Lynn & Yagil; Avi,29,0,30,1
1708255247428,PHYS 1AL,011,441626,Arlett; Jessica Lynn & Yagil; Avi,29,0,30,1
1708255247428,PHYS 1AL,012,441627,Arlett; Jessica Lynn & Yagil; Avi,29,0,30,1
1708255247955,PHYS 1B,A00,441630,Groisman; Alexander,351,0,362,11
1708255248500,PHYS 1BL,001,441632,Arlett; Jessica Lynn & Yagil; Avi,28,0,30,2
1708255248500,PHYS 1BL,002,441634,Arlett; Jessica Lynn & Yagil; Avi,29,0,30,1
1708255248500,PHYS 1BL,003,441636,Arlett; Jessica Lynn & Yagil; Avi,29,0,30,1
1708255248500,PHYS 1BL,004,441637,Arlett; Jessica Lynn & Yagil; Avi,29,0,30,1
1708255248500,PHYS 1BL,005,441639,Arlett; Jessica Lynn & Yagil; Avi,29,0,30,1
1708255248500,PHYS 1BL,006,441641,Arlett; Jessica Lynn & Yagil; Avi,26,0,30,4
1708255248500,PHYS 1BL,007,441642,Arlett; Jessica Lynn & Yagil; Avi,23,0,30,7
1708255248500,PHYS 1BL,008,441643,Arlett; Jessica Lynn & Yagil; Avi,30,0,30,0
1708255248500,PHYS 1BL,009,441646,Arlett; Jessica Lynn & Yagil; Avi,29,0,30,1
1708255248500,PHYS 1BL,010,441648,Arlett; Jessica Lynn & Yagil; Avi,29,0,30,1
1708255248500,PHYS 1BL,011,441652,Arlett; Jessica Lynn & Yagil; Avi,29,0,30,1
1708255248500,PHYS 1BL,012,441654,Arlett; Jessica Lynn & Yagil; Avi,30,0,30,0
1708255249026,PHYS 1C,A00,441658,Popmintchev; Tenio,587,0,600,13
1708255249026,PHYS 1C,B00,441662,Popmintchev; Tenio,558,0,600,42
1708255249665,PHYS 1CL,001,441664,Arlett; Jessica Lynn & Yagil; Avi,29,0,30,1
1708255249665,PHYS 1CL,002,441665,Arlett; Jessica Lynn & Yagil; Avi,27,0,30,3
1708255249665,PHYS 1CL,003,441666,Arlett; Jessica Lynn & Yagil; Avi,25,0,30,5
1708255249665,PHYS 1CL,004,441667,Arlett; Jessica Lynn & Yagil; Avi,30,0,30,0
1708255249665,PHYS 1CL,005,441668,Arlett; Jessica Lynn & Yagil; Avi,28,0,30,2
1708255249665,PHYS 1CL,006,441669,Arlett; Jessica Lynn & Yagil; Avi,25,0,30,5
1708255249665,PHYS 1CL,007,441671,Arlett; Jessica Lynn & Yagil; Avi,27,0,30,3
1708255249665,PHYS 1CL,008,441673,Arlett; Jessica Lynn & Yagil; Avi,30,0,30,0
1708255249665,PHYS 1CL,009,441674,Arlett; Jessica Lynn & Yagil; Avi,26,0,30,4
1708255249665,PHYS 1CL,010,441676,Arlett; Jessica Lynn & Yagil; Avi,30,0,30,0
1708255249665,PHYS 1CL,011,441677,Arlett; Jessica Lynn & Yagil; Avi,30,0,30,0
1708255249665,PHYS 1CL,012,441683,Arlett; Jessica Lynn & Yagil; Avi,30,0,30,0
1708255249665,PHYS 1CL,013,441685,Arlett; Jessica Lynn & Yagil; Avi,28,0,30,2
1708255249665,PHYS 1CL,014,441687,Arlett; Jessica Lynn & Yagil; Avi,30,0,30,0
1708255249665,PHYS 1CL,015,441689,Arlett; Jessica Lynn & Yagil; Avi,17,0,30,13
1708255249665,PHYS 1CL,016,441692,Arlett; Jessica Lynn & Yagil; Avi,29,0,30,1
1708255249665,PHYS 1CL,017,441696,Arlett; Jessica Lynn & Yagil; Avi,24,0,30,6
1708255249665,PHYS 1CL,018,441698,Arlett; Jessica Lynn & Yagil; Avi,25,0,30,5
1708255249665,PHYS 1CL,019,441702,Arlett; Jessica Lynn & Yagil; Avi,25,0,30,5
1708255249665,PHYS 1CL,020,441705,Arlett; Jessica Lynn & Yagil; Avi,29,0,30,1
1708255249665,PHYS 1CL,021,441706,Arlett; Jessica Lynn & Yagil; Avi,30,0,30,0
1708255249665,PHYS 1CL,022,441707,Arlett; Jessica Lynn & Yagil; Avi,30,0,30,0
1708255249665,PHYS 1CL,023,441708,Arlett; Jessica Lynn & Yagil; Avi,27,0,30,3
1708255249665,PHYS 1CL,024,441710,Arlett; Jessica Lynn & Yagil; Avi,29,0,30,1
1708255249665,PHYS 1CL,025,441711,Arlett; Jessica Lynn & Yagil; Avi,28,0,30,2
1708255249665,PHYS 1CL,026,441712,Arlett; Jessica Lynn & Yagil; Avi,29,0,30,1
1708255249665,PHYS 1CL,027,441713,Arlett; Jessica Lynn & Yagil; Avi,26,0,30,4
1708255249665,PHYS 1CL,028,441714,Arlett; Jessica Lynn & Yagil; Avi,29,0,30,1
1708255249665,PHYS 1CL,029,441715,Arlett; Jessica Lynn & Yagil; Avi,25,0,30,5
1708255249665,PHYS 1CL,030,441717,Arlett; Jessica Lynn & Yagil; Avi,29,0,30,1
1708255249665,PHYS 1CL,031,441718,Arlett; Jessica Lynn & Yagil; Avi,27,0,30,3
1708255249665,PHYS 1CL,032,441721,Arlett; Jessica Lynn & Yagil; Avi,30,0,30,0
1708255249665,PHYS 1CL,033,441724,Arlett; Jessica Lynn & Yagil; Avi,28,0,30,2
1708255249665,PHYS 1CL,034,441726,Arlett; Jessica Lynn & Yagil; Avi,29,0,30,1
1708255249665,PHYS 1CL,035,441728,Arlett; Jessica Lynn & Yagil; Avi,29,0,30,1
1708255249665,PHYS 1CL,036,441729,Arlett; Jessica Lynn & Yagil; Avi,30,0,30,0
1708255249665,PHYS 1CL,037,441730,Arlett; Jessica Lynn & Yagil; Avi,27,0,30,3
1708255249665,PHYS 1CL,038,441732,Arlett; Jessica Lynn & Yagil; Avi,29,0,30,1
1708255249665,PHYS 1CL,039,441733,Arlett; Jessica Lynn & Yagil; Avi,27,0,30,3
1708255249665,PHYS 1CL,040,441734,Arlett; Jessica Lynn & Yagil; Avi,30,0,30,0
1708255249665,PHYS 1CL,041,441735,Arlett; Jessica Lynn & Yagil; Avi,29,0,30,1
1708255249665,PHYS 1CL,042,441766,Arlett; Jessica Lynn & Yagil; Avi,30,0,30,0
1708255249665,PHYS 1CL,043,441768,Arlett; Jessica Lynn & Yagil; Avi,29,0,30,1
1708255249665,PHYS 1CL,044,441770,Arlett; Jessica Lynn & Yagil; Avi,30,0,30,0
1708255250265,PHYS 2A,A01,460308,Bal; Gurleen K,28,0,30,2
1708255250265,PHYS 2A,A02,460320,Bal; Gurleen K,30,0,30,0
1708255250265,PHYS 2A,A03,460321,Bal; Gurleen K,29,0,30,1
1708255250265,PHYS 2A,A04,460325,Bal; Gurleen K,28,0,30,2
1708255250265,PHYS 2A,A05,460326,Bal; Gurleen K,29,0,30,1
1708255250265,PHYS 2A,A06,460327,Bal; Gurleen K,30,0,30,0
1708255250265,PHYS 2A,A07,460495,Bal; Gurleen K,28,0,30,2
1708255250265,PHYS 2A,A08,460535,Bal; Gurleen K,27,0,30,3
1708255250265,PHYS 2A,A09,460536,Bal; Gurleen K,30,0,30,0
1708255250265,PHYS 2A,A10,460537,Bal; Gurleen K,30,0,30,0
1708255250265,PHYS 2A,A11,460538,Bal; Gurleen K,30,0,30,0
1708255250265,PHYS 2A,A12,460539,Bal; Gurleen K,30,0,30,0
1708255250891,PHYS 2B,A01,460620,Barreiro Guerrero; Julio,30,0,30,0
1708255250891,PHYS 2B,A02,460625,Barreiro Guerrero; Julio,30,0,30,0
1708255250891,PHYS 2B,A03,460626,Barreiro Guerrero; Julio,29,0,30,1
1708255250891,PHYS 2B,A04,460716,Barreiro Guerrero; Julio,26,0,30,4
1708255250891,PHYS 2B,A05,460756,Barreiro Guerrero; Julio,29,0,30,1
1708255250891,PHYS 2B,A06,460837,Barreiro Guerrero; Julio,30,0,30,0
1708255250891,PHYS 2B,A07,460865,Barreiro Guerrero; Julio,30,0,30,0
1708255250891,PHYS 2B,A08,460866,Barreiro Guerrero; Julio,30,0,30,0
1708255250891,PHYS 2B,A09,460867,Barreiro Guerrero; Julio,29,0,30,1
1708255250891,PHYS 2B,A10,460868,Barreiro Guerrero; Julio,30,0,30,0
1708255250891,PHYS 2B,A11,460869,Barreiro Guerrero; Julio,30,0,30,0
1708255250891,PHYS 2B,A12,460874,Barreiro Guerrero; Julio,30,0,30,0
1708255250891,PHYS 2B,B01,469381,Barreiro Guerrero; Julio,30,0,30,0
1708255250891,PHYS 2B,B02,469382,Barreiro Guerrero; Julio,29,0,30,1
1708255250891,PHYS 2B,B03,469402,Barreiro Guerrero; Julio,27,0,30,3
1708255250891,PHYS 2B,B04,469403,Barreiro Guerrero; Julio,28,0,30,2
1708255250891,PHYS 2B,B05,469442,Barreiro Guerrero; Julio,30,0,30,0
1708255250891,PHYS 2B,B06,469449,Barreiro Guerrero; Julio,30,0,30,0
1708255250891,PHYS 2B,B07,469450,Barreiro Guerrero; Julio,29,0,30,1
1708255250891,PHYS 2B,B08,469451,Barreiro Guerrero; Julio,30,0,30,0
1708255250891,PHYS 2B,B09,469457,Barreiro Guerrero; Julio,29,0,30,1
1708255250891,PHYS 2B,B10,469460,Barreiro Guerrero; Julio,30,0,30,0
1708255250891,PHYS 2B,B11,469468,Barreiro Guerrero; Julio,30,0,30,0
1708255250891,PHYS 2B,B12,469475,Barreiro Guerrero; Julio,30,0,30,0
1708255251434,PHYS 2BL,A01,441779,Meyertholen; Andrew D.,21,0,24,3
1708255251434,PHYS 2BL,A02,441780,Meyertholen; Andrew D.,17,0,24,7
1708255251434,PHYS 2BL,A03,441781,Meyertholen; Andrew D.,20,0,24,4
1708255251434,PHYS 2BL,A04,441782,Meyertholen; Andrew D.,21,0,24,3
1708255251434,PHYS 2BL,A05,441784,Meyertholen; Andrew D.,23,0,24,1
1708255251434,PHYS 2BL,A06,441786,Meyertholen; Andrew D.,23,0,24,1
1708255251434,PHYS 2BL,A07,441788,Meyertholen; Andrew D.,23,0,24,1
1708255251434,PHYS 2BL,A08,441790,Meyertholen; Andrew D.,24,0,24,0
1708255251434,PHYS 2BL,A09,441792,Meyertholen; Andrew D.,24,0,24,0
1708255251434,PHYS 2BL,A10,441794,Meyertholen; Andrew D.,23,0,24,1
1708255251434,PHYS 2BL,A11,441796,Meyertholen; Andrew D.,22,0,24,2
1708255251434,PHYS 2BL,A12,441798,Meyertholen; Andrew D.,24,0,24,0
1708255251434,PHYS 2BL,A13,441800,Meyertholen; Andrew D.,24,0,24,0
1708255251434,PHYS 2BL,A14,441802,Meyertholen; Andrew D.,24,0,24,0
1708255251434,PHYS 2BL,A15,441804,Meyertholen; Andrew D.,23,0,24,1
1708255251978,PHYS 2C,A01,460540,Tan; Tzer Han,30,0,30,0
1708255251978,PHYS 2C,A02,460541,Tan; Tzer Han,28,0,30,2
1708255251978,PHYS 2C,A03,460542,Tan; Tzer Han,28,0,30,2
1708255251978,PHYS 2C,A04,460543,Tan; Tzer Han,28,0,30,2
1708255251978,PHYS 2C,A05,460544,Tan; Tzer Han,28,0,30,2
1708255251978,PHYS 2C,A06,460545,Tan; Tzer Han,29,0,30,1
1708255251978,PHYS 2C,A07,460553,Tan; Tzer Han,30,0,30,0
1708255251978,PHYS 2C,A08,460561,Tan; Tzer Han,30,0,30,0
1708255251978,PHYS 2C,A09,460562,Tan; Tzer Han,28,0,30,2
1708255251978,PHYS 2C,A10,460563,Tan; Tzer Han,29,0,30,1
1708255251978,PHYS 2C,A11,460567,Tan; Tzer Han,30,0,30,0
1708255251978,PHYS 2C,A12,460568,Tan; Tzer Han,28,0,30,2
1708255252505,PHYS 2CL,A01,441809,Ni; Kaixuan,25,0,28,3
1708255252505,PHYS 2CL,A02,441811,Ni; Kaixuan,27,0,28,1
1708255252505,PHYS 2CL,A03,441814,Ni; Kaixuan,23,0,28,5
1708255252505,PHYS 2CL,A04,441817,Ni; Kaixuan,28,0,28,0
1708255252505,PHYS 2CL,A05,441819,Ni; Kaixuan,26,0,28,2
1708255252505,PHYS 2CL,A06,441820,Ni; Kaixuan,27,0,28,1
1708255253034,PHYS 2D,A01,460569,Sharma; Vivek A.,24,0,25,1
1708255253034,PHYS 2D,A02,460574,Sharma; Vivek A.,24,0,25,1
1708255253034,PHYS 2D,A03,460575,Sharma; Vivek A.,25,0,25,0
1708255253567,PHYS 4B,A01,441829,Grinstein; Benjamin,34,0,38,4
1708255253567,PHYS 4B,A02,441831,Grinstein; Benjamin,30,0,32,2
1708255253567,PHYS 4B,A03,441832,Grinstein; Benjamin,30,0,30,0
1708255253567,PHYS 4B,A04,441833,Grinstein; Benjamin,30,0,30,0
1708255254094,PHYS 4E,A01,441907,Frano Pereira; Alex M,33,0,34,1
1708255254094,PHYS 4E,A02,441958,Frano Pereira; Alex M,34,0,34,0
1708255254625,PHYS 10,A01,441971,Burgasser; Adam Jonathan,118,0,120,2
1708255255152,PHYS 13,A01,441974,Wright; Shelley Adams,61,0,65,4
1708255255679,PHYS 87,A00,486898,Grinstein; Benjamin,19,0,20,1
1708255256206,PHYS 100C,A01,441978,Averitt; Richard Douglas,58,0,60,2
1708255256733,PHYS 105B,A01,441985,Green; Daniel Richard,37,0,40,3
1708255257258,PHYS 120,A01,441995,Arnold; Kam S,40,0,44,4
1708255257258,PHYS 120,A02,442011,Arnold; Kam S,41,0,44,3
1708255257790,PHYS 130A,A01,442032,Parker; Daniel E,74,0,75,1
1708255258317,PHYS 130B,A01,442056,Branson; James G,47,0,50,3
1708255258849,PHYS 139,A00,442057,Jun; Suckjoon,30,0,30,0
1708255258849,PHYS 139,B00,442059,Duarte; Javier Mauricio & Li; Aobo,42,0,50,8
1708255259377,PHYS 140A,A01,442065,Shotwell; Brian,49,0,50,1
1708255259904,PHYS 152B,A01,442067,Hirsch; Jorge Eduardo,16,0,20,4
1708255260435,PHYS 154,A01,442069,Jenkins; Elizabeth,29,0,30,1
1708255260961,PHYS 162,A01,442096,Keating; Brian,64,0,65,1
1708255261494,PHYS 170,A01,486870,Oh; Seungeun,39,0,40,1
1708255262020,PHYS 177,A00,442103,Dudko; Olga,20,0,20,0
1708255265648,PHYS 203B,A01,442132,Fogler; Michael M.,20,0,20,0
1708255266178,PHYS 210A,A01,442143,Hwa; Terence T.,20,0,20,0
1708255266705,PHYS 212C,A01,442200,Chivukula; Raja S,18,0,20,2
1708255267236,PHYS 215C,A00,442201,Intriligator; Kenneth Arthur,19,0,20,1
1708255267765,PHYS 225C,A01,442203,Flauger; Raphael M,19,0,20,1
1708255268289,PHYS 227,A00,442204,Tytler; David Robert,29,0,30,1
1708255268815,PHYS 230,A01,442206,McGreevy; John A.,20,0,20,0
1708255269347,PHYS 239,A00,442207,Goldenfeld; Nigel,20,0,20,0
1708255269347,PHYS 239,B00,442208,Duarte; Javier Mauricio & Li; Aobo,5,0,5,0
1708255269874,PHYS 244,A01,442280,Norman; Michael L,12,0,20,8
1708255270400,PHYS 250,A00,442300,Fogler; Michael M.,50,0,50,0
1708255270930,PHYS 251,A00,442307,Grinstein; Benjamin,20,0,20,0
1708255271457,PHYS 252,A00,442348,Diamond; Patrick H,10,0,10,0
1708255271984,PHYS 253,A00,442349,Theissen; Christopher Alexander,30,0,30,0
1708255272510,PHYS 254,A00,442352,Hwa; Terence T.,30,0,30,0
1708255273036,PHYS 255,A00,442423,Hwa; Terence T.,30,0,30,0
1708255273566,PHYS 258,A00,442426,Theissen; Christopher Alexander,30,0,30,0
1708255274091,PHYS 260,A00,442427,Frano Pereira; Alex M,50,0,50,0
1708255274618,PHYS 277,A00,442428,Dudko; Olga,20,0,20,0
1708255275162,POLI 5D,A01,419010,Dai; Yinlin,5,0,7,2
1708255275162,POLI 5D,A02,419020,Dai; Yinlin,7,0,7,0
1708255275162,POLI 5D,A03,419022,Dai; Yinlin,4,0,6,2
1708255275162,POLI 5D,A04,419040,Dai; Yinlin,5,0,5,0
1708255275162,POLI 5D,B01,419065,Dai; Yinlin,7,0,7,0
1708255275162,POLI 5D,B02,419068,Dai; Yinlin,7,0,7,0
1708255275162,POLI 5D,B03,419069,Dai; Yinlin,6,0,6,0
1708255275162,POLI 5D,B04,419070,Dai; Yinlin,5,0,5,0
1708255275162,POLI 5D,C01,487211,Staff,3,0,5,2
1708255275705,POLI 11D,A01,419072,Desposato; Scott,32,0,34,2
1708255275705,POLI 11D,A02,419073,Desposato; Scott,33,0,34,1
1708255275705,POLI 11D,A03,419082,Desposato; Scott,32,0,34,2
1708255275705,POLI 11D,A04,419123,Desposato; Scott,34,0,34,0
1708255275705,POLI 11D,A05,419124,Desposato; Scott,34,0,34,0
1708255275705,POLI 11D,A06,419125,Desposato; Scott,34,0,34,0
1708255276239,POLI 12D,A01,419127,Gartzke; Erik,29,0,34,5
1708255276239,POLI 12D,A02,419128,Gartzke; Erik,34,0,34,0
1708255276239,POLI 12D,A03,419129,Gartzke; Erik,34,0,34,0
1708255276239,POLI 12D,A04,419130,Gartzke; Erik,34,0,34,0
1708255276239,POLI 12D,A05,419131,Gartzke; Erik,32,0,34,2
1708255276239,POLI 12D,A06,419168,Gartzke; Erik,34,0,34,0
1708255276782,POLI 13DR,A01,477733,Draper; Matthew William,28,0,34,6
1708255276782,POLI 13DR,A02,477734,Draper; Matthew William,32,0,34,2
1708255276782,POLI 13DR,A03,477736,Draper; Matthew William,33,0,34,1
1708255276782,POLI 13DR,A04,477737,Draper; Matthew William,32,0,34,2
1708255276782,POLI 13DR,A05,477739,Draper; Matthew William,31,0,34,3
1708255276782,POLI 13DR,A06,477740,Draper; Matthew William,34,0,34,0
1708255277309,POLI 30D,A01,419179,Desposato; Scott,19,0,28,9
1708255277309,POLI 30D,A02,419180,Desposato; Scott,25,0,28,3
1708255277309,POLI 30D,A03,419181,Desposato; Scott,27,0,28,1
1708255277309,POLI 30D,A04,419182,Desposato; Scott,28,0,28,0
1708255277309,POLI 30D,A05,419187,Desposato; Scott,24,0,28,4
1708255277309,POLI 30D,A06,419189,Desposato; Scott,28,0,28,0
1708255277840,POLI 100E,A00,419191,Pitcher; Kennedy Anell,105,0,115,10
1708255278368,POLI 104P,A00,419192,Orfield; Michael Bennett,183,0,196,13
1708255278894,POLI 104U,A00,419193,Nichter; Maysa,88,0,115,27
1708255279424,POLI 108,A00,419194,Adida; Claire,293,0,295,2
1708255279951,POLI 110C,A00,419195,Soon; Valerie,47,0,50,3
1708255280483,POLI 120D,A00,419207,Hansen; Jan Eric,48,0,50,2
1708255281008,POLI 124A,A00,419209,Fortunato; David,48,0,50,2
1708255281535,POLI 131CR,A00,419211,Hoston; Germaine,41,0,50,9
1708255281535,POLI 131CR,B00,481592,Hoston; Germaine,10,0,10,0
1708255282061,POLI 136A,A00,419212,Roeder; Philip G,111,0,115,4
1708255282587,POLI 140D,A00,419213,Wong; Tak Kei,183,0,192,9
1708255283111,POLI 142D,A00,419214,Gartzke; Erik,227,0,230,3
1708255283642,POLI 145C,A00,419222,Fisk; David Lee,101,0,115,14
1708255284168,POLI 150A,A00,419225,Wong; Tak Kei,216,0,230,14
1708255284694,POLI 170A,A00,419226,Skillman; Rachel Diane,115,0,115,0
1708255285220,POLI 179,A00,419238,Staff,95,0,104,9
1708255285750,POLI 194,A00,455332,Hill; Seth J,0,0,0,0
1708255286276,POLI 194SD,A00,419248,Nichter; Maysa,999,0,999,0
1708255286806,POLI 197SD,001,419258,Nichter; Maysa,999,0,999,0
1708255287338,POLI 203B,A00,419265,Slantchev; Branislav,21,0,25,4
1708255287864,POLI 214R,A00,419275,Hoston; Germaine,23,0,25,2
1708255288391,POLI 219,A00,419289,Soon; Valerie,24,0,25,1
1708255288916,POLI 220A,A00,419299,Ferree; Karen E,21,0,25,4
1708255289446,POLI 233,A00,419333,Adida; Claire,23,0,25,2
1708255289972,POLI 243,A00,479118,Joseph; Michael F,23,0,25,2
1708255290504,POLI 251,A00,419334,Ban; Pamela M,23,0,25,2
1708255291028,POLI 257,A00,419335,Hill; Seth J,25,0,25,0
1708255291571,POLI 273,A00,419336,Mignozzetti; Umberto,16,0,25,9
1708255292097,POLI 280,A00,419337,Hafner-Burton; Emilie,18,0,25,7
1708255292625,POLI 281,A00,419338,Ban; Pamela M,21,0,25,4
1708255293150,POLI 282,A00,419339,Ferree; Karen E,19,0,25,6
1708255293678,POLI 283,A00,419340,Naoi; Megumi,23,0,25,2
1708255294205,POLI 285,A00,419341,Ingham; Sean,25,0,25,0
1708255294732,POLI 286,A00,419342,Mignozzetti; Umberto,23,0,25,2
1708255295260,POLI 288,A00,479174,Fowler; James,13,0,15,2
1708255295789,PSY 296,001,465760,Besterman; Aaron David,49,0,50,1
1708255295789,PSY 296,002,465765,Eyler; Lisa T.,49,0,50,1
1708255295789,PSY 296,003,465767,Patel; Ekta Himanshu,49,0,50,1
1708255296315,PSYC 3R,A00,419378,Pilegard; Celeste Cristine,314,0,325,11
1708255296842,PSYC 7,A00,419384,Powell; Lindsey Jane,288,0,295,7
1708255297394,PSYC 60,A01,460208,Lowe; Angela Beth,31,0,35,4
1708255297394,PSYC 60,A02,460209,Lowe; Angela Beth,28,0,35,7
1708255297394,PSYC 60,A03,460210,Lowe; Angela Beth,35,0,35,0
1708255297394,PSYC 60,A04,460211,Lowe; Angela Beth,33,0,35,2
1708255297394,PSYC 60,A05,460212,Lowe; Angela Beth,34,0,35,1
1708255297394,PSYC 60,A06,460213,Lowe; Angela Beth,35,0,35,0
1708255297394,PSYC 60,A07,460214,Lowe; Angela Beth,33,0,35,2
1708255297394,PSYC 60,B01,460215,Rose; Fred E.,35,0,35,0
1708255297394,PSYC 60,B02,460216,Rose; Fred E.,35,0,35,0
1708255297394,PSYC 60,B03,460218,Rose; Fred E.,35,0,35,0
1708255297394,PSYC 60,B04,460219,Rose; Fred E.,35,0,35,0
1708255297394,PSYC 60,B05,460220,Rose; Fred E.,32,0,35,3
1708255297394,PSYC 60,B06,460221,Rose; Fred E.,35,0,35,0
1708255297394,PSYC 60,B07,460222,Rose; Fred E.,35,0,35,0
1708255297941,PSYC 70,A01,460223,Pilegard; Celeste Cristine,29,0,35,6
1708255297941,PSYC 70,A02,460224,Pilegard; Celeste Cristine,32,0,35,3
1708255297941,PSYC 70,A03,460225,Pilegard; Celeste Cristine,34,0,35,1
1708255297941,PSYC 70,A04,460266,Pilegard; Celeste Cristine,33,0,35,2
1708255297941,PSYC 70,A05,460267,Pilegard; Celeste Cristine,35,0,35,0
1708255297941,PSYC 70,A06,460277,Pilegard; Celeste Cristine,34,0,35,1
1708255298471,PSYC 71,A01,419620,Staff,19,0,21,2
1708255298471,PSYC 71,A02,419662,Staff,20,0,21,1
1708255298471,PSYC 71,B01,419682,Geller; Emma Harlan,24,0,25,1
1708255298471,PSYC 71,B02,419732,Geller; Emma Harlan,26,0,26,0
1708255298998,PSYC 88,A00,419733,Dobkins; Karen R.,47,0,65,18
1708255299525,PSYC 100,A00,419734,Chapman; Eddie Nathaniel,388,0,410,22
1708255300056,PSYC 101,A00,419735,Walker; Caren Michelle,272,0,295,23
1708255300583,PSYC 102,A00,419779,Moranton; Nirelia Melbina-,292,0,295,3
1708255301116,PSYC 104,A00,419880,Fine; Rachel,267,0,295,28
1708255301642,PSYC 105,A00,419946,Lowe; Angela Beth,276,0,295,19
1708255302168,PSYC 111B,A01,419948,Geller; Emma Harlan,35,0,35,0
1708255302716,PSYC 116C,A01,420046,Lang; Ariel,25,0,25,0
1708255303243,PSYC 117,A01,420092,Bajic; Daniel Andrew,25,0,25,0
1708255303776,PSYC 118,A01,420095,Miller; Cory T.,37,0,45,8
1708255304302,PSYC 124,A00,420096,Chapman; Eddie Nathaniel,381,0,410,29
1708255304828,PSYC 127,A00,420097,Dickenson; Janna Alene,14,0,20,6
1708255305356,PSYC 132,A00,420121,Staff,114,0,120,6
1708255305884,PSYC 133R,A01,420172,Golden; Susan S. & Gorman; Michael R.,10,0,16,6
1708255305884,PSYC 133R,A02,420173,Golden; Susan S. & Gorman; Michael R.,16,0,16,0
1708255305884,PSYC 133R,A03,420175,Golden; Susan S. & Gorman; Michael R.,16,0,16,0
1708255305884,PSYC 133R,A04,420249,Golden; Susan S. & Gorman; Michael R.,13,0,16,3
1708255306410,PSYC 134,A00,420311,Kaye; Walter H.,296,0,300,4
1708255306937,PSYC 137,A00,420312,Lin; Chujun,292,0,295,3
1708255307464,PSYC 144,A00,420313,Wixted; John T,287,0,295,8
1708255307994,PSYC 147,A00,420315,Wong; Lauren Hitomi,120,0,146,26
1708255308521,PSYC 164,A00,420328,Kaplan; Paul,259,0,295,36
1708255309048,PSYC 172,A00,420336,Dickenson; Janna Alene,294,0,300,6
1708255309579,PSYC 178,A00,420337,Glaser; Dale,131,0,146,15
1708255310104,PSYC 179,A00,420338,Lacefield; Katharine I,256,0,328,72
1708255310633,PSYC 181,A00,420339,Anagnostaras; Stephan,333,0,350,17
1708255311157,PSYC 184,A00,420367,Wilson; Brent M,275,0,295,20
1708255311698,PSYC 188,A00,420368,Lacefield; Katharine I,234,0,300,66
1708255312229,PSYC 190,A00,420378,Barner; David A.,374,0,395,21
1708255312763,PSYC 193,B00,420626,Brashier; Nadia Marie,215,0,216,1
1708255312763,PSYC 193,C00,420643,Gremel; Christina M,33,0,35,2
1708255313324,PSYC 193L,A01,420817,Brown; Sandra A,65,0,65,0
1708255313324,PSYC 193L,B01,420830,Staff,26,0,30,4
1708255313324,PSYC 193L,C01,420832,Staff,49,0,49,0
1708255313324,PSYC 193L,D01,420834,Staff,27,0,30,3
1708255313324,PSYC 193L,E01,493996,Aron; Adam,24,0,24,0
1708255313866,PSYC 194C,A01,420905,Heyman; Gail D.,1,0,1,0
1708255314398,PSYC 205,A00,420906,Harris; Christine Renee,17,0,20,3
1708255314927,PSYC 218,A00,420907,Brady; Timothy Francis,11,0,20,9
1708255315457,PSYC 224,A00,420908,Gremel; Christina M,30,0,30,0
1708255315983,PSYC 242,A00,421469,Walker; Caren Michelle,27,0,30,3
1708255316512,PSYC 247,A00,421473,Walker; Caren Michelle,14,0,20,6
1708255317038,PSYC 270C,A00,421554,Dobkins; Karen R.,13,0,20,7
1708255317564,PSYC 272,A00,421561,Gentner; Tim,20,0,20,0
1708255318094,PSYC 274,A00,421564,McCullough; Michael E,29,0,30,1
1708255318620,PSYC 275,A00,421620,Staff,23,0,30,7
1708255319202,PSYC 276,A00,421622,McCullough; Michael E,14,0,20,6
1708255319733,PSYC 280,A00,421623,Serences; John Thomas,76,0,85,9
1708255320278,PSYC 296,001,421667,Anagnostaras; Stephan,9999,0,9999,0
1708255320278,PSYC 296,002,421773,Aron; Adam,9999,0,9999,0
1708255320278,PSYC 296,003,421794,Mukku; Dhananjaya,9999,0,9999,0
1708255320278,PSYC 296,004,421795,Barner; David A.,9998,0,9999,1
1708255320278,PSYC 296,005,421796,Schachner; Adena,9999,0,9999,0
1708255320278,PSYC 296,006,421797,Brown; Sandra A,9999,0,9999,0
1708255320278,PSYC 296,007,421798,Chapman; Eddie Nathaniel,9999,0,9999,0
1708255320278,PSYC 296,008,421799,Dickenson; Janna Alene,9999,0,9999,0
1708255320278,PSYC 296,009,421800,Dobkins; Karen R.,9998,0,9999,1
1708255320278,PSYC 296,010,421801,Fan; Judith Ellen,9999,0,9999,0
1708255320278,PSYC 296,011,421803,Ferreira; Victor,9999,0,9999,0
1708255320278,PSYC 296,012,421814,Geller; Emma Harlan,9998,0,9999,1
1708255320278,PSYC 296,013,422102,Gentner; Tim,9999,0,9999,0
1708255320278,PSYC 296,014,422103,Gorman; Michael R.,9999,0,9999,0
1708255320278,PSYC 296,015,422104,Gremel; Christina M,9999,0,9999,0
1708255320278,PSYC 296,016,422106,Harris; Christine Renee,9999,0,9999,0
1708255320278,PSYC 296,017,422107,Heyman; Gail D.,9999,0,9999,0
1708255320278,PSYC 296,018,422108,McCullough; Michael E,9999,0,9999,0
1708255320278,PSYC 296,019,422109,Mc Kenzie; Craig R.M.,9999,0,9999,0
1708255320278,PSYC 296,020,422122,Miller; Cory T.,9999,0,9999,0
1708255320278,PSYC 296,021,422123,Pashler; Harold E,9999,0,9999,0
1708255320278,PSYC 296,022,422124,Pilegard; Celeste Cristine,9999,0,9999,0
1708255320278,PSYC 296,023,422125,Powell; Lindsey Jane,9999,0,9999,0
1708255320278,PSYC 296,025,422127,Rickard; Timothy C.,9998,0,9999,1
1708255320278,PSYC 296,026,422128,Serences; John Thomas,9998,0,9999,1
1708255320278,PSYC 296,027,422130,Walker; Caren Michelle,9998,0,9999,1
1708255320278,PSYC 296,028,422132,Winkielman; Piotr,9999,0,9999,0
1708255320278,PSYC 296,029,422134,Wixted; John T,9996,0,9999,3
1708255320278,PSYC 296,030,422146,Brady; Timothy Francis,9998,0,9999,1
1708255320278,PSYC 296,031,422154,Carver; Leslie J.,9999,0,9999,0
1708255320278,PSYC 296,032,422161,Lin; Chujun,9999,0,9999,0
1708255320278,PSYC 296,033,422169,Brashier; Nadia Marie,9998,0,9999,1
1708255320278,PSYC 296,034,422177,Oesch; Nicholas W,9999,0,9999,0
1708255320804,RAD 296,001,465795,Staff,50,0,50,0
1708255320804,RAD 296,002,465796,Staff,50,0,50,0
1708255320804,RAD 296,003,465797,Staff,50,0,50,0
1708255321334,RELI 150,A00,419353,Rahimi; Babak,37,0,40,3
1708255321862,REV 87,A00,422721,Lyon; Antony J.,19,0,20,1
1708255322393,RMAS 296,001,465827,Murphy; James D,49,0,50,1
1708255322393,RMAS 296,002,465828,Staff,50,0,50,0
1708255322393,RMAS 296,003,465831,Staff,50,0,50,0
1708255322919,RMED 296,001,466791,Staff,50,0,50,0
1708255322919,RMED 296,002,466792,Staff,50,0,50,0
1708255322919,RMED 296,003,466793,Staff,50,0,50,0
1708255323448,SE 3,A01,446938,Van Den Einde; Yael Dahlia,50,0,52,2
1708255323448,SE 3,A02,446942,Van Den Einde; Yael Dahlia,49,0,52,3
1708255323448,SE 3,A03,446948,Van Den Einde; Yael Dahlia,52,0,53,1
1708255323448,SE 3,A04,446965,Van Den Einde; Yael Dahlia,53,0,53,0
1708255323976,SE 9,A01,447015,Kuester; Falko,30,0,34,4
1708255323976,SE 9,A02,447017,Kuester; Falko,33,0,33,0
1708255323976,SE 9,A03,447022,Kuester; Falko,31,0,33,2
1708255324506,SE 101B,A01,447040,Kosmatka; John B,55,0,56,1
1708255325032,SE 105,A01,447042,Qiao; Yu,118,0,120,2
1708255325560,SE 110A,A01,467467,Asaro; Robert J,56,0,56,0
1708255326087,SE 110B,A00,447045,Zhu; Qiang,122,0,125,3
1708255326615,SE 130B,A01,447049,Chadha; Mayank,92,0,100,8
1708255327144,SE 131A,A01,447059,Krysl; Petr,102,0,110,8
1708255327670,SE 132,A01,447078,Chen; Jiun-Shyan,48,0,50,2
1708255328194,SE 140B,A01,447086,Restrepo; Jose,29,0,34,5
1708255328194,SE 140B,A02,447123,Restrepo; Jose,21,0,33,12
1708255328194,SE 140B,A03,447124,Restrepo; Jose,30,0,33,3
1708255328719,SE 143B,A01,447133,Tehrani; Mehran,11,0,15,4
1708255328719,SE 143B,A02,447134,Tehrani; Mehran,12,0,15,3
1708255329247,SE 150A,A01,447136,Uang; Chia-Ming,94,0,100,6
1708255329773,SE 150B,A01,447214,Morrison; Machel Leigh,49,0,50,1
1708255330303,SE 151B,A00,447215,Shing; P. Benson,71,0,75,4
1708255330829,SE 160B,A01,467468,Kim; Hyunsun Alicia,91,0,100,9
1708255331355,SE 165,A00,447238,Farrar; Charles R.,9,0,10,1
1708255331883,SE 184,A00,447253,Hutchinson; Tara,20,0,20,0
1708255332412,SE 202,A00,447392,Kosmatka; John B,25,0,30,5
1708255332939,SE 204,A00,447482,Todd; Michael,12,0,20,8
1708255333469,SE 206,A00,447483,Conte; Joel P,30,0,30,0
1708255333995,SE 213,A00,447499,Palermo; Alessandro,17,0,30,13
1708255334524,SE 215,A00,447500,Zhu; Qiang,34,0,45,11
1708255335050,SE 222,A00,447507,Elgamal; Ahmed,30,0,30,0
1708255335577,SE 227,A00,447576,Hutchinson; Tara,20,0,25,5
1708255336105,SE 244,A00,447577,Elgamal; Ahmed,29,0,30,1
1708255336631,SE 247,A00,447580,Hutchinson; Tara,0,0,5,5
1708255337161,SE 251B,A00,447612,Qiao; Yu,15,0,25,10
1708255337687,SE 253B,A00,447613,Kim; Hyonny,28,0,30,2
1708255338218,SE 260B,A00,447614,Kim; Hyunsun Alicia,10,0,10,0
1708255338744,SE 265,A00,447615,Farrar; Charles R.,20,0,25,5
1708255339271,SE 266,A00,447616,Loh; Chin Hsiung,23,0,25,2
1708255340328,SE 280,A00,447650,Krysl; Petr,22,0,25,3
1708255340870,SE 281,A01,447658,Kuester; Falko,12,0,30,18
1708255341397,SE 290,A00,447659,Qiao; Yu,78,0,100,22
1708255341952,SE 296,001,447666,Asaro; Robert J,9999,0,9999,0
1708255341952,SE 296,002,447669,Chen; Jiun-Shyan,9999,0,9999,0
1708255341952,SE 296,003,447689,Conte; Joel P,9999,0,9999,0
1708255341952,SE 296,004,447690,Elgamal; Ahmed,9999,0,9999,0
1708255341952,SE 296,005,447728,Hutchinson; Tara,9999,0,9999,0
1708255341952,SE 296,006,447733,Jandaghi Semnani; Shabnam,9999,0,9999,0
1708255341952,SE 296,007,447734,Kim; Hyonny,9999,0,9999,0
1708255341952,SE 296,008,447737,Kim; Hyunsun Alicia,9999,0,9999,0
1708255341952,SE 296,009,447738,Kosmatka; John B,9999,0,9999,0
1708255341952,SE 296,010,447739,Krysl; Petr,9999,0,9999,0
1708255341952,SE 296,011,447740,Kuester; Falko,9999,0,9999,0
1708255341952,SE 296,012,447741,Lanza Di Scalea; Francesco,9999,0,9999,0
1708255341952,SE 296,013,447742,Loh; Kenneth J. H.,9999,0,9999,0
1708255341952,SE 296,014,447745,McCartney; John Scott,9999,0,9999,0
1708255341952,SE 296,015,447747,Morrison; Machel Leigh,9999,0,9999,0
1708255341952,SE 296,016,447749,Mosqueda; Gilberto,9999,0,9999,0
1708255341952,SE 296,017,447874,Qiao; Yu,9999,0,9999,0
1708255341952,SE 296,018,447875,Restrepo; Jose,9999,0,9999,0
1708255341952,SE 296,019,447886,Shing; P. Benson,9999,0,9999,0
1708255341952,SE 296,020,447887,Todd; Michael,9999,0,9999,0
1708255341952,SE 296,021,447888,Tomac; Ingrid,9999,0,9999,0
1708255341952,SE 296,022,447889,Tsampras; Georgios,9999,0,9999,0
1708255341952,SE 296,023,447890,Uang; Chia-Ming,9999,0,9999,0
1708255341952,SE 296,024,447931,Van Den Einde; Yael Dahlia,9999,0,9999,0
1708255341952,SE 296,025,447932,Zhu; Qiang,9999,0,9999,0
1708255341952,SE 296,026,448007,Tehrani; Mehran,9999,0,9999,0
1708255341952,SE 296,027,448008,Palermo; Alessandro,9999,0,9999,0
1708255341952,SE 296,028,492941,Farrar; Charles R.,9998,0,9999,1
1708255342482,SIO 10,A00,446025,Borsa; Adrian Antal,573,0,590,17
1708255343012,SIO 16,A00,446031,Gee; Jeffrey S,119,0,120,1
1708255343554,SIO 50,A01,446057,Cook; Geoffrey W,19,0,22,3
1708255343554,SIO 50,A02,446058,Cook; Geoffrey W,21,0,22,1
1708255344085,SIO 75,A00,446060,Norris; Richard D.,32,0,35,3
1708255344616,SIO 87,A00,479215,Feddersen; Falk & Morzfeld; Matthias,20,0,20,0
1708255344616,SIO 87,B00,489613,Cook; Geoffrey W,19,0,20,1
1708255344616,SIO 87,C00,489620,Cook; Geoffrey W,20,0,20,0
1708255345142,SIO 90,A00,446061,Staff,61,0,70,9
1708255345668,SIO 113,A01,446064,May; David Alexander,27,0,30,3
1708255346722,SIO 128,A00,446115,Bartlett; Douglas H,110,0,120,10
1708255347247,SIO 135,A01,446153,Fricker; Helen A.,16,0,17,1
1708255347247,SIO 135,A02,446156,Fricker; Helen A.,14,0,18,4
1708255347783,SIO 136,A01,446159,Kacev; David & Wegner; Nicholas Craig & Bartlett; Douglas H,31,0,33,2
1708255347783,SIO 136,A02,446160,Kacev; David & Wegner; Nicholas Craig & Bartlett; Douglas H,33,0,33,0
1708255348308,SIO 139,A00,446164,Kacev; David,66,0,70,4
1708255348833,SIO 141,A01,446173,Pomeroy; Robert S.,11,0,12,1
1708255349363,SIO 143,A01,446175,Andersson; Andreas Jerry,20,0,30,10
1708255349906,SIO 145,A01,446181,Choy; Carolyn Anela,6,0,18,12
1708255350437,SIO 152,A01,446184,Van Allen; Emily Joyce,8,0,10,2
1708255350437,SIO 152,A02,479204,Van Allen; Emily Joyce,10,0,10,0
1708255350971,SIO 153,A01,446188,Capaldi; Tomas,24,0,26,2
1708255351497,SIO 160,A00,446189,Stegman; David,21,0,25,4
1708255352027,SIO 164,A00,446193,Staff,27,0,35,8
1708255352553,SIO 173,A00,446194,Lutsko; Nicholas J.,28,0,30,2
1708255353080,SIO 174,A00,446197,Aluwihare; Lihini & Russell; Lynn M.,26,0,30,4
1708255353612,SIO 181,A01,446200,Tresguerres; Martin,18,0,25,7
1708255353612,SIO 181,A02,446201,Tresguerres; Martin,23,0,25,2
1708255353612,SIO 181,A03,446209,Tresguerres; Martin,24,0,25,1
1708255353612,SIO 181,A04,446211,Tresguerres; Martin,24,0,25,1
1708255353612,SIO 181,A05,446223,Tresguerres; Martin,24,0,25,1
1708255353612,SIO 181,A06,446236,Tresguerres; Martin,24,0,25,1
1708255354140,SIO 192,A00,479211,Gerwick; William Henry,20,0,20,0
1708255354666,SIO 194,A00,455340,Hill; Seth J,0,0,0,0
1708255355193,SIOB 262,A00,446243,Gerwick; William Henry,23,0,25,2
1708255355721,SIOB 269,A00,446244,Staff,19,0,20,1
1708255356262,SIOB 270,A01,446261,Allen; Andrew Ellis & Petrik; Colleen Mary,18,0,20,2
1708255356787,SIOB 278,A00,446273,Arcila; Dahiana K,13,0,15,2
1708255356787,SIOB 278,B00,481742,Aburto Oropeza; Marco Octavio,18,0,20,2
1708255357316,SIOB 279,A00,446286,Franks; Peter,31,0,35,4
1708255357842,SIOB 291,A00,446292,Hechinger; Ryan F.,20,0,20,0
1708255358371,SIOB 296,A00,446293,Mongiardino Koch; Nicolas,16,0,20,4
1708255358898,SIOB 297,A00,446294,Allen; Eric,66,0,70,4
1708255359427,SIOC 202B,A00,446312,Stramski; Dariusz & Gabriel; Anne Alice-Agnes,17,0,20,3
1708255359953,SIOC 203C,A01,446314,Young; William Roy,5,0,5,0
1708255360481,SIOC 207C,A00,492798,Vasconcelos; Manuela,5,0,5,0
1708255361008,SIOC 208,A00,446315,Merrifield; Mark A,16,0,20,4
1708255361543,SIOC 209,A00,478924,Werner; Bradley T.,11,0,15,4
1708255361543,SIOC 209,B00,479224,Watson-Parris; Duncan,15,0,25,10
1708255361543,SIOC 209,C00,480739,Ricke; Katharine L,24,0,24,0
1708255362088,SIOC 212B,A01,446324,Cessi; Paola,40,0,40,0
1708255362615,SIOC 217C,A00,446325,Lutsko; Nicholas J.,25,0,25,0
1708255363145,SIOC 220,A00,446326,Rudnick; Daniel Lars,13,0,15,2
1708255363674,SIOC 224,A00,446327,Eisenman; Ian,20,0,25,5
1708255364201,SIOC 228,A00,446328,Shi; Yuanyuan,1,0,10,9
1708255364728,SIOC 235,A00,446342,Xie; Shang-Ping,14,0,15,1
1708255365256,SIOC 251,A00,446343,Evan; Amato Tomas,19,0,20,1
1708255365781,SIOG 200B,A00,446344,Gabriel; Anne Alice-Agnes,9,0,10,1
1708255366310,SIOG 221,A00,446354,Parnell-Turner; Ross Ernes,29,0,30,1
1708255366836,SIOG 227B,A00,446355,Laske; Gabi & Shearer; Peter M,19,0,20,1
1708255367360,SIOG 228,A00,446356,Van Allen; Emily Joyce,7,0,20,13
1708255367888,SIOG 230,A00,446359,Constable; Catherine G,25,0,25,0
1708255368414,SIOG 232,A00,446360,Constable; Catherine G & Constable; Steven C,37,0,40,3
1708255368942,SIOG 234,A00,446361,Sandwell; David T,15,0,15,0
1708255369466,SIOG 236,A01,477658,Fricker; Helen A.,5,0,5,0
1708255369466,SIOG 236,A02,477685,Fricker; Helen A.,3,0,5,2
1708255369993,SIOG 239,A00,446362,Gabriel; Anne Alice-Agnes,19,0,20,1
1708255369993,SIOG 239,B00,481507,May; David Alexander,6,0,6,0
1708255369993,SIOG 239,C00,486863,Fialko; Yuri A.,15,0,15,0
1708255370524,SIOG 268,A00,446364,Barbeau; Katherine,12,0,15,3
1708255371050,SOCE 194,A00,455341,Hill; Seth J,0,0,0,0
1708255371575,SOCG 204,A00,446551,Ng; Kwai,0,0,8,8
1708255372105,SOCG 206,A00,446552,Alvarez; Camila Huerta,4,0,8,4
1708255372685,SOCG 214,A00,446553,Raudenbush; Danielle,3,0,8,5
1708255373209,SOCG 255B,A00,446602,Serlin; David,2,0,5,3
1708255373738,SOCG 255C,A00,446813,Gates; Kelly,3,0,5,2
1708255374270,SOCG 290,A00,446910,Thorpe; Charles Robert,0,0,10,10
1708255374270,SOCG 290,B00,446911,Goldman; Harvey Stern,1,0,10,9
1708255374270,SOCG 290,C00,446914,Lampland; Martha,5,0,10,5
1708255375813,SOCI 2,A01,446373,Rogers; Julia Ellen,28,0,30,2
1708255375813,SOCI 2,A02,446374,Rogers; Julia Ellen,29,0,30,1
1708255375813,SOCI 2,A03,446382,Rogers; Julia Ellen,29,0,30,1
1708255375813,SOCI 2,A04,446384,Rogers; Julia Ellen,30,0,30,0
1708255375813,SOCI 2,A05,446389,Rogers; Julia Ellen,30,0,30,0
1708255375813,SOCI 2,A06,446393,Rogers; Julia Ellen,29,0,30,1
1708255376364,SOCI 20,A01,446396,Calderon-Zaks; Michael Aar,33,0,34,1
1708255376364,SOCI 20,A02,446409,Calderon-Zaks; Michael Aar,34,0,34,0
1708255376909,SOCI 40,A01,446417,Raudenbush; Danielle,30,0,32,2
1708255376909,SOCI 40,A02,446419,Raudenbush; Danielle,31,0,32,1
1708255376909,SOCI 40,A03,446434,Raudenbush; Danielle,31,0,32,1
1708255376909,SOCI 40,A04,446436,Raudenbush; Danielle,28,0,32,4
1708255376909,SOCI 40,A05,446441,Raudenbush; Danielle,29,0,32,3
1708255376909,SOCI 40,A06,446445,Raudenbush; Danielle,32,0,32,0
1708255377453,SOCI 60,A01,446461,Sutton; April Marie,30,0,32,2
1708255377453,SOCI 60,A02,446468,Sutton; April Marie,30,0,32,2
1708255377453,SOCI 60,A03,446469,Sutton; April Marie,26,0,32,6
1708255377453,SOCI 60,A04,446471,Sutton; April Marie,31,0,32,1
1708255377983,SOCI 100,A01,446480,Payne; Christine Anna,28,0,30,2
1708255377983,SOCI 100,A02,446491,Payne; Christine Anna,29,0,30,1
1708255377983,SOCI 100,A03,446492,Payne; Christine Anna,28,0,30,2
1708255377983,SOCI 100,A04,446493,Payne; Christine Anna,27,0,30,3
1708255378510,SOCI 103M,A00,481672,Kilpatrick; Kevin,27,0,28,1
1708255379036,SOCI 104,A00,446494,Turner; Christena L.,28,0,30,2
1708255379580,SOCI 104Q,A00,446495,Rogers; Julia Ellen,27,0,30,3
1708255380109,SOCI 106,A00,446496,Payne; Christine Anna,25,0,30,5
1708255380697,SOCI 107,A00,446497,Staff,30,0,30,0
1708255381222,SOCI 109,A00,446498,Rona-Tas; Akos,20,0,25,5
1708255381765,SOCI 111,A00,446499,Ribas Norris; Janet Vanesa,54,0,56,2
1708255382290,SOCI 114,A00,446500,Lampland; Martha,73,0,75,2
1708255382823,SOCI 117,A01,446502,Jones; Gabrielle Anastasia,14,0,17,3
1708255382823,SOCI 117,A02,446516,Jones; Gabrielle Anastasia,17,0,17,0
1708255382823,SOCI 117,A03,458787,Jones; Gabrielle Anastasia,17,0,17,0
1708255382823,SOCI 117,A04,458835,Jones; Gabrielle Anastasia,19,0,19,0
1708255383351,SOCI 120T,A00,446518,Staff,56,0,56,0
1708255383876,SOCI 123,A00,446519,Staff,79,0,80,1
1708255384402,SOCI 125,A00,487186,Calderon-Zaks; Michael Aar,55,0,56,1
1708255384928,SOCI 126,A01,446532,Jones; Makeba,15,0,15,0
1708255384928,SOCI 126,A02,446533,Jones; Makeba,15,0,15,0
1708255384928,SOCI 126,A03,458839,Jones; Makeba,15,0,15,0
1708255384928,SOCI 126,A04,458840,Jones; Makeba,15,0,15,0
1708255385459,SOCI 133,A00,446534,Calderon-Zaks; Michael Aar,53,0,56,3
1708255385987,SOCI 135,A00,486886,Ruiz; Jonathan Joseph,55,0,56,1
1708255386512,SOCI 136,A00,486887,Ruiz; Jonathan Joseph,56,0,56,0
1708255387044,SOCI 139,A00,446535,Ribas Norris; Janet Vanesa,78,0,80,2
1708255387569,SOCI 140J,A00,446537,Estefan; Michel,75,0,100,25
1708255388096,SOCI 142,A00,477639,Crofts; Christine,43,0,50,7
1708255388638,SOCI 146,A00,446538,Summers; Valerie R.,113,0,120,7
1708255389183,SOCI 151,A00,446540,Goldman; Harvey Stern,56,0,56,0
1708255389708,SOCI 156,A00,446541,Ostovany; Khashayar,55,0,56,1
1708255390237,SOCI 157,A00,446542,Jules-Rosette; Bennetta W.,28,0,28,0
1708255390763,SOCI 159,A00,494493,Estefan; Michel,93,0,96,3
1708255391287,SOCI 161,A00,477638,Staff,45,0,45,0
1708255391812,SOCI 162,A00,477642,Staff,54,0,55,1
1708255392341,SOCI 165,A00,446543,Rona-Tas; Akos,49,0,56,7
1708255392871,SOCI 171,A00,446544,Thorpe; Charles Robert,56,0,56,0
1708255393399,SOCI 173,A00,482888,Crofts; Christine,92,0,100,8
1708255393925,SOCI 180,A00,446545,Ostovany; Khashayar,55,0,56,1
1708255394455,SOCI 183,A00,446546,Sutton; April Marie,43,0,45,2
1708255394980,SOCI 185,A00,494495,Staff,30,0,30,0
1708255395506,SOCI 188D,A00,446549,Kokinis; Troy Andreas,24,0,25,1
1708255396031,SOCI 198RA,001,446550,Ng; Kwai,30,0,30,0
1708255396556,SOMC 224C,A00,466928,Bhakta; Savita Ganapathi,160,0,160,0
1708255397082,SOMC 229,A00,466925,Hoang; Mai Phuong,160,0,160,0
1708255397606,SOMC 240,A00,466937,Coyne; Christopher John,150,0,150,0
1708255398133,SOMC 242,A00,466931,Kline; Ahnika Sarah,160,0,160,0
1708255398660,SOMC 244,A00,466939,Mandel; Jess,150,0,150,0
1708255399187,SOMC 245C,A01,466935,Noel; Geoffroy Pierre Jean,160,0,160,0
1708255399715,SOMC 246C,A00,487163,Eyler; Lisa T.,160,0,160,0
1708255400241,SOMC 247C,A50,466950,Calcutt; Nigel A,160,0,160,0
1708255400771,SOMC 248C,A00,466936,Joshi; Weena Erin,160,0,160,0
1708255401296,SOMC 255C,A00,466951,Allison; Matthew,160,0,160,0
1708255402060,SPPH 161R,A01,476600,Chambers; Christina D,99,0,100,1
1708255402592,SPPH 263B,A01,460901,Hook; Vivian Yuan-Ho,25,0,25,0
1708255403116,SPPS 200A,A00,460907,Luli; Alex J,99,0,99,0
1708255403641,SPPS 200B,A00,460928,Luli; Alex J,99,0,99,0
1708255404168,SPPS 200C,A00,460934,Luli; Alex J,95,0,99,4
1708255404695,SPPS 203,A00,460955,Painter; Nathan A.,83,0,99,16
1708255405221,SPPS 205,A01,460978,Bandeira; Nuno Filipe Cabrita,64,0,80,16
1708255405747,SPPS 209,A00,460979,Bounthavong; Mark,94,0,99,5
1708255406273,SPPS 210,001,460980,Gustafsson; Asa Birgitta,99,0,99,0
1708255406802,SPPS 211A,A00,460987,Ferguson; Fleur,85,0,99,14
1708255407327,SPPS 211B,A00,460991,Ferguson; Fleur,96,0,99,3
1708255407852,SPPS 211C,A00,460992,Ferguson; Fleur,95,0,99,4
1708255408377,SPPS 211D,A00,460993,Tsunoda; Shirley M.,99,0,99,0
1708255408905,SPPS 212C,A01,460995,Saunders; Ila Maewal,95,0,99,4
1708255409431,SPPS 213C,A00,460996,Awdishu; Linda,95,0,99,4
1708255409957,SPPS 218B,A00,460997,Mandyam; Chitra,95,0,99,4
1708255410487,SPPS 225,A01,460999,Reed; Chantal,83,0,99,16
1708255411029,SPPS 236,A00,461000,Reid; Erin G.,96,0,99,3
1708255411558,SPPS 237,A00,461002,Mimoto; Mizuho Stacy,96,0,99,3
1708255412084,SPPS 238,A00,461041,Beyhan; Sinem,96,0,99,3
1708255412610,SPPS 241,A01,461122,Tsunoda; Shirley M.,83,0,99,16
1708255413140,SPPS 249,A00,461123,Brandl; Katharina,96,0,99,3
1708255413667,SPPS 250,A00,461126,Tsunoda; Shirley M.,45,0,50,5
1708255414195,SPPS 251,A00,461127,Chen; Timothy,99,0,99,0
1708255414722,SPPS 252,A00,461128,Abdul-Mutakabbir; Jacinda,74,0,80,6
1708255416263,SPPS 254,A00,481670,Shapiro; Desiree Nicolette,77,0,80,3
1708255416789,SPPS 261,A00,461129,Chambers; Christina D,93,0,99,6
1708255417316,SPPS 278,A00,459983,Fricovsky; Eduardo Santiago,98,0,99,1
1708255417846,SPPS 280,A00,461259,Fricovsky; Eduardo Santiago,19,0,20,1
1708255418375,SPPS 283,A00,461283,Tsunoda; Shirley M.,96,0,99,3
1708255418903,SURG 261,A00,466973,Staff,50,0,50,0
1708255419429,SURG 296,001,467004,Agha Hosseini; Ava,49,0,50,1
1708255419429,SURG 296,002,467005,Hinchcliff; Katharine Moss,49,0,50,1
1708255419429,SURG 296,003,467006,Eliceiri; Brian,49,0,50,1
1708255420026,SYN 1,001,448577,Bishop; Graham,19,0,20,1
1708255420026,SYN 1,002,448578,Iatarola; Briana Marie,19,0,20,1
1708255420026,SYN 1,003,448579,Browne; Emily,20,0,20,0
1708255420026,SYN 1,004,448580,Vega; Adrian,20,0,20,0
1708255420026,SYN 1,005,448581,Browne; Emily,20,0,20,0
1708255420026,SYN 1,006,448582,Rock; Martin,20,0,20,0
1708255420026,SYN 1,007,448583,Rock; Martin,20,0,20,0
1708255420026,SYN 1,008,448584,Iatarola; Briana Marie,19,0,20,1
1708255420026,SYN 1,009,448585,Bishop; Graham,20,0,20,0
1708255420026,SYN 1,010,448586,Bishop; Graham,20,0,20,0
1708255420026,SYN 1,011,448587,Gladstein; Jill M,15,0,15,0
1708255420026,SYN 1,012,448588,Meyer; Leslie Rose,20,0,20,0
1708255420026,SYN 1,013,448589,Rosenberg; Ryan Glenn,20,0,20,0
1708255420026,SYN 1,014,448627,Rosenberg; Ryan Glenn,19,0,20,1
1708255420026,SYN 1,015,448630,Atkinson; Arthur Laird,20,0,20,0
1708255420026,SYN 1,016,448651,Hom; Kirstyn Courtney,20,0,20,0
1708255420026,SYN 1,017,448652,Difruscio; Mark,20,0,20,0
1708255420026,SYN 1,018,448669,Hom; Kirstyn Courtney,20,0,20,0
1708255420026,SYN 1,019,448674,Hom; Kirstyn Courtney,18,0,20,2
1708255420026,SYN 1,020,448675,Atkinson; Arthur Laird,20,0,20,0
1708255420026,SYN 1,021,448678,Gladstein; Jill M,15,0,15,0
1708255420026,SYN 1,022,448682,Iatarola; Briana Marie,20,0,20,0
1708255420026,SYN 1,023,448691,Birberick; Brittany Celest,20,0,20,0
1708255420026,SYN 1,024,448751,Birberick; Brittany Celest,20,0,20,0
1708255420026,SYN 1,027,448766,Deavenport; James Cary,19,0,20,1
1708255420026,SYN 1,028,448767,Meyer; Leslie Rose,20,0,20,0
1708255420026,SYN 1,029,448775,Tawater; Hanna Jean,20,0,20,0
1708255420026,SYN 1,030,448777,Tawater; Hanna Jean,20,0,20,0
1708255420026,SYN 1,031,448792,Deavenport; James Cary,20,0,20,0
1708255420026,SYN 1,032,480169,Tawater; Hanna Jean,18,0,20,2
1708255420553,SYN 1R,001,448793,Difruscio; Mark,20,0,20,0
1708255420553,SYN 1R,004,449146,Difruscio; Mark,20,0,20,0
1708255421184,SYN 100,A01,449148,Staff,11,0,15,4
1708255421184,SYN 100,A02,449149,Staff,15,0,15,0
1708255421184,SYN 100,B01,449164,Gladstein; Jill M,0,0,0,0
1708255421184,SYN 100,B02,449166,Gladstein; Jill M,0,0,0,1
1708255421184,SYN 100,C01,449244,Staff,7,0,15,8
1708255421184,SYN 100,C02,449274,Staff,13,0,15,2
1708255421184,SYN 100,D01,449278,Staff,20,0,20,0
1708255421184,SYN 100,D02,449279,Staff,20,0,20,0
1708255421184,SYN 100,E01,449281,Rock; Martin,9,0,15,6
1708255421184,SYN 100,E02,449282,Rock; Martin,14,0,15,1
1708255421184,SYN 100,F01,449304,Browne; Emily,12,0,15,3
1708255421184,SYN 100,F02,449306,Browne; Emily,14,0,15,1
1708255421184,SYN 100,I01,449390,Gormally; Brenna,0,0,0,0
1708255421184,SYN 100,I02,449391,Gormally; Brenna,0,0,0,0
1708255421184,SYN 100,J01,449401,Atkinson; Arthur Laird,11,0,15,4
1708255421184,SYN 100,J02,449402,Atkinson; Arthur Laird,14,0,15,1
1708255421184,SYN 100,K01,449404,Deavenport; James Cary,11,0,15,4
1708255421184,SYN 100,K02,449405,Deavenport; James Cary,14,0,15,1
1708255421184,SYN 100,L01,449408,Rosenberg; Ryan Glenn,10,0,15,5
1708255421184,SYN 100,L02,449420,Rosenberg; Ryan Glenn,15,0,15,0
1708255421710,SYN 150,001,450016,Vega; Adrian,19,0,19,0
1708255421710,SYN 150,003,450031,Birberick; Brittany Celest,20,0,20,0
1708255422236,SYN 150R,001,494950,Vega; Adrian,20,0,20,0
1708255422766,SYN 198,001,494388,Staff,9999,0,9999,0
1708255423311,TDAC 1,A00,450042,Walsh; Kim C.,14,0,20,6
1708255423311,TDAC 1,B00,450043,Walsh; Kim C.,11,0,20,9
1708255423311,TDAC 1,C00,450044,Walsh; Kim C.,15,0,20,5
1708255423311,TDAC 1,D00,486830,Basso; Beatrice,20,0,20,0
1708255423311,TDAC 1,E00,492912,Walsh; Kim C.,15,0,20,5
1708255423311,TDAC 1,F00,492936,Walsh; Kim C.,18,0,20,2
1708255424076,TDAC 101,A00,450895,Celik; Aysan Karagasli,18,0,20,2
1708255424603,TDAC 102,A00,450904,Walsh; Kim C.,20,0,20,0
1708255424603,TDAC 102,B00,450916,Harting; Carla Kelso,20,0,20,0
1708255425144,TDAC 108,A00,450917,Buescher; Stephen W.,18,0,20,2
1708255425670,TDAC 109,A00,450924,Blair; Kyle Adam,20,0,20,0
1708255426201,TDAC 122,A00,451025,Perry; Lamar,30,0,30,0
1708255426201,TDAC 122,B00,480845,Perry; Lamar,30,0,30,0
1708255426744,TDAC 123,A00,451026,Buescher; Stephen W.,30,0,30,0
1708255426744,TDAC 123,B00,451028,Celik; Aysan Karagasli,30,0,30,0
1708255426744,TDAC 123,C00,480851,Perry; Lamar,30,0,30,0
1708255427284,TDDE 101,A00,451030,Guirguis; Mark C,18,0,20,2
1708255427810,TDDE 112,A00,451032,Staff,20,0,20,0
1708255428337,TDDE 130,A00,451033,Guirguis; Mark C,19,0,20,1
1708255428919,TDDE 132,A00,451034,Guirguis; Mark C,20,0,20,0
1708255429449,TDDE 169A,A00,481304,Petrovich; Victoria A.,19,0,20,1
1708255429980,TDDM 1,A00,450045,Weinberg; Sadie,27,0,30,3
1708255430509,TDDM 101,A00,451067,Staff,29,0,30,1
1708255431036,TDDR 101,A00,451068,Powell; Lora,29,0,34,5
1708255431562,TDDR 102,A00,451069,Powell; Lora,19,0,20,1
1708255432089,TDDR 111,A00,451070,Castro; Robert Jess,15,0,16,1
1708255432089,TDDR 111,B00,451071,Castro; Robert Jess,15,0,16,1
1708255432615,TDDR 190,A00,451073,Perry; Lamar,1,0,1,0
1708255433147,TDGE 1,A01,450047,Salovey; Todd,20,0,20,0
1708255433147,TDGE 1,A02,450048,Salovey; Todd,20,0,20,0
1708255433147,TDGE 1,A03,450085,Salovey; Todd,18,0,20,2
1708255433147,TDGE 1,A04,450093,Salovey; Todd,20,0,20,0
1708255433147,TDGE 1,A05,450096,Salovey; Todd,19,0,20,1
1708255433147,TDGE 1,A06,450132,Salovey; Todd,16,0,20,4
1708255433674,TDGE 25,A00,450236,Harting; Carla Kelso,12,0,20,8
1708255433674,TDGE 25,B00,450240,Harting; Carla Kelso,16,0,20,4
1708255433674,TDGE 25,C00,450243,Harting; Carla Kelso,14,0,20,6
1708255433674,TDGE 25,D00,450388,Harting; Carla Kelso,16,0,20,4
1708255434198,TDGE 100,A01,451098,Salovey; Todd,24,0,25,1
1708255434198,TDGE 100,A02,451099,Salovey; Todd,24,0,25,1
1708255434727,TDGE 124,A00,451122,Fulton; Julia,168,0,200,32
1708255435253,TDGE 125,A00,480853,Havis; Allan,197,0,200,3
1708255435253,TDGE 125,B00,480886,Staff,216,0,220,4
1708255435780,TDGE 133,A00,481097,Brill; Robert L.,20,0,20,0
1708255436314,TDGE 196B,A00,493144,Barricelli; Marc Alexander,1,0,1,0
1708255436314,TDGE 196B,B00,493148,Buescher; Stephen W.,2,0,2,0
1708255436314,TDGE 196B,C00,493151,Burelle; Julie Sara Veronique,1,0,1,0
1708255436314,TDGE 196B,D00,493189,Castro; Robert Jess,2,0,2,0
1708255436314,TDGE 196B,E00,493190,Guirguis; Mark C,1,0,1,0
1708255436314,TDGE 196B,F00,493240,Iizuka; Naomi Hisako,1,0,1,0
1708255436314,TDGE 196B,G00,493241,Perry; Lamar,1,0,1,0
1708255436314,TDGE 196B,H00,493249,Powell; Lora,1,0,1,0
1708255436314,TDGE 196B,I00,493296,Stein; Deborah Isobel,6,0,6,0
1708255436842,TDGR 213C,A00,451385,Buescher; Stephen W.,10,0,10,0
1708255437368,TDGR 220A,A00,451386,Barricelli; Marc Alexander,10,0,10,0
1708255437894,TDGR 239,A00,451387,Blair; Kyle Adam,10,0,10,0
1708255438421,TDGR 240,A00,481306,Portes; Elizabeth Marie,5,0,5,0
1708255438948,TDGR 245,A00,451388,Perry; Lamar,7,0,7,0
1708255439476,TDGR 250,A00,451395,Iizuka; Naomi Hisako,8,0,10,2
1708255440004,TDGR 251,A00,451397,Iizuka; Naomi Hisako,9,0,10,1
1708255440004,TDGR 251,B00,451398,Stein; Deborah Isobel,9,0,10,1
1708255440529,TDGR 257B,A00,451399,Finch; Michael S,8,0,10,2
1708255441059,TDGR 278,A00,481307,Petrovich; Victoria A.,4,0,5,1
1708255441590,TDGR 279,A00,451400,Bokovikova; Alina V,9,0,10,1
1708255441590,TDGR 279,B00,451401,Brill; Robert L.,10,0,10,0
1708255441590,TDGR 279,C00,451402,Petrovich; Victoria A.,10,0,10,0
1708255441590,TDGR 279,D00,451403,McElver; Robert Harrison,10,0,10,0
1708255441590,TDGR 279,E00,451404,Kuhl; Christopher August,10,0,10,0
1708255442117,TDGR 286,A00,451405,Knox; Leila Elizabeth,9,0,10,1
1708255442646,TDGR 288,A00,451406,Powell; Lora,6,0,7,1
1708255443172,TDGR 292,A00,451407,Power; Jade Yukana,10,0,10,0
1708255443172,TDGR 292,B00,451408,Mehrishi; Rishika,10,0,10,0
1708255443702,TDGR 293,001,451417,Power; Jade Yukana,7,0,7,0
1708255443702,TDGR 293,002,451418,Burelle; Julie Sara Veronique,7,0,7,0
1708255443702,TDGR 293,003,451419,Yapp; Hentyle T,7,0,7,0
1708255443702,TDGR 293,005,451421,Anderson; Mysia Anyse,7,0,7,0
1708255444228,TDGR 294,001,451429,Burelle; Julie Sara Veronique,7,0,7,0
1708255444228,TDGR 294,002,451431,Power; Jade Yukana,7,0,7,0
1708255444228,TDGR 294,003,451432,Yapp; Hentyle T,7,0,7,0
1708255444754,TDGR 295,A00,451433,Barricelli; Marc Alexander,10,0,10,0
1708255445287,TDGR 296,A00,451489,Powell; Lora,6,0,7,1
1708255445287,TDGR 296,B00,451497,Porter; Lisa,6,0,7,1
1708255445817,TDHD 175,A00,451123,Jun; Grace Shin Hae,40,0,40,0
1708255446353,TDHD 176,A00,451124,Caligagan; Maria T.,40,0,40,0
1708255446881,TDHT 10,A00,450409,Power; Jade Yukana,20,0,20,0
1708255446881,TDHT 10,B00,450450,Power; Jade Yukana,19,0,20,1
1708255447409,TDHT 23,A01,450546,Salimi; Rana,24,0,24,0
1708255447409,TDHT 23,A02,450549,Salimi; Rana,22,0,24,2
1708255447409,TDHT 23,A03,450553,Salimi; Rana,24,0,24,0
1708255447934,TDHT 101,A00,451125,Anderson; Mysia Anyse,25,0,25,0
1708255447934,TDHT 101,B00,451126,Mehrishi; Rishika,23,0,25,2
1708255448471,TDHT 104,A00,451225,Basso; Beatrice,22,0,25,3
1708255448999,TDHT 109,A01,451227,Anderson; Mysia Anyse,25,0,25,0
1708255449526,TDHT 122,A00,451228,Power; Jade Yukana,21,0,25,4
1708255450054,TDMV 1,A00,450558,Caligagan; Maria T.,15,0,30,15
1708255450585,TDMV 2,A00,450627,Anabo; Cherry,24,0,30,6
1708255451112,TDMV 3,A00,450630,Arcidiacono; Kristin,37,0,40,3
1708255451643,TDMV 11,A00,481244,Fyall; DauntÉ Edward,30,0,30,0
1708255452168,TDMV 20,A00,450789,Smith; Alison D,38,0,40,2
1708255452695,TDMV 110,A00,451229,Caligagan; Maria T.,28,0,30,2
1708255453225,TDMV 111,A00,451234,Smith; Alison D,28,0,30,2
1708255453752,TDMV 120,A00,451260,Weinberg; Sadie,30,0,30,0
1708255453752,TDMV 120,B00,451261,Sammartano; Tonnie,30,0,30,0
1708255454278,TDMV 122,A00,451262,Staff,28,0,30,2
1708255454804,TDMV 123,A00,451263,Duran; Marcos Antonio,28,0,30,2
1708255455333,TDMV 130,A00,451272,Mack; Kara Shanai',30,0,30,0
1708255455859,TDMV 138,A00,451275,Jun; Grace Shin Hae,4,0,30,26
1708255456396,TDMV 140,A00,451276,Lima; Paulo Henrique,40,0,40,0
1708255456396,TDMV 140,B00,451308,Power; Jade Yukana,39,0,40,1
1708255456396,TDMV 140,C00,451371,Caligagan; Tony,40,0,40,0
1708255456396,TDMV 140,D00,451373,Corrales; Joseph Bernales,28,0,30,2
1708255456924,TDMV 141,A00,451374,Caligagan; Tony,26,0,30,4
1708255457450,TDMV 142,A00,451375,Blanco; Juan Carlos,26,0,40,14
1708255457979,TDMV 143,A00,451376,Fyall; DauntÉ Edward,39,0,40,1
1708255458506,TDMV 144,A00,451377,Anabo; Cherry,39,0,40,1
1708255459034,TDMV 149,A00,451378,Jun; Grace Shin Hae,36,0,40,4
1708255459560,TDPF 162,A00,451379,Alvarez; Ana Maria,40,0,40,0
1708255460088,TDPR 6,A01,450799,Guirguis; Mark C,50,0,50,0
1708255460088,TDPR 6,A02,450801,Guirguis; Mark C,50,0,50,0
1708255460614,TDPR 102,A00,451380,Guirguis; Mark C,20,0,20,0
1708255461143,TDPR 104,A00,451381,Powell; Lora,15,0,15,0
1708255461675,TDPW 1,A00,450808,Stein; Deborah Isobel,14,0,15,1
1708255461675,TDPW 1,B00,450864,Stein; Deborah Isobel,13,0,15,2
1708255461675,TDPW 1,C00,450865,Stein; Deborah Isobel,15,0,15,0
1708255461675,TDPW 1,D00,450868,Stein; Deborah Isobel,13,0,15,2
1708255461675,TDPW 1,E00,450874,Stein; Deborah Isobel,14,0,15,1
1708255462202,TDPW 102,A00,451382,Staff,18,0,20,2
1708255462729,TDPW 104,A00,481182,Staff,17,0,20,3
1708255463260,TDTR 10,A00,450881,Wilson; Terry A.,28,0,30,2
1708255463789,TDTR 15,A00,450882,Smith; Alison D,30,0,30,0
1708255464314,TMC 15,A00,479039,Hemans; Patricia Ann Benitez,25,0,25,0
1708255464839,TMC 87,A00,479049,Solomon; Amanda Lee Albaniel,20,0,20,0
1708255465368,UROL 296,001,467060,Anger; Jennifer Tash,49,0,50,1
1708255465368,UROL 296,002,467061,Staff,50,0,50,0
1708255465902,USP 3,A01,458852,Martin; Isaac,34,0,35,1
1708255465902,USP 3,A02,458853,Martin; Isaac,35,0,35,0
1708255465902,USP 3,A03,458861,Martin; Isaac,34,0,35,1
1708255465902,USP 3,A04,458862,Martin; Isaac,32,0,35,3
1708255466429,USP 4,A00,451772,Schwaller; Nora Louise,19,0,25,6
1708255466961,USP 5,A01,458863,Shenkman; Michael Thomas,33,0,35,2
1708255466961,USP 5,A02,458864,Shenkman; Michael Thomas,31,0,35,4
1708255467491,USP 15,A01,458931,Staff,33,0,35,2
1708255467491,USP 15,A02,459024,Staff,31,0,35,4
1708255468017,USP 25,A00,451786,Sun; Feiyang,57,0,60,3
1708255468547,USP 100,A00,451787,Moses; Kelema Lee,55,0,60,5
1708255469073,USP 108,A00,477594,Martin; Isaac,25,0,25,0
1708255469599,USP 119,A00,477595,Schwaller; Nora Louise,23,0,25,2
1708255470127,USP 124,A00,451790,Hinds; Juli Beth,62,0,70,8
1708255470653,USP 128B,A01,451910,Lewis; Leslie R,12,0,13,1
1708255471184,USP 142B,A01,451954,Lewis; Leslie R,24,0,25,1
1708255471710,USP 142C,A00,451977,Lerner; Amy M,0,0,0,0
1708255472243,USP 145,A00,451999,Yaghmaee; Saman,140,0,146,6
1708255472774,USP 150,A00,452165,Staff,44,0,50,6
1708255473303,USP 151,A00,452166,Staff,49,0,50,1
1708255473830,USP 152A,A01,459025,Weaver; Todd D,25,0,25,0
1708255473830,USP 152A,A02,459074,Weaver; Todd D,24,0,25,1
1708255474356,USP 152B,A00,452224,Moeder; Nathan L,21,0,25,4
1708255474881,USP 153,A00,452339,Shenkman; Michael Thomas,50,0,50,0
1708255475412,USP 158A,A00,452410,Sun; Feiyang,25,0,25,0
1708255475939,USP 159B,A00,452411,Gherini; Paul Pier-Carlo,6,0,8,2
1708255476468,USP 160,A00,452412,Wartell; Julie Dara,25,0,25,0
1708255476994,USP 164,A00,452413,Moses; Kelema Lee,22,0,25,3
1708255477529,USP 165C,A00,452442,Frank; Lawrence Douglas,20,0,20,0
1708255478056,USP 169,A00,452598,Bajaj; Ravi Siddharth,32,0,35,3
1708255478586,USP 170,A00,477593,Entezam; Maryam,60,0,60,0
1708255479114,USP 172,A00,452676,Peerson; Susan,19,0,25,6
1708255479640,USP 175,A00,452848,Velasco; Diego,18,0,20,2
1708255480168,USP 177A,A00,453084,Velasco; Diego,21,0,25,4
1708255480693,USP 177B,A00,453127,Peerson; Susan,22,0,25,3
1708255481220,USP 183,A00,453128,Sutton; April Marie,19,0,20,1
1708255481750,USP 188B,A00,453187,Pezzoli; Keith,30,0,30,0
1708255482329,USP 190,A00,453234,Pezzoli; Keith,0,0,0,1
1708255482856,USP 191B,A00,453240,Polat; Soydan Alihan,18,0,20,2
1708255483382,USP 193,A00,453251,Bussell; Mirle Rabinowitz,24,0,25,1
1708255483910,USP 194,A00,455342,Hill; Seth J,0,0,0,0
1708255484439,USP 265C,A00,453264,Frank; Lawrence Douglas,10,0,10,0
1708255484967,VIS 3,A01,453427,Staff,25,0,25,0
1708255484967,VIS 3,A02,453428,Staff,15,0,25,10
1708255484967,VIS 3,A03,453429,Staff,25,0,25,0
1708255484967,VIS 3,A04,453430,Staff,21,0,25,4
1708255484967,VIS 3,A05,453431,Staff,25,0,25,0
1708255484967,VIS 3,A06,453432,Staff,23,0,25,2
1708255484967,VIS 3,A07,453433,Staff,17,0,25,8
1708255484967,VIS 3,A08,453434,Staff,23,0,25,2
1708255484967,VIS 3,A09,453435,Staff,21,0,25,4
1708255484967,VIS 3,A10,453436,Staff,23,0,25,2
1708255485493,VIS 9,A00,453437,Camargo; William,116,0,146,30
1708255486019,VIS 10,A00,453438,Kiratli; Solen,189,0,200,11
1708255486548,VIS 21B,A01,453440,Shen; Kuiyi,31,0,32,1
1708255486548,VIS 21B,A02,453441,Shen; Kuiyi,31,0,32,1
1708255486548,VIS 21B,A03,453442,Shen; Kuiyi,31,0,32,1
1708255486548,VIS 21B,A04,453443,Shen; Kuiyi,32,0,32,0
1708255486548,VIS 21B,A05,453444,Shen; Kuiyi,32,0,32,0
1708255486548,VIS 21B,A06,453452,Shen; Kuiyi,32,0,32,0
1708255486548,VIS 21B,A07,453468,Shen; Kuiyi,30,0,32,2
1708255486548,VIS 21B,A08,453587,Shen; Kuiyi,32,0,32,0
1708255487080,VIS 22,A01,453589,Rose; Jordan M,32,0,32,0
1708255487080,VIS 22,A02,453590,Rose; Jordan M,32,0,32,0
1708255487080,VIS 22,A03,453615,Rose; Jordan M,31,0,32,1
1708255487080,VIS 22,A04,453616,Rose; Jordan M,32,0,32,0
1708255487080,VIS 22,A05,453617,Rose; Jordan M,30,0,32,2
1708255487080,VIS 22,A06,453618,Rose; Jordan M,30,0,32,2
1708255487080,VIS 22,A07,453620,Rose; Jordan M,32,0,32,0
1708255487080,VIS 22,A08,453621,Rose; Jordan M,32,0,32,0
1708255487080,VIS 22,A09,453635,Rose; Jordan M,32,0,32,0
1708255487080,VIS 22,A10,453636,Rose; Jordan M,32,0,32,0
1708255487606,VIS 31,A00,453637,Dominguez; Ricardo,133,0,146,13
1708255488133,VIS 41,A01,453644,D'Elena-Tweed; Jessica Erin,23,0,25,2
1708255488133,VIS 41,A02,453645,D'Elena-Tweed; Jessica Erin,22,0,25,3
1708255488133,VIS 41,A03,453646,D'Elena-Tweed; Jessica Erin,25,0,25,0
1708255488133,VIS 41,A04,453647,D'Elena-Tweed; Jessica Erin,18,0,25,7
1708255488133,VIS 41,A05,453648,D'Elena-Tweed; Jessica Erin,25,0,25,0
1708255488133,VIS 41,A06,453650,D'Elena-Tweed; Jessica Erin,24,0,25,1
1708255488660,VIS 70N,A01,453652,Garnett; Mariah J,21,0,22,1
1708255488660,VIS 70N,A02,453653,Garnett; Mariah J,21,0,22,1
1708255488660,VIS 70N,A03,453654,Garnett; Mariah J,22,0,22,0
1708255488660,VIS 70N,A04,453657,Garnett; Mariah J,22,0,22,0
1708255488660,VIS 70N,A05,453662,Garnett; Mariah J,20,0,22,2
1708255488660,VIS 70N,A06,453663,Garnett; Mariah J,22,0,22,0
1708255489188,VIS 83,A00,453664,Kester; Grant,137,0,146,9
1708255489717,VIS 101A,A00,453666,Cruz; Edwin Teddy,10,0,15,5
1708255490243,VIS 102,A00,453668,Cruz; Edwin Teddy,81,0,85,4
1708255490773,VIS 105A,A00,453669,Adler; Amy,29,0,30,1
1708255491297,VIS 105B,A00,453738,Herc-Balaszek; Malgorzata,25,0,30,5
1708255491297,VIS 105B,B00,453739,Staff,27,0,30,3
1708255491823,VIS 106A,A00,453740,Staff,22,0,25,3
1708255492348,VIS 106B,A00,453741,De Luca; Mara Julia,20,0,25,5
1708255492875,VIS 106C,A00,453746,Vangenderen; Monique Luise,11,0,15,4
1708255493401,VIS 107A,A00,453747,Gregoire; Mathieu,19,0,25,6
1708255493928,VIS 107B,A00,453748,Dean; Danielle Adobi,23,0,25,2
1708255494456,VIS 110A,A00,453749,Adler; Amy,13,0,15,2
1708255494981,VIS 110E,A00,453798,Gregoire; Mathieu,14,0,15,1
1708255495505,VIS 110F,A00,453799,Staff,15,0,15,0
1708255496035,VIS 110N,A00,453803,Dean; Danielle Adobi,15,0,15,0
1708255496563,VIS 123B,A00,453804,Gaines; Malik Julian,75,0,75,0
1708255497090,VIS 125BN,A00,453813,Welchman; John C.,75,0,75,0
1708255497624,VIS 126P,A00,453814,Wardwell; Mariana Razo,74,0,75,1
1708255498150,VIS 128E,A00,453815,Staff,75,0,75,0
1708255498679,VIS 129E,A00,453855,Shen; Kuiyi,12,0,15,3
1708255499206,VIS 131,A00,453859,Trigilio; Michael,12,0,15,3
1708255499206,VIS 131,B00,479342,Mangolte; Babette,15,0,15,0
1708255499731,VIS 133A,A00,454231,Barbosa; Erika Katrina,13,0,15,2
1708255500260,VIS 134,A00,454232,Yoldas; Pinar,59,0,75,16
1708255500790,VIS 141B,A00,454233,Stalbaum; Brett,12,0,15,3
1708255501321,VIS 145B,A00,454234,Alexander; Amy J,14,0,15,1
1708255501321,VIS 145B,B00,454235,Kiratli; Solen,8,0,15,7
1708255501848,VIS 147A,A01,454237,Stalbaum; Brett,20,0,22,2
1708255501848,VIS 147A,A02,454238,Stalbaum; Brett,18,0,22,4
1708255502375,VIS 157,A01,454240,Cartwright; Lisa,32,0,34,2
1708255502375,VIS 157,A02,454241,Cartwright; Lisa,32,0,34,2
1708255502906,VIS 159,A01,454243,Akten; Mehmet,34,0,34,0
1708255502906,VIS 159,A02,454244,Akten; Mehmet,32,0,34,2
1708255502906,VIS 159,A03,454300,Akten; Mehmet,30,0,34,4
1708255502906,VIS 159,A04,454301,Akten; Mehmet,33,0,34,1
1708255502906,VIS 159,A05,454302,Akten; Mehmet,30,0,34,4
1708255502906,VIS 159,A06,454307,Akten; Mehmet,33,0,34,1
1708255502906,VIS 159,A07,454308,Akten; Mehmet,34,0,34,0
1708255502906,VIS 159,A08,454309,Akten; Mehmet,33,0,34,1
1708255503436,VIS 160B,A00,454310,Alexander; Amy J,13,0,15,2
1708255503436,VIS 160B,B00,454311,Akten; Mehmet,14,0,15,1
1708255503436,VIS 160B,C00,454312,Stone; Patricia,12,0,15,3
1708255503962,VIS 164,A00,454313,Cross; Brian R,19,0,22,3
1708255503962,VIS 164,B00,454314,Camargo; William,22,0,22,0
1708255504487,VIS 165,A00,454315,Erdmann; Dean,22,0,22,0
1708255505016,VIS 167,A00,454316,Staff,18,0,22,4
1708255505542,VIS 169A,A00,454317,Mostajo; Lorena,21,0,22,1
1708255506071,VIS 171,A00,454318,Nakayama; Yue,21,0,22,1
1708255506610,VIS 174,A00,454319,Staff,19,0,22,3
1708255507135,VIS 177,A00,454320,Cho; Erica,21,0,22,1
1708255507660,VIS 178,A00,454321,Staff,0,0,0,0
1708255508188,VIS 179,A00,454322,Erdmann; Dean,22,0,22,0
1708255508713,VIS 180A,A00,454323,Nakayama; Yue,21,0,22,1
1708255509241,VIS 180B,A00,454341,Cross; Brian R,20,0,22,2
1708255509766,VIS 183A,A00,454342,Cho; Erica,17,0,22,5
1708255510297,VIS 185,A00,454343,Miller; Nicole L,18,0,22,4
1708255510827,VIS 190,A00,454360,Crandall; Jordan,15,0,15,0
1708255510827,VIS 190,B00,454361,D'Elena-Tweed; Jessica Erin,10,0,15,5
1708255511352,VIS 202,A00,454369,Miller; Nicole L,12,0,15,3
1708255511882,VIS 203,A00,454370,Garnett; Mariah J,8,0,15,7
1708255512411,VIS 206,A00,454376,Kester; Grant,10,0,15,5
1708255512939,VIS 208,A00,454377,Moss; Ceci,15,0,15,0
1708255513465,VIS 211,A00,454413,Segade; Alexandro Abraham,0,0,0,2
1708255513990,VIS 243,A00,454429,Rose; Jordan M,5,0,15,10
1708255514515,VIS 255,A00,454430,Welchman; John C.,8,0,15,7
1708255515043,VIS 262,A00,454431,Yoldas; Pinar,11,0,15,4
1708255515570,WCWP 10A,001,454442,Uriarte; Emma,17,0,20,3
1708255515570,WCWP 10A,002,454443,Uriarte; Emma,14,0,20,6
1708255515570,WCWP 10A,003,454479,Uriarte; Emma,19,0,20,1
1708255515570,WCWP 10A,004,454480,Staff,0,0,0,0
1708255515570,WCWP 10A,005,454484,Staff,0,0,0,0
1708255515570,WCWP 10A,006,454485,Staff,0,0,0,0
1708255515570,WCWP 10A,007,454487,Staff,0,0,0,0
1708255515570,WCWP 10A,008,454488,Susi; Natalie,14,0,20,6
1708255515570,WCWP 10A,009,454489,Staff,0,0,0,0
1708255515570,WCWP 10A,010,454490,Staff,0,0,0,0
1708255516114,WCWP 10B,001,454492,Ornelas; Tricia,20,0,20,0
1708255516114,WCWP 10B,002,454501,Ornelas; Tricia,20,0,20,0
1708255516114,WCWP 10B,003,454565,Gagnon; Jeffrey C,2,0,20,18
1708255516114,WCWP 10B,004,454604,Ornelas; Tricia,16,0,20,4
1708255516114,WCWP 10B,005,454668,Staff,16,0,16,0
1708255516114,WCWP 10B,006,454724,Staff,16,0,16,0
1708255516114,WCWP 10B,007,454725,Staff,14,0,16,2
1708255516114,WCWP 10B,008,454768,Staff,0,0,0,0
1708255516114,WCWP 10B,009,454769,Staff,0,0,0,0
1708255516114,WCWP 10B,010,454770,Staff,0,0,0,0
1708255516114,WCWP 10B,011,454771,Dhir; Simrita,16,0,20,4
1708255516114,WCWP 10B,012,454772,Dhir; Simrita,16,0,20,4
1708255516114,WCWP 10B,013,454773,Merryman; Walter,17,0,20,3
1708255516114,WCWP 10B,014,454774,Dhir; Simrita,18,0,20,2
1708255516114,WCWP 10B,015,454775,Merryman; Walter,17,0,20,3
1708255516114,WCWP 10B,016,454776,Merryman; Walter,18,0,20,2
1708255516114,WCWP 10B,017,454777,Welji; Haleema Nazir,14,0,16,2
1708255516114,WCWP 10B,018,478868,Staff,16,0,16,0
1708255516114,WCWP 10B,019,478869,Staff,0,0,0,0
1708255516114,WCWP 10B,020,478876,Staff,0,0,0,0
1708255516114,WCWP 10B,021,478877,Staff,0,0,0,0
1708255516114,WCWP 10B,022,478887,Staff,0,0,0,0
1708255516114,WCWP 10B,023,478889,Staff,16,0,16,0
1708255516114,WCWP 10B,024,478892,Staff,0,0,0,0
1708255516114,WCWP 10B,025,478907,Staff,0,0,0,0
1708255516642,WCWP 100,A00,454800,McCleary; Keith Long,20,0,20,0
1708255516642,WCWP 100,B00,454804,McCleary; Keith Long,20,0,20,0
1708255516642,WCWP 100,C00,454822,Twohig; Niall Ivan,19,0,20,1
1708255516642,WCWP 100,D00,454855,Young; Mark T,20,0,20,0
1708255516642,WCWP 100,E00,454860,Twohig; Niall Ivan,19,0,20,1
1708255516642,WCWP 100,F00,454932,Young; Mark T,20,0,20,0
1708255516642,WCWP 100,G00,454933,Young; Mark T,20,0,20,0
1708255517167,WES 207,A00,454941,Kastner; Ryan Charles,20,0,20,0
1708255517693,WES 265,A00,454942,Staff,19,0,20,1
1708255519496,AAS 10,A01,392963,Butler; Elizabeth Annette,34,0,34,0
1708255519496,AAS 10,A02,392965,Butler; Elizabeth Annette,33,0,34,1
1708255520025,AAS 170,A00,392977,Butler; Elizabeth Annette,31,0,32,1
1708255520552,AAS 198,001,479182,Childs; Dennis R.,20,0,20,0
1708255521078,AESE 261,A00,387945,Staff,33,0,33,0
1708255521607,AESE 278D,A00,387953,Staff,33,0,33,0
1708255522136,AESE 278E,A00,387954,Staff,33,0,33,0
1708255522661,AESE 279A,A00,387956,Staff,33,0,33,0
1708255523187,AIP 197P,001,494494,Goldfarb; Brian,9999,0,9999,0
1708255523716,ANAR 100,A00,387884,Shtienberg; Gilad,15,0,16,1
1708255524246,ANAR 104,A01,387886,Tamberino; Anthony Thomas,21,0,25,4
1708255524772,ANAR 111,A00,387888,Staff,36,0,36,0
1708255525301,ANAR 115,A00,387889,Shtienberg; Gilad,36,0,36,0
1708255525826,ANAR 120,A00,387890,Staff,36,0,36,0
1708255526352,ANAR 155,A00,387891,Braswell; Geoffrey E.,15,0,25,10
1708255526881,ANAR 164,A00,387892,Staff,32,0,35,3
1708255527407,ANBI 100,A00,489626,Fox; Patrick Keolu Ozer,39,0,40,1
1708255527934,ANBI 111,A00,387893,Hrvoj Mihic; Branka,37,0,40,3
1708255529001,ANBI 144,A00,387896,Wilder; Linnea Lorene,72,0,75,3
1708255529532,ANBI 149,A00,489628,Non; Amy L,0,0,0,0
1708255530059,ANBI 173,A00,387897,Wilder; Linnea Lorene,74,0,75,1
1708255530585,ANBI 174,A00,489627,Strum; Shirley C.,13,0,15,2
1708255531112,ANES 296,001,463968,Gabriel; Rodney A,49,0,50,1
1708255531112,ANES 296,002,463969,Staff,50,0,50,0
1708255531112,ANES 296,003,463970,Staff,50,0,50,0
1708255531643,ANSC 100,A00,387898,Bialecki; Jon Anthony,40,0,40,0
1708255532169,ANSC 101,A00,387900,Sloane; Julia Kathryn,34,0,40,6
1708255532699,ANSC 117,A00,387901,Martin Sandino; Amanda Maria Yoland,13,0,15,2
1708255533228,ANSC 134,A00,387902,Staff,38,0,40,2
1708255533754,ANSC 137,A00,387903,Stewart; Alexander B,80,0,80,0
1708255534282,ANSC 138,A00,387904,Parish; Steven Martin,14,0,15,1
1708255534814,ANSC 142,A00,387905,Stone; Annika Britt,34,0,40,6
1708255535343,ANSC 147,A00,387906,Stewart; Alexander B,40,0,40,0
1708255535868,ANSC 148,A00,387907,Olivas Hernandez; Olga Lid,92,0,92,0
1708255536454,ANSC 186,A00,387910,Hankins; Joseph D.,28,0,30,2
1708255536987,ANTH 2,A01,387863,Marchetto; Maria Carolina,37,0,40,3
1708255536987,ANTH 2,A02,387864,Marchetto; Maria Carolina,40,0,40,0
1708255536987,ANTH 2,A03,387865,Marchetto; Maria Carolina,36,0,40,4
1708255536987,ANTH 2,A04,387866,Marchetto; Maria Carolina,39,0,40,1
1708255537513,ANTH 3,A01,387868,Stroth; Luke Reyneri,28,0,30,2
1708255537513,ANTH 3,A02,387869,Stroth; Luke Reyneri,29,0,30,1
1708255537513,ANTH 3,A03,387870,Stroth; Luke Reyneri,30,0,30,0
1708255537513,ANTH 3,A04,387871,Stroth; Luke Reyneri,29,0,30,1
1708255538042,ANTH 10,A00,387872,Stewart; Alexander B,80,0,80,0
1708255538569,ANTH 21,A01,387874,Stone; Annika Britt,40,0,40,0
1708255538569,ANTH 21,A02,387875,Stone; Annika Britt,40,0,40,0
1708255538569,ANTH 21,A03,387876,Stone; Annika Britt,40,0,40,0
1708255538569,ANTH 21,A04,387877,Stone; Annika Britt,39,0,40,1
1708255539095,ANTH 23,A01,387879,Staff,40,0,40,0
1708255539095,ANTH 23,A02,387880,Staff,40,0,40,0
1708255539095,ANTH 23,A03,387881,Staff,40,0,40,0
1708255539095,ANTH 23,A04,387882,Staff,40,0,40,0
1708255539625,ANTH 24,A00,387883,Pedersen; David,40,0,40,0
1708255540151,ANTH 103,A00,387911,Staff,343,0,350,7
1708255540677,ANTH 105,A00,387912,Staff,73,0,75,2
1708255541206,ANTH 112,A00,387913,Staff,23,0,25,2
1708255541732,ANTH 120,A00,479486,Parish; Steven Martin,28,0,30,2
1708255542258,ANTH 128B,A01,387923,Lewis; Leslie R,12,0,12,0
1708255542787,ANTH 192,A00,387925,Varma; Saiba,20,0,20,0
1708255543313,ANTH 196C,A00,387927,Varma; Saiba,15,0,15,0
1708255543840,ANTH 212,A00,387931,Marchetto; Maria Carolina,25,0,25,0
1708255543840,ANTH 212,B00,479487,Semendeferi; Ekaterini,25,0,25,0
1708255544365,ANTH 220,A00,387932,Csordas; Thomas J.,9,0,12,3
1708255544893,ANTH 230,001,493297,Goldstein; Paul S,18,0,20,2
1708255545422,ANTH 260,A00,479223,Jenkins; Janis A.,25,0,25,0
1708255545953,ANTH 272,A00,387936,Serlin; David,5,0,5,0
1708255546479,ANTH 273,A00,387938,Gates; Kelly,5,0,5,0
1708255547005,ANTH 288,A00,387940,Braswell; Geoffrey E.,25,0,25,0
1708255547541,ANTH 295,001,493298,Algaze; Guillermo,3,0,3,0
1708255547541,ANTH 295,002,493299,Brenner; Suzanne A,3,0,3,0
1708255547541,ANTH 295,003,493300,Csordas; Thomas J.,3,0,3,0
1708255547541,ANTH 295,004,493422,Fox; Patrick Keolu Ozer,3,0,3,0
1708255547541,ANTH 295,005,493472,Gagneux; Pascal,3,0,3,0
1708255547541,ANTH 295,006,493515,Goldstein; Paul S,3,0,3,0
1708255547541,ANTH 295,007,493592,Hankins; Joseph D.,3,0,3,0
1708255547541,ANTH 295,008,493631,Jassal; Aftab,3,0,3,0
1708255547541,ANTH 295,009,493639,Jenkins; Janis A.,3,0,3,0
1708255547541,ANTH 295,010,493657,Kaiser; Bronwyn Nicole,3,0,3,0
1708255547541,ANTH 295,011,493692,Kang; Byung Chu,3,0,3,0
1708255547541,ANTH 295,012,493758,Marchetto; Maria Carolina,3,0,3,0
1708255547541,ANTH 295,013,493761,Non; Amy L,3,0,3,0
1708255547541,ANTH 295,014,493762,Pedersen; David,3,0,3,0
1708255547541,ANTH 295,015,493825,Rivera-Collazo; Isabel C,3,0,3,0
1708255547541,ANTH 295,016,493826,Varma; Saiba,3,0,3,0
1708255547541,ANTH 295,017,493828,Yeh; Rihan Wen Xin,3,0,3,0
1708255548069,ANTH 296,001,493830,Braswell; Geoffrey E.,3,0,3,0
1708255548069,ANTH 296,002,493836,Marchetto; Maria Carolina,3,0,3,0
1708255548069,ANTH 296,003,493838,Rivera-Collazo; Isabel C,3,0,3,0
1708255548069,ANTH 296,004,493840,Varma; Saiba,3,0,3,0
1708255548069,ANTH 296,005,493842,Algaze; Guillermo,3,0,3,0
1708255548069,ANTH 296,006,493845,Brenner; Suzanne A,3,0,3,0
1708255548069,ANTH 296,007,493846,Csordas; Thomas J.,3,0,3,0
1708255548069,ANTH 296,008,493907,Fox; Patrick Keolu Ozer,3,0,3,0
1708255548069,ANTH 296,009,493949,Gagneux; Pascal,3,0,3,0
1708255548069,ANTH 296,010,493960,Goldstein; Paul S,3,0,3,0
1708255548069,ANTH 296,011,493961,Hankins; Joseph D.,3,0,3,0
1708255548069,ANTH 296,012,493962,Jassal; Aftab,3,0,3,0
1708255548069,ANTH 296,013,493963,Jenkins; Janis A.,3,0,3,0
1708255548069,ANTH 296,014,493964,Kaiser; Bronwyn Nicole,3,0,3,0
1708255548069,ANTH 296,015,493965,Kang; Byung Chu,3,0,3,0
1708255548069,ANTH 296,016,493966,Levy; Thomas E,3,0,3,0
1708255548069,ANTH 296,017,493967,Non; Amy L,3,0,3,0
1708255548069,ANTH 296,018,493968,Pedersen; David,3,0,3,0
1708255548069,ANTH 296,019,493969,Postero; Nancy Grey,3,0,3,0
1708255548069,ANTH 296,020,493970,Semendeferi; Ekaterini,3,0,3,0
1708255548069,ANTH 296,021,493971,Yeh; Rihan Wen Xin,3,0,3,0
1708255548596,AUD 236,A00,480192,Harris; Jeffrey Paul,12,0,12,0
1708255549142,AUD 260,A00,480227,Spriggs; Meghan K,12,0,12,0
1708255549684,AUD 272,A00,480367,Zettner; Erika,12,0,12,0
1708255550211,AUD 275,A00,480369,Zettner; Erika,12,0,12,0
1708255550737,AUD 284,A00,480370,Zettner; Erika,12,0,12,0
1708255550737,AUD 284,B00,480372,Spriggs; Meghan K,12,0,12,0
1708255551262,AUD 291,A00,480374,Zettner; Erika,12,0,12,0
1708255551792,AUD 296,A00,480375,Zettner; Erika,12,0,12,0
1708255551792,AUD 296,B00,480376,Harris; Jeffrey Paul,12,0,12,0
1708255551792,AUD 296,C00,480377,Ryan; Allen F.,12,0,12,0
1708255552322,AWP 3,002,387672,Given; William Allan,9,0,9,0
1708255552322,AWP 3,003,387678,Staff,5,0,5,0
1708255552322,AWP 3,004,387681,Staff,0,0,0,0
1708255552322,AWP 3,007,387784,West; Geoffrey Scott,4,0,5,1
1708255552322,AWP 3,009,387786,Kolodezh; Samuel,5,0,5,0
1708255552322,AWP 3,010,387787,Gilbert; Peter W,5,0,5,0
1708255552853,AWP 4A,001,387791,Staff,12,0,12,0
1708255552853,AWP 4A,002,387792,Staff,0,0,0,0
1708255553445,AWP 4B,001,387793,Bolin; Jillian,0,0,0,0
1708255553445,AWP 4B,002,387794,Bolin; Jillian,0,0,0,0
1708255553445,AWP 4B,003,387795,Bauer; Holly Jean,0,0,0,0
1708255553445,AWP 4B,004,387796,Vaughn; Kelsey Sara,0,0,0,0
1708255553445,AWP 4B,005,387797,Vaughn; Kelsey Sara,0,0,0,0
1708255553445,AWP 4B,007,387799,Ajo; Frances Margaret,0,0,0,0
1708255553445,AWP 4B,008,387800,Ajo; Frances Margaret,0,0,0,0
1708255553445,AWP 4B,009,387801,Hall; Graham T,0,0,0,0
1708255553445,AWP 4B,010,387802,Hall; Graham T,0,0,0,0
1708255553445,AWP 4B,011,387803,Heiser; Jerrod A,0,0,0,0
1708255553445,AWP 4B,012,387804,Heiser; Jerrod A,0,0,0,0
1708255553445,AWP 4B,013,387805,Jones; William Jadie,0,0,0,0
1708255553445,AWP 4B,014,387806,Jones; William Jadie,0,0,0,0
1708255553445,AWP 4B,015,387807,Christie; Veronica Ann,0,0,0,0
1708255553445,AWP 4B,016,387808,Christie; Veronica Ann,0,0,0,0
1708255553445,AWP 4B,019,387820,Falcon; Jennifer A,0,0,0,0
1708255553445,AWP 4B,020,387821,Falcon; Jennifer A,0,0,0,0
1708255553445,AWP 4B,021,387822,Eastin; Schuyler E.,0,0,0,0
1708255553445,AWP 4B,023,387824,Coulter; Jane Elisabeth,0,0,0,0
1708255553445,AWP 4B,025,387826,O'Neil; Courtney L,0,0,0,0
1708255553445,AWP 4B,026,387827,O'Neil; Courtney L,0,0,0,0
1708255553445,AWP 4B,027,387828,Tsurska Svetina; Olena,0,0,0,0
1708255553445,AWP 4B,028,387829,Tsurska Svetina; Olena,0,0,0,0
1708255553445,AWP 4B,029,387830,Spicer; Jacqueline,0,0,0,0
1708255553445,AWP 4B,030,387831,Spicer; Jacqueline,0,0,0,0
1708255553445,AWP 4B,031,387832,Steinberg; Stacy A,0,0,0,0
1708255553445,AWP 4B,032,387833,Steinberg; Stacy A,0,0,0,0
1708255553445,AWP 4B,033,387834,Chandler; Bailee Daniele,0,0,0,0
1708255553445,AWP 4B,034,387835,Chandler; Bailee Daniele,0,0,0,0
1708255553445,AWP 4B,035,387836,Tiernan; Christa Michelle,0,0,0,0
1708255553445,AWP 4B,036,387837,Tiernan; Christa Michelle,0,0,0,0
1708255553445,AWP 4B,037,387840,Gardella; Alexander Drew,0,0,0,0
1708255553445,AWP 4B,038,387841,Gardella; Alexander Drew,0,0,0,0
1708255553445,AWP 4B,039,387857,Zimmerman; Guy,0,0,0,0
1708255553445,AWP 4B,040,387858,Zimmerman; Guy,0,0,0,0
1708255553445,AWP 4B,041,387859,Zroka; Amy Liane,0,0,0,0
1708255553445,AWP 4B,042,387860,Zroka; Amy Liane,0,0,0,0
1708255553972,BENG 87,A00,489656,Sah; Robert Lie-Yuan,20,0,20,0
1708255553972,BENG 87,B00,489657,Sah; Robert Lie-Yuan,20,0,20,0
1708255553972,BENG 87,C00,494754,Omens; Jeffrey Howard,20,0,20,0
1708255554500,BENG 100,A01,387959,Alexandrov; Ludmil B,26,0,28,2
1708255554500,BENG 100,A02,387960,Alexandrov; Ludmil B,26,0,28,2
1708255554500,BENG 100,A03,387984,Alexandrov; Ludmil B,26,0,28,2
1708255554500,BENG 100,A04,387985,Alexandrov; Ludmil B,25,0,28,3
1708255554500,BENG 100,A05,387986,Alexandrov; Ludmil B,27,0,28,1
1708255555027,BENG 102,A00,387987,Chapelin; Fanny,55,0,56,1
1708255555569,BENG 103B,A00,387993,Fraley; Stephanie I.,116,0,120,4
1708255556101,BENG 112B,A01,388053,Shi; Lingyan,26,0,30,4
1708255556101,BENG 112B,A02,388054,Shi; Lingyan,29,0,30,1
1708255556630,BENG 125,A00,388055,Hasty; Jeff M,120,0,160,40
1708255557156,BENG 133,A01,388866,Mali; Prashant Gulab Ram,36,0,40,4
1708255557690,BENG 140B,A01,388884,Cabrales; Pedro,28,0,30,2
1708255557690,BENG 140B,A02,388885,Cabrales; Pedro,30,0,30,0
1708255557690,BENG 140B,A03,388886,Cabrales; Pedro,26,0,30,4
1708255558218,BENG 160,A50,388889,Aguado; Brian Alberto,23,0,25,2
1708255558218,BENG 160,A51,388919,Aguado; Brian Alberto,25,0,25,0
1708255558218,BENG 160,A52,388920,Aguado; Brian Alberto,25,0,25,0
1708255558744,BENG 168,A01,388961,Khojah; Reem I,30,0,30,0
1708255559275,BENG 172,A50,389087,Omens; Jeffrey Howard & Cabrales; Pedro,15,0,20,5
1708255559275,BENG 172,A51,389088,Omens; Jeffrey Howard & Cabrales; Pedro,14,0,20,6
1708255559805,BENG 182,A01,389128,Bafna; Vineet,28,0,30,2
1708255560331,BENG 186A,A00,389130,Kwon; Ester Jihae,105,0,120,15
1708255560858,BENG 187A,A00,389289,Taylor Amos; Alyssa C,157,0,170,13
1708255561388,BENG 187D,A00,389290,Taylor Amos; Alyssa C,33,0,60,27
1708255561388,BENG 187D,B00,389300,Taylor Amos; Alyssa C,51,0,60,9
1708255561388,BENG 187D,C00,389302,Taylor Amos; Alyssa C,35,0,60,25
1708255561916,BENG 189,A00,389303,Contijoch; Francisco,26,0,30,4
1708255562458,BENG 193,A00,389328,Engler; Adam J.,0,0,0,0
1708255562984,BENG 196,A00,436038,Engler; Adam J.,9999,0,9999,0
1708255563511,BENG 197,A00,436081,Engler; Adam J.,9999,0,9999,0
1708255564041,BENG 203,A00,389385,Bafna; Vineet & Zhong; Sheng,20,0,20,0
1708255564569,BENG 207,A00,389386,Kwon; Ester Jihae,10,0,40,30
1708255564569,BENG 207,B00,389400,Taylor Amos; Alyssa C,8,0,30,22
1708255564569,BENG 207,C00,389432,Khojah; Reem I,20,0,40,20
1708255565096,BENG 209,A00,389456,Scholtes Acevedo; Claire,30,0,30,0
1708255565623,BENG 213,A00,389496,Palsson; Bernhard O.,16,0,20,4
1708255566681,BENG 224,A00,389515,Staff,0,0,0,0
1708255567213,BENG 226,A01,479043,Schmid-Schoenbein; Geert W,7,0,30,23
1708255567739,BENG 227,A00,389591,Fraley; Stephanie I.,55,0,120,65
1708255568264,BENG 230C,A00,389810,Mc Culloch; Andrew Douglas,43,0,90,47
1708255568794,BENG 232,A01,390161,Sah; Robert Lie-Yuan,6,0,50,44
1708255569319,BENG 233,A00,390290,Shah; Sameer B,33,0,50,17
1708255569850,BENG 234,A00,390291,Silva; Gabriel,20,0,56,36
1708255570378,BENG 235,A00,390318,Bintu; Bogdan,16,0,40,24
1708255570905,BENG 276,A00,390357,Mc Culloch; Andrew Douglas & Amaro; Rommie E,0,0,0,0
1708255571449,BENG 280C,A01,390443,McVeigh; Elliot R.,45,0,56,11
1708255571974,BENG 281,A00,390444,Kravets; Vira V.,50,0,110,60
1708255572501,BENG 283,A00,390445,Komives; Elizabeth A,4,0,4,0
1708255573028,BENG 292,A01,390623,Ross; Camille,20,0,20,0
1708255573557,BENG 294C,A00,390709,Engler; Adam J.,17,0,20,3
1708255574083,BENG 295,A00,436300,Watson; John Thomas,9999,0,9999,0
1708255574610,BGGN 205,A00,423656,Daugherty; Matthew Dorton,47,0,60,13
1708255575136,BGGN 207,A01,423703,Ross; Camille,0,0,0,0
1708255575667,BGGN 215,A00,423704,Petrie; Katherine Lynn,22,0,30,8
1708255576194,BGGN 216,A01,423855,Mueller; Liam O'Connor,37,0,50,13
1708255576720,BGGN 218,A00,423861,David; Michael,19,0,30,11
1708255577247,BGGN 223,A00,423862,Bier; Ethan,17,0,35,18
1708255577778,BGGN 230,A00,423863,Taylor; Susan S.,8,0,15,7
1708255578304,BGGN 232,A00,423864,Briggs; Steven & Troemel; Emily Ruth,25,0,30,5
1708255578831,BGGN 239,A01,424014,Kronenberg; Mitchell E.,30,0,30,0
1708255579361,BGGN 240,A01,424016,Juavinett; Ashley Lauren,0,0,6,6
1708255579888,BGGN 248,A00,424017,Halpain; Shelley,26,0,30,4
1708255580417,BGGN 249C,A00,424052,Staff,33,0,33,0
1708255580957,BGGN 250,A01,424091,Zou; Yimin,7,0,8,1
1708255581484,BGGN 252,A01,424093,Sejnowski; Terrence J,5,0,6,1
1708255582013,BGGN 255,A00,424094,Root; Cory Matthew,29,0,30,1
1708255582540,BGGN 262,A01,424096,Villa Rodriguez; Elizabeth,30,0,30,0
1708255583073,BGGN 267,A01,424099,Benna; Marcus K & Aljadeff; Johnatan,5,0,6,1
1708255583598,BGGN 270,A00,477483,Juavinett; Ashley Lauren,67,0,75,8
1708255584330,BGGN 271,001,481745,Ackerman; Susan,9998,0,9999,1
1708255584330,BGGN 271,002,481746,Akbari; Omar Sultan,9999,0,9999,0
1708255584330,BGGN 271,003,481747,Allen; Nicola J,9999,0,9999,0
1708255584330,BGGN 271,004,481748,Banegas; Matthew Patrick,9999,0,9999,0
1708255584330,BGGN 271,005,481749,Breen; Ellen C.,9998,0,9999,1
1708255584330,BGGN 271,006,481750,Briggs; Steven,9998,0,9999,1
1708255584330,BGGN 271,007,481751,Bui; Jack D,9999,0,9999,0
1708255584330,BGGN 271,008,481762,Busch; Wolfgang,9999,0,9999,0
1708255584330,BGGN 271,009,481763,Castle; Michael James,9999,0,9999,0
1708255584330,BGGN 271,010,481764,Chang; John Tzu-yu,9999,0,9999,0
1708255584330,BGGN 271,011,481765,Chen; Ju,9998,0,9999,1
1708255584330,BGGN 271,012,481766,Chen; Xu,9999,0,9999,0
1708255584330,BGGN 271,013,481767,Cheng; Christine Shiang-Ling,9999,0,9999,0
1708255584330,BGGN 271,014,481768,Cherqui; Stephanie,9999,0,9999,0
1708255584330,BGGN 271,015,481769,Cho; Yoshitake,9999,0,9999,0
1708255584330,BGGN 271,016,481770,Church; Kellie Breen,9998,0,9999,1
1708255584330,BGGN 271,017,481771,Cleland; Elsa Eleanor,9999,0,9999,0
1708255584330,BGGN 271,018,481779,Cohen; Shiran,9998,0,9999,1
1708255584330,BGGN 271,019,481814,Cook-Andersen; Heidi Leigh,9999,0,9999,0
1708255584330,BGGN 271,020,481815,Cooke; James Edward,9999,0,9999,0
1708255584330,BGGN 271,021,481816,Coufal; Nicole Gabriele,9998,0,9999,1
1708255584330,BGGN 271,022,481818,Crotty Alexander; Laura E,9999,0,9999,0
1708255584330,BGGN 271,023,481819,Daugherty; Matthew Dorton,9998,0,9999,1
1708255584330,BGGN 271,024,481820,De Guglielmo; Giordano,9998,0,9999,1
1708255584330,BGGN 271,025,481821,Doherty; Taylor Alan,9998,0,9999,1
1708255584330,BGGN 271,026,481822,Dulawa; Stephanie Carole,9999,0,9999,0
1708255584330,BGGN 271,027,481823,Esko; Jeffrey D.,9998,0,9999,1
1708255584330,BGGN 271,028,481824,Feldstein; Ariel E,9998,0,9999,1
1708255584330,BGGN 271,029,481825,Friedman; Rick Adam,9999,0,9999,0
1708255584330,BGGN 271,030,481826,Furnari; Frank,9999,0,9999,0
1708255584330,BGGN 271,031,481829,Ghosh; Pradipta,9998,0,9999,1
1708255584330,BGGN 271,032,481830,Gleeson; Joseph Gerard,9999,0,9999,0
1708255584330,BGGN 271,033,481831,Golden; Susan S.,9998,0,9999,1
1708255584330,BGGN 271,034,481832,Goren; Alon M,9998,0,9999,1
1708255584330,BGGN 271,035,481834,Gustafsson; Asa Birgitta,9999,0,9999,0
1708255584330,BGGN 271,036,481836,Hamdoun; Amr,9999,0,9999,0
1708255584330,BGGN 271,037,481837,Hao; Nan,9999,0,9999,0
1708255584330,BGGN 271,038,481840,Holway; David A.,9998,0,9999,1
1708255584330,BGGN 271,039,481841,Huffaker; Alisa,9998,0,9999,1
1708255584330,BGGN 271,040,481843,Sebat; Lilia Mikhailovna,9998,0,9999,1
1708255584330,BGGN 271,041,481889,Ideker; Trey,9999,0,9999,0
1708255584330,BGGN 271,042,481890,Jiang; Qingfei,9998,0,9999,1
1708255584330,BGGN 271,043,482311,Jin; Yishi,9999,0,9999,0
1708255584330,BGGN 271,044,482334,Joiner; William J.,9999,0,9999,0
1708255584330,BGGN 271,045,482353,Kaech; Susan Michelle,9998,0,9999,1
1708255584330,BGGN 271,046,482378,Karin; Michael,9999,0,9999,0
1708255584330,BGGN 271,047,482379,Kleinfeld; David,9999,0,9999,0
1708255584330,BGGN 271,048,482413,Koffler; Yacov,9999,0,9999,0
1708255584330,BGGN 271,049,482414,Komiyama; Takaki,9999,0,9999,0
1708255584330,BGGN 271,050,482415,Kryazhimskiy; Sergey A,9999,0,9999,0
1708255584330,BGGN 271,051,482416,Lawson; Mark Andrew,9999,0,9999,0
1708255584330,BGGN 271,052,482417,Lee; Yun Sok,9999,0,9999,0
1708255584330,BGGN 271,053,482451,Leutgeb; Stefan,9998,0,9999,1
1708255584330,BGGN 271,054,482452,Lo; Stanley M.,9999,0,9999,0
1708255584330,BGGN 271,055,482453,Lu; Pengzhe,9998,0,9999,1
1708255584330,BGGN 271,056,482454,Lykke-Andersen; Jens,9998,0,9999,1
1708255584330,BGGN 271,057,482456,McDonnell; Lisa Marie,9999,0,9999,0
1708255584330,BGGN 271,058,482461,McHugh; Colleen A,9998,0,9999,1
1708255584330,BGGN 271,059,482478,Meharena; Hiruy Sibhatu,9999,0,9999,0
1708255584330,BGGN 271,060,482497,Morris; Gerald P,9999,0,9999,0
1708255584330,BGGN 271,061,482499,Mukamel; Eran A,9998,0,9999,1
1708255584330,BGGN 271,062,482535,Muotri; Alysson,9999,0,9999,0
1708255584330,BGGN 271,063,482551,Muroyama; Andrew David,9999,0,9999,0
1708255584330,BGGN 271,064,482552,Neal; Sonya E,9999,0,9999,0
1708255584330,BGGN 271,065,482618,Nieh; James Charles,9999,0,9999,0
1708255584330,BGGN 271,066,482619,O'Donoghue; Anthony John,9999,0,9999,0
1708255584330,BGGN 271,067,482626,Pantham; Priyadarshini,9999,0,9999,0
1708255584330,BGGN 271,068,482633,Parast; Mana,9999,0,9999,0
1708255584330,BGGN 271,069,482634,Perry; Michael William,9999,0,9999,0
1708255584330,BGGN 271,070,482639,Pride; David Tevis,9999,0,9999,0
1708255584330,BGGN 271,071,482645,Pruneda-Paz; Jose L.,9999,0,9999,0
1708255584330,BGGN 271,072,482648,Rana; Tariq,9999,0,9999,0
1708255584330,BGGN 271,073,482650,Risbrough; Victoria Blythe,9999,0,9999,0
1708255584330,BGGN 271,074,482655,Rissman; Robert Andrew,9999,0,9999,0
1708255584330,BGGN 271,075,482656,Rosenfeld; Michael G,9999,0,9999,0
1708255584330,BGGN 271,076,482657,Saier; Milton H.,9999,0,9999,0
1708255584330,BGGN 271,077,482663,Sander; Maike,9999,0,9999,0
1708255584330,BGGN 271,078,482664,Schenk; Simon,9999,0,9999,0
1708255584330,BGGN 271,079,482665,Schoeneberg; Johannes,9998,0,9999,1
1708255584330,BGGN 271,080,482666,Schroeder; Julian I,9998,0,9999,1
1708255584330,BGGN 271,081,482667,Shaner; Nathan C.,9999,0,9999,0
1708255584330,BGGN 271,082,482668,Sheikh; Farah,9999,0,9999,0
1708255584330,BGGN 271,083,482669,Shurin; Jonathan,9999,0,9999,0
1708255584330,BGGN 271,084,482675,Sigurdson; Christina,9999,0,9999,0
1708255584330,BGGN 271,085,482676,Smith; David M.,9999,0,9999,0
1708255584330,BGGN 271,086,482677,Steinmetz; Nicole F,9999,0,9999,0
1708255584330,BGGN 271,087,482692,Su; Chih-Ying,9999,0,9999,0
1708255584330,BGGN 271,088,482694,Suel; Gurol Mehmet,9999,0,9999,0
1708255584330,BGGN 271,089,482695,Telese; Francesca,9999,0,9999,0
1708255584330,BGGN 271,090,482745,Thackray; Varykina G.,9999,0,9999,0
1708255584330,BGGN 271,091,482746,Towers; Christina Garlingt,9999,0,9999,0
1708255584330,BGGN 271,092,482747,Troemel; Emily Ruth,9997,0,9999,2
1708255584330,BGGN 271,093,482748,Tye; Kay M,9999,0,9999,0
1708255584330,BGGN 271,094,482749,Valdez-Jasso; Daniela,9998,0,9999,1
1708255584330,BGGN 271,095,482750,Wahlin; Karl Jonas,9997,0,9999,2
1708255584330,BGGN 271,096,482751,Welsbie; Derek,9999,0,9999,0
1708255584330,BGGN 271,097,482752,Wilkinson; Miles Frome,9999,0,9999,0
1708255584330,BGGN 271,098,482754,Yaksh; Tony L.,9999,0,9999,0
1708255584330,BGGN 271,099,482760,Yang; Jing,9999,0,9999,0
1708255584330,BGGN 271,100,482761,Yeo; Eugene Wei-Ming,9998,0,9999,1
1708255584330,BGGN 271,101,482763,Ying; Wei,9999,0,9999,0
1708255584330,BGGN 271,102,482764,Zarrinpar; Amir,9999,0,9999,0
1708255584330,BGGN 271,103,482765,Zengler; Karsten B,9999,0,9999,0
1708255584330,BGGN 271,104,482766,Zhang; Dong-Er,9999,0,9999,0
1708255584330,BGGN 271,105,482768,Zhao; Yunde,9999,0,9999,0
1708255584330,BGGN 271,106,482776,Zheng; Binhai,9999,0,9999,0
1708255584330,BGGN 271,107,482777,Zheng; Ye,9998,0,9999,1
1708255584330,BGGN 271,108,482806,Zuniga; Elina I,9999,0,9999,0
1708255584857,BGGN 273,A01,424101,Mueller; Liam O'Connor,43,0,50,7
1708255585389,BGGN 280,A00,424102,Ernst; Andreas,3,0,5,2
1708255585389,BGGN 280,C00,481361,Amaro; Rommie E,2,0,5,3
1708255585914,BGGN 281,A00,424103,Desai; Arshad & Oegema; Karen,0,0,5,5
1708255586441,BGGN 283,A00,424104,Rivera; Fabian Chavez,0,0,5,5
1708255586441,BGGN 283,B00,424105,Russell; Alistair B,4,0,5,1
1708255586441,BGGN 283,D00,424107,Wildonger; Jill Cathleen,1,0,5,4
1708255586983,BGGN 284,A00,424108,Glasgow; Stacey Marie,2,0,5,3
1708255587516,BGGN 285,A00,424109,Chisholm; Andrew D.,1,0,5,4
1708255587516,BGGN 285,B00,424110,Farley; Emma Kristen,2,0,5,3
1708255588043,BGGN 295,A00,424120,Tour; Ella,9,0,30,21
1708255588571,BGJC 204,A00,424138,Lu; Li-Fan & Chang; John Tzu-yu,9998,0,9999,1
1708255589100,BGJC 215,A00,424139,Cooke; James Edward & Lo; Stanley M.,10,0,10,0
1708255589866,BGRD 200,001,485528,Ackerman; Susan,9998,0,9999,1
1708255589866,BGRD 200,002,485529,Akbari; Omar Sultan,9999,0,9999,0
1708255589866,BGRD 200,003,485530,Allen; Eric,9999,0,9999,0
1708255589866,BGRD 200,004,485531,Allen; Nicola J,9999,0,9999,0
1708255589866,BGRD 200,005,485533,Amaro; Rommie E,9999,0,9999,0
1708255589866,BGRD 200,006,485535,Augustine; Vineet,9999,0,9999,0
1708255589866,BGRD 200,007,485536,Ayres; Janelle Samantha,9999,0,9999,0
1708255589866,BGRD 200,008,485538,Banegas; Matthew Patrick,9999,0,9999,0
1708255589866,BGRD 200,009,485539,Banghart; Matthew Ryan,9999,0,9999,0
1708255589866,BGRD 200,010,485542,Benna; Marcus K,9999,0,9999,0
1708255589866,BGRD 200,011,485543,Bennett; Eric J,9999,0,9999,0
1708255589866,BGRD 200,012,485545,Bloodgood; Brenda Laurie,9999,0,9999,0
1708255589866,BGRD 200,013,485546,Breen; Ellen C.,9998,0,9999,1
1708255589866,BGRD 200,014,485548,Briggs; Steven,9998,0,9999,1
1708255589866,BGRD 200,015,485549,Bui; Jack D,9999,0,9999,0
1708255589866,BGRD 200,016,485552,Busch; Wolfgang,9999,0,9999,0
1708255589866,BGRD 200,017,485621,Callaway; Edward M,9999,0,9999,0
1708255589866,BGRD 200,018,485622,Castle; Michael James,9999,0,9999,0
1708255589866,BGRD 200,019,485623,Chaim; Isaac,9999,0,9999,0
1708255589866,BGRD 200,020,485624,Chang; John Tzu-yu,9999,0,9999,0
1708255589866,BGRD 200,021,485625,Chen; Ju,9999,0,9999,0
1708255589866,BGRD 200,022,485626,Chen; Xu,9999,0,9999,0
1708255589866,BGRD 200,023,485627,Cheng; Christine Shiang-Ling,9999,0,9999,0
1708255589866,BGRD 200,024,485632,Cherqui; Stephanie,9999,0,9999,0
1708255589866,BGRD 200,025,485633,Cho; Yoshitake,9999,0,9999,0
1708255589866,BGRD 200,026,485634,Church; Kellie Breen,9999,0,9999,0
1708255589866,BGRD 200,027,485635,Cleland; Elsa Eleanor,9999,0,9999,0
1708255589866,BGRD 200,028,485636,Cohen; Shiran,9998,0,9999,1
1708255589866,BGRD 200,029,485639,Cook-Andersen; Heidi Leigh,9999,0,9999,0
1708255589866,BGRD 200,030,485686,Cooke; James Edward,9999,0,9999,0
1708255589866,BGRD 200,031,485688,Cooper; Kimberly Lynn,9999,0,9999,0
1708255589866,BGRD 200,032,485689,Coufal; Nicole Gabriele,9998,0,9999,1
1708255589866,BGRD 200,033,485690,Crotty Alexander; Laura E,9999,0,9999,0
1708255589866,BGRD 200,034,485691,Staff,9999,0,9999,0
1708255589866,BGRD 200,035,485692,De Guglielmo; Giordano,9999,0,9999,0
1708255589866,BGRD 200,036,485693,De Silva; Shermin,9999,0,9999,0
1708255589866,BGRD 200,037,485694,Desai; Arshad,9999,0,9999,0
1708255589866,BGRD 200,038,485695,Dickinson; Alexandra Jazz,9999,0,9999,0
1708255589866,BGRD 200,039,485717,Doherty; Taylor Alan,9998,0,9999,1
1708255589866,BGRD 200,040,485720,Dulawa; Stephanie Carole,9999,0,9999,0
1708255589866,BGRD 200,041,485721,Ecker; Joseph R,9999,0,9999,0
1708255589866,BGRD 200,042,485760,Engle; Dannielle D,9999,0,9999,0
1708255589866,BGRD 200,043,485761,Ernst; Andreas,9998,0,9999,1
1708255589866,BGRD 200,044,485766,Esko; Jeffrey D.,9998,0,9999,1
1708255589866,BGRD 200,045,485905,Evans; Ronald M,9999,0,9999,0
1708255589866,BGRD 200,046,485907,Staff,9999,0,9999,0
1708255589866,BGRD 200,047,485918,Feldstein; Ariel E,9998,0,9999,1
1708255589866,BGRD 200,048,485938,Friedman; Rick Adam,9999,0,9999,0
1708255589866,BGRD 200,049,485986,Furnari; Frank,9999,0,9999,0
1708255589866,BGRD 200,050,486018,Gage; Fred H,9999,0,9999,0
1708255589866,BGRD 200,051,486139,George; Monique Leana,9999,0,9999,0
1708255589866,BGRD 200,052,486140,Ghosh; Pradipta,9998,0,9999,1
1708255589866,BGRD 200,053,486141,Glass; Christopher,9998,0,9999,1
1708255589866,BGRD 200,054,486142,Gleeson; Joseph Gerard,9999,0,9999,0
1708255589866,BGRD 200,055,486143,Golden; Susan S.,9999,0,9999,0
1708255589866,BGRD 200,056,486144,Goldrath; Ananda,9999,0,9999,0
1708255589866,BGRD 200,057,486145,Goren; Alon M,9998,0,9999,1
1708255589866,BGRD 200,058,486146,Gustafsson; Asa Birgitta,9999,0,9999,0
1708255589866,BGRD 200,059,486164,Gutkind; Jorge Silvio,9999,0,9999,0
1708255589866,BGRD 200,060,486203,Hamdoun; Amr,9999,0,9999,0
1708255589866,BGRD 200,061,486204,Hampton; Randolph Y.,9999,0,9999,0
1708255589866,BGRD 200,062,486205,Hao; Nan,9999,0,9999,0
1708255589866,BGRD 200,063,486206,Staff,9999,0,9999,0
1708255589866,BGRD 200,064,486207,Hasty; Jeff M,9999,0,9999,0
1708255589866,BGRD 200,065,486208,Hollern; Daniel Patrick,9999,0,9999,0
1708255589866,BGRD 200,066,486209,Holway; David A.,9997,0,9999,2
1708255589866,BGRD 200,067,486214,Huffaker; Alisa,9998,0,9999,1
1708255589866,BGRD 200,068,486215,Hui; Enfu,9999,0,9999,0
1708255589866,BGRD 200,069,486216,Hwa; Terence T.,9999,0,9999,0
1708255589866,BGRD 200,070,486217,Sebat; Lilia Mikhailovna,9998,0,9999,1
1708255589866,BGRD 200,071,486218,Ideker; Trey,9999,0,9999,0
1708255589866,BGRD 200,072,486219,Jackrel; Sara,9998,0,9999,1
1708255589866,BGRD 200,073,486224,Jiang; Qingfei,9998,0,9999,1
1708255589866,BGRD 200,074,486225,Jin; Yishi,9999,0,9999,0
1708255589866,BGRD 200,075,486226,Joiner; William J.,9999,0,9999,0
1708255589866,BGRD 200,076,486227,Jun; Suckjoon,9999,0,9999,0
1708255589866,BGRD 200,077,486228,Kadonaga; James T,9998,0,9999,1
1708255589866,BGRD 200,078,486229,Kaech; Susan Michelle,9997,0,9999,2
1708255589866,BGRD 200,079,486237,Karin; Michael,9999,0,9999,0
1708255589866,BGRD 200,080,486238,Kleinfeld; David,9999,0,9999,0
1708255589866,BGRD 200,081,486239,Knight; Robin,9999,0,9999,0
1708255589866,BGRD 200,082,486335,Koffler; Yacov,9999,0,9999,0
1708255589866,BGRD 200,083,486336,Komiyama; Takaki,9999,0,9999,0
1708255589866,BGRD 200,084,486337,Kosuri; Pallav,9999,0,9999,0
1708255589866,BGRD 200,085,486353,Kryazhimskiy; Sergey A,9999,0,9999,0
1708255589866,BGRD 200,086,486354,Kurle; Carolyn M.,9999,0,9999,0
1708255589866,BGRD 200,087,486355,Law; Julie A,9999,0,9999,0
1708255589866,BGRD 200,088,486356,Lawson; Mark Andrew,9999,0,9999,0
1708255589866,BGRD 200,089,486357,Lee; Kuo Fen,9999,0,9999,0
1708255589866,BGRD 200,090,486376,Lee; Yun Sok,9999,0,9999,0
1708255589866,BGRD 200,091,486413,Leutgeb; Jill K.,9999,0,9999,0
1708255589866,BGRD 200,092,486414,Leutgeb; Stefan,9998,0,9999,1
1708255589866,BGRD 200,093,486415,Lim; Byungkook,9999,0,9999,0
1708255589866,BGRD 200,094,486419,Lo; Stanley M.,9999,0,9999,0
1708255589866,BGRD 200,095,486420,Looger; Loren Lee,9999,0,9999,0
1708255589866,BGRD 200,096,486422,Lovett-Barron; Matthew Rod,9999,0,9999,0
1708255589866,BGRD 200,097,486423,Lu; Li-Fan,9998,0,9999,1
1708255589866,BGRD 200,098,486424,Lu; Pengzhe,9998,0,9999,1
1708255589866,BGRD 200,099,486425,Lykke-Andersen; Jens,9998,0,9999,1
1708255589866,BGRD 200,100,486426,Lyumkis; Dmitry Evgenievich,9999,0,9999,0
1708255589866,BGRD 200,101,486427,Madigan; Cressida Ariana,9999,0,9999,0
1708255589866,BGRD 200,102,486428,Staff,9999,0,9999,0
1708255589866,BGRD 200,103,486429,Mayfield; Stephen P.,9998,0,9999,1
1708255589866,BGRD 200,104,486430,McDonnell; Lisa Marie,9999,0,9999,0
1708255589866,BGRD 200,105,486620,McHugh; Colleen A,9998,0,9999,1
1708255589866,BGRD 200,106,486621,Meharena; Hiruy Sibhatu,9999,0,9999,0
1708255589866,BGRD 200,107,486622,Staff,9999,0,9999,0
1708255589866,BGRD 200,108,486681,Morris; Gerald P,9999,0,9999,0
1708255589866,BGRD 200,109,486682,Mukamel; Eran A,9998,0,9999,1
1708255589866,BGRD 200,110,486683,Muotri; Alysson,9999,0,9999,0
1708255589866,BGRD 200,111,486684,Muroyama; Andrew David,9999,0,9999,0
1708255589866,BGRD 200,112,486687,Murre; Cornelis,9999,0,9999,0
1708255589866,BGRD 200,113,486691,Neal; Sonya E,9999,0,9999,0
1708255589866,BGRD 200,114,486692,Nieh; James Charles,9998,0,9999,1
1708255589866,BGRD 200,115,486693,Nimmerjahn; Axel,9999,0,9999,0
1708255589866,BGRD 200,116,486694,Nizet; Victor F.,9999,0,9999,0
1708255589866,BGRD 200,117,486695,O'Donoghue; Anthony John,9999,0,9999,0
1708255589866,BGRD 200,118,486706,Oegema; Karen,9999,0,9999,0
1708255589866,BGRD 200,119,486708,O'Shea; Clodagh,9999,0,9999,0
1708255589866,BGRD 200,120,486709,Pantham; Priyadarshini,9999,0,9999,0
1708255589866,BGRD 200,121,486715,Parast; Mana,9999,0,9999,0
1708255589866,BGRD 200,122,486716,Pasquinelli; Amy,9998,0,9999,1
1708255589866,BGRD 200,123,486718,Pekkurnaz Banghart; Gulcin,9999,0,9999,0
1708255589866,BGRD 200,124,486720,Perry; Michael William,9999,0,9999,0
1708255589866,BGRD 200,125,486721,Pfaff; Samuel,9999,0,9999,0
1708255589866,BGRD 200,126,486723,Pogliano; Joseph,9999,0,9999,0
1708255589866,BGRD 200,127,486724,Pogliano; Kit J.,9999,0,9999,0
1708255589866,BGRD 200,128,486727,Pride; David Tevis,9999,0,9999,0
1708255589866,BGRD 200,129,486728,Pruneda-Paz; Jose L.,9999,0,9999,0
1708255589866,BGRD 200,130,486733,Staff,9999,0,9999,0
1708255589866,BGRD 200,131,486734,Rana; Tariq,9999,0,9999,0
1708255589866,BGRD 200,132,486736,Reck-Peterson; Samara L,9999,0,9999,0
1708255589866,BGRD 200,133,486738,Rennison; Diana,9999,0,9999,0
1708255589866,BGRD 200,134,486741,Rifkin; Scott,9999,0,9999,0
1708255589866,BGRD 200,135,486743,Risbrough; Victoria Blythe,9999,0,9999,0
1708255589866,BGRD 200,136,486749,Rissman; Robert Andrew,9999,0,9999,0
1708255589866,BGRD 200,137,486750,Rivera; Fabian Chavez,9999,0,9999,0
1708255589866,BGRD 200,138,486753,Root; Cory Matthew,9999,0,9999,0
1708255589866,BGRD 200,139,486760,Rosenfeld; Michael G,9998,0,9999,1
1708255589866,BGRD 200,140,486763,Russell; Alistair B,9999,0,9999,0
1708255589866,BGRD 200,141,486766,Saier; Milton H.,9999,0,9999,0
1708255589866,BGRD 200,142,486768,Sander; Maike,9999,0,9999,0
1708255589866,BGRD 200,143,486770,Saphire; Erica Ollmann,9999,0,9999,0
1708255589866,BGRD 200,144,486771,Schenk; Simon,9999,0,9999,0
1708255589866,BGRD 200,145,486774,Schoeneberg; Johannes,9999,0,9999,0
1708255589866,BGRD 200,146,486777,Schroeder; Julian I,9998,0,9999,1
1708255589866,BGRD 200,147,486783,Shah; Sameer B,9999,0,9999,0
1708255589866,BGRD 200,148,486784,Shaner; Nathan C.,9999,0,9999,0
1708255589866,BGRD 200,149,486785,Shaw; Reuben,9999,0,9999,0
1708255589866,BGRD 200,150,486786,Sheikh; Farah,9999,0,9999,0
1708255589866,BGRD 200,151,486787,Staff,9999,0,9999,0
1708255589866,BGRD 200,152,486788,Signer; Robert,9999,0,9999,0
1708255589866,BGRD 200,153,486789,Sigurdson; Christina,9999,0,9999,0
1708255589866,BGRD 200,154,486790,Smith; David M.,9999,0,9999,0
1708255589866,BGRD 200,155,486791,Soncin; Francesca,9999,0,9999,0
1708255589866,BGRD 200,156,486792,Steinmetz; Nicole F,9999,0,9999,0
1708255589866,BGRD 200,157,486793,Su; Chih-Ying,9999,0,9999,0
1708255589866,BGRD 200,158,486794,Suel; Gurol Mehmet,9999,0,9999,0
1708255589866,BGRD 200,159,486795,Sun; Xin,9999,0,9999,0
1708255589866,BGRD 200,160,486796,Telese; Francesca,9999,0,9999,0
1708255589866,BGRD 200,161,486797,Thackray; Varykina G.,9999,0,9999,0
1708255589866,BGRD 200,162,486798,Towers; Christina Garlingt,9999,0,9999,0
1708255589866,BGRD 200,163,486799,Traver; David,9999,0,9999,0
1708255589866,BGRD 200,164,486800,Troemel; Emily Ruth,9998,0,9999,1
1708255589866,BGRD 200,165,486801,Tye; Kay M,9999,0,9999,0
1708255589866,BGRD 200,166,486802,Valdez-Jasso; Daniela,9998,0,9999,1
1708255589866,BGRD 200,167,486803,Vijayanand; Pandurangan,9999,0,9999,0
1708255589866,BGRD 200,168,486804,Villa Rodriguez; Elizabeth,9999,0,9999,0
1708255589866,BGRD 200,169,486805,Wahlin; Karl Jonas,9997,0,9999,2
1708255589866,BGRD 200,170,486806,Wang; Jean Yin Jen,9999,0,9999,0
1708255589866,BGRD 200,171,486807,Welsbie; Derek,9999,0,9999,0
1708255589866,BGRD 200,172,486808,Wildonger; Jill Cathleen,9998,0,9999,1
1708255589866,BGRD 200,173,486809,Wilkinson; Miles Frome,9999,0,9999,0
1708255589866,BGRD 200,174,486810,Winzeler; Elizabeth A,9999,0,9999,0
1708255589866,BGRD 200,175,486811,Yaksh; Tony L.,9999,0,9999,0
1708255589866,BGRD 200,176,486812,Yang; Jing,9999,0,9999,0
1708255589866,BGRD 200,177,486813,Staff,9999,0,9999,0
1708255589866,BGRD 200,178,486814,Yeo; Eugene Wei-Ming,9998,0,9999,1
1708255589866,BGRD 200,179,486815,Ying; Wei,9999,0,9999,0
1708255589866,BGRD 200,180,486816,Zarrinpar; Amir,9999,0,9999,0
1708255589866,BGRD 200,181,486817,Zengler; Karsten B,9999,0,9999,0
1708255589866,BGRD 200,182,486818,Zhang; Dong-Er,9999,0,9999,0
1708255589866,BGRD 200,183,486819,Zhao; Yunde,9999,0,9999,0
1708255589866,BGRD 200,184,486820,Zheng; Binhai,9999,0,9999,0
1708255589866,BGRD 200,185,486821,Zheng; Ye,9998,0,9999,1
1708255589866,BGRD 200,186,486822,Zuniga; Elina I,9999,0,9999,0
1708255590462,BGSE 200,A00,424140,Tour; Ella & Petrie; Katherine Lynn,9995,0,9999,4
1708255590993,BGSE 205,A00,424177,Bennett; Eric J,49,0,50,1
1708255590993,BGSE 205,B00,424179,Bennett; Eric J,48,0,50,2
1708255590993,BGSE 205,C00,424182,Bennett; Eric J,47,0,50,3
1708255590993,BGSE 205,D00,424184,Bennett; Eric J,46,0,50,4
1708255590993,BGSE 205,E00,424185,Bennett; Eric J,50,0,50,0
1708255591522,BIBC 100,A01,425401,Corbett; Kevin Daniel,150,0,158,8
1708255591522,BIBC 100,B01,477769,Amaro; Rommie E,156,0,158,2
1708255592050,BIBC 102,A01,425425,Bozinovic; Goran,255,0,256,1
1708255592050,BIBC 102,B01,425440,Hampton; Randolph Y.,250,0,256,6
1708255592050,BIBC 102,C01,486849,Flagg; Matthew Paul,61,0,120,59
1708255592581,BIBC 103,A01,425476,Grossman; Emily N,17,0,24,7
1708255592581,BIBC 103,A02,425509,Grossman; Emily N,21,0,24,3
1708255592581,BIBC 103,A03,425530,Grossman; Emily N,18,0,24,6
1708255592581,BIBC 103,A04,425536,Grossman; Emily N,22,0,24,2
1708255592581,BIBC 103,B01,425538,Boumechache; Miyyada,20,0,24,4
1708255592581,BIBC 103,B02,425539,Boumechache; Miyyada,24,0,24,0
1708255592581,BIBC 103,B03,425548,Boumechache; Miyyada,24,0,24,0
1708255592581,BIBC 103,B04,425549,Boumechache; Miyyada,24,0,24,0
1708255593108,BIBC 120,A01,425592,Coleman; Aaron B.,242,0,256,14
1708255593641,BIBC 194,A00,425609,Ernst; Andreas,21,0,27,6
1708255593641,BIBC 194,B00,477632,Saier; Milton H.,26,0,27,1
1708255593641,BIBC 194,C00,481360,Amaro; Rommie E,23,0,27,4
1708255593641,BIBC 194,D00,486852,Flagg; Matthew Paul,21,0,32,11
1708255594184,BICD 100,A01,470377,Troemel; Emily Ruth,127,0,128,1
1708255594184,BICD 100,A02,470378,Troemel; Emily Ruth,126,0,128,2
1708255594184,BICD 100,B01,470409,Reinagel; Pam,59,0,64,5
1708255594184,BICD 100,B02,470413,Reinagel; Pam,62,0,64,2
1708255594184,BICD 100,B03,470464,Reinagel; Pam,64,0,64,0
1708255594184,BICD 100,B04,470468,Reinagel; Pam,63,0,64,1
1708255594184,BICD 100,C01,470469,Beyhan; Sinem,51,0,64,13
1708255594184,BICD 100,C02,470605,Beyhan; Sinem,58,0,64,6
1708255594184,BICD 100,C03,470606,Beyhan; Sinem,60,0,64,4
1708255594184,BICD 100,C04,470607,Beyhan; Sinem,63,0,64,1
1708255594184,BICD 100,D01,477465,Nguyen; Vu Quang,158,0,160,2
1708255594712,BICD 100R,A01,425674,Smith; Laurie,29,0,34,5
1708255594712,BICD 100R,A02,425675,Smith; Laurie,30,0,34,4
1708255594712,BICD 100R,A03,425676,Smith; Laurie,30,0,34,4
1708255595239,BICD 104,A01,425696,Greenspan; Ralph J.,60,0,64,4
1708255595769,BICD 110,A01,470608,Muroyama; Andrew David,264,0,275,11
1708255595769,BICD 110,B01,425721,Ernst; Andreas,244,0,275,31
1708255596317,BICD 112,A01,458177,Cooper; Kimberly Lynn & Traver; David,10,0,32,22
1708255596317,BICD 112,A02,458180,Cooper; Kimberly Lynn & Traver; David,28,0,32,4
1708255596843,BICD 123,A01,425725,Zhao; Yunde,24,0,32,8
1708255597373,BICD 140,A01,425728,Lu; Li-Fan,227,0,240,13
1708255597899,BICD 158,A01,425730,Bier; Ethan,136,0,145,9
1708255598428,BICD 194,A00,425731,Desai; Arshad & Oegema; Karen,17,0,27,10
1708255598428,BICD 194,B00,481735,Wilhelm; James E.,29,0,32,3
1708255598972,BIEB 121,A00,425732,Butler; Shannon Rhey,21,0,32,11
1708255598972,BIEB 121,B00,425733,Butler; Shannon Rhey,24,0,32,8
1708255599500,BIEB 130,A01,425735,Kurle; Carolyn M.,243,0,295,52
1708255600028,BIEB 146,A01,425737,Petrie; Katherine Lynn,365,0,395,30
1708255600554,BIEB 148,A01,470637,Rose; Noah Hartmann,59,0,63,4
1708255600554,BIEB 148,A02,470638,Rose; Noah Hartmann,61,0,63,2
1708255601080,BIEB 154,A01,458184,Stockwell; Sarah R,29,0,30,1
1708255601080,BIEB 154,A02,458186,Stockwell; Sarah R,29,0,30,1
1708255601625,BIEB 176,A01,425741,De Silva; Shermin,56,0,64,8
1708255602150,BIEB 182,A01,458194,Roy; Kaustuv,25,0,32,7
1708255602150,BIEB 182,A02,458215,Roy; Kaustuv,31,0,32,1
1708255602699,BILD 1,A01,424267,Patrick; Gentry,249,0,250,1
1708255602699,BILD 1,B01,424272,Burg; Michael,231,0,250,19
1708255602699,BILD 1,C01,424293,Pickett; Brooke Elizabeth,245,0,250,5
1708255602699,BILD 1,D01,458292,Gonzalez Gamboa; Ivonne,48,0,50,2
1708255602699,BILD 1,D02,458295,Gonzalez Gamboa; Ivonne,50,0,50,0
1708255602699,BILD 1,D03,458296,Gonzalez Gamboa; Ivonne,50,0,50,0
1708255602699,BILD 1,D04,458297,Gonzalez Gamboa; Ivonne,49,0,50,1
1708255602699,BILD 1,D05,458303,Gonzalez Gamboa; Ivonne,50,0,50,0
1708255603245,BILD 2,A01,458304,Reyes Gonzalez; Catalina,53,0,56,3
1708255603245,BILD 2,A02,458307,Reyes Gonzalez; Catalina,55,0,56,1
1708255603245,BILD 2,A03,458313,Reyes Gonzalez; Catalina,55,0,56,1
1708255603245,BILD 2,A04,458320,Reyes Gonzalez; Catalina,56,0,56,0
1708255603245,BILD 2,B01,458324,Reyes Gonzalez; Catalina,47,0,56,9
1708255603245,BILD 2,B02,458327,Reyes Gonzalez; Catalina,54,0,56,2
1708255603245,BILD 2,B03,458339,Reyes Gonzalez; Catalina,56,0,56,0
1708255603245,BILD 2,B04,458340,Reyes Gonzalez; Catalina,56,0,56,0
1708255603245,BILD 2,C01,458387,Park; Ji Young,44,0,49,5
1708255603245,BILD 2,C02,458544,Park; Ji Young,46,0,49,3
1708255603245,BILD 2,C03,458557,Park; Ji Young,47,0,49,2
1708255603245,BILD 2,C04,458563,Park; Ji Young,46,0,49,3
1708255603787,BILD 3,A01,424312,Hammond; LaTisha Marie,331,0,350,19
1708255603787,BILD 3,B01,470107,Stockwell; Sarah R,66,0,70,4
1708255603787,BILD 3,B02,470110,Stockwell; Sarah R,70,0,70,0
1708255603787,BILD 3,B03,470116,Stockwell; Sarah R,70,0,70,0
1708255603787,BILD 3,B04,470123,Stockwell; Sarah R,67,0,70,3
1708255603787,BILD 3,B05,470150,Stockwell; Sarah R,70,0,70,0
1708255603787,BILD 3,C01,470159,Cooper; Kimberly Lynn,67,0,70,3
1708255603787,BILD 3,C02,470160,Cooper; Kimberly Lynn,69,0,70,1
1708255603787,BILD 3,C03,470164,Cooper; Kimberly Lynn,70,0,70,0
1708255603787,BILD 3,C04,470165,Cooper; Kimberly Lynn,69,0,70,1
1708255603787,BILD 3,C05,470374,Cooper; Kimberly Lynn,68,0,70,2
1708255604331,BILD 4,A01,424318,Staff,22,0,24,2
1708255604331,BILD 4,A02,424324,Staff,24,0,24,0
1708255604331,BILD 4,A03,424325,Staff,24,0,24,0
1708255604331,BILD 4,A04,424326,Staff,22,0,24,2
1708255604331,BILD 4,A05,424327,Staff,24,0,24,0
1708255604331,BILD 4,A06,424330,Staff,24,0,24,0
1708255604331,BILD 4,A07,424331,Staff,24,0,24,0
1708255604331,BILD 4,A08,424342,Staff,24,0,24,0
1708255604331,BILD 4,B01,424462,Pickett; Brooke Elizabeth,23,0,24,1
1708255604331,BILD 4,B02,424466,Pickett; Brooke Elizabeth,24,0,24,0
1708255604331,BILD 4,B03,424469,Pickett; Brooke Elizabeth,23,0,24,1
1708255604331,BILD 4,B04,424470,Pickett; Brooke Elizabeth,22,0,24,2
1708255604331,BILD 4,B05,424700,Pickett; Brooke Elizabeth,23,0,24,1
1708255604331,BILD 4,B06,424723,Pickett; Brooke Elizabeth,24,0,24,0
1708255604331,BILD 4,B07,424730,Pickett; Brooke Elizabeth,24,0,24,0
1708255604331,BILD 4,B08,424929,Pickett; Brooke Elizabeth,22,0,24,2
1708255604331,BILD 4,C01,424947,Gonzalez Gamboa; Ivonne,22,0,24,2
1708255604331,BILD 4,C02,424951,Gonzalez Gamboa; Ivonne,23,0,24,1
1708255604331,BILD 4,C03,424991,Gonzalez Gamboa; Ivonne,23,0,24,1
1708255604331,BILD 4,C04,424993,Gonzalez Gamboa; Ivonne,24,0,24,0
1708255604331,BILD 4,C05,424994,Gonzalez Gamboa; Ivonne,24,0,24,0
1708255604331,BILD 4,C06,425209,Gonzalez Gamboa; Ivonne,24,0,24,0
1708255604331,BILD 4,C07,425233,Gonzalez Gamboa; Ivonne,24,0,24,0
1708255604331,BILD 4,C08,425247,Gonzalez Gamboa; Ivonne,24,0,24,0
1708255604859,BILD 60,A01,425326,Hammond; LaTisha Marie,62,0,64,2
1708255605385,BILD 83,A00,425347,Pogliano; Joseph,25,0,30,5
1708255605915,BILD 87,A00,425368,Saier; Milton H.,20,0,20,0
1708255606442,BIMM 100,A01,425744,Cooper; Andrew Michael,303,0,320,17
1708255606442,BIMM 100,B01,425746,Cooper; Andrew Michael,315,0,320,5
1708255606976,BIMM 101,A01,425748,McDonnell; Lisa Marie,8,0,24,16
1708255606976,BIMM 101,A02,425749,McDonnell; Lisa Marie,23,0,24,1
1708255606976,BIMM 101,B01,425751,Day; Christopher D,22,0,24,2
1708255606976,BIMM 101,B02,425752,Day; Christopher D,24,0,24,0
1708255606976,BIMM 101,B03,425753,Day; Christopher D,22,0,24,2
1708255606976,BIMM 101,B04,425754,Day; Christopher D,24,0,24,0
1708255606976,BIMM 101,C01,425756,Rusert; Jessica Marie,16,0,24,8
1708255606976,BIMM 101,C02,425757,Rusert; Jessica Marie,23,0,24,1
1708255606976,BIMM 101,C03,425758,Rusert; Jessica Marie,23,0,24,1
1708255606976,BIMM 101,C04,425759,Rusert; Jessica Marie,23,0,24,1
1708255607508,BIMM 110,A01,425764,Niwa; Maho,55,0,56,1
1708255607508,BIMM 110,A02,425765,Niwa; Maho,56,0,56,0
1708255607508,BIMM 110,A03,425766,Niwa; Maho,56,0,56,0
1708255607508,BIMM 110,A04,425767,Niwa; Maho,55,0,56,1
1708255608041,BIMM 116R,A01,425771,Golden; Susan S. & Gorman; Michael R.,55,0,72,17
1708255608041,BIMM 116R,A02,425772,Golden; Susan S. & Gorman; Michael R.,53,0,72,19
1708255608041,BIMM 116R,A03,425773,Golden; Susan S. & Gorman; Michael R.,66,0,72,6
1708255608041,BIMM 116R,A04,425774,Golden; Susan S. & Gorman; Michael R.,70,0,72,2
1708255608567,BIMM 118,A01,425779,David; Michael,83,0,96,13
1708255609094,BIMM 120,A01,425792,Pirino; Giorgia,203,0,216,13
1708255609094,BIMM 120,B01,470639,Saier; Milton H.,201,0,216,15
1708255609622,BIMM 121,A01,425830,Gustafson-Brown; Cindy,18,0,24,6
1708255609622,BIMM 121,A02,425831,Gustafson-Brown; Cindy,21,0,24,3
1708255609622,BIMM 121,A03,425832,Gustafson-Brown; Cindy,24,0,24,0
1708255609622,BIMM 121,A04,425833,Gustafson-Brown; Cindy,23,0,24,1
1708255609622,BIMM 121,B01,425835,Pirino; Giorgia,17,0,24,7
1708255609622,BIMM 121,B02,425836,Pirino; Giorgia,24,0,24,0
1708255609622,BIMM 121,C01,425838,Park; Ji Young,6,0,24,18
1708255609622,BIMM 121,C02,425839,Park; Ji Young,20,0,24,4
1708255610149,BIMM 134,A01,425841,Burg; Michael,393,0,416,23
1708255610680,BIMM 143,A01,425843,Grant; Barry J,17,0,40,23
1708255610680,BIMM 143,B01,425845,Bozinovic; Goran,33,0,40,7
1708255611206,BIMM 182,A01,455012,Bafna; Vineet,28,0,50,22
1708255611731,BIMM 194,A00,425847,Rivera; Fabian Chavez,24,0,27,3
1708255611731,BIMM 194,B00,425868,Russell; Alistair B,16,0,27,11
1708255611731,BIMM 194,D00,425870,Wildonger; Jill Cathleen,14,0,27,13
1708255612263,BIOM 202,A00,390710,Corbett; Kevin Daniel,93,0,100,7
1708255612792,BIOM 219,A00,390713,Ross; Camille,0,0,0,7
1708255613317,BIOM 231,A00,455099,Furnari; Frank,0,0,0,0
1708255613317,BIOM 231,B00,455100,Lopez Ramirez; Miguel Alej,0,0,0,0
1708255613843,BIOM 242,A00,390714,Hamilton; Bruce Alan,20,0,20,0
1708255614369,BIOM 246,A00,492784,Gordts; Philip & Varki; Ajit P & Lewis; Amanda Lark & Godula; Kamil & Gagneux; Pascal & Esko; Jeffrey D. & Bode; Lars,0,0,0,0
1708255614898,BIOM 252,A00,390715,Ayyagari; Radha,27,0,28,1
1708255615424,BIOM 254,A00,390718,Corbett; Kevin Daniel,14,0,20,6
1708255615951,BIOM 272,A00,390722,Hangauer; Matthew John,16,0,20,4
1708255616480,BIOM 274,A00,390725,Sun; Bryan Kee-Hong,7,0,15,8
1708255617005,BIOM 283,A00,390728,Komives; Elizabeth A,2,0,2,0
1708255617531,BIOM 285,A00,390730,Gaulton; Kyle J,10,0,20,10
1708255618058,BIOM 295,A00,455083,Brown; Joan Heller,0,0,0,0
1708255618593,BIPN 100,A01,425872,Augustine; Vineet,240,0,245,5
1708255618593,BIPN 100,B01,425874,George; Monique Leana,240,0,245,5
1708255618593,BIPN 100,C01,458640,Maita; Isabella Vincenza,44,0,49,5
1708255618593,BIPN 100,C02,458646,Maita; Isabella Vincenza,48,0,49,1
1708255618593,BIPN 100,C03,458714,Maita; Isabella Vincenza,48,0,49,1
1708255618593,BIPN 100,C04,458716,Maita; Isabella Vincenza,48,0,49,1
1708255618593,BIPN 100,C05,458717,Maita; Isabella Vincenza,46,0,49,3
1708255619119,BIPN 105,A01,425877,Armour; Jon Christopher,12,0,21,9
1708255619119,BIPN 105,A02,425878,Armour; Jon Christopher,21,0,21,0
1708255619119,BIPN 105,A03,425879,Armour; Jon Christopher,10,0,21,11
1708255619119,BIPN 105,A04,425880,Armour; Jon Christopher,20,0,21,1
1708255619648,BIPN 120,A01,425882,Cooke; James Edward,370,0,395,25
1708255620172,BIPN 140,A01,425884,Hibbs; Ryan E.,183,0,192,9
1708255620698,BIPN 144,A01,425886,Zou; Yimin,153,0,158,5
1708255621232,BIPN 145,A01,425888,Maita; Isabella Vincenza,41,0,42,1
1708255621232,BIPN 145,B01,425918,Marino; Marc J,37,0,42,5
1708255621232,BIPN 145,B02,425954,Marino; Marc J,40,0,42,2
1708255621757,BIPN 147,A01,426086,Sejnowski; Terrence J,53,0,64,11
1708255622302,BIPN 152,A01,426112,Halpain; Shelley,97,0,128,31
1708255622829,BIPN 162,A01,426120,Juavinett; Ashley Lauren,17,0,30,13
1708255623353,BIPN 164,A01,455010,Benna; Marcus K & Aljadeff; Johnatan,120,0,120,0
1708255623880,BIPN 194,A00,426122,Glasgow; Stacey Marie,20,0,27,7
1708255624408,BISP 170,A00,426158,French; Kathleen Ann,26,0,30,4
1708255624935,BISP 182,A00,426168,Pogliano; Joseph,9999,0,9999,0
1708255625461,BISP 194,A00,426240,Chisholm; Andrew D.,11,0,27,16
1708255625461,BISP 194,B00,426241,Farley; Emma Kristen,25,0,27,2
1708255625986,BNFO 281,A00,427175,Gaasterland; Theresa,85,0,100,15
1708255626516,BNFO 283,A00,427211,Carter; Hannah Kathryn & Chavez; Alejandro,39,0,50,11
1708255626516,BNFO 283,B00,480483,Amariuta-Bartell; Tiffany & Dorrestein; Pieter,21,0,30,9
1708255627044,BNFO 294,B01,427269,Ross; Camille,47,0,50,3
1708255627643,CAT 3,A01,396994,Glaser; Amelia,15,0,15,0
1708255627643,CAT 3,A02,396995,Glaser; Amelia,15,0,15,0
1708255627643,CAT 3,A03,396996,Glaser; Amelia,7,0,15,8
1708255627643,CAT 3,A04,396997,Glaser; Amelia,12,0,15,3
1708255627643,CAT 3,A05,397004,Glaser; Amelia,15,0,15,0
1708255627643,CAT 3,A06,397039,Glaser; Amelia,11,0,15,4
1708255627643,CAT 3,A07,397040,Glaser; Amelia,13,0,15,2
1708255627643,CAT 3,A08,397084,Glaser; Amelia,15,0,15,0
1708255627643,CAT 3,A09,397269,Glaser; Amelia,13,0,15,2
1708255627643,CAT 3,A10,397270,Glaser; Amelia,0,0,15,15
1708255627643,CAT 3,A11,397271,Glaser; Amelia,9,0,15,6
1708255627643,CAT 3,A12,397272,Glaser; Amelia,12,0,15,3
1708255627643,CAT 3,A13,397273,Glaser; Amelia,15,0,15,0
1708255627643,CAT 3,A14,397274,Glaser; Amelia,14,0,15,1
1708255627643,CAT 3,B01,397276,Porter; Lisa,15,0,15,0
1708255627643,CAT 3,B02,397277,Porter; Lisa,15,0,15,0
1708255627643,CAT 3,B03,397278,Porter; Lisa,14,0,15,1
1708255627643,CAT 3,B04,397279,Porter; Lisa,15,0,15,0
1708255627643,CAT 3,B06,397281,Porter; Lisa,15,0,15,0
1708255627643,CAT 3,B07,397291,Porter; Lisa,15,0,15,0
1708255627643,CAT 3,B09,397293,Porter; Lisa,15,0,15,0
1708255627643,CAT 3,B10,397294,Porter; Lisa,15,0,15,0
1708255627643,CAT 3,B11,397295,Porter; Lisa,12,0,15,3
1708255627643,CAT 3,B12,397296,Porter; Lisa,14,0,15,1
1708255627643,CAT 3,B13,397297,Porter; Lisa,11,0,15,4
1708255627643,CAT 3,B14,397298,Porter; Lisa,15,0,15,0
1708255627643,CAT 3,B15,397299,Porter; Lisa,15,0,15,0
1708255627643,CAT 3,B16,397300,Porter; Lisa,15,0,15,0
1708255627643,CAT 3,C01,397302,Marchisotto; Jennifer Anne,13,0,15,2
1708255627643,CAT 3,C02,397308,Marchisotto; Jennifer Anne,9,0,15,6
1708255627643,CAT 3,C03,397309,Marchisotto; Jennifer Anne,9,0,15,6
1708255627643,CAT 3,C04,397315,Marchisotto; Jennifer Anne,11,0,15,4
1708255627643,CAT 3,C05,397316,Marchisotto; Jennifer Anne,14,0,15,1
1708255627643,CAT 3,C06,397322,Marchisotto; Jennifer Anne,15,0,15,0
1708255627643,CAT 3,C07,397323,Marchisotto; Jennifer Anne,15,0,15,0
1708255627643,CAT 3,C08,397329,Marchisotto; Jennifer Anne,15,0,15,0
1708255627643,CAT 3,C09,397333,Marchisotto; Jennifer Anne,15,0,15,0
1708255627643,CAT 3,C10,397336,Marchisotto; Jennifer Anne,15,0,15,0
1708255627643,CAT 3,C11,397354,Marchisotto; Jennifer Anne,13,0,15,2
1708255627643,CAT 3,C12,397357,Marchisotto; Jennifer Anne,15,0,15,0
1708255627643,CAT 3,C13,397364,Marchisotto; Jennifer Anne,14,0,15,1
1708255627643,CAT 3,C14,397367,Marchisotto; Jennifer Anne,14,0,15,1
1708255627643,CAT 3,C15,397369,Marchisotto; Jennifer Anne,15,0,15,0
1708255627643,CAT 3,C16,397373,Marchisotto; Jennifer Anne,15,0,15,0
1708255627643,CAT 3,C17,397374,Marchisotto; Jennifer Anne,15,0,15,0
1708255627643,CAT 3,C18,397380,Marchisotto; Jennifer Anne,14,0,15,1
1708255627643,CAT 3,D02,397405,Rahimi; Babak,13,0,15,2
1708255627643,CAT 3,D03,397408,Rahimi; Babak,14,0,15,1
1708255627643,CAT 3,D04,397415,Rahimi; Babak,15,0,15,0
1708255627643,CAT 3,D05,397416,Rahimi; Babak,15,0,15,0
1708255627643,CAT 3,D06,397422,Rahimi; Babak,15,0,15,0
1708255627643,CAT 3,D07,397426,Rahimi; Babak,14,0,15,1
1708255627643,CAT 3,D09,397447,Rahimi; Babak,11,0,15,4
1708255627643,CAT 3,D10,397450,Rahimi; Babak,13,0,15,2
1708255627643,CAT 3,D11,397625,Rahimi; Babak,13,0,15,2
1708255627643,CAT 3,D12,397630,Rahimi; Babak,15,0,15,0
1708255627643,CAT 3,D13,397631,Rahimi; Babak,14,0,15,1
1708255627643,CAT 3,D14,397635,Rahimi; Babak,14,0,15,1
1708255628168,CAT 3CE,A01,397642,Bronstein; Phoebe Malan,25,0,25,0
1708255628695,CAT 87,A00,397645,Bronstein; Phoebe Malan,19,0,20,1
1708255629222,CAT 90,A00,480731,Bronstein; Phoebe Malan,20,0,20,0
1708255629748,CAT 124,A01,397662,Knight; Amy,5,0,5,0
1708255629748,CAT 124,A02,397722,Knight; Amy,5,0,5,0
1708255629748,CAT 124,A03,397726,Knight; Amy,5,0,5,0
1708255629748,CAT 124,A04,397829,Knight; Amy,4,0,5,1
1708255630294,CAT 125,001,397832,Popko; Elizabeth Ashley,20,0,20,0
1708255630294,CAT 125,002,397833,Delaville; Romain,20,0,20,0
1708255630294,CAT 125,003,397834,Marchisotto; Jennifer Anne,18,0,20,2
1708255630294,CAT 125,004,397835,Bigham; David Joseph,20,0,20,0
1708255630294,CAT 125,005,397836,Bigham; David Joseph,19,0,20,1
1708255630294,CAT 125,006,397837,Bigham; David Joseph,16,0,20,4
1708255630294,CAT 125,007,397838,Vanderschuit; Maya Alysia,20,0,20,0
1708255630294,CAT 125,008,397839,Vanderschuit; Maya Alysia,20,0,20,0
1708255630294,CAT 125,009,397840,Vanderschuit; Maya Alysia,20,0,20,0
1708255630294,CAT 125,010,397841,Morales; Celeste Georgianna,15,0,16,1
1708255630294,CAT 125,011,397842,Morales; Celeste Georgianna,16,0,16,0
1708255630294,CAT 125,012,397881,Morales; Celeste Georgianna,19,0,20,1
1708255630294,CAT 125,013,397954,Rose; Becca Rae,18,0,20,2
1708255630294,CAT 125,014,397956,Rose; Becca Rae,20,0,20,0
1708255630294,CAT 125,015,397998,Rose; Becca Rae,19,0,20,1
1708255630294,CAT 125,016,397999,Tosun; Adriana,20,0,20,0
1708255630294,CAT 125,017,398001,Tosun; Adriana,20,0,20,0
1708255630294,CAT 125,018,398009,Irwin; Matthew Joseph,19,0,20,1
1708255630294,CAT 125,019,398010,Irwin; Matthew Joseph,18,0,20,2
1708255630294,CAT 125,020,398014,Irwin; Matthew Joseph,20,0,20,0
1708255630824,CAT 125R,A00,398015,Smith; Lauryn Alissa,19,0,20,1
1708255630824,CAT 125R,B00,398016,Smith; Lauryn Alissa,17,0,20,3
1708255630824,CAT 125R,C00,398017,Smith; Lauryn Alissa,19,0,20,1
1708255630824,CAT 125R,D00,398019,Tosun; Adriana,19,0,20,1
1708255630824,CAT 125R,E00,398020,Hyland; Tina Mae,12,0,20,8
1708255630824,CAT 125R,F00,398027,Hyland; Tina Mae,18,0,20,2
1708255630824,CAT 125R,G00,398028,Hyland; Tina Mae,18,0,20,2
1708255631370,CCE 1,A01,396087,Kenley Grounds; Nicole,40,0,40,0
1708255631370,CCE 1,B01,396142,Quijada; David,39,0,40,1
1708255631370,CCE 1,C01,396159,Bigley; Michele Heather,39,0,40,1
1708255631370,CCE 1,D01,396164,Bigley; Michele Heather,40,0,40,0
1708255631370,CCE 1,E01,396166,Lee; Kassandra,40,0,40,0
1708255631370,CCE 1,F01,396168,Lee; Kassandra,40,0,40,0
1708255631370,CCE 1,G01,396170,Staff,40,0,40,0
1708255631370,CCE 1,H01,396172,Staff,40,0,40,0
1708255631898,CENG 101B,A00,392993,Chen; Shaochen,44,0,45,1
1708255632424,CENG 101C,A00,392997,Li; Yanran,148,0,150,2
1708255632956,CENG 113,A00,393000,Chen; Zheng,69,0,70,1
1708255632956,CENG 113,B00,393001,Li; Wan-Lu,69,0,70,1
1708255633483,CENG 124B,A00,393036,Powell; Alyssa & Russ; Benjamin Edward,113,0,120,7
1708255634012,CENG 157,A00,393220,Opatkiewicz; Justin Paul,50,0,57,7
1708255634539,CENG 160,A00,393231,Powell; Alyssa,70,0,80,10
1708255635070,CENG 170,A01,393238,Drews; Aaron,27,0,30,3
1708255635600,CENG 175,A00,393239,Steinmetz; Nicole F,34,0,35,1
1708255636127,CENG 176B,A01,393285,Opatkiewicz; Justin Paul,46,0,52,6
1708255636127,CENG 176B,B01,393629,Zhang; Liangfang,40,0,49,9
1708255636656,CENG 205,A00,393681,Jahed Motlagh; Zeinab,53,0,60,7
1708255637182,CENG 257,A00,393682,Opatkiewicz; Justin Paul,10,0,13,3
1708255637713,CGS 87,A00,489609,Wesling; Megan E.,20,0,20,0
1708255638239,CGS 100B,A00,396181,Whitley; Leila Marie,28,0,30,2
1708255638765,CGS 109,A00,396194,Whitley; Leila Marie,19,0,20,1
1708255639311,CGS 112,A00,396220,Martin Sandino; Amanda Maria Yoland,22,0,25,3
1708255639837,CGS 114,A00,396223,Steelman; Katherine Wallis,14,0,16,2
1708255640365,CGS 116,A00,396295,Staff,19,0,20,1
1708255640894,CGS 117,A00,396306,Martin Sandino; Amanda Maria Yoland,14,0,15,1
1708255641422,CGS 118,A00,396314,Hankins; Joseph D.,28,0,29,1
1708255641947,CGS 128,A00,396366,Whitley; Leila Marie,14,0,15,1
1708255642473,CGS 137,A00,396865,Martin Sandino; Amanda Maria Yoland,16,0,19,3
1708255643002,CGS 150,A00,396901,Taylor-Garcia; Daphne,18,0,18,0
1708255643530,CGS 196B,A00,396904,Lo; Stanley M.,7,0,7,0
1708255643530,CGS 196B,B00,396973,Brenner; Suzanne A,7,0,7,0
1708255643530,CGS 196B,C00,396985,Jones; Makeba,7,0,7,0
1708255644116,CGS 198,001,396987,Anderson; Patrick W.,0,0,0,0
1708255644116,CGS 198,002,396988,Anderson; Patrick W.,0,0,0,0
1708255644116,CGS 198,003,396989,Anderson; Patrick W.,0,0,0,0
1708255644116,CGS 198,004,396990,Anderson; Patrick W.,0,0,0,0
1708255644642,CGS 200,A00,396991,Perez; Roy,0,0,0,3
1708255645168,CHEM 6A,A01,459563,Deshmukh; Lalit,40,0,40,0
1708255645168,CHEM 6A,A02,459564,Deshmukh; Lalit,35,0,40,5
1708255645168,CHEM 6A,A03,459565,Deshmukh; Lalit,31,0,40,9
1708255645168,CHEM 6A,A04,459566,Deshmukh; Lalit,30,0,38,8
1708255645168,CHEM 6A,A05,459567,Deshmukh; Lalit,40,0,40,0
1708255645168,CHEM 6A,A06,459568,Deshmukh; Lalit,37,0,40,3
1708255645168,CHEM 6A,A07,459569,Deshmukh; Lalit,37,0,40,3
1708255645168,CHEM 6A,A08,459570,Deshmukh; Lalit,0,0,0,0
1708255645701,CHEM 6B,A01,467314,Ortony; Julia Helen,39,0,40,1
1708255645701,CHEM 6B,A02,467322,Ortony; Julia Helen,32,0,40,8
1708255645701,CHEM 6B,A03,467323,Ortony; Julia Helen,40,0,40,0
1708255645701,CHEM 6B,A04,467325,Ortony; Julia Helen,31,0,40,9
1708255645701,CHEM 6B,A05,467326,Ortony; Julia Helen,39,0,40,1
1708255645701,CHEM 6B,A06,467346,Ortony; Julia Helen,40,0,40,0
1708255645701,CHEM 6B,B01,467360,Hopkins; Patrycja Anna,35,0,40,5
1708255645701,CHEM 6B,B02,467363,Hopkins; Patrycja Anna,38,0,40,2
1708255645701,CHEM 6B,B03,467364,Hopkins; Patrycja Anna,35,0,40,5
1708255645701,CHEM 6B,B04,467380,Hopkins; Patrycja Anna,40,0,40,0
1708255645701,CHEM 6B,B05,467381,Hopkins; Patrycja Anna,40,0,40,0
1708255645701,CHEM 6B,B06,467382,Hopkins; Patrycja Anna,39,0,40,1
1708255646235,CHEM 6C,A01,468994,Ternansky; Robert J.,39,0,40,1
1708255646235,CHEM 6C,A02,469054,Ternansky; Robert J.,38,0,40,2
1708255646235,CHEM 6C,A03,469065,Ternansky; Robert J.,39,0,40,1
1708255646235,CHEM 6C,A04,469069,Ternansky; Robert J.,40,0,40,0
1708255646235,CHEM 6C,A05,469080,Ternansky; Robert J.,40,0,40,0
1708255646235,CHEM 6C,B01,469318,Ternansky; Robert J.,39,0,40,1
1708255646235,CHEM 6C,B02,469319,Ternansky; Robert J.,40,0,40,0
1708255646235,CHEM 6C,B03,469320,Ternansky; Robert J.,39,0,40,1
1708255646235,CHEM 6C,B04,469321,Ternansky; Robert J.,40,0,40,0
1708255646235,CHEM 6C,B05,469322,Ternansky; Robert J.,40,0,40,0
1708255646235,CHEM 6C,C01,469323,Schurmeier; Kimberly,38,0,40,2
1708255646235,CHEM 6C,C02,469324,Schurmeier; Kimberly,36,0,40,4
1708255646235,CHEM 6C,C03,469325,Schurmeier; Kimberly,38,0,40,2
1708255646235,CHEM 6C,C04,469326,Schurmeier; Kimberly,36,0,40,4
1708255646235,CHEM 6C,C05,469327,Schurmeier; Kimberly,40,0,40,0
1708255646235,CHEM 6C,D01,460183,Schurmeier; Kimberly,39,0,40,1
1708255646235,CHEM 6C,D02,460184,Schurmeier; Kimberly,32,0,40,8
1708255646235,CHEM 6C,D03,460185,Schurmeier; Kimberly,26,0,40,14
1708255646235,CHEM 6C,D04,460186,Schurmeier; Kimberly,38,0,40,2
1708255646235,CHEM 6C,D05,460187,Schurmeier; Kimberly,40,0,40,0
1708255646235,CHEM 6C,E01,460188,Stallings; Dontarie M,24,0,40,16
1708255646235,CHEM 6C,E02,460190,Stallings; Dontarie M,25,0,40,15
1708255646235,CHEM 6C,E03,460191,Stallings; Dontarie M,3,0,20,17
1708255646235,CHEM 6C,E04,460192,Stallings; Dontarie M,36,0,40,4
1708255646235,CHEM 6C,E05,460193,Stallings; Dontarie M,37,0,40,3
1708255646761,CHEM 6CH,A01,459630,Tezcan; Faik,40,0,40,0
1708255647290,CHEM 7L,A01,393998,Jazzar; Rodolphe,0,0,0,3
1708255647290,CHEM 7L,A02,393999,Jazzar; Rodolphe,10,0,24,14
1708255647290,CHEM 7L,A03,394000,Jazzar; Rodolphe,21,0,24,3
1708255647290,CHEM 7L,A04,394001,Jazzar; Rodolphe,22,0,24,2
1708255647290,CHEM 7L,A05,394002,Jazzar; Rodolphe,18,0,24,6
1708255647290,CHEM 7L,A06,394003,Jazzar; Rodolphe,22,0,24,2
1708255647290,CHEM 7L,A07,394004,Jazzar; Rodolphe,18,0,21,3
1708255647290,CHEM 7L,A08,394005,Jazzar; Rodolphe,0,0,0,0
1708255647290,CHEM 7L,A09,394006,Jazzar; Rodolphe,20,0,24,4
1708255647290,CHEM 7L,A10,394007,Jazzar; Rodolphe,24,0,24,0
1708255647290,CHEM 7L,B01,394009,Jazzar; Rodolphe,0,0,0,1
1708255647290,CHEM 7L,B02,394010,Jazzar; Rodolphe,1,0,6,5
1708255647290,CHEM 7L,B03,394011,Jazzar; Rodolphe,15,0,24,9
1708255647290,CHEM 7L,B04,394012,Jazzar; Rodolphe,18,0,21,3
1708255647290,CHEM 7L,B05,394013,Jazzar; Rodolphe,0,0,0,0
1708255647290,CHEM 7L,B06,394014,Jazzar; Rodolphe,15,0,24,9
1708255647290,CHEM 7L,B07,394015,Jazzar; Rodolphe,18,0,24,6
1708255647290,CHEM 7L,B08,394016,Jazzar; Rodolphe,23,0,24,1
1708255647290,CHEM 7L,B09,394017,Jazzar; Rodolphe,24,0,24,0
1708255647290,CHEM 7L,B10,394018,Jazzar; Rodolphe,24,0,24,0
1708255647290,CHEM 7L,C01,394020,Staff,0,0,0,0
1708255647290,CHEM 7L,C02,394021,Staff,21,0,24,3
1708255647290,CHEM 7L,C03,394022,Staff,23,0,24,1
1708255647290,CHEM 7L,C04,394023,Staff,24,0,24,0
1708255647290,CHEM 7L,C05,394024,Staff,0,0,0,0
1708255647290,CHEM 7L,C06,394025,Staff,20,0,24,4
1708255647290,CHEM 7L,C07,394026,Staff,22,0,24,2
1708255647290,CHEM 7L,C08,394027,Staff,23,0,24,1
1708255647290,CHEM 7L,C09,394028,Staff,24,0,24,0
1708255647290,CHEM 7L,C10,394029,Staff,23,0,24,1
1708255647820,CHEM 11,A01,459661,Staff,42,0,44,2
1708255647820,CHEM 11,A02,459664,Staff,44,0,44,0
1708255647820,CHEM 11,A03,459702,Staff,42,0,44,2
1708255647820,CHEM 11,A04,459707,Staff,44,0,44,0
1708255647820,CHEM 11,A05,459708,Staff,43,0,44,1
1708255647820,CHEM 11,A06,459711,Staff,41,0,44,3
1708255648352,CHEM 40A,A01,459576,Albizati; Kim F.,36,0,40,4
1708255648352,CHEM 40A,A02,459577,Albizati; Kim F.,33,0,40,7
1708255648352,CHEM 40A,A03,459578,Albizati; Kim F.,37,0,40,3
1708255648352,CHEM 40A,A04,459579,Albizati; Kim F.,38,0,40,2
1708255648352,CHEM 40A,A05,459580,Albizati; Kim F.,40,0,40,0
1708255648352,CHEM 40A,A06,459581,Albizati; Kim F.,37,0,40,3
1708255648352,CHEM 40A,A07,459582,Albizati; Kim F.,38,0,40,2
1708255648352,CHEM 40A,A08,459588,Albizati; Kim F.,39,0,40,1
1708255648886,CHEM 40B,A01,467442,Weizman; Haim,29,0,40,11
1708255648886,CHEM 40B,A02,467443,Weizman; Haim,33,0,40,7
1708255648886,CHEM 40B,A03,467444,Weizman; Haim,39,0,40,1
1708255648886,CHEM 40B,A04,467445,Weizman; Haim,38,0,40,2
1708255648886,CHEM 40B,A05,467446,Weizman; Haim,39,0,40,1
1708255648886,CHEM 40B,A06,467447,Weizman; Haim,37,0,40,3
1708255648886,CHEM 40B,A07,467448,Weizman; Haim,31,0,40,9
1708255648886,CHEM 40B,A08,467449,Weizman; Haim,40,0,40,0
1708255648886,CHEM 40B,B01,467383,Molinski; Tadeusz,40,0,40,0
1708255648886,CHEM 40B,B02,467384,Molinski; Tadeusz,40,0,40,0
1708255648886,CHEM 40B,B03,467385,Molinski; Tadeusz,40,0,40,0
1708255648886,CHEM 40B,B04,467399,Molinski; Tadeusz,40,0,40,0
1708255648886,CHEM 40B,B05,467400,Molinski; Tadeusz,40,0,40,0
1708255648886,CHEM 40B,B06,467401,Molinski; Tadeusz,40,0,40,0
1708255648886,CHEM 40B,B07,467402,Molinski; Tadeusz,40,0,40,0
1708255648886,CHEM 40B,B08,467404,Molinski; Tadeusz,39,0,40,1
1708255649415,CHEM 41B,A01,459571,Klosterman; Jeremy K,40,0,40,0
1708255649415,CHEM 41B,A02,459572,Klosterman; Jeremy K,36,0,37,1
1708255649415,CHEM 41B,A03,459573,Klosterman; Jeremy K,40,0,40,0
1708255649941,CHEM 41C,A01,459589,Tor; Yitzhak,40,0,40,0
1708255649941,CHEM 41C,A02,459624,Tor; Yitzhak,38,0,40,2
1708255649941,CHEM 41C,A03,459625,Tor; Yitzhak,40,0,40,0
1708255649941,CHEM 41C,A04,459626,Tor; Yitzhak,40,0,40,0
1708255649941,CHEM 41C,A05,459627,Tor; Yitzhak,29,0,29,0
1708255649941,CHEM 41C,A06,459628,Tor; Yitzhak,38,0,40,2
1708255649941,CHEM 41C,A07,459629,Tor; Yitzhak,40,0,40,0
1708255650481,CHEM 43A,A01,394068,Lam; Tin Yiu,12,0,24,12
1708255650481,CHEM 43A,A02,394088,Lam; Tin Yiu,23,0,24,1
1708255650481,CHEM 43A,A03,394092,Lam; Tin Yiu,23,0,24,1
1708255650481,CHEM 43A,A04,394093,Lam; Tin Yiu,21,0,24,3
1708255650481,CHEM 43A,A05,394094,Lam; Tin Yiu,23,0,24,1
1708255650481,CHEM 43A,A06,394096,Lam; Tin Yiu,15,0,24,9
1708255650481,CHEM 43A,A07,394115,Lam; Tin Yiu,20,0,24,4
1708255650481,CHEM 43A,A08,394116,Lam; Tin Yiu,22,0,24,2
1708255650481,CHEM 43A,A09,394117,Lam; Tin Yiu,22,0,24,2
1708255650481,CHEM 43A,A10,394118,Lam; Tin Yiu,20,0,24,4
1708255650481,CHEM 43A,A11,394119,Lam; Tin Yiu,8,0,13,5
1708255650481,CHEM 43A,A12,394120,Lam; Tin Yiu,24,0,24,0
1708255650481,CHEM 43A,A13,394132,Lam; Tin Yiu,24,0,24,0
1708255650481,CHEM 43A,B01,394134,Lam; Tin Yiu,24,0,24,0
1708255650481,CHEM 43A,B02,394135,Lam; Tin Yiu,16,0,24,8
1708255650481,CHEM 43A,B03,394136,Lam; Tin Yiu,13,0,24,11
1708255650481,CHEM 43A,B04,394137,Lam; Tin Yiu,17,0,24,7
1708255650481,CHEM 43A,B05,394138,Lam; Tin Yiu,20,0,24,4
1708255650481,CHEM 43A,B06,394139,Lam; Tin Yiu,19,0,24,5
1708255650481,CHEM 43A,B07,394140,Lam; Tin Yiu,19,0,24,5
1708255650481,CHEM 43A,B08,394141,Lam; Tin Yiu,24,0,24,0
1708255650481,CHEM 43A,B09,394142,Lam; Tin Yiu,20,0,24,4
1708255650481,CHEM 43A,B10,394143,Lam; Tin Yiu,24,0,24,0
1708255650481,CHEM 43A,B11,394145,Lam; Tin Yiu,22,0,24,2
1708255650481,CHEM 43A,B12,394146,Lam; Tin Yiu,23,0,24,1
1708255651008,CHEM 96,A00,394159,Bussey; Thomas J,24,0,25,1
1708255651535,CHEM 100A,A01,394161,Li; Shaowei,16,0,22,6
1708255651535,CHEM 100A,A02,394162,Li; Shaowei,20,0,24,4
1708255651535,CHEM 100A,A03,394163,Li; Shaowei,22,0,24,2
1708255651535,CHEM 100A,A04,394164,Li; Shaowei,24,0,24,0
1708255651535,CHEM 100A,A05,394165,Li; Shaowei,24,0,24,0
1708255651535,CHEM 100A,A06,394166,Li; Shaowei,20,0,22,2
1708255652065,CHEM 100B,A01,394175,Pomeroy; Robert S.,19,0,25,6
1708255652592,CHEM 105A,A01,394177,Young; Mark,31,0,39,8
1708255652592,CHEM 105A,B01,394179,Young; Mark,0,0,0,0
1708255653121,CHEM 108,A01,394181,Staff,14,0,20,6
1708255653121,CHEM 108,A02,394182,Staff,23,0,24,1
1708255653121,CHEM 108,B01,394184,Staff,4,0,20,16
1708255653121,CHEM 108,B02,394185,Staff,23,0,24,1
1708255653648,CHEM 109,A01,394187,Piercy; Marc Anthony,17,0,20,3
1708255653648,CHEM 109,A02,394188,Piercy; Marc Anthony,22,0,24,2
1708255653648,CHEM 109,B01,394193,Piercy; Marc Anthony,12,0,20,8
1708255653648,CHEM 109,B02,394194,Piercy; Marc Anthony,23,0,24,1
1708255654174,CHEM 111,A00,394195,Thiemens; Mark H,97,0,100,3
1708255654704,CHEM 114B,A01,459574,Piercy; Marc Anthony,39,0,45,6
1708255654704,CHEM 114B,A02,459575,Piercy; Marc Anthony,40,0,45,5
1708255655229,CHEM 114C,A01,467286,Komives; Elizabeth A,32,0,44,12
1708255655229,CHEM 114C,A02,467287,Komives; Elizabeth A,42,0,44,2
1708255655229,CHEM 114C,A03,467290,Komives; Elizabeth A,42,0,44,2
1708255655229,CHEM 114C,A04,467295,Komives; Elizabeth A,43,0,44,1
1708255655759,CHEM 114D,A00,394198,Ghosh; Gourisankar,29,0,30,1
1708255656284,CHEM 118,A01,459788,Donoghue; Daniel J.,37,0,40,3
1708255656284,CHEM 118,A02,459800,Donoghue; Daniel J.,37,0,40,3
1708255656284,CHEM 118,A03,459807,Donoghue; Daniel J.,36,0,40,4
1708255656284,CHEM 118,A04,459809,Donoghue; Daniel J.,38,0,40,2
1708255656284,CHEM 118,A05,459811,Donoghue; Daniel J.,37,0,40,3
1708255656284,CHEM 118,A06,459826,Donoghue; Daniel J.,39,0,40,1
1708255656814,CHEM 119,A01,467427,Joseph; Simpson,35,0,40,5
1708255656814,CHEM 119,A02,467441,Joseph; Simpson,0,0,0,0
1708255657339,CHEM 120B,A01,467450,Griffith; Kent,37,0,40,3
1708255657339,CHEM 120B,A02,467451,Griffith; Kent,34,0,40,6
1708255657339,CHEM 120B,A03,467452,Griffith; Kent,35,0,40,5
1708255657866,CHEM 123,A00,394211,Schimpf; Alina M,0,0,0,1
1708255658392,CHEM 125,A00,394217,Tezcan; Faik,18,0,20,2
1708255658923,CHEM 126A,A01,459715,Yong; Haiwang,39,0,40,1
1708255658923,CHEM 126A,A02,459725,Yong; Haiwang,36,0,40,4
1708255659453,CHEM 126B,A01,467405,Tauber; Michael,36,0,40,4
1708255659453,CHEM 126B,A02,467406,Tauber; Michael,39,0,40,1
1708255659453,CHEM 126B,A03,467426,Tauber; Michael,39,0,40,1
1708255659981,CHEM 132,A01,460181,Galperin; Michael,42,0,45,3
1708255659981,CHEM 132,A02,460182,Galperin; Michael,37,0,45,8
1708255660510,CHEM 135,A01,394222,Tauber; Michael,15,0,15,0
1708255661035,CHEM 143B,A01,394229,Klosterman; Jeremy K,16,0,24,8
1708255661035,CHEM 143B,A02,394230,Klosterman; Jeremy K,21,0,24,3
1708255661561,CHEM 156,A00,394231,Romero; Erik Anthony,30,0,30,0
1708255662089,CHEM 157,A00,394232,Tor; Yitzhak,74,0,80,6
1708255662616,CHEM 165,A01,460194,Herzik; Mark Anthony,21,0,25,4
1708255663142,CHEM 167,A01,467296,Deshmukh; Lalit,39,0,40,1
1708255663142,CHEM 167,A02,467297,Deshmukh; Lalit,33,0,40,7
1708255663142,CHEM 167,A03,467298,Deshmukh; Lalit,37,0,40,3
1708255663142,CHEM 167,A04,467312,Deshmukh; Lalit,37,0,40,3
1708255663672,CHEM 173,A00,394284,Young; Mark,48,0,50,2
1708255664198,CHEM 174,A01,455015,Pomeroy; Robert S.,45,0,50,5
1708255664727,CHEM 186,A00,477716,Paesani; Francesco & Gilson; Michael K.,6,0,12,6
1708255665252,CHEM 188,A00,394294,Bussey; Thomas J,19,0,20,1
1708255665779,CHEM 214,A00,394336,Ghosh; Gourisankar,12,0,20,8
1708255666303,CHEM 217,A00,394341,Joseph; Simpson,25,0,30,5
1708255666827,CHEM 221,A00,394425,Taylor; Susan S.,10,0,20,10
1708255667352,CHEM 225,A00,394429,Tezcan; Faik,4,0,10,6
1708255667880,CHEM 227,A00,394430,Schimpf; Alina M,26,0,30,4
1708255668410,CHEM 229,A00,394431,Stauber; Julia Megan,13,0,20,7
1708255668935,CHEM 235,A01,394433,Tauber; Michael,20,0,20,0
1708255669461,CHEM 236,A00,394434,Kummel; Andrew C,14,0,15,1
1708255669986,CHEM 241,A00,394435,Pokorski; Jonathan Kyle,14,0,15,1
1708255670511,CHEM 250,A00,394436,Weizman; Haim,0,0,0,16
1708255671038,CHEM 256,A00,394437,Romero; Erik Anthony,15,0,20,5
1708255671564,CHEM 257,A00,394438,Tor; Yitzhak,23,0,30,7
1708255672092,CHEM 265,A01,460195,Herzik; Mark Anthony,13,0,20,7
1708255672618,CHEM 273,A00,394440,Young; Mark,13,0,20,7
1708255673143,CHEM 276,A00,394441,Mc Culloch; Andrew Douglas & Amaro; Rommie E,0,0,0,0
1708255673673,CHEM 283,A00,394443,Komives; Elizabeth A,2,0,4,2
1708255674199,CHEM 286,A00,477693,Paesani; Francesco & Gilson; Michael K.,26,0,34,8
1708255674724,CHEM 291,A00,394446,Komives; Elizabeth A,20,0,20,0
1708255675251,CHEM 294,A00,394447,Romero; Erik Anthony,50,0,50,0
1708255675777,CHIN 10CD,A01,394453,Liu; Mingming,17,0,17,0
1708255675777,CHIN 10CD,A02,394457,Liu; Mingming,18,0,18,0
1708255676303,CHIN 10CM,A01,394465,Chen; Pei-Chia,11,0,12,1
1708255676303,CHIN 10CM,A02,394466,Chen; Pei-Chia,12,0,12,0
1708255676303,CHIN 10CM,B01,394468,Liu; Mingming,11,0,13,2
1708255676303,CHIN 10CM,B02,394469,Liu; Mingming,13,0,13,0
1708255676830,CHIN 10CN,A01,394581,Xu; Li,14,0,14,0
1708255676830,CHIN 10CN,A02,394582,Xu; Li,14,0,14,0
1708255676830,CHIN 10CN,B01,394585,Xu; Li,14,0,14,0
1708255676830,CHIN 10CN,B02,394586,Xu; Li,13,0,14,1
1708255677431,CHIN 20CD,A01,394591,Wang; Xiao,11,0,12,1
1708255677431,CHIN 20CD,A02,394592,Wang; Xiao,11,0,12,1
1708255677963,CHIN 20CN,A01,394597,Anderson; Qin-Hong,7,0,8,1
1708255677963,CHIN 20CN,A02,394599,Anderson; Qin-Hong,8,0,8,0
1708255677963,CHIN 20CN,B01,394601,Anderson; Qin-Hong,14,0,15,1
1708255678499,CHIN 100CM,A00,394602,Anderson; Qin-Hong,19,0,20,1
1708255679025,CHIN 100CN,A00,394603,Chen; Pei-Chia,24,0,24,0
1708255679553,CHIN 169B,A00,394623,Wang; Xiao,19,0,20,1
1708255680082,CLAS 87,A00,394669,Herbst; Matthew,19,0,20,1
1708255680608,CLAS 121R,A01,394671,Herbst; Matthew,11,0,12,1
1708255680608,CLAS 121R,B01,486854,Herbst; Matthew,8,0,8,0
1708255681139,CLIN 294C,A00,476856,Wierenga; Christina E & Banks; Sarah Jane,20,0,20,0
1708255681665,CLIN 296,001,476768,Brookman; Lauren Irene,94,0,100,6
1708255681665,CLIN 296,002,476855,Brookman; Lauren Irene,10,0,10,0
1708255682192,CLRE 238R,A00,394675,Mehta; Ravindra L.,9998,0,9999,1
1708255682721,CLRE 254,A00,394678,Vaida; Florin,9999,0,9999,0
1708255683247,CLRE 256,A00,394685,Morris; Sheldon,9999,0,9999,0
1708255683775,CLRE 258,A00,394692,Mehta; Ravindra L.,9999,0,9999,0
1708255684300,CLRE 260,A00,394693,Cuomo; Raphael Eduardo,9999,0,9999,0
1708255684830,CLRE 264,A00,394696,Mehta; Ravindra L.,9999,0,9999,0
1708255685356,CLRE 267,A00,394703,Vaida; Florin,9999,0,9999,0
1708255685885,CLRE 297,001,394705,Cuomo; Raphael Eduardo,9999,0,9999,0
1708255686412,CMM 246,A00,492783,Gordts; Philip & Varki; Ajit P & Lewis; Amanda Lark & Godula; Kamil & Gagneux; Pascal & Esko; Jeffrey D. & Bode; Lars,9,0,10,1
1708255686942,CMM 250,A00,492943,Willert; Karl Heinrich,31,0,40,9
1708255687468,COGR 200B,A00,395746,Jack; Caroline Sarah,2,0,5,3
1708255687995,COGR 225B,A00,395750,Serlin; David,1,0,5,4
1708255688523,COGR 225C,A00,395753,Gates; Kelly,1,0,5,4
1708255689048,COGR 275,A00,395943,Goldfarb; Brian,6,0,10,4
1708255689048,COGR 275,B00,396046,Fattal; Alexander Leor,4,0,10,6
1708255689048,COGR 275,C00,396047,Kidman; Shawna F,4,0,10,6
1708255689575,COGR 280,A00,396048,Ahn; Patricia Jeehyun,6,0,10,4
1708255690101,COGS 1,A01,407484,Boyle; Mary E. T.,52,0,60,8
1708255690101,COGS 1,A02,407498,Boyle; Mary E. T.,54,0,60,6
1708255690101,COGS 1,A03,407504,Boyle; Mary E. T.,59,0,60,1
1708255690101,COGS 1,A04,407512,Boyle; Mary E. T.,57,0,60,3
1708255690101,COGS 1,A05,407513,Boyle; Mary E. T.,60,0,60,0
1708255690101,COGS 1,A06,407514,Boyle; Mary E. T.,58,0,60,2
1708255690101,COGS 1,A07,407515,Boyle; Mary E. T.,57,0,57,0
1708255690629,COGS 9,A01,407520,Shannon; Kyle Michael,54,0,60,6
1708255690629,COGS 9,A02,407521,Shannon; Kyle Michael,60,0,60,0
1708255690629,COGS 9,A03,407522,Shannon; Kyle Michael,59,0,60,1
1708255690629,COGS 9,A04,407524,Shannon; Kyle Michael,57,0,60,3
1708255690629,COGS 9,A05,407525,Shannon; Kyle Michael,59,0,60,1
1708255691161,COGS 10,A01,407527,Morgan; Eric,45,0,50,5
1708255691161,COGS 10,A02,407530,Morgan; Eric,46,0,50,4
1708255691161,COGS 10,A03,407531,Morgan; Eric,46,0,50,4
1708255691161,COGS 10,A04,407532,Morgan; Eric,47,0,50,3
1708255691161,COGS 10,A05,407534,Morgan; Eric,47,0,50,3
1708255691161,COGS 10,A06,407539,Morgan; Eric,50,0,50,0
1708255691161,COGS 10,A07,407628,Morgan; Eric,50,0,50,0
1708255691695,COGS 11,A01,407699,Boroditsky; Lera,179,0,180,1
1708255692221,COGS 12,A00,407702,Boroditsky; Lera,75,0,75,0
1708255692753,COGS 14A,A01,407706,Barrera; Steven James,51,0,57,6
1708255692753,COGS 14A,A02,407707,Barrera; Steven James,54,0,57,3
1708255692753,COGS 14A,A03,407712,Barrera; Steven James,0,0,0,1
1708255692753,COGS 14A,A04,407715,Barrera; Steven James,57,0,57,0
1708255692753,COGS 14A,A05,407717,Barrera; Steven James,55,0,56,1
1708255692753,COGS 14A,A06,407718,Barrera; Steven James,52,0,55,3
1708255692753,COGS 14A,A07,407720,Barrera; Steven James,49,0,55,6
1708255693279,COGS 14B,A01,407723,Hoffman; Drew Ellen,52,0,57,5
1708255693279,COGS 14B,A02,407726,Hoffman; Drew Ellen,48,0,55,7
1708255693279,COGS 14B,A03,407727,Hoffman; Drew Ellen,52,0,55,3
1708255693279,COGS 14B,A04,407729,Hoffman; Drew Ellen,52,0,55,3
1708255693279,COGS 14B,A05,407730,Hoffman; Drew Ellen,50,0,55,5
1708255693828,COGS 17,A01,407733,Johnson; Christine M.,50,0,50,0
1708255693828,COGS 17,A02,407734,Johnson; Christine M.,48,0,50,2
1708255693828,COGS 17,A03,407735,Johnson; Christine M.,46,0,50,4
1708255693828,COGS 17,A04,407740,Johnson; Christine M.,47,0,50,3
1708255693828,COGS 17,A05,407745,Johnson; Christine M.,48,0,50,2
1708255693828,COGS 17,A06,407824,Johnson; Christine M.,48,0,50,2
1708255693828,COGS 17,A07,407878,Johnson; Christine M.,50,0,55,5
1708255693828,COGS 17,A08,408015,Johnson; Christine M.,52,0,55,3
1708255694369,COGS 18,A01,408118,Ellis; Shannon Elizabeth,27,0,35,8
1708255694369,COGS 18,A02,408119,Ellis; Shannon Elizabeth,31,0,35,4
1708255694369,COGS 18,A03,408120,Ellis; Shannon Elizabeth,23,0,35,12
1708255694369,COGS 18,A04,408136,Ellis; Shannon Elizabeth,33,0,35,2
1708255694369,COGS 18,A05,408141,Ellis; Shannon Elizabeth,35,0,35,0
1708255694369,COGS 18,A06,408143,Ellis; Shannon Elizabeth,34,0,35,1
1708255694369,COGS 18,A07,408144,Ellis; Shannon Elizabeth,35,0,35,0
1708255694369,COGS 18,A08,408145,Ellis; Shannon Elizabeth,34,0,35,1
1708255694369,COGS 18,A09,408146,Ellis; Shannon Elizabeth,35,0,35,0
1708255694369,COGS 18,B01,408148,Ellis; Shannon Elizabeth,30,0,32,2
1708255694369,COGS 18,B02,408149,Ellis; Shannon Elizabeth,26,0,32,6
1708255694369,COGS 18,B03,408151,Ellis; Shannon Elizabeth,27,0,33,6
1708255694369,COGS 18,B04,408154,Ellis; Shannon Elizabeth,32,0,33,1
1708255694369,COGS 18,B05,408163,Ellis; Shannon Elizabeth,29,0,33,4
1708255694369,COGS 18,B06,408176,Ellis; Shannon Elizabeth,33,0,33,0
1708255694369,COGS 18,B07,408177,Ellis; Shannon Elizabeth,31,0,33,2
1708255694369,COGS 18,B08,408178,Ellis; Shannon Elizabeth,32,0,33,1
1708255694369,COGS 18,B09,408195,Ellis; Shannon Elizabeth,31,0,33,2
1708255694897,COGS 87,A00,408196,Deak; Gedeon O.,20,0,20,0
1708255694897,COGS 87,B00,479478,Fleischer; Jason G,20,0,20,0
1708255695428,COGS 100,A01,408262,Allen; Michael Gordon,54,0,56,2
1708255695428,COGS 100,A02,408263,Allen; Michael Gordon,52,0,56,4
1708255695428,COGS 100,A03,408264,Allen; Michael Gordon,55,0,56,1
1708255695428,COGS 100,A04,408265,Allen; Michael Gordon,56,0,56,0
1708255695428,COGS 100,A05,408266,Allen; Michael Gordon,56,0,56,0
1708255695428,COGS 100,A06,408349,Allen; Michael Gordon,55,0,56,1
1708255695958,COGS 101A,A01,408352,Morgan; Eric,60,0,60,0
1708255695958,COGS 101A,A02,408353,Morgan; Eric,58,0,60,2
1708255695958,COGS 101A,A03,408354,Morgan; Eric,57,0,60,3
1708255695958,COGS 101A,A04,408355,Morgan; Eric,59,0,60,1
1708255696491,COGS 101B,A01,408373,Barrera; Steven James,47,0,50,3
1708255696491,COGS 101B,A02,408380,Barrera; Steven James,46,0,50,4
1708255696491,COGS 101B,A03,408384,Barrera; Steven James,38,0,50,12
1708255696491,COGS 101B,A04,408385,Barrera; Steven James,37,0,50,13
1708255697018,COGS 101C,A01,408387,Trott; Sean Thomas,48,0,50,2
1708255697018,COGS 101C,A02,408388,Trott; Sean Thomas,43,0,50,7
1708255697018,COGS 101C,A03,408389,Trott; Sean Thomas,45,0,50,5
1708255697600,COGS 107A,A01,408396,Boyle; Mary E. T.,54,0,56,2
1708255697600,COGS 107A,A02,408397,Boyle; Mary E. T.,54,0,56,2
1708255697600,COGS 107A,A03,408399,Boyle; Mary E. T.,51,0,56,5
1708255697600,COGS 107A,A04,408409,Boyle; Mary E. T.,50,0,56,6
1708255697600,COGS 107A,A05,408410,Boyle; Mary E. T.,51,0,56,5
1708255697600,COGS 107A,A06,408411,Boyle; Mary E. T.,55,0,56,1
1708255698142,COGS 107B,A01,408413,Mooshagian; Eric Frederick,46,0,50,4
1708255698142,COGS 107B,A02,408414,Mooshagian; Eric Frederick,43,0,50,7
1708255698142,COGS 107B,A03,408428,Mooshagian; Eric Frederick,43,0,50,7
1708255698142,COGS 107B,A04,408434,Mooshagian; Eric Frederick,46,0,50,4
1708255698142,COGS 107B,A05,408435,Mooshagian; Eric Frederick,50,0,50,0
1708255698142,COGS 107B,A06,408446,Mooshagian; Eric Frederick,49,0,50,1
1708255698671,COGS 107C,A01,408500,Chiba; Andrea,51,0,60,9
1708255698671,COGS 107C,A02,408519,Chiba; Andrea,55,0,60,5
1708255698671,COGS 107C,A03,408524,Chiba; Andrea,56,0,60,4
1708255699213,COGS 108,A01,408532,Fleischer; Jason G,45,0,60,15
1708255699213,COGS 108,A02,408543,Fleischer; Jason G,58,0,60,2
1708255699213,COGS 108,A03,408544,Fleischer; Jason G,59,0,60,1
1708255699213,COGS 108,A04,408552,Fleischer; Jason G,32,0,60,28
1708255699213,COGS 108,A05,408554,Fleischer; Jason G,47,0,60,13
1708255699213,COGS 108,A06,408574,Fleischer; Jason G,43,0,60,17
1708255699213,COGS 108,A07,408576,Fleischer; Jason G,56,0,60,4
1708255699739,COGS 112,A01,408682,Hoffman; Drew Ellen,32,0,50,18
1708255699739,COGS 112,A02,408683,Hoffman; Drew Ellen,38,0,50,12
1708255699739,COGS 112,A03,408684,Hoffman; Drew Ellen,48,0,60,12
1708255700265,COGS 122,A01,408695,Dow; Steven P,21,0,50,29
1708255700792,COGS 125,A00,408697,Klemmer; Scott R,35,0,50,15
1708255701320,COGS 126,A01,408787,Hollan; James D.,44,0,50,6
1708255701847,COGS 138,A01,408866,Khosla; Meenakshi,71,0,75,4
1708255702378,COGS 142,A01,408868,Rossano; Federico,49,0,50,1
1708255702908,COGS 144,A01,408950,Rossano; Federico,48,0,50,2
1708255703435,COGS 155,A01,408993,Staff,49,0,50,1
1708255703965,COGS 157,A00,408994,Creel; Sarah,0,0,0,0
1708255704493,COGS 160,A00,409031,Deak; Gedeon O.,20,0,20,0
1708255705018,COGS 175,A01,409035,Rill; Bryan,67,0,75,8
1708255705550,COGS 178,A00,409274,Jernigan; Terry Lynne,68,0,70,2
1708255706079,COGS 179,A00,409278,Staff,40,0,40,0
1708255706606,COGS 184,A01,409317,Johnson; Christine M.,42,0,50,8
1708255708148,COGS 185,A01,409476,Tu; Zhuowen,33,0,50,17
1708255708148,COGS 185,A02,409525,Tu; Zhuowen,45,0,50,5
1708255708676,COGS 188,A01,409527,Fleischer; Jason G,44,0,75,31
1708255709224,COGS 190C,001,409528,Chiba; Andrea,9999,0,9999,0
1708255709224,COGS 190C,002,409530,Fleischer; Jason G,9999,0,9999,0
1708255709224,COGS 190C,003,409531,Boyle; Mary E. T.,9999,0,9999,0
1708255709224,COGS 190C,004,409532,Nitz; Douglas A.,9999,0,9999,0
1708255709224,COGS 190C,005,409535,Rangel; Lara M,9999,0,9999,0
1708255709224,COGS 190C,006,409536,Rossano; Federico,9999,0,9999,0
1708255709224,COGS 190C,007,409537,Deak; Gedeon O.,9999,0,9999,0
1708255709224,COGS 190C,008,409538,Trott; Sean Thomas,9999,0,9999,0
1708255709224,COGS 190C,009,409540,Creel; Sarah,9999,0,9999,0
1708255709224,COGS 190C,010,409541,Voytek; Bradley Thomas,9999,0,9999,0
1708255709224,COGS 190C,011,409542,Greene; Deanna Jacquelyn,9999,0,9999,0
1708255709224,COGS 190C,012,409543,Ellis; Shannon Elizabeth,9999,0,9999,0
1708255709224,COGS 190C,013,409546,Kirsh; David Joel,9999,0,9999,0
1708255709749,COGS 190D,A00,409547,Voytek; Bradley Thomas,20,0,20,0
1708255710272,COGS 194,A00,409548,Hill; Seth J,9999,0,9999,0
1708255710799,COGS 200,A01,406697,Creel; Sarah,0,0,0,0
1708255711328,COGS 205,A00,406698,Chiba; Andrea,20,0,20,0
1708255711854,COGS 209,A00,406699,Mukamel; Eran A,41,0,68,27
1708255712384,COGS 210C,001,406700,Kirsh; David Joel,9999,0,9999,0
1708255712384,COGS 210C,002,406701,Greene; Deanna Jacquelyn,9998,0,9999,1
1708255712384,COGS 210C,003,406702,Xia; Haijun,9999,0,9999,0
1708255712384,COGS 210C,004,406703,Nitz; Douglas A.,9998,0,9999,1
1708255712384,COGS 210C,005,406710,Hollan; James D.,9999,0,9999,0
1708255712384,COGS 210C,006,406713,De Sa; Virginia,9999,0,9999,0
1708255712384,COGS 210C,007,406714,Rossano; Federico,9999,0,9999,0
1708255712384,COGS 210C,008,406740,Kiyonaga; Anastasia,9999,0,9999,0
1708255712384,COGS 210C,009,406745,Guo; Philip J,9998,0,9999,1
1708255712384,COGS 210C,010,406746,Dow; Steven P,9999,0,9999,0
1708255712384,COGS 210C,011,406747,Bergen; Benjamin,9999,0,9999,0
1708255712384,COGS 210C,012,406758,Coulson; Seana M,9999,0,9999,0
1708255712911,COGS 211C,A00,406763,Coulson; Seana M,17,0,20,3
1708255713436,COGS 229,A00,406788,Hollan; James D. & Xia; Haijun,4,0,10,6
1708255713983,COGS 238,A00,406789,Bergen; Benjamin,17,0,20,3
1708255714510,COGS 278,A00,406794,Jernigan; Terry Lynne,18,0,20,2
1708255715053,COMM 10,A01,394711,Schmidt; Thomas Rainer,20,0,24,4
1708255715053,COMM 10,A02,394714,Schmidt; Thomas Rainer,24,0,24,0
1708255715053,COMM 10,A03,394716,Schmidt; Thomas Rainer,24,0,24,0
1708255715053,COMM 10,A04,394717,Schmidt; Thomas Rainer,22,0,24,2
1708255715053,COMM 10,A05,394731,Schmidt; Thomas Rainer,24,0,24,0
1708255715053,COMM 10,A06,394733,Schmidt; Thomas Rainer,24,0,24,0
1708255715053,COMM 10,A07,394740,Schmidt; Thomas Rainer,24,0,24,0
1708255715053,COMM 10,A08,394741,Schmidt; Thomas Rainer,24,0,24,0
1708255715053,COMM 10,A09,394751,Schmidt; Thomas Rainer,23,0,24,1
1708255715053,COMM 10,A10,394779,Schmidt; Thomas Rainer,24,0,24,0
1708255715053,COMM 10,A11,394809,Schmidt; Thomas Rainer,24,0,24,0
1708255715053,COMM 10,A12,394811,Schmidt; Thomas Rainer,24,0,24,0
1708255715053,COMM 10,A13,394818,Schmidt; Thomas Rainer,24,0,24,0
1708255715053,COMM 10,A14,394825,Schmidt; Thomas Rainer,23,0,24,1
1708255715053,COMM 10,A15,394828,Schmidt; Thomas Rainer,24,0,24,0
1708255715053,COMM 10,A16,394829,Schmidt; Thomas Rainer,0,0,0,0
1708255715053,COMM 10,A17,486828,Schmidt; Thomas Rainer,20,0,21,1
1708255715582,COMM 20,A01,394834,McKenna; Denise,69,0,70,1
1708255716108,COMM 80,A01,394849,Campbell; Robert Harold,120,0,120,0
1708255716655,COMM 100C,A01,394957,Kidman; Shawna F,24,0,25,1
1708255716655,COMM 100C,A02,394972,Kidman; Shawna F,25,0,25,0
1708255716655,COMM 100C,A03,394977,Kidman; Shawna F,22,0,25,3
1708255716655,COMM 100C,A04,394981,Kidman; Shawna F,25,0,25,0
1708255716655,COMM 100C,A05,394985,Kidman; Shawna F,24,0,25,1
1708255716655,COMM 100C,A06,394989,Kidman; Shawna F,23,0,25,2
1708255716655,COMM 100C,A07,394993,Kidman; Shawna F,24,0,25,1
1708255716655,COMM 100C,A08,394997,Kidman; Shawna F,23,0,25,2
1708255716655,COMM 100C,A09,394999,Kidman; Shawna F,25,0,25,0
1708255716655,COMM 100C,A10,395018,Kidman; Shawna F,25,0,25,0
1708255716655,COMM 100C,A11,395041,Kidman; Shawna F,24,0,25,1
1708255716655,COMM 100C,A12,395080,Kidman; Shawna F,24,0,25,1
1708255717185,COMM 101,A01,395135,Halm; Gavin Patrick,15,0,15,0
1708255717185,COMM 101,A02,395252,Halm; Gavin Patrick,15,0,15,0
1708255717185,COMM 101,A03,395253,Halm; Gavin Patrick,15,0,15,0
1708255717185,COMM 101,A04,395263,Halm; Gavin Patrick,15,0,15,0
1708255717711,COMM 101D,A00,395264,Martinico; Daniel J,13,0,16,3
1708255718238,COMM 101K,A00,395266,Ahn; Patricia Jeehyun,16,0,18,2
1708255718764,COMM 101N,A00,395267,Martinico; Daniel J,16,0,16,0
1708255719288,COMM 102C,A01,395270,Campion; Camille E,5,0,6,1
1708255719288,COMM 102C,A02,395271,Campion; Camille E,6,0,6,0
1708255719288,COMM 102C,A03,395272,Campion; Camille E,5,0,6,1
1708255719815,COMM 102M,A01,395285,Davis; Zeinabu I.,9,0,10,1
1708255719815,COMM 102M,A02,395288,Davis; Zeinabu I.,8,0,10,2
1708255720341,COMM 103D,A00,395343,Gates; Kelly,34,0,35,1
1708255720871,COMM 107,A00,395461,Serlin; David,33,0,35,2
1708255721414,COMM 109D,A00,395462,Halm; Gavin Patrick,72,0,75,3
1708255721940,COMM 110G,A00,395481,Whitworth-Smith; Andrew C,32,0,35,3
1708255722471,COMM 110M,A00,395482,Harb; Anthony Joseph,34,0,35,1
1708255722998,COMM 111A,A00,487217,Pavon Aramburu; Maria Laur,34,0,35,1
1708255723528,COMM 113T,A00,395516,Fields; Gary,35,0,35,0
1708255724054,COMM 114A,A00,395517,Zilberg; Elana,32,0,35,3
1708255724582,COMM 114B,A00,395523,Zilberg; Elana,19,0,20,1
1708255725111,COMM 114E,A00,487218,Pavon Aramburu; Maria Laur,34,0,35,1
1708255725639,COMM 114W,A00,395524,Walkover; Lillian B,17,0,18,1
1708255726166,COMM 126,A00,479341,Staff,26,0,30,4
1708255726692,COMM 132,A00,481491,Rojo Solis; Juan Jose,0,0,0,0
1708255727222,COMM 134,A00,395578,Abuelhiga; Soraya Jill,28,0,30,2
1708255727749,COMM 143,A00,395579,Rojo Solis; Juan Jose,28,0,30,2
1708255728277,COMM 146,A00,395584,Jack; Caroline Sarah,29,0,30,1
1708255728803,COMM 168,A00,395592,Harb; Anthony Joseph,29,0,30,1
1708255729333,COMM 170,A00,395608,Pavon Aramburu; Maria Laur,30,0,30,0
1708255729858,COMM 173,A00,395609,Alac; Morana,29,0,30,1
1708255730383,COMM 174,A00,395679,Alac; Morana,30,0,30,0
1708255730913,COMM 190,A00,395682,Abuelhiga; Soraya Jill,19,0,23,4
1708255730913,COMM 190,B00,395696,Staff,21,0,23,2
1708255730913,COMM 190,C00,395697,Fattal; Alexander Leor,22,0,23,1
1708255731442,CSE 8A,A50,459200,Miranda; Gregory Joseph,34,0,35,1
1708255731442,CSE 8A,A51,459205,Miranda; Gregory Joseph,34,0,35,1
1708255731442,CSE 8A,A52,459206,Miranda; Gregory Joseph,34,0,35,1
1708255731442,CSE 8A,A53,459212,Miranda; Gregory Joseph,34,0,35,1
1708255731442,CSE 8A,A54,459213,Miranda; Gregory Joseph,34,0,35,1
1708255731442,CSE 8A,A55,459232,Miranda; Gregory Joseph,34,0,35,1
1708255731970,CSE 11,A01,470735,Ochoa; Benjamin Lawrence,180,0,195,15
1708255732502,CSE 12,A01,470744,Cao; Yingjun,189,0,200,11
1708255732502,CSE 12,B01,470752,Miranda; Gregory Joseph,71,0,100,29
1708255732502,CSE 12,B02,470760,Miranda; Gregory Joseph,93,0,100,7
1708255733030,CSE 15L,A01,410174,Solares; Edwin A,6,0,10,4
1708255733030,CSE 15L,B01,410215,Solares; Edwin A,7,0,10,3
1708255733030,CSE 15L,C01,410305,Solares; Edwin A,3,0,10,7
1708255733030,CSE 15L,D01,410400,Solares; Edwin A,1,0,10,9
1708255733562,CSE 20,A01,470765,Minnes Kemp; Mor Mia,145,0,150,5
1708255734088,CSE 21,A01,470776,Jones; Miles E,68,0,73,5
1708255734088,CSE 21,A02,482889,Jones; Miles E,68,0,72,4
1708255734616,CSE 29,A01,494014,Soosai Raj; Adalbert Geral,48,0,50,2
1708255734616,CSE 29,A02,494016,Soosai Raj; Adalbert Geral,40,0,50,10
1708255734616,CSE 29,B01,494018,Shalev; Aaron D,16,0,20,4
1708255735147,CSE 30,A01,470784,Cao; Yingjun,141,0,150,9
1708255735147,CSE 30,B01,467469,Muller; P Keith,98,0,120,22
1708255735689,CSE 87,A00,410528,Moshiri; Niema,20,0,20,0
1708255736218,CSE 90,A00,486885,Minnes Kemp; Mor Mia,0,0,0,0
1708255736747,CSE 91,A00,486872,Minnes Kemp; Mor Mia,0,0,0,0
1708255736747,CSE 91,B00,486873,Minnes Kemp; Mor Mia,0,0,0,0
1708255737274,CSE 95,A00,410529,Minnes Kemp; Mor Mia,50,0,50,0
1708255737803,CSE 100,A01,470792,Sahoo; Debashis,54,0,70,16
1708255738330,CSE 100R,A01,410556,Moshiri; Niema,2,0,40,38
1708255738856,CSE 101,A01,470797,Jones; Miles E,14,0,44,30
1708255738856,CSE 101,A02,482892,Jones; Miles E,31,0,43,12
1708255739385,CSE 105,A01,470800,Micciancio; Daniele,85,0,98,13
1708255739909,CSE 107,A01,467479,Bellare; Mihir,141,0,146,5
1708255740434,CSE 109,A01,459538,Shang; Jingbo,0,0,25,25
1708255740961,CSE 110,A50,459395,Powell; Thomas Allan,49,0,50,1
1708255740961,CSE 110,A51,459512,Powell; Thomas Allan,37,0,50,13
1708255740961,CSE 110,A52,459513,Powell; Thomas Allan,46,0,50,4
1708255740961,CSE 110,A53,459514,Powell; Thomas Allan,48,0,50,2
1708255740961,CSE 110,A54,459515,Powell; Thomas Allan,47,0,50,3
1708255740961,CSE 110,A55,459516,Powell; Thomas Allan,45,0,50,5
1708255740961,CSE 110,A56,459517,Powell; Thomas Allan,47,0,48,1
1708255741492,CSE 112,A50,459518,Powell; Thomas Allan,132,0,146,14
1708255742023,CSE 120,A01,470808,Zhou; Yuan-Yuan,167,0,200,33
1708255742549,CSE 125,A00,410564,Voelker; Geoffrey M.,30,0,30,0
1708255743080,CSE 127,A01,467484,Fernandes; Earlence T,174,0,196,22
1708255743605,CSE 130,A01,467485,Polikarpova; Nadezhda,176,0,192,16
1708255744136,CSE 131,A01,459522,Ding; Yufei,36,0,50,14
1708255744662,CSE 132B,A01,470816,Deutsch; Alin Bernard,60,0,70,10
1708255745209,CSE 140,A01,410606,Orailoglu; Alex,99,0,100,1
1708255745209,CSE 140,B01,410622,Eldon; John,130,0,146,16
1708255745739,CSE 140L,A01,410655,Orailoglu; Alex,99,0,100,1
1708255745739,CSE 140L,B01,410658,Eldon; John,122,0,146,24
1708255746280,CSE 141,A01,467486,Zhao; Jishen,173,0,196,23
1708255746807,CSE 141L,A01,410685,Eldon; John,162,0,196,34
1708255747335,CSE 145,A01,410713,Kastner; Ryan Charles,25,0,25,0
1708255747880,CSE 150B,A01,470824,Gao; Sicun,310,0,362,52
1708255748406,CSE 156,A01,467487,Nakashole; Ndapandula,137,0,192,55
1708255748934,CSE 165,A01,410757,Weibel; Nadir & Schulze; Jurgen P.,40,0,50,10
1708255749462,CSE 168,A01,410759,Ramamoorthi; Ravi,24,0,25,1
1708255749462,CSE 168,A02,410761,Ramamoorthi; Ravi,24,0,25,1
1708255749989,CSE 175,A01,410764,Kumar; Rakesh,48,0,50,2
1708255750516,CSE 182,A01,455011,Bafna; Vineet,47,0,50,3
1708255751046,CSE 185,A01,410895,Gymrek; Melissa Ann,41,0,57,16
1708255751046,CSE 185,A02,479240,Gymrek; Melissa Ann,53,0,58,5
1708255751574,CSE 190,A00,410982,Grier; Daniel T,48,0,50,2
1708255751574,CSE 190,B00,410983,Riek; Laurel D,50,0,50,0
1708255751574,CSE 190,C00,410984,Staff,36,0,50,14
1708255751574,CSE 190,D00,481666,Saha; Barna & Impagliazzo; Russell,27,0,28,1
1708255752171,CSE 203A,A00,410985,Saha; Barna & Impagliazzo; Russell,0,0,0,0
1708255752700,CSE 209A,A00,410986,Grier; Daniel T,0,0,0,0
1708255753229,CSE 209B,A00,410987,Bellare; Mihir,0,0,0,0
1708255753755,CSE 217,A01,459553,Weibel; Nadir,0,0,0,0
1708255754284,CSE 218,A00,410989,Griswold; William G.,0,0,0,0
1708255754810,CSE 219,A00,410990,Hollan; James D. & Xia; Haijun,0,0,0,0
1708255755337,CSE 224,A01,470832,Snoeren; Alex C.,0,0,0,0
1708255755866,CSE 229A,A00,410993,Shalev; Aaron D,0,0,0,0
1708255756393,CSE 229C,A00,410994,Fernandes; Earlence T,0,0,0,0
1708255756919,CSE 231,A01,467488,Jhala; Ranjit,0,0,0,0
1708255757443,CSE 233,A00,410996,Vianu; Victor Dan,0,0,0,0
1708255757969,CSE 237D,A00,410998,Kastner; Ryan Charles,0,0,0,0
1708255758501,CSE 239A,A00,410999,Vianu; Victor Dan,0,0,0,0
1708255759028,CSE 239B,A00,411000,Coblenz; Michael J,0,0,0,0
1708255759561,CSE 240A,A00,411001,Chin; Bryan W.,0,0,0,0
1708255760092,CSE 252D,A00,411004,Chandraker; Manmohan Krishna,0,0,0,0
1708255760619,CSE 256,A00,411005,Nakashole; Ndapandula,0,0,0,0
1708255761148,CSE 260,A01,467491,Chin; Bryan W.,0,0,0,0
1708255761675,CSE 276B,A00,411007,Riek; Laurel D,0,0,0,0
1708255762205,CSE 276F,A01,459554,Su; Hao,0,0,0,0
1708255762735,CSE 283,A00,411009,Bafna; Vineet & Zhong; Sheng,0,0,0,0
1708255763263,CSE 290,A00,411010,Gao; Sicun,0,0,0,0
1708255763263,CSE 290,B00,411011,Chern; Albert Ren-Haur,0,0,0,0
1708255763263,CSE 290,C00,411012,Swanson; Steven James,0,0,0,0
1708255763263,CSE 290,E00,411013,Su; Hao,0,0,0,0
1708255763263,CSE 290,F00,411014,Riek; Laurel D,0,0,0,0
1708255763263,CSE 290,G00,411015,Gymrek; Melissa Ann,0,0,0,0
1708255763263,CSE 290,H00,479239,Dasgupta; Sanjoy & Gymrek; Melissa Ann,0,0,0,0
1708255763263,CSE 290,I00,481669,Bafna; Vineet,0,0,0,0
1708255763263,CSE 290,J00,494949,Paturi; Ramamohan,0,0,0,0
1708255763790,CSE 291,A00,411016,Li; Tzumao,0,0,0,0
1708255763790,CSE 291,B00,411017,Heninger; Nadia A,0,0,0,0
1708255763790,CSE 291,C00,411114,Chern; Albert Ren-Haur,0,0,0,0
1708255763790,CSE 291,D00,411115,Zhang; Yiying,0,0,0,0
1708255763790,CSE 291,E00,411116,Cheng; Chung Kuan,0,0,0,0
1708255763790,CSE 291,G00,411118,Lerner; Sorin,0,0,0,0
1708255763790,CSE 291,I00,481509,Shang; Jingbo,0,0,0,0
1708255763790,CSE 291,J00,494844,Savage; Stefan & Stefan; Deian,50,0,50,0
1708255764331,CSE 293,001,487239,Bafna; Vineet,9999,0,9999,0
1708255764331,CSE 293,002,487240,Bellare; Mihir,9999,0,9999,0
1708255764331,CSE 293,003,487241,Berg-Kirkpatrick; Taylor D,9999,0,9999,0
1708255764331,CSE 293,004,487242,Chandraker; Manmohan Krishna,9999,0,9999,0
1708255764331,CSE 293,005,487243,Cheng; Chung Kuan,9999,0,9999,0
1708255764331,CSE 293,006,487244,Christensen; Henrik I,9999,0,9999,0
1708255764331,CSE 293,007,487245,Coblenz; Michael J,9999,0,9999,0
1708255764331,CSE 293,008,487363,Cottrell; Garrison W,9999,0,9999,0
1708255764331,CSE 293,009,487366,Deutsch; Alin Bernard,9999,0,9999,0
1708255764331,CSE 293,010,487433,Esmaeilzadeh; Hadi,9999,0,9999,0
1708255764331,CSE 293,011,487434,Freund; Yoav,9999,0,9999,0
1708255764331,CSE 293,012,487455,Griswold; William G.,9999,0,9999,0
1708255764331,CSE 293,013,487469,Gymrek; Melissa Ann,9999,0,9999,0
1708255764331,CSE 293,014,487470,Heninger; Nadia A,9999,0,9999,0
1708255764331,CSE 293,015,487471,Impagliazzo; Russell,9999,0,9999,0
1708255764331,CSE 293,016,487472,Jhala; Ranjit,9999,0,9999,0
1708255764331,CSE 293,017,487473,Kahng; Andrew Byun,9999,0,9999,0
1708255764331,CSE 293,018,487474,Kane; Daniel Mertz,9999,0,9999,0
1708255764331,CSE 293,019,487475,Kriegman; David J,9999,0,9999,0
1708255764331,CSE 293,020,487476,Kumar; Arun Kumar,9999,0,9999,0
1708255764331,CSE 293,021,487477,Lerner; Sorin,9999,0,9999,0
1708255764331,CSE 293,022,487478,Lovett; Shachar,9999,0,9999,0
1708255764331,CSE 293,023,487520,McAuley; Julian John,9999,0,9999,0
1708255764331,CSE 293,024,487522,Micciancio; Daniele,9999,0,9999,0
1708255764331,CSE 293,025,487577,Orailoglu; Alex,9999,0,9999,0
1708255764331,CSE 293,026,487586,Pannuto; Patrick William,9999,0,9999,0
1708255764331,CSE 293,027,487598,Paturi; Ramamohan,9999,0,9999,0
1708255764331,CSE 293,028,487604,Polikarpova; Nadezhda,9999,0,9999,0
1708255764331,CSE 293,029,487609,Politz; Joseph Gibbs,9999,0,9999,0
1708255764331,CSE 293,030,487642,Porter; George M,9999,0,9999,0
1708255764331,CSE 293,031,487665,Porter; Leonard Emerson,9999,0,9999,0
1708255764331,CSE 293,032,487689,Ramamoorthi; Ravi,9999,0,9999,0
1708255764331,CSE 293,033,487698,Riek; Laurel D,9999,0,9999,0
1708255764331,CSE 293,034,487712,Sahoo; Debashis,9999,0,9999,0
1708255764331,CSE 293,035,487721,Saul; Lawrence,9999,0,9999,0
1708255764331,CSE 293,036,487735,Savage; Stefan,9999,0,9999,0
1708255764331,CSE 293,037,487744,Schulze; Jurgen P.,9999,0,9999,0
1708255764331,CSE 293,038,487758,Snoeren; Alex C.,9999,0,9999,0
1708255764331,CSE 293,039,487767,Shang; Jingbo,9999,0,9999,0
1708255764331,CSE 293,040,487790,Stefan; Deian,9999,0,9999,0
1708255764331,CSE 293,041,487817,Su; Hao,9999,0,9999,0
1708255764331,CSE 293,042,487827,Swanson; Steven James,9999,0,9999,0
1708255764331,CSE 293,043,487830,Tullsen; Dean Michael,9999,0,9999,0
1708255764331,CSE 293,044,487837,Vaccaro; Kristen Marie,9999,0,9999,0
1708255764331,CSE 293,045,487838,Voelker; Geoffrey M.,9999,0,9999,0
1708255764331,CSE 293,046,487842,Zhao; Jishen,9999,0,9999,0
1708255764331,CSE 293,047,487847,Zhou; Yuan-Yuan,9999,0,9999,0
1708255764331,CSE 293,048,487852,Gao; Sicun,9999,0,9999,0
1708255764331,CSE 293,049,487853,Weibel; Nadir,9999,0,9999,0
1708255764331,CSE 293,050,487854,Gupta; Rajesh K.,9999,0,9999,0
1708255764331,CSE 293,051,487855,Soosai Raj; Adalbert Geral,9999,0,9999,0
1708255764331,CSE 293,052,494373,Zhang; Hao,9999,0,9999,0
1708255764855,CSE 294,A00,411124,Voelker; Geoffrey M.,15,0,15,0
1708255765385,CSS 100,A01,396053,Trott; Sean Thomas,43,0,50,7
1708255765911,CSS 120,A01,479237,Mignozzetti; Umberto,47,0,50,3
1708255765911,CSS 120,A02,479238,Mignozzetti; Umberto,50,0,50,0
1708255766437,CSS 209,A00,396054,Styler; William Francis,21,0,35,14
1708255766966,CSS 296,001,396055,Mignozzetti; Umberto,0,0,0,1
1708255766966,CSS 296,002,396056,Styler; William Francis,0,0,0,1
1708255766966,CSS 296,003,396057,Broz; James Lawrence,0,0,0,2
1708255766966,CSS 296,004,396058,Elliott; Graham,0,0,0,5
1708255766966,CSS 296,005,396059,Sun; Feiyang,0,0,0,0
1708255766966,CSS 296,006,396060,Dewaard; Andrew Michael,0,0,0,0
1708255767492,DDPM 210,A00,400652,Ma; Joseph David,36,0,36,0
1708255768016,DDPM 211,A00,400653,Ma; Joseph David,36,0,36,0
1708255768544,DDPM 214,A00,400720,Ma; Joseph David,36,0,36,0
1708255769072,DERM 296,001,464131,Staff,50,0,50,0
1708255769072,DERM 296,002,464178,Staff,50,0,50,0
1708255769072,DERM 296,003,464181,Staff,50,0,50,0
1708255769624,DOC 3,A01,399409,Strom; Megan C.,0,0,0,0
1708255769624,DOC 3,A02,399414,Strom; Megan C.,0,0,0,0
1708255769624,DOC 3,A03,399432,Strom; Megan C.,0,0,0,0
1708255769624,DOC 3,A04,399461,Strom; Megan C.,0,0,0,0
1708255769624,DOC 3,A05,399470,Strom; Megan C.,0,0,0,0
1708255769624,DOC 3,A06,399476,Strom; Megan C.,0,0,0,0
1708255769624,DOC 3,A07,399547,Strom; Megan C.,0,0,0,0
1708255769624,DOC 3,A08,399548,Strom; Megan C.,0,0,0,0
1708255769624,DOC 3,A09,399675,Strom; Megan C.,0,0,0,0
1708255769624,DOC 3,A10,399687,Strom; Megan C.,0,0,0,0
1708255769624,DOC 3,A11,399704,Strom; Megan C.,0,0,0,0
1708255769624,DOC 3,A12,399707,Strom; Megan C.,0,0,0,0
1708255769624,DOC 3,A13,399714,Strom; Megan C.,0,0,0,0
1708255769624,DOC 3,A14,399721,Strom; Megan C.,0,0,0,0
1708255769624,DOC 3,A15,399765,Strom; Megan C.,0,0,0,0
1708255769624,DOC 3,A16,399766,Strom; Megan C.,0,0,0,0
1708255769624,DOC 3,B01,399786,Strom; Megan C.,0,0,0,0
1708255769624,DOC 3,B02,399787,Strom; Megan C.,0,0,0,0
1708255769624,DOC 3,B03,399788,Strom; Megan C.,0,0,0,0
1708255769624,DOC 3,B04,399845,Strom; Megan C.,0,0,0,0
1708255769624,DOC 3,B05,399846,Strom; Megan C.,0,0,0,0
1708255769624,DOC 3,B06,399895,Strom; Megan C.,0,0,0,0
1708255769624,DOC 3,B07,399916,Strom; Megan C.,0,0,0,0
1708255769624,DOC 3,B08,400073,Strom; Megan C.,0,0,0,0
1708255769624,DOC 3,B09,400074,Strom; Megan C.,0,0,0,0
1708255769624,DOC 3,B10,400076,Strom; Megan C.,0,0,0,0
1708255769624,DOC 3,B11,400077,Strom; Megan C.,0,0,0,0
1708255769624,DOC 3,B12,400078,Strom; Megan C.,0,0,0,0
1708255769624,DOC 3,B13,400079,Strom; Megan C.,0,0,0,0
1708255769624,DOC 3,B14,400080,Strom; Megan C.,0,0,0,0
1708255769624,DOC 3,B15,400081,Strom; Megan C.,0,0,0,0
1708255769624,DOC 3,B16,400082,Strom; Megan C.,0,0,0,0
1708255769624,DOC 3,C01,400084,Chapman; Dillon,0,0,0,0
1708255769624,DOC 3,C02,400085,Chapman; Dillon,0,0,0,0
1708255769624,DOC 3,C03,400086,Chapman; Dillon,0,0,0,0
1708255769624,DOC 3,C04,400087,Chapman; Dillon,0,0,0,0
1708255769624,DOC 3,C05,400113,Chapman; Dillon,0,0,0,0
1708255769624,DOC 3,C06,400114,Chapman; Dillon,0,0,0,0
1708255769624,DOC 3,C07,400117,Chapman; Dillon,0,0,0,0
1708255769624,DOC 3,C08,400118,Chapman; Dillon,0,0,0,0
1708255769624,DOC 3,C09,400119,Chapman; Dillon,0,0,0,0
1708255769624,DOC 3,C10,400121,Chapman; Dillon,0,0,0,0
1708255769624,DOC 3,C11,400122,Chapman; Dillon,0,0,0,0
1708255769624,DOC 3,C12,400126,Chapman; Dillon,0,0,0,0
1708255769624,DOC 3,C13,400157,Chapman; Dillon,0,0,0,0
1708255769624,DOC 3,C14,400240,Chapman; Dillon,0,0,0,0
1708255769624,DOC 3,C15,400241,Chapman; Dillon,0,0,0,0
1708255769624,DOC 3,C16,400242,Chapman; Dillon,0,0,0,0
1708255769624,DOC 3,D01,400253,Chapman; Dillon,0,0,0,0
1708255769624,DOC 3,D02,400294,Chapman; Dillon,0,0,0,0
1708255769624,DOC 3,D03,400295,Chapman; Dillon,0,0,0,0
1708255769624,DOC 3,D04,400430,Chapman; Dillon,0,0,0,0
1708255769624,DOC 3,D05,400438,Chapman; Dillon,0,0,0,0
1708255769624,DOC 3,D06,400439,Chapman; Dillon,0,0,0,0
1708255769624,DOC 3,D07,400441,Chapman; Dillon,0,0,0,0
1708255769624,DOC 3,D08,400442,Chapman; Dillon,0,0,0,0
1708255769624,DOC 3,D09,400443,Chapman; Dillon,0,0,0,0
1708255769624,DOC 3,D10,400445,Chapman; Dillon,0,0,0,0
1708255769624,DOC 3,D11,400446,Chapman; Dillon,0,0,0,0
1708255769624,DOC 3,D12,400447,Chapman; Dillon,0,0,0,0
1708255769624,DOC 3,D13,400448,Chapman; Dillon,0,0,0,0
1708255769624,DOC 3,D14,400646,Chapman; Dillon,0,0,0,0
1708255769624,DOC 3,D15,400647,Chapman; Dillon,0,0,0,0
1708255769624,DOC 3,D16,400648,Chapman; Dillon,0,0,0,0
1708255770149,DOC 100D,A00,400649,Pass; Natalye Joann,22,0,25,3
1708255770149,DOC 100D,B00,400650,Pass; Natalye Joann,25,0,25,0
1708255770677,DSC 10,A01,398041,Tiefenbruck; Janine LoBue,142,0,147,5
1708255770677,DSC 10,B01,398180,Tiefenbruck; Janine LoBue,144,0,147,3
1708255770677,DSC 10,C01,398400,Tiefenbruck; Janine LoBue,143,0,147,4
1708255771207,DSC 20,A01,398415,Langlois; Marina,200,0,200,0
1708255771734,DSC 30,A01,398436,Langlois; Marina,156,0,158,2
1708255771734,DSC 30,B01,398439,Langlois; Marina,144,0,150,6
1708255772264,DSC 40A,A01,398441,Rampure; Suraj,123,0,125,2
1708255772264,DSC 40A,B01,398443,Rampure; Suraj,125,0,125,0
1708255772793,DSC 40B,A01,398445,Staff,150,0,150,0
1708255773322,DSC 80,A01,398470,Lau; Samuel Ethan,70,0,70,0
1708255773322,DSC 80,B01,398541,Lau; Samuel Ethan,68,0,70,2
1708255773848,DSC 95,A01,398650,Rampure; Suraj,50,0,50,0
1708255774374,DSC 100,A01,398683,Salimi; Babak,147,0,150,3
1708255774901,DSC 102,A01,398708,Jin; Haojian,145,0,150,5
1708255775428,DSC 106,A01,398711,Wilber; Jared Dane,146,0,149,3
1708255775955,DSC 140A,A01,398724,Eldridge; Justin Matthew,98,0,100,2
1708255775955,DSC 140A,B01,479346,Ustun; Tevfik Berk,50,0,50,0
1708255776483,DSC 140B,A01,398726,Weng; Tsui-Wei (lily),144,0,150,6
1708255777016,DSC 190,A01,398738,Silberman; Jack,20,0,20,0
1708255777016,DSC 190,B01,479475,Ustun; Tevfik Berk,29,0,30,1
1708255777016,DSC 190,C01,481341,Rahman; Tauhidur,50,0,50,0
1708255777542,DSC 197,001,494360,Eldridge; Justin Matthew,9999,0,9999,0
1708255778069,DSC 214,A00,477322,Staff,21,0,60,39
1708255778598,DSC 231,A01,398863,Gupta; Rajesh K.,60,0,60,0
1708255779129,DSC 232R,A01,487133,Solares; Edwin A,38,0,60,22
1708255779654,DSC 240,A00,398957,Belkin; Mikhail,74,0,90,16
1708255780708,DSC 243,A00,398958,Ma; Yian,59,0,60,1
1708255781234,DSC 245,A00,398959,Huang; Biwei,41,0,60,19
1708255781763,DSC 253,A00,398960,Shang; Jingbo,0,0,30,30
1708255782288,DSC 258R,A01,398962,Shang; Jingbo,42,0,60,18
1708255782815,DSC 267R,A01,398964,Staff,56,0,60,4
1708255783349,DSC 291,A00,398965,Belkin; Mikhail,90,0,90,0
1708255783349,DSC 291,B00,398966,Weng; Tsui-Wei (lily),90,0,90,0
1708255783349,DSC 291,C00,398997,Staff,60,0,60,0
1708255783349,DSC 291,D00,398998,Zhang; Hao,40,0,40,0
1708255783349,DSC 291,E00,477386,Staff,50,0,50,0
1708255783874,DSC 293,A00,477388,Ustun; Tevfik Berk,9989,0,9999,10
1708255784418,DSC 295,A00,480826,Danks; David J,30,0,40,10
1708255784948,DSE 220,A00,398034,Dasgupta; Sanjoy,20,0,20,0
1708255785474,DSE 230,A00,398035,Nguyen; Mai Huong,20,0,20,0
1708255786000,DSE 260B,A00,398037,Altintas De Callaf; Ilkay,20,0,20,0
1708255786530,DSGN 1,A01,408210,Klemmer; Scott R,46,0,50,4
1708255786530,DSGN 1,A02,408245,Klemmer; Scott R,47,0,50,3
1708255787056,DSGN 119,A00,407467,Hollan; James D. & Xia; Haijun,76,0,90,14
1708255787582,DSGN 160,A00,494371,Aronoff-Spencer; Eliah Sea,15,0,20,5
1708255788110,DSGN 219,A00,474323,Hollan; James D. & Xia; Haijun,15,0,15,0
1708255788636,ECE 5,A01,428645,Morris; Karcher William,21,0,24,3
1708255788636,ECE 5,A02,428646,Morris; Karcher William,24,0,24,0
1708255788636,ECE 5,A03,428647,Morris; Karcher William,24,0,24,0
1708255788636,ECE 5,A04,428648,Morris; Karcher William,24,0,24,0
1708255789163,ECE 15,A01,428650,Sahay; Rajeev,119,0,120,1
1708255789689,ECE 16,A01,428652,Wang; Edward Jay,22,0,30,8
1708255790216,ECE 17,A01,428654,Sahay; Rajeev,48,0,60,12
1708255790742,ECE 25,A50,428657,Dey; Sujit,30,0,30,0
1708255790742,ECE 25,A51,428658,Dey; Sujit,30,0,30,0
1708255791268,ECE 30,A50,428674,Mir Arabbaygi; Siavash,27,0,30,3
1708255791268,ECE 30,A51,428675,Mir Arabbaygi; Siavash,28,0,30,2
1708255791268,ECE 30,A52,428676,Mir Arabbaygi; Siavash,28,0,30,2
1708255791268,ECE 30,A53,428679,Mir Arabbaygi; Siavash,29,0,30,1
1708255791268,ECE 30,A54,428680,Mir Arabbaygi; Siavash,30,0,30,0
1708255791794,ECE 35,A50,428684,Taur; Yuan,29,0,30,1
1708255791794,ECE 35,A51,428685,Taur; Yuan,30,0,30,0
1708255791794,ECE 35,A52,428686,Taur; Yuan,30,0,30,0
1708255791794,ECE 35,A53,428687,Taur; Yuan,29,0,30,1
1708255792325,ECE 45,A01,428689,Zeger; Kenneth A.,137,0,150,13
1708255792857,ECE 65,A50,428701,Baghdadchi; Saharnaz,28,0,30,2
1708255792857,ECE 65,A51,428742,Baghdadchi; Saharnaz,29,0,30,1
1708255792857,ECE 65,A52,428743,Baghdadchi; Saharnaz,30,0,30,0
1708255792857,ECE 65,A53,428754,Baghdadchi; Saharnaz,26,0,30,4
1708255792857,ECE 65,A54,428796,Baghdadchi; Saharnaz,30,0,30,0
1708255792857,ECE 65,A55,428797,Baghdadchi; Saharnaz,29,0,30,1
1708255792857,ECE 65,A56,428803,Baghdadchi; Saharnaz,30,0,30,0
1708255793385,ECE 100,A01,428978,Baghdadchi; Saharnaz,29,0,30,1
1708255793385,ECE 100,A02,428988,Baghdadchi; Saharnaz,30,0,30,0
1708255793385,ECE 100,A03,428989,Baghdadchi; Saharnaz,29,0,30,1
1708255793385,ECE 100,A04,429008,Baghdadchi; Saharnaz,29,0,30,1
1708255793913,ECE 101,A01,429017,Bharadia; Dinesh,57,0,60,3
1708255793913,ECE 101,A02,429019,Bharadia; Dinesh,60,0,60,0
1708255794443,ECE 103,A01,429027,Kuzum; Duygu,74,0,75,1
1708255794969,ECE 107,A01,429055,Fullerton; Eric E,73,0,75,2
1708255795495,ECE 108,A01,429068,Kang; Mingu,53,0,60,7
1708255796025,ECE 109,A01,429085,Orlitsky; Alon,97,0,100,3
1708255796025,ECE 109,A02,429098,Orlitsky; Alon,96,0,100,4
1708255796552,ECE 111,A01,429132,Turakhia; Yatish Girish,173,0,180,7
1708255797080,ECE 115,A01,429314,Yip; Michael,21,0,26,5
1708255797610,ECE 123,A01,429327,Sievenpiper; Daniel F.,56,0,60,4
1708255798142,ECE 125B,A50,429397,Esmaili; Gholamreza,23,0,24,1
1708255798142,ECE 125B,A51,429627,Esmaili; Gholamreza,23,0,24,1
1708255798668,ECE 134,A00,429630,Ng; Tse Nga,50,0,50,0
1708255799198,ECE 136L,A01,429634,Dayeh; Shadi Ahmad,3,0,5,2
1708255799198,ECE 136L,A02,429636,Dayeh; Shadi Ahmad,3,0,5,2
1708255799198,ECE 136L,A03,429637,Dayeh; Shadi Ahmad,5,0,5,0
1708255799198,ECE 136L,A04,429641,Dayeh; Shadi Ahmad,5,0,5,0
1708255799727,ECE 139,A00,429642,Nomura; Kenji,17,0,20,3
1708255800252,ECE 140B,A01,455349,Khoshabeh; Ramsin & Gessner; Richard K.,19,0,24,5
1708255800252,ECE 140B,A02,455351,Khoshabeh; Ramsin & Gessner; Richard K.,23,0,24,1
1708255800252,ECE 140B,A03,455354,Khoshabeh; Ramsin & Gessner; Richard K.,21,0,22,1
1708255800782,ECE 141B,A01,455355,Gessner; Richard K.,47,0,50,3
1708255801306,ECE 148,A01,492803,Silberman; Jack,0,0,0,0
1708255801835,ECE 153,A01,429655,Naghizadeh Ardabili; Parin,94,0,100,6
1708255802363,ECE 157A,A01,429657,Bharadia; Dinesh,22,0,25,3
1708255802892,ECE 158B,A01,429659,Zhang; Xinyu,14,0,20,6
1708255803423,ECE 161C,A00,429660,Cosman; Pamela C.,58,0,60,2
1708255803954,ECE 163,A00,429664,Hsueh; Tzu-Chien,95,0,100,5
1708255804479,ECE 165,A51,429672,Mercier; Patrick Philip,20,0,30,10
1708255804479,ECE 165,A52,429673,Mercier; Patrick Philip,22,0,30,8
1708255804479,ECE 165,A53,429674,Mercier; Patrick Philip,30,0,30,0
1708255804479,ECE 165,A54,429675,Mercier; Patrick Philip,30,0,30,0
1708255805008,ECE 171A,A01,429813,Zheng; Yang,96,0,100,4
1708255805590,ECE 175B,A01,429886,Xie; Pengtao,72,0,75,3
1708255806117,ECE 183,A01,430023,Mookherjea; Shayan,26,0,30,4
1708255806644,ECE 185,A01,430025,Papen; George C.,19,0,20,1
1708255807177,ECE 191,A00,430039,Zhang; Xinyu,30,0,30,0
1708255807706,ECE 196,A00,430040,Morris; Karcher William,18,0,24,6
1708255807706,ECE 196,B00,430045,Morris; Karcher William,23,0,24,1
1708255808230,ECE 198,001,430052,Nguyen; Truong Quang,9999,0,9999,0
1708255808765,ECE 200,001,438659,Atanasov; Nikolay A.,9999,0,9999,0
1708255808765,ECE 200,002,438660,Bharadia; Dinesh,9999,0,9999,0
1708255808765,ECE 200,003,438668,Cheng; Chung Kuan,9999,0,9999,0
1708255808765,ECE 200,004,438845,Cosman; Pamela C.,9999,0,9999,0
1708255808765,ECE 200,005,438846,Dayeh; Shadi Ahmad,9999,0,9999,0
1708255808765,ECE 200,006,438847,Fainman; Yeshaiahu,9999,0,9999,0
1708255808765,ECE 200,007,438848,Ford; Joseph Earl,9999,0,9999,0
1708255808765,ECE 200,008,438849,Franceschetti; Massimo,9999,0,9999,0
1708255808765,ECE 200,009,438850,Fullerton; Eric E,9999,0,9999,0
1708255808765,ECE 200,010,438851,Galton; Ian A,9999,0,9999,0
1708255808765,ECE 200,011,438852,Gilja; Vikash,9999,0,9999,0
1708255808765,ECE 200,012,438853,Hall; Drew A.,9999,0,9999,0
1708255808765,ECE 200,013,438854,Hsueh; Tzu-Chien,9999,0,9999,0
1708255808765,ECE 200,014,438855,Javidi; Tara,9999,0,9999,0
1708255808765,ECE 200,015,438865,Kahng; Andrew Byun,9999,0,9999,0
1708255808765,ECE 200,016,438866,Kim; Young-Han,9999,0,9999,0
1708255808765,ECE 200,017,438876,Koushanfar; Farinaz,9999,0,9999,0
1708255808765,ECE 200,018,438877,Kuzum; Duygu,9999,0,9999,0
1708255808765,ECE 200,019,438934,Le; Hanh-Phuc,9999,0,9999,0
1708255808765,ECE 200,020,438954,Lin; Bill,9999,0,9999,0
1708255808765,ECE 200,021,438955,Liu; Zhaowei,9999,0,9999,0
1708255808765,ECE 200,022,438957,Lo; Yu-Hwa,9999,0,9999,0
1708255808765,ECE 200,023,439086,Lomakin; Vitaliy,9999,0,9999,0
1708255808765,ECE 200,024,439087,Mercier; Patrick Philip,9999,0,9999,0
1708255808765,ECE 200,025,439088,Meyer; Florian,9999,0,9999,0
1708255808765,ECE 200,026,439090,Milstein; Laurence B.,9999,0,9999,0
1708255808765,ECE 200,027,439208,Mir Arabbaygi; Siavash,9999,0,9999,0
1708255808765,ECE 200,028,439209,Mookherjea; Shayan,9999,0,9999,0
1708255808765,ECE 200,029,439210,Morris; Karcher William,9999,0,9999,0
1708255808765,ECE 200,030,439211,Ng; Tse Nga,9999,0,9999,0
1708255808765,ECE 200,031,439219,Nguyen; Truong Quang,9999,0,9999,0
1708255808765,ECE 200,032,439220,Nomura; Kenji,9999,0,9999,0
1708255808765,ECE 200,033,439221,Orlitsky; Alon,9999,0,9999,0
1708255808765,ECE 200,034,439222,Pal; Piya,9999,0,9999,0
1708255808765,ECE 200,035,439223,Papen; George C.,9999,0,9999,0
1708255808765,ECE 200,036,439224,Radic; Stojan,9999,0,9999,0
1708255808765,ECE 200,037,439225,Rao; Bhaskar D.,9999,0,9999,0
1708255808765,ECE 200,038,439227,Rao; Ramesh R,9999,0,9999,0
1708255808765,ECE 200,039,439231,Rebeiz; Gabriel,9999,0,9999,0
1708255808765,ECE 200,040,439232,Sanford; John R,9999,0,9999,0
1708255808765,ECE 200,041,439302,Siegel; Paul H.,9999,0,9999,0
1708255808765,ECE 200,042,439303,Sievenpiper; Daniel F.,9999,0,9999,0
1708255808765,ECE 200,043,439305,Sworder; David D.,9999,0,9999,0
1708255808765,ECE 200,044,439306,Taur; Yuan,9999,0,9999,0
1708255808765,ECE 200,045,439419,Touri; Behrouz,9999,0,9999,0
1708255808765,ECE 200,046,439425,Trivedi; Mohan M.,9999,0,9999,0
1708255808765,ECE 200,047,439538,Vasconcelos; Nuno,9999,0,9999,0
1708255808765,ECE 200,048,439546,Wang; Xiaolong,9999,0,9999,0
1708255808765,ECE 200,049,439549,Xie; Pengtao,9999,0,9999,0
1708255808765,ECE 200,050,439551,Yip; Michael,9999,0,9999,0
1708255808765,ECE 200,051,439553,Zeger; Kenneth A.,9999,0,9999,0
1708255808765,ECE 200,052,439554,Zhang; Xinyu,9999,0,9999,0
1708255808765,ECE 200,053,439555,Zheng; Yang,9999,0,9999,0
1708255808765,ECE 200,054,439557,Turakhia; Yatish Girish,9999,0,9999,0
1708255808765,ECE 200,055,439558,Kang; Mingu,9999,0,9999,0
1708255808765,ECE 200,056,439560,Shi; Yuanyuan,9999,0,9999,0
1708255808765,ECE 200,057,439564,Wang; Edward Jay,9999,0,9999,0
1708255808765,ECE 200,058,439565,Antipa; Nicholas A,9999,0,9999,0
1708255808765,ECE 200,059,439566,Zheng; Yang,9999,0,9999,0
1708255808765,ECE 200,060,492991,Yu; Paul K L,9999,0,9999,0
1708255808765,ECE 200,061,492992,Ndao; Abdoulaye,9999,0,9999,0
1708255808765,ECE 200,062,493019,Naghizadeh Ardabili; Parin,9999,0,9999,0
1708255808765,ECE 200,063,493033,Sahay; Rajeev,9999,0,9999,0
1708255809290,ECE 208,A00,430053,Mir Arabbaygi; Siavash,0,0,0,0
1708255809815,ECE 212CN,A00,430054,Liu; Zhaowei,0,0,0,0
1708255810341,ECE 222C,A00,430055,Lomakin; Vitaliy,0,0,0,0
1708255810870,ECE 227,A00,430057,Franceschetti; Massimo,0,0,0,0
1708255811399,ECE 228,A00,430078,Shi; Yuanyuan,0,0,0,0
1708255811924,ECE 230C,A00,430079,Yu; Paul K L,0,0,0,0
1708255812449,ECE 235,A00,430081,Taur; Yuan,0,0,0,0
1708255812975,ECE 236B,A00,430082,Lo; Yu-Hwa,0,0,0,0
1708255813502,ECE 240C,A00,430083,Mookherjea; Shayan,0,0,0,0
1708255814028,ECE 250,A00,430115,Touri; Behrouz,0,0,0,0
1708255814558,ECE 251B,A00,430166,Vasconcelos; Manuela,0,0,0,0
1708255815083,ECE 258B,A00,430167,Milstein; Laurence B.,0,0,0,0
1708255815614,ECE 260C,A00,430168,Eldon; John,0,0,0,0
1708255816142,ECE 264B,A00,430169,Galton; Ian A,0,0,0,0
1708255816668,ECE 265B,A00,430170,Gudem; Prasad S.S.,0,0,0,0
1708255817194,ECE 266,A01,430273,Hall; Drew A.,0,0,0,0
1708255817723,ECE 271C,A00,430283,Vasconcelos; Nuno,0,0,0,0
1708255818248,ECE 272A,A01,430340,Poveda Fonseca; Jorge,0,0,0,0
1708255818778,ECE 273,A00,430352,Wang; Jun-Kun,0,0,0,0
1708255819304,ECE 276B,A00,430353,Atanasov; Nikolay A.,0,0,0,0
1708255819831,ECE 284,A00,430385,Wang; Edward,0,0,0,0
1708255820363,ECE 285,A00,430386,Wang; Xiaolong,0,0,0,0
1708255820363,ECE 285,B00,430387,Antipa; Nicholas A,0,0,0,0
1708255820893,ECON 1,A01,409576,Crane; Meredith Helen,87,0,100,13
1708255820893,ECON 1,A02,409577,Crane; Meredith Helen,96,0,100,4
1708255820893,ECON 1,A03,409578,Crane; Meredith Helen,97,0,100,3
1708255821418,ECON 2,A01,409580,Candido; Maria Teresa,70,0,75,5
1708255821944,ECON 3,A01,409582,Crane; Meredith Helen,109,0,120,11
1708255821944,ECON 3,A02,409583,Crane; Meredith Helen,114,0,115,1
1708255821944,ECON 3,A03,409584,Crane; Meredith Helen,110,0,115,5
1708255822476,ECON 4,A01,409586,Levkoff; Steven B.,88,0,92,4
1708255822476,ECON 4,A02,409587,Levkoff; Steven B.,89,0,90,1
1708255823004,ECON 5,A01,409589,Dai; Yinlin,53,0,58,5
1708255823004,ECON 5,A02,409590,Dai; Yinlin,56,0,58,2
1708255823004,ECON 5,A03,409591,Dai; Yinlin,54,0,54,0
1708255823004,ECON 5,A04,409593,Dai; Yinlin,55,0,55,0
1708255823004,ECON 5,B01,409595,Dai; Yinlin,57,0,58,1
1708255823004,ECON 5,B02,409596,Dai; Yinlin,49,0,49,0
1708255823004,ECON 5,B03,409597,Dai; Yinlin,59,0,59,0
1708255823004,ECON 5,B04,409598,Dai; Yinlin,55,0,55,0
1708255823004,ECON 5,C01,487209,Staff,40,0,45,5
1708255823532,ECON 100A,A01,409600,Famulari; Melissa,94,0,100,6
1708255823532,ECON 100A,A02,409601,Famulari; Melissa,98,0,100,2
1708255823532,ECON 100A,A03,409604,Famulari; Melissa,98,0,100,2
1708255823532,ECON 100A,B01,409610,Famulari; Melissa,76,0,80,4
1708255824062,ECON 100AH,A00,409612,Famulari; Melissa,19,0,20,1
1708255824589,ECON 100B,A01,409614,Grigoryan; Aram,109,0,120,11
1708255824589,ECON 100B,A02,409616,Grigoryan; Aram,117,0,120,3
1708255824589,ECON 100B,B01,409626,Grigoryan; Aram,47,0,50,3
1708255824589,ECON 100B,B02,409627,Grigoryan; Aram,49,0,50,1
1708255825119,ECON 100C,A01,409629,Levkoff; Steven B.,143,0,146,3
1708255825119,ECON 100C,B01,409632,Levkoff; Steven B.,143,0,146,3
1708255825646,ECON 106,A00,409633,Bowen; T. Renee,90,0,90,0
1708255826172,ECON 109T,A00,409634,Trevino; Isabel,18,0,20,2
1708255826697,ECON 110A,A01,409637,Staff,68,0,75,7
1708255827227,ECON 110B,A01,409663,Herreno Lopera; Juan,119,0,125,6
1708255827227,ECON 110B,A02,409682,Herreno Lopera; Juan,125,0,125,0
1708255827227,ECON 110B,B01,409734,Herreno Lopera; Juan,99,0,100,1
1708255827755,ECON 120A,A01,409739,Candido; Maria Teresa,84,0,90,6
1708255827755,ECON 120A,A02,409740,Candido; Maria Teresa,87,0,90,3
1708255827755,ECON 120A,B01,409742,Candido; Maria Teresa,85,0,90,5
1708255827755,ECON 120A,B02,409743,Candido; Maria Teresa,90,0,90,0
1708255828286,ECON 120B,A01,409748,Ma; Xinwei,128,0,130,2
1708255828286,ECON 120B,A02,409754,Ma; Xinwei,128,0,130,2
1708255828286,ECON 120B,B01,409756,Ma; Xinwei,25,0,40,15
1708255828816,ECON 120C,A01,409758,Sun; Yixiao,141,0,146,5
1708255828816,ECON 120C,B01,409762,Sun; Yixiao,144,0,146,2
1708255829341,ECON 129,A00,409763,Eckert; Fabian Paul,44,0,50,6
1708255829870,ECON 134,A00,409764,Gelber; Alexander Michael,45,0,50,5
1708255829870,ECON 134,B00,409765,Gelber; Alexander Michael,49,0,50,1
1708255830394,ECON 137,A00,409766,Niehaus; Paul,19,0,20,1
1708255830925,ECON 142,A00,409767,Trevino; Isabel,39,0,40,1
1708255830925,ECON 142,B00,409768,Trevino; Isabel,38,0,40,2
1708255831456,ECON 164,A00,409771,Muralidharan; Karthik,118,0,120,2
1708255831983,ECON 172A,A01,409773,Newhouse; Herbert S,67,0,75,8
1708255832510,ECON 172B,A01,409775,Newhouse; Herbert S,74,0,75,1
1708255832510,ECON 172B,B01,409777,Newhouse; Herbert S,71,0,75,4
1708255833564,ECON 191A,A00,409780,Cullen; Julie,20,0,20,0
1708255834090,ECON 200C,A00,409782,Du; Songzi,34,0,35,1
1708255834621,ECON 210C,A00,409784,Herreno Lopera; Juan & Wieland; Johannes Friedrich,35,0,35,0
1708255835147,ECON 220C,A00,409785,Sun; Yixiao,35,0,35,0
1708255835673,ECON 220F,A00,409786,Carson; Richard T,27,0,30,3
1708255836200,ECON 221,A00,409787,Zhu; Ying,25,0,25,0
1708255836729,ECON 241,A00,409788,Muralidharan; Karthik,18,0,20,2
1708255837258,ECON 243,A00,409789,Niehaus; Paul,18,0,20,2
1708255837785,ECON 248,A00,409790,Eckert; Fabian Paul,18,0,20,2
1708255838316,ECON 250C,A00,409791,Arnold; David Hall & Betts; Julian,25,0,25,0
1708255838842,ECON 268,A00,409792,Jacobsen; Mark,24,0,25,1
1708255839368,ECON 281,A00,409793,Meckel; Katherine Hunter,19,0,20,1
1708255839368,ECON 281,B00,409794,Herreno Lopera; Juan & Wieland; Johannes Friedrich,19,0,20,1
1708255839368,ECON 281,C00,477854,Herreno Lopera; Juan & Wieland; Johannes Friedrich,18,0,20,2
1708255839893,ECON 285,A00,409795,Eckert; Fabian Paul,20,0,20,0
1708255840420,ECON 286,A00,409796,Ma; Xinwei,15,0,15,0
1708255840420,ECON 286,B00,409797,Hamilton; James D.,15,0,15,0
1708255840420,ECON 286,C00,409798,Grigoryan; Aram,15,0,15,0
1708255840420,ECON 286,D00,409799,Niehaus; Paul,15,0,15,0
1708255840947,ECON 296,A00,409800,Eckert; Fabian Paul,20,0,20,0
1708255841477,EDS 31,A00,409801,Bussey; Thomas J,9,0,10,1
1708255842004,EDS 38,A01,409803,Chung; Luz Marina,25,0,25,0
1708255842532,EDS 39,A01,409805,Heinzman; Erica M.,24,0,25,1
1708255843057,EDS 102,A01,409807,Ambo; Theresa Jean,37,0,45,8
1708255843583,EDS 110R,A01,409809,Staff,42,0,50,8
1708255843583,EDS 110R,B01,481358,Staff,20,0,20,0
1708255844111,EDS 111,A00,479044,Wishard Guerra; Alison G.,56,0,60,4
1708255844637,EDS 117,A01,409818,Jones; Gabrielle Anastasia,21,0,23,2
1708255844637,EDS 117,A02,409819,Jones; Gabrielle Anastasia,23,0,23,0
1708255844637,EDS 117,A03,409820,Jones; Gabrielle Anastasia,22,0,23,1
1708255844637,EDS 117,A04,409821,Jones; Gabrielle Anastasia,21,0,21,0
1708255845163,EDS 118,A00,409828,Warstadt; Melissa Fawn,46,0,50,4
1708255845690,EDS 123,A00,409831,Bussey; Thomas J,10,0,10,0
1708255846219,EDS 124AR,A00,419352,Simon; Elizabeth A,81,0,100,19
1708255846219,EDS 124AR,B00,419377,Simon; Elizabeth A,97,0,100,3
1708255846219,EDS 124AR,C00,481485,Simon; Elizabeth A,25,0,25,0
1708255846219,EDS 124AR,D00,481490,Simon; Elizabeth A,25,0,25,0
1708255846745,EDS 124BR,A00,409838,Eguchi; Emi,52,0,75,23
1708255846745,EDS 124BR,B00,481363,Eguchi; Emi,25,0,25,0
1708255847274,EDS 125,A00,409839,Aragon; Maria Jose,48,0,50,2
1708255847802,EDS 126,A01,409843,Jones; Makeba,19,0,25,6
1708255847802,EDS 126,A02,409844,Jones; Makeba,25,0,25,0
1708255847802,EDS 126,A03,409846,Jones; Makeba,25,0,25,0
1708255847802,EDS 126,A04,409847,Jones; Makeba,25,0,25,0
1708255848327,EDS 128B,A01,409851,Pappas; Elizabeth,49,0,50,1
1708255848857,EDS 129C,A01,409906,Millstone; Rachel Diana,44,0,50,6
1708255849383,EDS 130,A01,409954,Mendez; Kathrina Mendoza,14,0,15,1
1708255849383,EDS 130,A02,409955,Mendez; Kathrina Mendoza,24,0,25,1
1708255849383,EDS 130,A03,409956,Mendez; Kathrina Mendoza,20,0,20,0
1708255849912,EDS 133,A01,409961,Bintliff; Amy S.V.,15,0,20,5
1708255849912,EDS 133,A02,409962,Bintliff; Amy S.V.,20,0,20,0
1708255849912,EDS 133,A03,489636,Bintliff; Amy S.V.,15,0,15,0
1708255850437,EDS 136,A01,409964,Chung; Luz Marina,30,0,30,0
1708255850437,EDS 136,A02,409977,Chung; Luz Marina,30,0,30,0
1708255850964,EDS 139,A00,479197,Millstone; Rachel Diana,42,0,50,8
1708255850964,EDS 139,B00,479198,Pappas; Elizabeth,49,0,50,1
1708255850964,EDS 139,C00,479199,Mendez; Kathrina Mendoza,58,0,60,2
1708255850964,EDS 139,D00,479200,Bintliff; Amy S.V.,56,0,60,4
1708255850964,EDS 139,E00,479201,Chung; Luz Marina,59,0,60,1
1708255850964,EDS 139,F00,479202,Bintliff; Amy S.V.,15,0,15,0
1708255850964,EDS 139,G00,479203,Mamas; Christoforos,27,0,30,3
1708255850964,EDS 139,H00,493997,Choi; Bailey Miyeon,28,0,30,2
1708255851493,EDS 141,A00,409979,Mamas; Christoforos,38,0,40,2
1708255852019,EDS 145,A01,409989,Choi; Bailey Miyeon,13,0,15,2
1708255852019,EDS 145,A02,409990,Choi; Bailey Miyeon,15,0,15,0
1708255852545,EDS 180,A00,409991,Chapman; Thandeka K,30,0,30,0
1708255852545,EDS 180,B00,409992,Ambo; Theresa Jean,24,0,25,1
1708255852545,EDS 180,C00,409993,Jones; Gabrielle Anastasia,20,0,20,0
1708255852545,EDS 180,D00,409994,Phuong; Andrew,24,0,24,0
1708255853072,EDS 198,001,487216,Eguchi; Emi,20,0,20,0
1708255853598,EDS 205B,A00,409995,Staff,40,0,45,5
1708255853598,EDS 205B,B00,409997,Staff,42,0,45,3
1708255854123,EDS 232,A00,409999,Hopkins; Megan Beth,9,0,12,3
1708255854649,EDS 255,A00,410001,Phuong; Andrew,14,0,15,1
1708255855175,EDS 257,A00,410003,Datnow; Amanda Lee,14,0,15,1
1708255855705,EDS 282,A00,479192,Daly; Alan J.,16,0,16,0
1708255856232,EDS 287B,A00,479193,Daly; Alan J.,16,0,16,0
1708255856758,EDS 288A,A00,410005,Staff,18,0,18,0
1708255857291,EDS 288C,A00,410007,Staff,18,0,18,0
1708255857818,EDS 289B,A01,410009,Daly; Alan J.,18,0,18,0
1708255858345,EDS 290,A00,410010,Black; Alison Michelle,30,0,30,0
1708255858345,EDS 290,B00,410012,Choi; Bailey Miyeon,29,0,30,1
1708255858345,EDS 290,C00,479205,Heinzman; Erica M.,0,0,0,0
1708255858923,EDS 291B,A01,479195,Daly; Alan J.,16,0,16,0
1708255859448,EDS 293B,A01,410016,Staff,18,0,18,0
1708255859977,EDS 294B,A00,479196,Burrell; Sade Renee,16,0,16,0
1708255860506,EDS 296,001,478927,Ambo; Theresa Jean,0,0,0,0
1708255860506,EDS 296,002,478935,Aragon; Maria Jose,0,0,0,1
1708255860506,EDS 296,003,478936,Chapman; Thandeka K,0,0,0,0
1708255860506,EDS 296,004,478942,Bintliff; Amy S.V.,0,0,0,0
1708255860506,EDS 296,005,478943,Clarke; Sherice Nicole,0,0,0,0
1708255860506,EDS 296,006,478967,Cohen; Shana R,0,0,0,1
1708255860506,EDS 296,007,478968,Datnow; Amanda Lee,0,0,0,0
1708255860506,EDS 296,008,478969,Daly; Alan J.,0,0,0,0
1708255860506,EDS 296,009,478970,Eguchi; Emi,0,0,0,0
1708255860506,EDS 296,010,478971,Fine; Sarah,0,0,0,0
1708255860506,EDS 296,011,478972,Jones; Gabrielle Anastasia,0,0,0,0
1708255860506,EDS 296,012,479020,Jones; Makeba,0,0,0,0
1708255860506,EDS 296,013,479021,Halter; Christopher P.,0,0,0,0
1708255860506,EDS 296,014,479027,Hofstetter; Carolyn,0,0,0,0
1708255860506,EDS 296,015,479028,Hopkins; Megan Beth,0,0,0,0
1708255860506,EDS 296,016,479034,Mamas; Christoforos,0,0,0,0
1708255860506,EDS 296,017,479035,Pollock; Mica,0,0,0,0
1708255860506,EDS 296,018,479036,Wishard Guerra; Alison G.,0,0,0,0
1708255860506,EDS 296,019,494549,Phuong; Andrew,0,0,0,0
1708255861038,EMED 296,001,464428,Singh; Sukhdeep,49,0,50,1
1708255861038,EMED 296,002,464438,Subramony; Rachna,49,0,50,1
1708255861038,EMED 296,003,464490,Staff,50,0,50,0
1708255861568,ENG 10,A00,399006,Evdokimenko; Ekaterina,30,0,30,0
1708255862095,ENG 100D,A00,399084,Ngo; Anh-Thu T.,33,0,50,17
1708255862626,ENG 100DR,A00,479230,Ngo; Anh-Thu T.,29,0,40,11
1708255863151,ENG 100L,A00,399163,Kleissl; Jan,6,0,6,0
1708255863151,ENG 100L,B00,399217,Bratton; Maryann,8,0,8,0
1708255863151,ENG 100L,C00,399218,Yu; Paul K L,8,0,8,0
1708255863151,ENG 100L,D00,399257,Bratton; Maryann,6,0,6,0
1708255863151,ENG 100L,E00,399258,de Oliveira; Mauricio,9,0,10,1
1708255863151,ENG 100L,F00,399314,Bratton; Maryann,7,0,7,0
1708255863151,ENG 100L,G00,399394,Boyle; Mary E. T.,14,0,15,1
1708255863679,ENVR 102,A00,400777,Daly; Heather Marie,19,0,20,1
1708255863679,ENVR 102,B00,400778,Montejo; Carolina,24,0,25,1
1708255863679,ENVR 102,C00,400791,Staff,23,0,25,2
1708255864206,ENVR 140,A01,400813,Siapno; Jacqueline A,12,0,15,3
1708255864206,ENVR 140,A02,400870,Siapno; Jacqueline A,15,0,15,0
1708255864206,ENVR 140,A03,400889,Siapno; Jacqueline A,15,0,15,0
1708255864206,ENVR 140,A04,400890,Siapno; Jacqueline A,15,0,15,0
1708255864732,ENVR 144,A01,400929,Herbst; Matthew,20,0,20,0
1708255865258,ERC 20,A00,400722,Evans; Ivan T,30,0,30,0
1708255865783,ESYS 103,A01,400931,Lerner; Amy M,32,0,34,2
1708255865783,ESYS 103,A02,400934,Lerner; Amy M,34,0,34,0
1708255865783,ESYS 103,A03,400938,Lerner; Amy M,28,0,34,6
1708255865783,ESYS 103,A04,400939,Lerner; Amy M,33,0,34,1
1708255865783,ESYS 103,A05,400940,Lerner; Amy M,34,0,34,0
1708255865783,ESYS 103,A06,400941,Lerner; Amy M,33,0,34,1
1708255866313,ESYS 187C,A01,400945,Hetherington; Elizabeth Dorsey,28,0,40,12
1708255866313,ESYS 187C,A02,400946,Hetherington; Elizabeth Dorsey,39,0,40,1
1708255866844,ETHN 3R,A01,400948,Streeby; Shelley,21,0,25,4
1708255866844,ETHN 3R,A02,401220,Streeby; Shelley,24,0,25,1
1708255866844,ETHN 3R,A03,401231,Streeby; Shelley,22,0,25,3
1708255866844,ETHN 3R,A04,401236,Streeby; Shelley,23,0,25,2
1708255866844,ETHN 3R,A05,401241,Streeby; Shelley,21,0,25,4
1708255866844,ETHN 3R,A06,401311,Streeby; Shelley,21,0,25,4
1708255866844,ETHN 3R,A07,401318,Streeby; Shelley,25,0,25,0
1708255866844,ETHN 3R,A08,401319,Streeby; Shelley,25,0,25,0
1708255866844,ETHN 3R,A09,401397,Streeby; Shelley,25,0,25,0
1708255866844,ETHN 3R,A10,401398,Streeby; Shelley,25,0,25,0
1708255866844,ETHN 3R,A11,401399,Streeby; Shelley,24,0,25,1
1708255866844,ETHN 3R,A12,401518,Streeby; Shelley,25,0,25,0
1708255866844,ETHN 3R,A13,401551,Streeby; Shelley,24,0,25,1
1708255866844,ETHN 3R,A14,401552,Streeby; Shelley,23,0,25,2
1708255867371,ETHN 30,A01,401554,Fuste; Jose Ignacio,24,0,25,1
1708255867371,ETHN 30,A02,401555,Fuste; Jose Ignacio,25,0,25,0
1708255867371,ETHN 30,A03,401556,Fuste; Jose Ignacio,25,0,25,0
1708255867371,ETHN 30,A04,401557,Fuste; Jose Ignacio,25,0,25,0
1708255867898,ETHN 100C,A00,401558,Museus; Samuel David,36,0,40,4
1708255868427,ETHN 101TV,A01,401560,Marez; Curtis F.,21,0,25,4
1708255868427,ETHN 101TV,A02,401564,Marez; Curtis F.,25,0,25,0
1708255868953,ETHN 108,A00,401584,Hankins; Sarah E.,25,0,29,4
1708255869482,ETHN 113A,A00,401657,Werner; Bradley T.,15,0,15,0
1708255870008,ETHN 114B,A00,401724,Frank; Ross H.,19,0,20,1
1708255870534,ETHN 120D,A01,401848,Alvarez; Luis A,8,0,10,2
1708255870534,ETHN 120D,A02,401853,Alvarez; Luis A,10,0,10,0
1708255871064,ETHN 125R,A00,401858,Sasaki; Christen T,39,0,50,11
1708255871591,ETHN 126,A00,401865,Tran; Ly Thi Hai,39,0,40,1
1708255872117,ETHN 127,A00,401866,Martin Sandino; Amanda Maria Yoland,24,0,25,1
1708255872646,ETHN 137,A00,401867,Martin Sandino; Amanda Maria Yoland,19,0,19,0
1708255873172,ETHN 139,A00,401992,Perreira; Christopher Michael,25,0,25,0
1708255873697,ETHN 143,A00,402059,Marez; Curtis F.,39,0,40,1
1708255874228,ETHN 144M,A00,402060,Jolivette; Andrew J,62,0,65,3
1708255874754,ETHN 150,A00,402158,Taylor-Garcia; Daphne,16,0,18,2
1708255875281,ETHN 153,A00,402160,Martinez-Matsuda; Veronica,24,0,25,1
1708255875808,ETHN 179,A00,402165,Richards; Stephanie F,23,0,25,2
1708255876335,ETHN 183,A00,402217,Steelman; Katherine Wallis,16,0,16,0
1708255876861,ETHN 186,A00,402313,Perez; Roy,15,0,15,0
1708255877388,ETHN 189,A00,479226,Museus; Samuel David,29,0,30,1
1708255877914,ETHN 196H,A00,402314,Espiritu; Yen,0,0,0,0
1708255877914,ETHN 196H,B00,402325,Perreira; Christopher Michael,0,0,0,0
1708255877914,ETHN 196H,C00,402344,Perez; Roy,0,0,0,0
1708255877914,ETHN 196H,D00,402345,Streeby; Shelley,0,0,0,0
1708255877914,ETHN 196H,E00,402346,Taylor-Garcia; Daphne,0,0,0,0
1708255878439,ETHN 200C,A00,402358,Fuste; Jose Ignacio,19,0,20,1
1708255878965,ETHN 230,A00,402359,Streeby; Shelley,16,0,20,4
1708255879493,ETHN 291,A00,402363,Perreira; Christopher Michael,16,0,20,4
1708255880018,EXPR 100,A00,477778,Staff,9999,0,9999,0
1708255880544,EXPR 105,A00,477779,Staff,9999,0,9999,0
1708255881068,EXPR 201,A00,477780,Staff,9999,0,9999,0
1708255881595,EXPR 205,A00,477781,Staff,9999,0,9999,0
1708255882125,FILM 87,A00,402794,Rahimi; Babak,19,0,20,1
1708255882125,FILM 87,B00,402796,Rahimi; Babak,20,0,20,0
1708255882125,FILM 87,C00,402821,Havis; Allan,19,0,20,1
1708255882656,FMPH 95,A00,481734,Larsen; Britta Ann,0,0,0,2
1708255883182,FMPH 101,A00,404648,Tan; Gene Brian,31,0,40,9
1708255883710,FMPH 102,A01,404692,Rana; Brinda Kanti,25,0,28,3
1708255883710,FMPH 102,A02,404714,Rana; Brinda Kanti,28,0,28,0
1708255883710,FMPH 102,B01,404739,Rana; Brinda Kanti,26,0,28,2
1708255883710,FMPH 102,B02,404746,Rana; Brinda Kanti,28,0,28,0
1708255884236,FMPH 110,A00,404747,Campbell; Chadwick Karl,52,0,55,3
1708255884236,FMPH 110,B00,404789,Zoumas-Morse; Christine E.,24,0,30,6
1708255884766,FMPH 120,A00,404792,Nguyen-Grozavu; France T.,48,0,60,12
1708255885293,FMPH 130,A00,404859,Gould; Carlos Francisco,49,0,55,6
1708255885293,FMPH 130,B00,479047,Ciborowski; Haley Minae,52,0,55,3
1708255885822,FMPH 155,A00,404864,Fielding-Miller; Rebecca,65,0,65,0
1708255886347,FMPH 161,A00,404865,Zoumas-Morse; Christine E.,27,0,35,8
1708255886877,FMPH 191,A00,404866,Eikey; Elizabeth Victoria,35,0,35,0
1708255887409,FMPH 194,A00,404938,Larsen; Britta Ann,0,0,0,0
1708255887409,FMPH 194,B00,404939,Marquez; Becky,0,0,0,0
1708255887409,FMPH 194,C00,404949,Nguyen-Grozavu; France T.,0,0,0,0
1708255887409,FMPH 194,D00,404950,Stone; Matthew David,0,0,0,0
1708255887409,FMPH 194,E00,404958,White; Anne Elizabeth Clar,0,0,0,0
1708255887409,FMPH 194,F00,404969,Zoumas-Morse; Christine E.,0,0,0,0
1708255887939,FMPH 223,A00,404977,Vaida; Florin,7,0,26,19
1708255888471,FMPH 225,A00,404978,Zou; Jingjing,0,0,0,0
1708255889001,FMPH 291,A00,404992,Salem; Rany Mansour,15,0,15,0
1708255889001,FMPH 291,C00,405005,Schwartzman; Armin,0,0,0,11
1708255889001,FMPH 291,D00,479113,Shadyab; Aladdin Hassan,0,0,0,0
1708255889001,FMPH 291,E00,479114,Shadyab; Aladdin Hassan,0,0,0,0
1708255889001,FMPH 291,F00,479115,Wynn; Adriane Michelle,0,0,0,3
1708255889001,FMPH 291,G00,479116,Xu; Ronghui,0,0,0,10
1708255889001,FMPH 291,H00,479119,Vaida; Florin,0,0,0,2
1708255889531,FPM 258C,A00,405129,Chen; Brian Hwa-Yang,11,0,15,4
1708255890058,FPM 259C,A00,405130,Nguyen; Annie Lu & Araneta; Maria Rosario Gorrez,4,0,5,1
1708255890588,FPM 278,A00,405131,Strong; David R,13,0,15,2
1708255891113,FPM 280C,A01,405133,Banegas; Matthew Patrick,10,0,10,0
1708255891638,FPM 296,001,464651,Johnson; Michelle Lee,49,0,50,1
1708255891638,FPM 296,002,464652,Staff,50,0,50,0
1708255891638,FPM 296,003,464653,Staff,50,0,50,0
1708255892166,FPM 297,001,479175,Vaida; Florin,9999,0,9999,0
1708255892166,FPM 297,002,494007,Strong; David R,9999,0,9999,0
1708255892166,FPM 297,003,494364,Bazzi; Angela Robertson,9999,0,9999,0
1708255892695,GLBH 20,A00,405134,Elwardani; Nile Regina,143,0,146,3
1708255893221,GLBH 100,A00,405135,Bhavsar; Radhika,68,0,70,2
1708255893221,GLBH 100,B00,477773,Villarino; Margarita,39,0,44,5
1708255893221,GLBH 100,C00,477855,Jenkins; Janis A.,20,0,20,0
1708255893221,GLBH 100,D00,481337,Mishra; Jyoti,40,0,40,0
1708255893747,GLBH 101,A00,405136,Sloane; Julia Kathryn,40,0,40,0
1708255894276,GLBH 107,A00,405137,Wilson; Brenda K,63,0,70,7
1708255894802,GLBH 111,A01,486865,Burgos; Jose L.,0,0,0,0
1708255894802,GLBH 111,B01,486867,Burgos; Jose L.,0,0,0,0
1708255895328,GLBH 114W,A00,405138,Walkover; Lillian B,17,0,17,0
1708255895858,GLBH 118,A00,405140,Wilson; Brenda K,31,0,32,1
1708255896384,GLBH 147,A00,405141,Stewart; Alexander B,40,0,40,0
1708255896909,GLBH 148,A00,405142,Olivas Hernandez; Olga Lid,93,0,100,7
1708255897438,GLBH 150B,A00,486855,Sanchez; Giselle,0,0,0,0
1708255897964,GLBH 181,A00,405154,Burgos; Jose L.,211,0,216,5
1708255898490,GLBH 215,A00,479241,Walkover; Lillian B,18,0,18,0
1708255899016,GLBH 260,A00,480722,Elwardani; Nile Regina,18,0,18,0
1708255899545,GSS 20,A00,405155,Siapno; Jacqueline A,25,0,30,5
1708255900072,GSS 25,A00,405156,Batarseh; Amanda Alicia,24,0,30,6
1708255900603,HDS 1,A01,405160,Reese; Clarissa Jane,25,0,25,0
1708255900603,HDS 1,A02,405168,Reese; Clarissa Jane,25,0,25,0
1708255900603,HDS 1,A03,405169,Reese; Clarissa Jane,22,0,25,3
1708255900603,HDS 1,A04,405170,Reese; Clarissa Jane,24,0,25,1
1708255900603,HDS 1,A05,405171,Reese; Clarissa Jane,23,0,25,2
1708255900603,HDS 1,A06,405172,Reese; Clarissa Jane,24,0,25,1
1708255900603,HDS 1,A07,405173,Reese; Clarissa Jane,24,0,25,1
1708255901130,HDS 60,A01,405175,Warstadt; Melissa Fawn,34,0,35,1
1708255901130,HDS 60,A02,405176,Warstadt; Melissa Fawn,33,0,35,2
1708255901656,HDS 95,A00,405177,Staff,38,0,40,2
1708255902187,HDS 120,A00,405178,Staff,0,0,0,0
1708255902714,HDS 122,A00,405179,Rodriguez; Victoria Calip,64,0,75,11
1708255903243,HDS 150,A00,405180,Staff,20,0,20,0
1708255903243,HDS 150,B00,405181,Staff,20,0,20,0
1708255903243,HDS 150,C00,405182,Staff,20,0,20,0
1708255903769,HDS 181,A01,405185,Bjorklund; Peter,30,0,30,0
1708255904295,HDS 191,A01,405187,Reese; Clarissa Jane,40,0,40,0
1708255904295,HDS 191,B01,405194,Staff,25,0,25,0
1708255904820,HIAF 113,A00,403736,Prestholdt; Jeremy,74,0,75,1
1708255905345,HIAF 114,A00,403738,Gyamfi; Bright,49,0,50,1
1708255905875,HIEA 132,A00,403740,Kletzer; Benjamin Nathan,25,0,30,5
1708255906401,HIEA 154,A00,403741,Henry; Todd A.,62,0,64,2
1708255906931,HIEU 139,A00,403742,Strasser; Ulrike,52,0,56,4
1708255907461,HIEU 171,A00,403743,Hansen; Jan Eric,62,0,64,2
1708255907986,HIEU 176,A00,403744,Hertz; Deborah,14,0,15,1
1708255908515,HIEU 183,A00,403800,Gallant; Thomas W.,15,0,15,0
1708255909041,HIEU 276,A00,403862,Hertz; Deborah,0,0,0,0
1708255909570,HIGL 127,A00,403802,Ivey; James Alexander,56,0,56,0
1708255910096,HIGR 201,A00,494372,Pineda De Avila; Nydia,9,0,10,1
1708255910624,HIGR 205,A00,403863,Strasser; Ulrike,11,0,15,4
1708255911149,HIGR 217C,A00,403864,Lu; Weijing,9,0,10,1
1708255911675,HIGR 239,A00,403865,Serlin; David,4,0,5,1
1708255912270,HIGR 240,A00,403875,Gates; Kelly,2,0,5,3
1708255912797,HILA 101,A00,403818,LeNeave; Kimiko Nicole,62,0,64,2
1708255913324,HILA 119,A00,403819,Kozameh; Sara J,47,0,50,3
1708255913851,HILA 144,A00,403821,Kozameh; Sara J,50,0,50,0
1708255914376,HILD 2C,A01,402843,Hendrickson; Gerald M.,31,0,32,1
1708255914376,HILD 2C,A02,403030,Hendrickson; Gerald M.,31,0,32,1
1708255914376,HILD 2C,A03,403042,Hendrickson; Gerald M.,32,0,32,0
1708255914376,HILD 2C,A04,403048,Hendrickson; Gerald M.,30,0,32,2
1708255914376,HILD 2C,A05,403049,Hendrickson; Gerald M.,32,0,32,0
1708255914376,HILD 2C,A06,403098,Hendrickson; Gerald M.,32,0,32,0
1708255914909,HILD 7C,A01,403501,Bermudez; Rosie Cano,27,0,32,5
1708255914909,HILD 7C,A02,403513,Bermudez; Rosie Cano,30,0,32,2
1708255914909,HILD 7C,A03,403570,Bermudez; Rosie Cano,32,0,32,0
1708255914909,HILD 7C,A04,403572,Bermudez; Rosie Cano,32,0,32,0
1708255914909,HILD 7C,A05,403587,Bermudez; Rosie Cano,32,0,32,0
1708255914909,HILD 7C,A06,403588,Bermudez; Rosie Cano,32,0,32,0
1708255914909,HILD 7C,A07,403589,Bermudez; Rosie Cano,29,0,32,3
1708255914909,HILD 7C,A08,403590,Bermudez; Rosie Cano,32,0,32,0
1708255914909,HILD 7C,A09,403601,Bermudez; Rosie Cano,30,0,32,2
1708255914909,HILD 7C,A10,403602,Bermudez; Rosie Cano,32,0,32,0
1708255914909,HILD 7C,A11,403603,Bermudez; Rosie Cano,32,0,32,0
1708255914909,HILD 7C,A12,403604,Bermudez; Rosie Cano,32,0,32,0
1708255915435,HILD 12,A01,403607,Henry; Todd A.,32,0,32,0
1708255915435,HILD 12,A02,403608,Henry; Todd A.,31,0,32,1
1708255915435,HILD 12,A03,403609,Henry; Todd A.,32,0,32,0
1708255915435,HILD 12,A04,403699,Henry; Todd A.,32,0,32,0
1708255915435,HILD 12,A05,403700,Henry; Todd A.,32,0,32,0
1708255915435,HILD 12,A06,403701,Henry; Todd A.,32,0,32,0
1708255915961,HILD 30,A01,403703,Soleiman; Matthew Teymour,29,0,32,3
1708255915961,HILD 30,A02,403704,Soleiman; Matthew Teymour,30,0,32,2
1708255916489,HINE 118,A00,403822,Kayali; Hasan,50,0,50,0
1708255917015,HISC 119,A00,403823,Golan; Tal,26,0,30,4
1708255917541,HISC 123,A00,403839,Pineda De Avila; Nydia,44,0,50,6
1708255918070,HITO 87,A00,403707,Patterson; Patrick H.,15,0,15,0
1708255918070,HITO 87,B00,403709,Patterson; Patrick H.,15,0,15,0
1708255918070,HITO 87,C00,403735,Schneewind; Sarah,15,0,15,0
1708255918596,HITO 100,B00,403841,Klann; Mary Cameron,24,0,25,1
1708255919123,HITO 170,A00,403842,Watts; Edward J.,8,0,10,2
1708255919652,HITO 193,A00,455333,Hill; Seth J,0,0,0,0
1708255920178,HIUS 114A,A00,403843,Lewandoski; Julia Mavis,52,0,56,4
1708255920708,HIUS 120D,A01,403854,Alvarez; Luis A,8,0,10,2
1708255920708,HIUS 120D,A02,403855,Alvarez; Luis A,10,0,10,0
1708255921234,HIUS 136,A00,403857,Martinez-Matsuda; Veronica,21,0,25,4
1708255921762,HIUS 144,A00,403858,Martinez-Matsuda; Veronica,55,0,56,1
1708255921762,HIUS 144,B00,403859,Vandevelde; Kenneth Joseph,54,0,56,2
1708255921762,HIUS 144,C00,403860,Klann; Mary Cameron,52,0,56,4
1708255921762,HIUS 144,D00,403861,Lewandoski; Julia Mavis,55,0,56,1
1708255922311,HUM 2,A01,422723,Watts; Edward J.,16,0,16,0
1708255922311,HUM 2,A02,422735,Watts; Edward J.,15,0,16,1
1708255922311,HUM 2,A03,422736,Watts; Edward J.,15,0,16,1
1708255922311,HUM 2,A04,422737,Watts; Edward J.,16,0,16,0
1708255922311,HUM 2,A05,422738,Watts; Edward J.,15,0,16,1
1708255922311,HUM 2,A06,422760,Watts; Edward J.,15,0,16,1
1708255922311,HUM 2,A07,422778,Watts; Edward J.,16,0,16,0
1708255922311,HUM 2,A08,422793,Watts; Edward J.,16,0,16,0
1708255922311,HUM 2,A09,422794,Watts; Edward J.,16,0,16,0
1708255922311,HUM 2,A10,422795,Watts; Edward J.,16,0,16,0
1708255922311,HUM 2,B01,422805,Markman; Kristina,13,0,16,3
1708255922311,HUM 2,B02,422806,Markman; Kristina,14,0,16,2
1708255922311,HUM 2,B03,422807,Markman; Kristina,14,0,16,2
1708255922311,HUM 2,B04,422808,Markman; Kristina,16,0,16,0
1708255922311,HUM 2,B05,422809,Markman; Kristina,16,0,16,0
1708255922311,HUM 2,B06,422842,Markman; Kristina,16,0,16,0
1708255922311,HUM 2,B07,422843,Markman; Kristina,15,0,16,1
1708255922311,HUM 2,B08,422848,Markman; Kristina,16,0,16,0
1708255922311,HUM 2,B09,422850,Markman; Kristina,15,0,16,1
1708255922311,HUM 2,B10,422851,Markman; Kristina,12,0,16,4
1708255922311,HUM 2,B11,422852,Markman; Kristina,15,0,16,1
1708255922311,HUM 2,B12,422853,Markman; Kristina,16,0,16,0
1708255922311,HUM 2,C01,422855,Rodriguez; Bretton Sigfred,15,0,16,1
1708255922311,HUM 2,C02,422856,Rodriguez; Bretton Sigfred,16,0,16,0
1708255922311,HUM 2,C03,422859,Rodriguez; Bretton Sigfred,15,0,16,1
1708255922311,HUM 2,C04,423106,Rodriguez; Bretton Sigfred,12,0,16,4
1708255922311,HUM 2,C05,423107,Rodriguez; Bretton Sigfred,15,0,16,1
1708255922311,HUM 2,C06,423108,Rodriguez; Bretton Sigfred,14,0,16,2
1708255922311,HUM 2,C07,423109,Rodriguez; Bretton Sigfred,15,0,16,1
1708255922311,HUM 2,C08,423110,Rodriguez; Bretton Sigfred,15,0,16,1
1708255922311,HUM 2,C09,423133,Rodriguez; Bretton Sigfred,14,0,16,2
1708255922311,HUM 2,C10,423134,Rodriguez; Bretton Sigfred,14,0,16,2
1708255922311,HUM 2,C11,423135,Rodriguez; Bretton Sigfred,16,0,16,0
1708255922311,HUM 2,C12,423136,Rodriguez; Bretton Sigfred,15,0,16,1
1708255922311,HUM 2,C13,423137,Rodriguez; Bretton Sigfred,16,0,16,0
1708255922311,HUM 2,C14,423138,Rodriguez; Bretton Sigfred,16,0,16,0
1708255922311,HUM 2,D01,423140,West; Geoffrey Scott,13,0,16,3
1708255922311,HUM 2,D02,423141,West; Geoffrey Scott,15,0,16,1
1708255922311,HUM 2,D03,423142,West; Geoffrey Scott,15,0,16,1
1708255922311,HUM 2,D04,423143,West; Geoffrey Scott,14,0,16,2
1708255922311,HUM 2,D05,423144,West; Geoffrey Scott,16,0,16,0
1708255922311,HUM 2,D06,423145,West; Geoffrey Scott,16,0,16,0
1708255922311,HUM 2,D07,423146,West; Geoffrey Scott,16,0,16,0
1708255922311,HUM 2,D08,423158,West; Geoffrey Scott,16,0,16,0
1708255922311,HUM 2,D09,423169,West; Geoffrey Scott,16,0,16,0
1708255922311,HUM 2,D10,423174,West; Geoffrey Scott,16,0,16,0
1708255922311,HUM 2,D11,423175,West; Geoffrey Scott,16,0,16,0
1708255922311,HUM 2,D12,423179,West; Geoffrey Scott,15,0,16,1
1708255922311,HUM 2,D13,423188,West; Geoffrey Scott,15,0,16,1
1708255922311,HUM 2,D14,423204,West; Geoffrey Scott,16,0,16,0
1708255922840,HUM 5,A01,423221,Lyon; Antony J.,26,0,30,4
1708255922840,HUM 5,A02,423232,Lyon; Antony J.,24,0,30,6
1708255922840,HUM 5,A03,423237,Lyon; Antony J.,18,0,30,12
1708255922840,HUM 5,A04,423240,Lyon; Antony J.,25,0,30,5
1708255922840,HUM 5,A05,423242,Lyon; Antony J.,28,0,30,2
1708255922840,HUM 5,A06,423244,Lyon; Antony J.,23,0,30,7
1708255922840,HUM 5,A07,423247,Lyon; Antony J.,27,0,30,3
1708255922840,HUM 5,A08,423254,Lyon; Antony J.,27,0,30,3
1708255922840,HUM 5,B01,423286,Patterson; Patrick H.,28,0,30,2
1708255922840,HUM 5,B02,423291,Patterson; Patrick H.,29,0,30,1
1708255922840,HUM 5,B03,423294,Patterson; Patrick H.,28,0,30,2
1708255922840,HUM 5,B04,423297,Patterson; Patrick H.,29,0,30,1
1708255922840,HUM 5,B05,423313,Patterson; Patrick H.,30,0,30,0
1708255922840,HUM 5,B06,423318,Patterson; Patrick H.,30,0,30,0
1708255922840,HUM 5,B07,423362,Patterson; Patrick H.,29,0,30,1
1708255922840,HUM 5,B08,423363,Patterson; Patrick H.,29,0,30,1
1708255922840,HUM 5,C01,423365,Caldwell; Michael Alan,22,0,30,8
1708255922840,HUM 5,C02,423474,Caldwell; Michael Alan,24,0,30,6
1708255922840,HUM 5,C03,423528,Caldwell; Michael Alan,30,0,30,0
1708255922840,HUM 5,C04,423529,Caldwell; Michael Alan,27,0,30,3
1708255922840,HUM 5,C05,423545,Caldwell; Michael Alan,30,0,30,0
1708255922840,HUM 5,C06,423546,Caldwell; Michael Alan,30,0,30,0
1708255922840,HUM 5,C07,423547,Caldwell; Michael Alan,29,0,30,1
1708255922840,HUM 5,C08,423548,Caldwell; Michael Alan,28,0,30,2
1708255923370,INTL 101,A01,404350,Day; Joel Keith,23,0,25,2
1708255923370,INTL 101,A02,404356,Day; Joel Keith,25,0,25,0
1708255923370,INTL 101,A03,404357,Day; Joel Keith,24,0,25,1
1708255923370,INTL 101,A04,404360,Day; Joel Keith,25,0,25,0
1708255923896,INTL 102,A01,404375,Fisk; David Lee,25,0,25,0
1708255923896,INTL 102,A02,404376,Fisk; David Lee,22,0,25,3
1708255923896,INTL 102,A03,404377,Fisk; David Lee,20,0,25,5
1708255923896,INTL 102,A04,404381,Fisk; David Lee,25,0,25,0
1708255924423,INTL 190,A00,404396,Samphantharak; Krislert,24,0,25,1
1708255924423,INTL 190,B00,404402,McIntosh; Justin Daniel,24,0,25,1
1708255924423,INTL 190,C00,404403,Vos; Stacie N.,24,0,25,1
1708255924423,INTL 190,D00,404404,Nadkarni; Vidya,24,0,25,1
1708255924423,INTL 190,E00,404407,Scott; Jeffrey F,25,0,25,0
1708255924423,INTL 190,F00,404409,Auerbach; Bradford C,25,0,25,0
1708255924423,INTL 190,G00,404442,Auerbach; Bradford C,25,0,25,0
1708255924423,INTL 190,H00,404465,Segui; Alan S,25,0,25,0
1708255924423,INTL 190,I00,404481,Segui; Alan S,25,0,25,0
1708255924958,JAPN 10C,A01,403881,Iwamoto; Naoki,15,0,15,0
1708255924958,JAPN 10C,B01,403884,McKee; Mayumi Mochizuki,15,0,15,0
1708255924958,JAPN 10C,C01,403887,Sato; Kyoko,10,0,10,0
1708255924958,JAPN 10C,C02,403888,Sato; Kyoko,10,0,10,0
1708255924958,JAPN 10C,D01,403890,Inada; Minori,8,0,10,2
1708255924958,JAPN 10C,D02,403891,Inada; Minori,10,0,10,0
1708255924958,JAPN 10C,E01,403893,Sato; Kyoko,10,0,10,0
1708255924958,JAPN 10C,E02,403894,Sato; Kyoko,10,0,10,0
1708255924958,JAPN 10C,F01,403896,McKee; Mayumi Mochizuki,10,0,10,0
1708255924958,JAPN 10C,F02,403897,McKee; Mayumi Mochizuki,10,0,10,0
1708255924958,JAPN 10C,G01,403899,Homma; Kunihiko,10,0,10,0
1708255924958,JAPN 10C,G02,403900,Homma; Kunihiko,10,0,10,0
1708255924958,JAPN 10C,H01,403902,Maruyama; Rie,10,0,10,0
1708255924958,JAPN 10C,H02,403903,Maruyama; Rie,9,0,10,1
1708255924958,JAPN 10C,I01,403905,Inada; Minori,10,0,10,0
1708255924958,JAPN 10C,I02,403906,Inada; Minori,9,0,10,1
1708255924958,JAPN 10C,J01,403915,Iwamoto; Naoki,10,0,10,0
1708255924958,JAPN 10C,J02,403916,Iwamoto; Naoki,9,0,10,1
1708255924958,JAPN 10C,K01,403918,Ross; Kayoko F,10,0,10,0
1708255924958,JAPN 10C,K02,403928,Ross; Kayoko F,10,0,10,0
1708255924958,JAPN 10C,L01,403935,Homma; Kunihiko,9,0,10,1
1708255924958,JAPN 10C,L02,403936,Homma; Kunihiko,10,0,10,0
1708255924958,JAPN 10C,M02,403939,Kamioka; Sachiko,13,0,15,2
1708255924958,JAPN 10C,N01,479041,Iwamoto; Naoki,15,0,15,0
1708255925488,JAPN 10CR,A01,403982,Inada; Minori,12,0,12,0
1708255925488,JAPN 10CR,A02,403983,Inada; Minori,12,0,12,0
1708255926016,JAPN 20C,A01,403988,Homma; Kunihiko,10,0,12,2
1708255926016,JAPN 20C,B02,404029,Kamioka; Sachiko,10,0,12,2
1708255926016,JAPN 20C,C01,404033,Takeda; Izumi,8,0,12,4
1708255926016,JAPN 20C,D02,404114,Kamioka; Sachiko,11,0,12,1
1708255926016,JAPN 20C,E01,404135,Simpson; Junko Tokuda,12,0,12,0
1708255926547,JAPN 130C,A01,404144,Maruyama; Rie,9,0,9,0
1708255926547,JAPN 130C,A02,404145,Maruyama; Rie,9,0,9,0
1708255926547,JAPN 130C,B01,404147,Simpson; Junko Tokuda,8,0,9,1
1708255926547,JAPN 130C,B02,404148,Simpson; Junko Tokuda,9,0,9,0
1708255927073,JAPN 135C,A00,404176,Ross; Kayoko F,16,0,16,0
1708255927073,JAPN 135C,B00,404253,Takeda; Izumi,14,0,16,2
1708255927599,JAPN 140C,A00,404255,Sato; Kyoko,18,0,20,2
1708255928130,JAPN 150C,A00,404258,McKee; Mayumi Mochizuki,14,0,14,0
1708255928655,JAPN 190,A00,404260,Miyao; Daisuke,17,0,20,3
1708255929182,JAPN 196B,001,487237,Turner; Christena L.,9999,0,9999,0
1708255929707,JWSP 3,A01,404485,Shuster; Alana,20,0,20,0
1708255930233,LATI 10,A01,405201,Kennemore; Amy Michelle,27,0,30,3
1708255930233,LATI 10,A02,405202,Kennemore; Amy Michelle,27,0,30,3
1708255930233,LATI 10,A03,405208,Kennemore; Amy Michelle,28,0,30,2
1708255930762,LATI 50,A01,405214,Kokinis; Troy Andreas,34,0,35,1
1708255930762,LATI 50,A02,405215,Kokinis; Troy Andreas,34,0,35,1
1708255931289,LATI 130,A01,482880,Alvarez; Camila Huerta,29,0,30,1
1708255931815,LATI 160,A01,477482,Kokinis; Troy Andreas,30,0,30,0
1708255932345,LATI 180,A00,405221,Kennemore; Amy Michelle,28,0,30,2
1708255932345,LATI 180,B00,405222,Mostajo; Lorena,30,0,30,0
1708255932872,LIAB 1C,A00,405278,Saab; Dima,13,0,14,1
1708255932872,LIAB 1C,B00,405279,Saab; Dima,11,0,14,3
1708255933402,LIAB 1CX,A00,405281,Akjeje; Abdelhak,19,0,20,1
1708255933402,LIAB 1CX,B00,405291,Akjeje; Abdelhak,20,0,20,0
1708255933929,LIAB 1F,A00,482814,El Cheddadi; Youniss,14,0,14,0
1708255934455,LIDS 19,001,492979,Goodall; Grant Todd,9999,0,9999,0
1708255934455,LIDS 19,002,492980,Goodall; Grant Todd,9999,0,9999,0
1708255934455,LIDS 19,003,492981,Goodall; Grant Todd,9999,0,9999,0
1708255934455,LIDS 19,004,492982,Goodall; Grant Todd,9999,0,9999,0
1708255934455,LIDS 19,005,492983,Goodall; Grant Todd,9999,0,9999,0
1708255934455,LIDS 19,006,492984,Goodall; Grant Todd,9999,0,9999,0
1708255934455,LIDS 19,007,492985,Goodall; Grant Todd,9999,0,9999,0
1708255934455,LIDS 19,008,492986,Goodall; Grant Todd,9999,0,9999,0
1708255934455,LIDS 19,009,492987,Goodall; Grant Todd,9999,0,9999,0
1708255934455,LIDS 19,010,492988,Goodall; Grant Todd,9999,0,9999,0
1708255934455,LIDS 19,011,492989,Goodall; Grant Todd,9999,0,9999,0
1708255934455,LIDS 19,012,492990,Goodall; Grant Todd,9999,0,9999,0
1708255934985,LIFR 1A,A00,405299,Van Moer; Vinciane G,13,0,14,1
1708255934985,LIFR 1A,B00,405300,Van Moer; Vinciane G,13,0,14,1
1708255934985,LIFR 1A,C00,405301,Van Moer; Vinciane G,13,0,14,1
1708255934985,LIFR 1A,D00,405307,Van Moer; Vinciane G,14,0,14,0
1708255935511,LIFR 1AX,A00,405308,Van Moer; Vinciane G,27,0,28,1
1708255935511,LIFR 1AX,B00,405309,Van Moer; Vinciane G,27,0,28,1
1708255936040,LIFR 1C,A00,405310,Van Moer; Vinciane G,14,0,14,0
1708255936040,LIFR 1C,B00,405311,Van Moer; Vinciane G,12,0,14,2
1708255936040,LIFR 1C,C00,405325,Van Moer; Vinciane G,13,0,14,1
1708255936040,LIFR 1C,D00,405326,Van Moer; Vinciane G,11,0,14,3
1708255936566,LIFR 1CX,A00,405332,Van Moer; Vinciane G,25,0,28,3
1708255936566,LIFR 1CX,B00,405333,Van Moer; Vinciane G,27,0,28,1
1708255937092,LIFR 1D,A00,405334,Van Moer; Vinciane G,13,0,14,1
1708255937092,LIFR 1D,B00,405335,Van Moer; Vinciane G,13,0,14,1
1708255937092,LIFR 1D,C00,405336,Van Moer; Vinciane G,13,0,14,1
1708255937092,LIFR 1D,D00,405337,Van Moer; Vinciane G,13,0,14,1
1708255937621,LIFR 1DX,A00,405338,Van Moer; Vinciane G,25,0,28,3
1708255937621,LIFR 1DX,B00,405394,Van Moer; Vinciane G,27,0,28,1
1708255938145,LIFR 11,001,405395,Goodall; Grant Todd,999,0,999,0
1708255938675,LIGM 1C,A00,405398,Fischer-Grunski; Eva K,12,0,14,2
1708255938675,LIGM 1C,B00,405400,Fischer-Grunski; Eva K,13,0,14,1
1708255938675,LIGM 1C,C00,405403,Fischer-Grunski; Eva K,13,0,14,1
1708255938675,LIGM 1C,D00,405404,Fischer-Grunski; Eva K,13,0,14,1
1708255939201,LIGM 1CX,A00,405407,Fischer-Grunski; Eva K,27,0,28,1
1708255939201,LIGM 1CX,B00,405408,Fischer-Grunski; Eva K,26,0,28,2
1708255939728,LIGM 11,001,405464,Goodall; Grant Todd,999,0,999,0
1708255940253,LIGN 8,A00,411133,McIntosh; Justin Daniel,232,0,240,8
1708255940779,LIGN 17,A00,411141,Kehler; Andrew Scott,287,0,300,13
1708255941307,LIGN 101,A01,411144,Staff,28,0,30,2
1708255941307,LIGN 101,A02,411147,Staff,29,0,30,1
1708255941307,LIGN 101,A03,411154,Staff,27,0,30,3
1708255941307,LIGN 101,A04,411163,Staff,29,0,30,1
1708255941833,LIGN 120,A01,411165,Ackerman; Farrell,28,0,30,2
1708255941833,LIGN 120,A02,411177,Ackerman; Farrell,23,0,27,4
1708255942363,LIGN 130,A01,411223,Staff,29,0,30,1
1708255942363,LIGN 130,A02,411231,Staff,30,0,30,0
1708255942363,LIGN 130,A03,411232,Staff,29,0,30,1
1708255942890,LIGN 141,A00,411276,Rose; Sharon,37,0,40,3
1708255943416,LIGN 144,A00,411277,Lott; Margaret S.,22,0,24,2
1708255943944,LIGN 148,A00,411278,Mayberry; Rachel,71,0,75,4
1708255944469,LIGN 165,A00,411279,Bergen; Leon,41,0,70,29
1708255944999,LIGN 168,A01,411281,Styler; William Francis,65,0,70,5
1708255945525,LIGN 175,A00,482816,Rodriguez Aispuro; Alejandro,35,0,40,5
1708255946050,LIGN 230,A00,411293,Caponigro; Ivano,19,0,20,1
1708255946577,LIGN 238,A00,411308,Bergen; Benjamin,20,0,20,0
1708255947105,LIGN 252,A00,411309,Bergen; Leon,28,0,30,2
1708255947632,LIGN 256,A00,411310,Nakashole; Ndapandula,0,0,5,5
1708255948160,LIGN 272,A00,482887,Kluender; Robert,10,0,10,0
1708255948685,LIHL 112P,A00,405228,Pagkalinawan; Leticia Cant,27,0,28,1
1708255949211,LIHL 114P,A00,405229,Nguyen; Hoan Thi,26,0,28,2
1708255949739,LIHL 117P,A00,405256,Sadegholvad; Elham,27,0,28,1
1708255950265,LIHL 118,A00,405257,Chen; Areana Yen,28,0,28,0
1708255950793,LIHL 124P,A00,405262,Nguyen; Hoan Thi,28,0,28,0
1708255951319,LIHL 132P,A00,405263,Pagkalinawan; Leticia Cant,28,0,28,0
1708255951847,LIHL 134P,A00,405269,Nguyen; Hoan Thi,28,0,28,0
1708255952373,LIHL 138,A00,405270,Chen; Areana Yen,27,0,28,1
1708255952902,LIIT 1C,A00,405465,Carnelos; Chiara,12,0,14,2
1708255952902,LIIT 1C,B00,405466,Carnelos; Chiara,14,0,14,0
1708255953428,LIIT 1CX,A00,405594,Carnelos; Chiara,28,0,28,0
1708255953958,LIPO 1C,A00,405595,Paladini; Denise,13,0,14,1
1708255953958,LIPO 1C,B00,405596,Paladini; Denise,14,0,14,0
1708255954484,LIPO 1CX,A00,405597,De Abreu; Cassia,28,0,28,0
1708255955009,LISL 1A,C00,405600,Lott; Margaret S.,13,0,14,1
1708255955009,LISL 1A,D00,405601,Lott; Margaret S.,10,0,14,4
1708255955009,LISL 1A,E00,405602,Lott; Margaret S.,13,0,14,1
1708255955009,LISL 1A,F00,405603,Lott; Margaret S.,13,0,14,1
1708255955537,LISL 1AR,A00,480605,Lott; Margaret S.,13,0,15,2
1708255955537,LISL 1AR,B00,480606,Lott; Margaret S.,14,0,15,1
1708255956066,LISL 1AX,A00,405754,Lott; Margaret S.,26,0,28,2
1708255956066,LISL 1AX,B00,405755,Lott; Margaret S.,23,0,28,5
1708255956593,LISL 1C,A00,405776,Lott; Margaret S.,13,0,14,1
1708255956593,LISL 1C,B00,405779,Lott; Margaret S.,14,0,14,0
1708255956593,LISL 1C,C00,405785,Lott; Margaret S.,14,0,14,0
1708255956593,LISL 1C,D00,405787,Lott; Margaret S.,9,0,14,5
1708255956593,LISL 1C,E00,405827,Lott; Margaret S.,12,0,14,2
1708255956593,LISL 1C,F00,405830,Lott; Margaret S.,13,0,14,1
1708255957118,LISL 1CX,A00,405844,Lott; Margaret S.,25,0,28,3
1708255957118,LISL 1CX,B00,405848,Lott; Margaret S.,25,0,28,3
1708255957118,LISL 1CX,C00,405849,Lott; Margaret S.,28,0,28,0
1708255957648,LISL 1D,A00,405850,Lott; Margaret S.,8,0,14,6
1708255957648,LISL 1D,B00,405851,Lott; Margaret S.,13,0,14,1
1708255957648,LISL 1D,C00,405852,Lott; Margaret S.,10,0,14,4
1708255958174,LISL 1DX,A00,405854,Lott; Margaret S.,17,0,22,5
1708255958174,LISL 1DX,B00,405855,Lott; Margaret S.,18,0,22,4
1708255958704,LISP 1A,001,405856,Munoz Sanchez; Alicia,11,0,14,3
1708255958704,LISP 1A,002,405857,Munoz Sanchez; Alicia,13,0,14,1
1708255958704,LISP 1A,003,405858,Munoz Sanchez; Alicia,14,0,14,0
1708255958704,LISP 1A,004,405861,Munoz Sanchez; Alicia,14,0,14,0
1708255959231,LISP 1AX,001,405862,Munoz Sanchez; Alicia,28,0,28,0
1708255959231,LISP 1AX,002,405863,Munoz Sanchez; Alicia,25,0,28,3
1708255959757,LISP 1C,001,405864,Munoz Sanchez; Alicia,13,0,14,1
1708255959757,LISP 1C,002,405865,Munoz Sanchez; Alicia,12,0,14,2
1708255959757,LISP 1C,003,405879,Munoz Sanchez; Alicia,12,0,14,2
1708255959757,LISP 1C,004,405880,Munoz Sanchez; Alicia,13,0,14,1
1708255959757,LISP 1C,005,405881,Munoz Sanchez; Alicia,12,0,14,2
1708255959757,LISP 1C,006,405882,Munoz Sanchez; Alicia,12,0,14,2
1708255959757,LISP 1C,007,405904,Munoz Sanchez; Alicia,14,0,14,0
1708255959757,LISP 1C,008,405905,Munoz Sanchez; Alicia,14,0,14,0
1708255959757,LISP 1C,009,405908,Munoz Sanchez; Alicia,14,0,14,0
1708255959757,LISP 1C,010,405917,Munoz Sanchez; Alicia,13,0,14,1
1708255960284,LISP 1CX,001,405922,Munoz Sanchez; Alicia,24,0,28,4
1708255960284,LISP 1CX,002,405990,Munoz Sanchez; Alicia,26,0,28,2
1708255960284,LISP 1CX,003,406007,Munoz Sanchez; Alicia,27,0,28,1
1708255960284,LISP 1CX,004,406008,Munoz Sanchez; Alicia,25,0,28,3
1708255960284,LISP 1CX,005,406015,Munoz Sanchez; Alicia,26,0,28,2
1708255960814,LISP 1D,001,406016,Munoz Sanchez; Alicia,12,0,14,2
1708255960814,LISP 1D,002,406017,Munoz Sanchez; Alicia,13,0,14,1
1708255960814,LISP 1D,003,406018,Munoz Sanchez; Alicia,14,0,14,0
1708255960814,LISP 1D,004,406019,Munoz Sanchez; Alicia,11,0,14,3
1708255960814,LISP 1D,005,406020,Munoz Sanchez; Alicia,13,0,14,1
1708255960814,LISP 1D,006,406021,Munoz Sanchez; Alicia,10,0,14,4
1708255960814,LISP 1D,007,406022,Munoz Sanchez; Alicia,12,0,14,2
1708255960814,LISP 1D,008,406023,Munoz Sanchez; Alicia,13,0,14,1
1708255960814,LISP 1D,009,406024,Munoz Sanchez; Alicia,11,0,14,3
1708255960814,LISP 1D,010,406025,Munoz Sanchez; Alicia,12,0,14,2
1708255960814,LISP 1D,011,406026,Munoz Sanchez; Alicia,13,0,14,1
1708255960814,LISP 1D,012,406027,Munoz Sanchez; Alicia,13,0,14,1
1708255960814,LISP 1D,013,406028,Munoz Sanchez; Alicia,12,0,14,2
1708255960814,LISP 1D,014,406029,Munoz Sanchez; Alicia,12,0,14,2
1708255960814,LISP 1D,015,406030,Munoz Sanchez; Alicia,10,0,14,4
1708255960814,LISP 1D,016,406031,Munoz Sanchez; Alicia,14,0,14,0
1708255960814,LISP 1D,017,406032,Munoz Sanchez; Alicia,14,0,14,0
1708255960814,LISP 1D,018,406033,Munoz Sanchez; Alicia,12,0,14,2
1708255960814,LISP 1D,019,406034,Munoz Sanchez; Alicia,13,0,14,1
1708255960814,LISP 1D,020,406035,Munoz Sanchez; Alicia,14,0,14,0
1708255960814,LISP 1D,021,406036,Munoz Sanchez; Alicia,13,0,14,1
1708255960814,LISP 1D,022,406037,Munoz Sanchez; Alicia,14,0,14,0
1708255960814,LISP 1D,023,406038,Munoz Sanchez; Alicia,14,0,14,0
1708255960814,LISP 1D,024,406039,Munoz Sanchez; Alicia,13,0,14,1
1708255961348,LISP 1DX,001,406040,Munoz Sanchez; Alicia,28,0,28,0
1708255961348,LISP 1DX,002,406041,Munoz Sanchez; Alicia,27,0,28,1
1708255961348,LISP 1DX,003,406127,Munoz Sanchez; Alicia,24,0,28,4
1708255961348,LISP 1DX,004,406128,Munoz Sanchez; Alicia,17,0,28,11
1708255961348,LISP 1DX,005,406418,Munoz Sanchez; Alicia,24,0,28,4
1708255961348,LISP 1DX,006,406536,Munoz Sanchez; Alicia,27,0,28,1
1708255961348,LISP 1DX,007,406561,Munoz Sanchez; Alicia,23,0,28,5
1708255961348,LISP 1DX,008,406576,Munoz Sanchez; Alicia,25,0,28,3
1708255961348,LISP 1DX,009,406679,Munoz Sanchez; Alicia,28,0,28,0
1708255961348,LISP 1DX,010,406691,Munoz Sanchez; Alicia,26,0,28,2
1708255961348,LISP 1DX,011,406692,Munoz Sanchez; Alicia,28,0,28,0
1708255961348,LISP 1DX,012,406693,Munoz Sanchez; Alicia,28,0,28,0
1708255961878,LISP 17,001,406694,Munoz Sanchez; Alicia,18,0,20,2
1708255962404,LISP 18,001,406695,Munoz Sanchez; Alicia,20,0,20,0
1708255962932,LTAM 105,A00,412520,Ruiz; Ariana,28,0,40,12
1708255963458,LTCH 101,A00,479214,Zhu; Ping,39,0,40,1
1708255963986,LTCS 87,A00,492906,Nguyen; Hoang Tan,20,0,20,0
1708255963986,LTCS 87,B00,492907,Nguyen; Hoang Tan,20,0,20,0
1708255964512,LTCS 150,A00,412543,Liao; Ping H,39,0,40,1
1708255965038,LTCS 225,A00,412819,Mendoza; Andrea,14,0,15,1
1708255965623,LTCS 250,A00,412821,Lee; Jin-Kyung,15,0,15,0
1708255966148,LTEA 110B,A00,412548,Liao; Ping H,60,0,60,0
1708255966677,LTEA 120A,A00,479216,Zhu; Ping,36,0,40,4
1708255967202,LTEA 120C,A00,412552,Fiss; Geraldine Anna,295,0,300,5
1708255967726,LTEA 132,A00,412561,Mendoza; Andrea,51,0,60,9
1708255968251,LTEA 141,A00,412565,Lee; Jin-Kyung,37,0,40,3
1708255968782,LTEN 23,A01,411317,Vijay; Ameeth Varma,24,0,25,1
1708255968782,LTEN 23,A02,411318,Vijay; Ameeth Varma,24,0,25,1
1708255968782,LTEN 23,A03,411371,Vijay; Ameeth Varma,25,0,25,0
1708255968782,LTEN 23,A04,411375,Vijay; Ameeth Varma,24,0,25,1
1708255969323,LTEN 28,A01,411632,Blanco; John D,25,0,25,0
1708255969323,LTEN 28,A02,411697,Blanco; John D,25,0,25,0
1708255969323,LTEN 28,A03,411698,Blanco; John D,25,0,25,0
1708255969323,LTEN 28,A04,411709,Blanco; John D,25,0,25,0
1708255969323,LTEN 28,A05,411719,Blanco; John D,25,0,25,0
1708255969323,LTEN 28,A06,411744,Blanco; John D,25,0,25,0
1708255969323,LTEN 28,A07,411780,Blanco; John D,25,0,25,0
1708255969323,LTEN 28,A08,411820,Blanco; John D,25,0,25,0
1708255969852,LTEN 110,A00,486891,Vitkus; Daniel J.,38,0,40,2
1708255970377,LTEN 144,A00,412570,Vijay; Ameeth Varma,39,0,40,1
1708255970902,LTEN 180,A00,412581,Perreira; Christopher Michael,18,0,25,7
1708255971444,LTEN 181,A00,412582,Mukherjee; Silpa,55,0,60,5
1708255971970,LTEN 245,A00,412824,Johnson; Sara E.,13,0,15,2
1708255972496,LTEN 259,A00,412825,Streeby; Shelley,13,0,15,2
1708255973037,LTEU 111,A00,412588,Kontje; Todd Curtis,38,0,40,2
1708255973564,LTEU 140,A00,480172,De Marchi Gherini; Adriana,36,0,37,1
1708255974094,LTEU 141,A00,412592,Cohen; Alain J. J.,40,0,40,0
1708255974625,LTFR 2A,A01,411996,Ploye; Catherine,25,0,25,0
1708255975152,LTFR 2C,A00,411997,Ploye; Catherine,24,0,25,1
1708255975680,LTFR 142,A00,412597,Zhiri; Oumelbanine,20,0,20,0
1708255976206,LTGK 3,A00,412001,Murray; Kourtney Kristine,30,0,30,0
1708255976735,LTGM 2C,A00,412002,Fischer-Grunski; Eva K,25,0,25,0
1708255977278,LTKO 1C,A01,412029,Cho; Hye Jin,24,0,25,1
1708255977278,LTKO 1C,B01,412164,Cho; Hye Jin,23,0,25,2
1708255977278,LTKO 1C,C01,412168,Cho; Hye Jin,25,0,25,0
1708255977278,LTKO 1C,D01,412353,Yim; Nancy,24,0,25,1
1708255977278,LTKO 1C,E01,412372,Yim; Nancy,25,0,25,0
1708255977804,LTKO 2C,A01,412374,Yim; Nancy,21,0,25,4
1708255978345,LTKO 130P,A00,412601,Lee; Jeyseon,25,0,25,0
1708255978871,LTKO 135,A00,412606,Lee; Jeyseon,25,0,25,0
1708255979397,LTLA 3,A00,412375,Murray; Kourtney Kristine,36,0,40,4
1708255979923,LTRU 1C,A01,412491,Wells; Patricia Rebecca,24,0,25,1
1708255980448,LTRU 104A,A01,412614,Wells; Patricia Rebecca,20,0,20,0
1708255980979,LTSP 2A,A01,412493,Lampell; Toni,24,0,25,1
1708255981510,LTSP 2B,A01,412497,Lampell; Toni,22,0,25,3
1708255981510,LTSP 2B,B01,479218,Lampell; Toni,24,0,25,1
1708255982039,LTSP 2C,A01,412499,Mastromartino; Alexandra L,23,0,25,2
1708255982581,LTSP 2D,A00,412500,Dominguez; Noelia,24,0,25,1
1708255983107,LTSP 2E,A00,412501,Mastromartino; Alexandra L,24,0,25,1
1708255983107,LTSP 2E,B00,412502,Mastromartino; Alexandra L,25,0,25,0
1708255983635,LTSP 87,A00,479212,Bessett; Ryan Matthew,20,0,20,0
1708255984159,LTSP 100B,A00,412619,Dominguez; Noelia,25,0,25,0
1708255984159,LTSP 100B,B00,412623,Dominguez; Noelia,24,0,25,1
1708255984688,LTSP 116,A00,412628,Blanco; John D,28,0,30,2
1708255985214,LTSP 135A,A00,412631,Parra; Max,27,0,30,3
1708255985740,LTSP 174,A00,479213,Staff,28,0,30,2
1708255986272,LTTH 115,A00,412632,Kontje; Todd Curtis,35,0,40,5
1708255986798,LTTH 210C,A00,412826,Batarseh; Amanda Alicia,14,0,15,1
1708255987323,LTTH 255,A00,412827,Ali; Mohammad Kazim,13,0,15,2
1708255987849,LTTH 260,A00,412828,Kim; Joo Ok,30,0,30,0
1708255988375,LTWL 19C,A00,412503,Kelting; Edward William,40,0,40,0
1708255988903,LTWL 101,A00,412633,Kelting; Edward William,39,0,40,1
1708255989434,LTWL 114,A00,412656,Fiss; Geraldine Anna,60,0,60,0
1708255989964,LTWL 123,A00,412674,Lampert-Weissig; Lisa,31,0,40,9
1708255990490,LTWL 172,A00,412729,De Marchi Gherini; Adriana,37,0,40,3
1708255991019,LTWL 183,A00,412731,Cohen; Alain J. J.,38,0,40,2
1708255991545,LTWL 184,A00,479219,Mukherjee; Silpa,38,0,40,2
1708255992072,LTWL 194A,A00,489635,Vijay; Ameeth Varma,27,0,31,4
1708255993616,LTWR 8A,A01,412505,Springer; Anna Joy,24,0,25,1
1708255993616,LTWR 8A,A02,412506,Springer; Anna Joy,24,0,25,1
1708255993616,LTWR 8A,A03,412507,Springer; Anna Joy,25,0,25,0
1708255993616,LTWR 8A,A04,412508,Springer; Anna Joy,23,0,25,2
1708255994162,LTWR 8C,A01,412511,Forbes; Camille,23,0,25,2
1708255994162,LTWR 8C,A02,412512,Forbes; Camille,25,0,25,0
1708255994162,LTWR 8C,A03,412514,Forbes; Camille,25,0,25,0
1708255994162,LTWR 8C,A04,412519,Forbes; Camille,24,0,25,1
1708255994690,LTWR 100,A00,412734,Forbes; Camille,7,0,15,8
1708255995216,LTWR 113,A00,412816,Carroll; Amy Sara,28,0,30,2
1708255995742,LTWR 114,A00,412817,Springer; Anna Joy,23,0,30,7
1708255996271,LTWR 126,A00,412818,Hoang; Lily Kim,25,0,30,5
1708255996797,LTWR 215,A00,412880,Carroll; Amy Sara,19,0,20,1
1708255997346,MAE 3,A01,435606,Qi; Huihui,16,0,20,4
1708255997346,MAE 3,A02,435607,Qi; Huihui,15,0,20,5
1708255997346,MAE 3,A03,435608,Qi; Huihui,19,0,20,1
1708255997346,MAE 3,B01,435618,Delson; Nathan Joseph & Mullin; Jennifer S,20,0,20,0
1708255997346,MAE 3,B02,435626,Delson; Nathan Joseph & Mullin; Jennifer S,20,0,20,0
1708255997346,MAE 3,B03,435666,Delson; Nathan Joseph & Mullin; Jennifer S,20,0,20,0
1708255997346,MAE 3,B04,435679,Delson; Nathan Joseph & Mullin; Jennifer S,20,0,20,0
1708255997346,MAE 3,B05,494545,Delson; Nathan Joseph & Mullin; Jennifer S,20,0,20,0
1708255997872,MAE 8,A01,435688,Pham; Hieu Tan,197,0,200,3
1708255998397,MAE 30B,A00,435689,Lubarda; Marko,128,0,130,2
1708255998397,MAE 30B,B00,435701,Ghazinejad; Maziar,117,0,130,13
1708255998924,MAE 101B,A00,435702,Saintillan; David,146,0,150,4
1708255998924,MAE 101B,B00,435703,Nomura; Keiko K.,138,0,146,8
1708255999450,MAE 101C,A00,435704,Sadeghizadeh; Zahra,53,0,65,12
1708255999977,MAE 101D,A00,435705,Chen; Renkun,14,0,20,6
1708256000507,MAE 105,A00,435706,Becker; Janet Maria,115,0,120,5
1708256001036,MAE 107,A00,435707,Lindsey; Stephanie,48,0,50,2
1708256001036,MAE 107,B00,435708,Davidson; Michael R,55,0,60,5
1708256001563,MAE 119,A00,435710,Hidalgo-Gonzalez; Patricia,100,0,120,20
1708256002094,MAE 120,A00,435722,Arefiev; Alexey,49,0,65,16
1708256002621,MAE 125,A00,435723,Kleissl; Jan,60,0,65,5
1708256003152,MAE 131A,A00,435724,Qi; Huihui,119,0,125,6
1708256003152,MAE 131A,B00,435725,Meyers; Marc,123,0,125,2
1708256003682,MAE 143B,A00,435726,Morimoto; Tania,114,0,120,6
1708256003682,MAE 143B,B00,435727,Herbert; Sylvia Lee,117,0,120,3
1708256003682,MAE 143B,C00,435728,Diagne; Mamadou Lamine,107,0,120,13
1708256004213,MAE 145,A00,435729,Martinez; Sonia,41,0,60,19
1708256004741,MAE 148,A01,492802,Silberman; Jack,14,0,24,10
1708256005282,MAE 150,A00,435730,Pham; Hieu Tan,51,0,60,9
1708256005808,MAE 152,A00,435731,Llewellyn Smith; Stefan G.,14,0,14,0
1708256005808,MAE 152,B00,435747,Llewellyn Smith; Stefan G.,12,0,14,2
1708256005808,MAE 152,C00,435748,Llewellyn Smith; Stefan G.,12,0,14,2
1708256005808,MAE 152,D00,435749,Llewellyn Smith; Stefan G.,8,0,14,6
1708256005808,MAE 152,E00,435750,Llewellyn Smith; Stefan G.,13,0,14,1
1708256006340,MAE 155B,A01,435752,Hwang; John T,36,0,50,14
1708256006340,MAE 155B,B01,435768,Anderson; Mark Ronald,27,0,50,23
1708256006340,MAE 155B,C01,494006,Saha; Abhishek,0,0,0,0
1708256006875,MAE 156B,A01,435770,Tustaniwskyj; Jerry I,32,0,40,8
1708256006875,MAE 156B,B01,435772,Ghazinejad; Maziar,35,0,40,5
1708256006875,MAE 156B,C01,435774,Delson; Nathan Joseph,38,0,40,2
1708256006875,MAE 156B,D01,435776,Saha; Abhishek,31,0,40,9
1708256007402,MAE 166,A00,435777,Fullerton; Eric E,44,0,50,6
1708256007934,MAE 170,A01,435779,Lubarda; Marko,30,0,32,2
1708256007934,MAE 170,A02,435780,Lubarda; Marko,27,0,32,5
1708256007934,MAE 170,A03,435781,Lubarda; Marko,32,0,32,0
1708256007934,MAE 170,A04,435782,Lubarda; Marko,31,0,32,1
1708256007934,MAE 170,A05,435783,Lubarda; Marko,29,0,32,3
1708256007934,MAE 170,A06,435784,Lubarda; Marko,30,0,32,2
1708256007934,MAE 170,B01,435786,Evdokimenko; Ekaterina,23,0,24,1
1708256007934,MAE 170,B02,435787,Evdokimenko; Ekaterina,20,0,24,4
1708256007934,MAE 170,B03,435788,Evdokimenko; Ekaterina,23,0,24,1
1708256007934,MAE 170,B04,435789,Evdokimenko; Ekaterina,23,0,24,1
1708256007934,MAE 170,B05,435790,Evdokimenko; Ekaterina,19,0,24,5
1708256007934,MAE 170,B06,435791,Evdokimenko; Ekaterina,23,0,24,1
1708256008471,MAE 180,A00,479477,Sadeghizadeh; Zahra,55,0,60,5
1708256008998,MAE 184,A00,435792,Anderson; Mark Ronald,6,0,50,44
1708256009531,MAE 190,A00,435793,Beg; Farhat N.,17,0,20,3
1708256009531,MAE 190,B00,479209,Gerardo; Hortense Flotilde,12,0,15,3
1708256010056,MAE 202,A00,435794,Bandaru; Prabhakar,32,0,70,38
1708256010600,MAE 205,A00,435804,Hwang; John T & Tynan; George Robert & Seshadri; Kalyanasundaram & Rangamani; Padmini & Bandaru; Prabhakar,9990,0,9999,9
1708256011127,MAE 207,A00,435805,Beg; Farhat N.,9,0,10,1
1708256011127,MAE 207,B00,435815,Campbell; Edward Michael,6,0,10,4
1708256011127,MAE 207,C00,477499,Gerardo; Hortense Flotilde,6,0,30,24
1708256011658,MAE 209,A00,435816,Scholtes Acevedo; Claire,25,0,30,5
1708256012187,MAE 210C,A00,435817,Becker; Janet Maria,22,0,30,8
1708256012712,MAE 211,A00,435818,Seshadri; Kalyanasundaram,20,0,30,10
1708256013239,MAE 214A,A00,435819,Sarkar; Sutanu,27,0,35,8
1708256013766,MAE 217C,A00,435820,Marinoni; Alessandro,10,0,10,0
1708256014296,MAE 221C,A00,435821,Seshadri; Kalyanasundaram,9,0,15,6
1708256014822,MAE 221D,A00,435822,Poulikakos; Lisa Voula,23,0,30,7
1708256015348,MAE 224A,A00,435823,Pawlak; Geno Ronald,5,0,10,5
1708256015892,MAE 227,A00,435824,Hidalgo-Gonzalez; Patricia,21,0,35,14
1708256016418,MAE 231A,A00,435825,Boechler; Nicholas Sebastia,14,0,30,16
1708256016961,MAE 240,A00,435826,Rosengren; Aaron,19,0,30,11
1708256017491,MAE 242,A00,435827,Martinez; Sonia,0,0,45,45
1708256018018,MAE 249,A00,435842,Tolley; Michael Thomas,0,0,35,35
1708256018544,MAE 253,A00,435891,Staff,24,0,25,1
1708256019070,MAE 256,A00,435949,Coimbra; Carlos F.,6,0,10,4
1708256019600,MAE 263,A00,435987,Rangamani; Padmini,10,0,10,0
1708256021200,MAE 266,A00,435988,Evdokimenko; Ekaterina,7,0,30,23
1708256021729,MAE 271C,A00,435990,Arzt; Eduard,10,0,10,0
1708256022255,MAE 281B,A00,435991,Cortes; Jorge,9,0,25,16
1708256022780,MAE 288A,A00,435998,McEneaney; William Michael,6,0,40,34
1708256023307,MAE 288B,A00,435999,Bitmead; Robert R.,41,0,45,4
1708256023837,MAE 290C,A00,436008,Schmidt; Oliver,26,0,30,4
1708256024365,MAE 294C,A01,436010,Young; William Roy,19,0,20,1
1708256024892,MATH 2,A01,431271,Staff,31,0,35,4
1708256024892,MATH 2,B01,431273,Staff,29,0,35,6
1708256024892,MATH 2,C01,431275,Staff,31,0,35,4
1708256025424,MATH 3C,A01,431277,Safii; Soheil,12,0,15,3
1708256025424,MATH 3C,A02,431278,Safii; Soheil,12,0,15,3
1708256025424,MATH 3C,A03,431279,Safii; Soheil,12,0,15,3
1708256025424,MATH 3C,A04,431280,Safii; Soheil,15,0,15,0
1708256025424,MATH 3C,A05,431281,Safii; Soheil,14,0,15,1
1708256025424,MATH 3C,A06,431282,Safii; Soheil,15,0,15,0
1708256026984,MATH 10A,A01,431284,Bowers; Adam R.,20,0,30,10
1708256026984,MATH 10A,A02,431285,Bowers; Adam R.,18,0,30,12
1708256026984,MATH 10A,A03,431369,Bowers; Adam R.,28,0,30,2
1708256026984,MATH 10A,A04,431395,Bowers; Adam R.,27,0,30,3
1708256026984,MATH 10A,A05,431450,Bowers; Adam R.,28,0,30,2
1708256026984,MATH 10A,A06,431508,Bowers; Adam R.,30,0,30,0
1708256026984,MATH 10A,B01,431572,Kowalenko; Ethan J,24,0,30,6
1708256026984,MATH 10A,B02,431573,Kowalenko; Ethan J,29,0,30,1
1708256026984,MATH 10A,B03,431574,Kowalenko; Ethan J,30,0,30,0
1708256026984,MATH 10A,B04,431576,Kowalenko; Ethan J,30,0,30,0
1708256026984,MATH 10A,B05,431577,Kowalenko; Ethan J,30,0,30,0
1708256026984,MATH 10A,B06,431583,Kowalenko; Ethan J,30,0,30,0
1708256027569,MATH 10B,A01,431595,Habib; Yousaf,29,0,36,7
1708256027569,MATH 10B,A02,431597,Habib; Yousaf,35,0,36,1
1708256027569,MATH 10B,A03,431669,Habib; Yousaf,37,0,37,0
1708256027569,MATH 10B,A04,431670,Habib; Yousaf,36,0,37,1
1708256027569,MATH 10B,A05,431671,Habib; Yousaf,70,0,70,0
1708256027569,MATH 10B,B01,431673,Habib; Yousaf,25,0,33,8
1708256027569,MATH 10B,B02,431712,Habib; Yousaf,33,0,33,0
1708256027569,MATH 10B,B03,431713,Habib; Yousaf,33,0,33,0
1708256027569,MATH 10B,B04,431714,Habib; Yousaf,33,0,33,0
1708256027569,MATH 10B,B05,431715,Habib; Yousaf,60,0,60,0
1708256027569,MATH 10B,C01,431717,Bach; Quang Tran,57,0,60,3
1708256027569,MATH 10B,C02,431718,Bach; Quang Tran,18,0,34,16
1708256027569,MATH 10B,C03,431719,Bach; Quang Tran,34,0,34,0
1708256027569,MATH 10B,C04,431720,Bach; Quang Tran,33,0,34,1
1708256027569,MATH 10B,C05,431721,Bach; Quang Tran,32,0,34,2
1708256027569,MATH 10B,D01,431723,Staff,28,0,34,6
1708256027569,MATH 10B,D02,431724,Staff,34,0,34,0
1708256027569,MATH 10B,D03,431725,Staff,34,0,34,0
1708256027569,MATH 10B,D04,431726,Staff,34,0,34,0
1708256027569,MATH 10B,D05,431727,Staff,57,0,60,3
1708256028096,MATH 10C,A01,431741,Staff,94,0,96,2
1708256028096,MATH 10C,A02,431742,Staff,39,0,40,1
1708256028096,MATH 10C,B01,431744,Staff,95,0,96,1
1708256028096,MATH 10C,B02,431746,Staff,27,0,40,13
1708256028096,MATH 10C,C01,431748,Pardo Guerra; Sebastian,30,0,40,10
1708256028096,MATH 10C,C02,431885,Pardo Guerra; Sebastian,40,0,40,0
1708256028096,MATH 10C,C03,431895,Pardo Guerra; Sebastian,32,0,33,1
1708256028096,MATH 10C,C04,431896,Pardo Guerra; Sebastian,32,0,32,0
1708256028639,MATH 11,A01,431933,Rava; Denise,82,0,100,18
1708256028639,MATH 11,A02,431960,Rava; Denise,66,0,70,4
1708256028639,MATH 11,A03,431971,Rava; Denise,39,0,40,1
1708256028639,MATH 11,B01,432053,Staff,99,0,100,1
1708256028639,MATH 11,B02,432064,Staff,37,0,45,8
1708256028639,MATH 11,B03,432073,Staff,44,0,45,1
1708256029207,MATH 18,A01,432082,Mackall; Eoin Travis,65,0,70,5
1708256029207,MATH 18,A02,432086,Mackall; Eoin Travis,68,0,70,2
1708256029207,MATH 18,B01,432089,Suk; Andrew Hoon,39,0,40,1
1708256029207,MATH 18,B02,432090,Suk; Andrew Hoon,35,0,40,5
1708256029207,MATH 18,B03,432091,Suk; Andrew Hoon,33,0,40,7
1708256029207,MATH 18,B04,432092,Suk; Andrew Hoon,30,0,40,10
1708256029207,MATH 18,B05,432093,Suk; Andrew Hoon,34,0,35,1
1708256029207,MATH 18,B06,432094,Suk; Andrew Hoon,33,0,35,2
1708256029207,MATH 18,B07,432095,Suk; Andrew Hoon,98,0,100,2
1708256029207,MATH 18,B08,432096,Suk; Andrew Hoon,100,0,100,0
1708256029207,MATH 18,B09,432097,Suk; Andrew Hoon,98,0,100,2
1708256029207,MATH 18,B10,432098,Suk; Andrew Hoon,69,0,70,1
1708256029735,MATH 20A,A01,432101,Briones; Jor-el Thomas Caparas,30,0,40,10
1708256029735,MATH 20A,A02,432102,Briones; Jor-el Thomas Caparas,98,0,100,2
1708256029735,MATH 20A,B01,432104,Briones; Jor-el Thomas Caparas,99,0,100,1
1708256029735,MATH 20A,B02,432105,Briones; Jor-el Thomas Caparas,40,0,40,0
1708256030283,MATH 20B,A01,432107,Quarfoot; David James,33,0,35,2
1708256030283,MATH 20B,A02,432108,Quarfoot; David James,18,0,35,17
1708256030283,MATH 20B,A03,432109,Quarfoot; David James,32,0,35,3
1708256030283,MATH 20B,A04,432110,Quarfoot; David James,34,0,35,1
1708256030283,MATH 20B,A05,432331,Quarfoot; David James,26,0,32,6
1708256030283,MATH 20B,A06,432411,Quarfoot; David James,31,0,32,1
1708256030283,MATH 20B,B01,432413,Mackall; Eoin Travis,62,0,65,3
1708256030283,MATH 20B,B02,432443,Mackall; Eoin Travis,65,0,65,0
1708256030283,MATH 20B,B03,432444,Mackall; Eoin Travis,60,0,60,0
1708256030283,MATH 20B,B04,432471,Mackall; Eoin Travis,60,0,60,0
1708256031847,MATH 20C,A01,432473,Ohm; Ko Woon,26,0,38,12
1708256031847,MATH 20C,A02,432474,Ohm; Ko Woon,36,0,38,2
1708256031847,MATH 20C,A03,432475,Ohm; Ko Woon,34,0,37,3
1708256031847,MATH 20C,A04,432546,Ohm; Ko Woon,36,0,37,1
1708256031847,MATH 20C,A05,432550,Ohm; Ko Woon,88,0,90,2
1708256031847,MATH 20C,B01,432568,Ohm; Ko Woon,43,0,45,2
1708256031847,MATH 20C,B02,432594,Ohm; Ko Woon,40,0,45,5
1708256031847,MATH 20C,B03,432609,Ohm; Ko Woon,85,0,90,5
1708256031847,MATH 20C,C01,432613,Cheng; Hsiao-Bing,67,0,70,3
1708256031847,MATH 20C,C02,432614,Cheng; Hsiao-Bing,68,0,70,2
1708256031847,MATH 20C,C03,432615,Cheng; Hsiao-Bing,70,0,70,0
1708256031847,MATH 20C,D01,432617,Cheng; Hsiao-Bing,69,0,70,1
1708256031847,MATH 20C,D02,432618,Cheng; Hsiao-Bing,68,0,70,2
1708256031847,MATH 20C,D03,432619,Cheng; Hsiao-Bing,70,0,70,0
1708256032446,MATH 20D,A01,432622,Hammock; Frances H,58,0,60,2
1708256032446,MATH 20D,A02,432623,Hammock; Frances H,58,0,60,2
1708256032446,MATH 20D,A03,432658,Hammock; Frances H,35,0,35,0
1708256032446,MATH 20D,A04,432660,Hammock; Frances H,35,0,35,0
1708256032446,MATH 20D,B01,432702,Hammock; Frances H,66,0,70,4
1708256032446,MATH 20D,B02,432703,Hammock; Frances H,70,0,70,0
1708256032446,MATH 20D,B03,432766,Hammock; Frances H,30,0,30,0
1708256032446,MATH 20D,B04,432782,Hammock; Frances H,20,0,30,10
1708256032446,MATH 20D,C01,432811,Sheng; Hongyi,60,0,60,0
1708256032446,MATH 20D,C02,432931,Sheng; Hongyi,60,0,60,0
1708256032446,MATH 20D,C03,432945,Sheng; Hongyi,27,0,30,3
1708256032446,MATH 20D,C04,432949,Sheng; Hongyi,30,0,30,0
1708256033006,MATH 20E,A01,433007,Eggers; John Dietrich,70,0,80,10
1708256033006,MATH 20E,A02,433070,Eggers; John Dietrich,77,0,80,3
1708256033006,MATH 20E,A03,433079,Eggers; John Dietrich,32,0,35,3
1708256033006,MATH 20E,B01,433092,Staff,86,0,90,4
1708256033006,MATH 20E,B02,433093,Staff,90,0,90,0
1708256033006,MATH 20E,C01,433237,Bach; Quang Tran,52,0,60,8
1708256033006,MATH 20E,C02,433238,Bach; Quang Tran,69,0,70,1
1708256033006,MATH 20E,C03,433239,Bach; Quang Tran,70,0,70,0
1708256033536,MATH 31CH,A01,433241,Rabin; Jeffrey Mark,35,0,35,0
1708256035081,MATH 95,A00,433242,Stevens; Laura Jeanne,30,0,30,0
1708256035623,MATH 100C,A01,433244,Pollack; Aaron,31,0,35,4
1708256035623,MATH 100C,A02,433245,Pollack; Aaron,35,0,35,0
1708256036212,MATH 102,A01,433298,Ophir; Amit,29,0,30,1
1708256036212,MATH 102,A02,433369,Ophir; Amit,30,0,30,0
1708256036212,MATH 102,A03,433373,Ophir; Amit,30,0,30,0
1708256036212,MATH 102,A04,433374,Ophir; Amit,29,0,30,1
1708256036212,MATH 102,B01,433572,Zhang; Ming,28,0,30,2
1708256036212,MATH 102,B02,433732,Zhang; Ming,30,0,30,0
1708256036212,MATH 102,B03,433733,Zhang; Ming,30,0,30,0
1708256036212,MATH 102,B04,433734,Zhang; Ming,29,0,30,1
1708256036771,MATH 103B,A01,433793,Lu; Yunze,23,0,30,7
1708256036771,MATH 103B,A02,433795,Lu; Yunze,30,0,30,0
1708256036771,MATH 103B,A03,433830,Lu; Yunze,28,0,30,2
1708256036771,MATH 103B,B01,433845,Lahiri; Aranya,24,0,30,6
1708256036771,MATH 103B,B02,433846,Lahiri; Aranya,28,0,30,2
1708256036771,MATH 103B,B03,433847,Lahiri; Aranya,27,0,30,3
1708256037313,MATH 109,A01,433849,Aycock; Jon Merrill,6,0,10,4
1708256037313,MATH 109,A02,433850,Aycock; Jon Merrill,9,0,10,1
1708256037313,MATH 109,B01,433852,Klevdal; Christian Sleek,10,0,10,0
1708256037313,MATH 109,B02,433859,Klevdal; Christian Sleek,10,0,10,0
1708256037313,MATH 109,C01,433861,Treuer; John N,5,0,10,5
1708256037313,MATH 109,C02,433862,Treuer; John N,10,0,10,0
1708256037313,MATH 109,D01,433864,Treuer; John N,8,0,10,2
1708256037313,MATH 109,D02,433865,Treuer; John N,8,0,10,2
1708256037313,MATH 109,E01,433868,Sheng; Hongyi,10,0,10,0
1708256037313,MATH 109,E02,433869,Sheng; Hongyi,19,0,20,1
1708256037854,MATH 110,A01,433871,Pillai; Mohandas K,24,0,35,11
1708256037854,MATH 110,A02,433872,Pillai; Mohandas K,33,0,35,2
1708256038382,MATH 112B,A01,480683,Komarova; Natalia,27,0,27,0
1708256038908,MATH 120B,A01,433885,Xiao; Ming,32,0,35,3
1708256038908,MATH 120B,A02,433886,Xiao; Ming,34,0,35,1
1708256039452,MATH 121B,A01,433888,Stevens; Laura Jeanne,29,0,30,1
1708256041009,MATH 140B,A01,433890,Seward; Brandon M.,31,0,35,4
1708256041009,MATH 140B,A02,433891,Seward; Brandon M.,35,0,35,0
1708256041555,MATH 140C,A01,433895,Spolaor; Luca,32,0,35,3
1708256041555,MATH 140C,A02,433896,Spolaor; Luca,35,0,35,0
1708256042099,MATH 142B,A01,433966,Eggers; John Dietrich,25,0,35,10
1708256042099,MATH 142B,A02,434063,Eggers; John Dietrich,32,0,35,3
1708256042099,MATH 142B,B01,434071,Sanchez; Anthony,32,0,35,3
1708256042099,MATH 142B,B02,434083,Sanchez; Anthony,34,0,35,1
1708256042099,MATH 142B,C01,434094,Kunnawalkam Elayavalli; Sr,31,0,35,4
1708256042099,MATH 142B,C02,434095,Kunnawalkam Elayavalli; Sr,34,0,35,1
1708256042625,MATH 144,A01,434097,Cloninger; Alexander,30,0,30,0
1708256043170,MATH 150B,A01,434104,Parise; Davide,33,0,35,2
1708256043696,MATH 152,A01,434107,Grier; Daniel T,20,0,40,20
1708256044242,MATH 154,A01,434109,Wesley; William J,31,0,35,4
1708256044242,MATH 154,A02,434119,Wesley; William J,35,0,35,0
1708256044242,MATH 154,A03,434120,Wesley; William J,35,0,35,0
1708256044242,MATH 154,A04,434121,Wesley; William J,34,0,35,1
1708256044242,MATH 154,B01,434126,Aliabadi Sr.; Mohsen,26,0,35,9
1708256044242,MATH 154,B02,434127,Aliabadi Sr.; Mohsen,34,0,35,1
1708256044242,MATH 154,B03,434138,Aliabadi Sr.; Mohsen,35,0,35,0
1708256044242,MATH 154,B04,434139,Aliabadi Sr.; Mohsen,35,0,35,0
1708256044768,MATH 163,A01,434144,Bowers; Adam R.,0,0,5,5
1708256045294,MATH 170A,A01,434148,Nag; Panchali,36,0,36,0
1708256045294,MATH 170A,A02,434149,Nag; Panchali,36,0,36,0
1708256045294,MATH 170A,A03,434150,Nag; Panchali,36,0,37,1
1708256045294,MATH 170A,A04,434151,Nag; Panchali,36,0,36,0
1708256045825,MATH 170B,A01,434155,Huang; Lei,31,0,35,4
1708256045825,MATH 170B,A02,434160,Huang; Lei,35,0,35,0
1708256045825,MATH 170B,A03,434161,Huang; Lei,35,0,35,0
1708256045825,MATH 170B,A04,434162,Huang; Lei,35,0,35,0
1708256046352,MATH 170C,A01,434176,Leok; Melvin,30,0,35,5
1708256046352,MATH 170C,A02,434300,Leok; Melvin,34,0,35,1
1708256046883,MATH 171B,A01,434576,Nie; Jiawang,24,0,35,11
1708256046883,MATH 171B,A02,434583,Nie; Jiawang,35,0,35,0
1708256046883,MATH 171B,A03,434584,Nie; Jiawang,35,0,35,0
1708256046883,MATH 171B,A04,434609,Nie; Jiawang,35,0,35,0
1708256047409,MATH 180A,A01,434638,Gartland; Christopher John,29,0,30,1
1708256047409,MATH 180A,A02,434821,Gartland; Christopher John,28,0,30,2
1708256047409,MATH 180A,A03,434833,Gartland; Christopher John,24,0,30,6
1708256047409,MATH 180A,A04,434839,Gartland; Christopher John,30,0,30,0
1708256047409,MATH 180A,A05,434843,Gartland; Christopher John,30,0,30,0
1708256047409,MATH 180A,A06,434895,Gartland; Christopher John,30,0,30,0
1708256047939,MATH 180B,A01,435085,Gartland; Christopher John,30,0,35,5
1708256047939,MATH 180B,A02,435086,Gartland; Christopher John,35,0,35,0
1708256047939,MATH 180B,A03,435087,Gartland; Christopher John,34,0,35,1
1708256047939,MATH 180B,A04,435088,Gartland; Christopher John,35,0,35,0
1708256048477,MATH 180C,A01,435090,Carfagnini; Marco,29,0,35,6
1708256048477,MATH 180C,A02,435091,Carfagnini; Marco,35,0,35,0
1708256048477,MATH 180C,A03,435092,Carfagnini; Marco,32,0,35,3
1708256048477,MATH 180C,A04,435113,Carfagnini; Marco,35,0,35,0
1708256049004,MATH 181A,A01,435279,Zhang; Danna,30,0,35,5
1708256049004,MATH 181A,A02,435300,Zhang; Danna,35,0,35,0
1708256049004,MATH 181A,A03,435301,Zhang; Danna,21,0,35,14
1708256049004,MATH 181A,A04,435302,Zhang; Danna,31,0,35,4
1708256049550,MATH 181B,A01,435315,Rava; Denise,33,0,35,2
1708256049550,MATH 181B,A02,435316,Rava; Denise,32,0,35,3
1708256049550,MATH 181B,A03,435317,Rava; Denise,33,0,35,2
1708256049550,MATH 181B,A04,435318,Rava; Denise,35,0,35,0
1708256050076,MATH 183,A01,435320,Quarfoot; David James,26,0,35,9
1708256050076,MATH 183,A02,435321,Quarfoot; David James,35,0,35,0
1708256050076,MATH 183,A03,435322,Quarfoot; David James,32,0,35,3
1708256050076,MATH 183,A04,435323,Quarfoot; David James,34,0,35,1
1708256050076,MATH 183,A05,435327,Quarfoot; David James,34,0,35,1
1708256050076,MATH 183,A06,435329,Quarfoot; David James,33,0,35,2
1708256050605,MATH 184,A01,435337,Verstraete; Jacques Allan,32,0,35,3
1708256050605,MATH 184,A02,435338,Verstraete; Jacques Allan,35,0,35,0
1708256050605,MATH 184,A03,435339,Verstraete; Jacques Allan,34,0,35,1
1708256050605,MATH 184,A04,435347,Verstraete; Jacques Allan,30,0,35,5
1708256051133,MATH 185,A01,435432,Arias-Castro; Ery,15,0,30,15
1708256051133,MATH 185,A02,435436,Arias-Castro; Ery,30,0,30,0
1708256051133,MATH 185,A03,435437,Arias-Castro; Ery,30,0,30,0
1708256051133,MATH 185,A04,435438,Arias-Castro; Ery,30,0,30,0
1708256051676,MATH 187A,A01,435443,Agrawal; Shishir,15,0,30,15
1708256051676,MATH 187A,A02,435444,Agrawal; Shishir,30,0,30,0
1708256051676,MATH 187A,A03,435503,Agrawal; Shishir,28,0,30,2
1708256051676,MATH 187A,A04,435507,Agrawal; Shishir,30,0,30,0
1708256051676,MATH 187A,A05,435554,Agrawal; Shishir,22,0,30,8
1708256051676,MATH 187A,A06,435558,Agrawal; Shishir,28,0,30,2
1708256052203,MATH 187B,A01,435570,Bucur; Alina Ioana,24,0,35,11
1708256052203,MATH 187B,A02,435571,Bucur; Alina Ioana,35,0,35,0
1708256052731,MATH 188,A01,435573,Kunnawalkam Elayavalli; Sr,35,0,35,0
1708256053262,MATH 189,A01,435577,Vishwanath; Siddharth,0,0,10,10
1708256053262,MATH 189,A02,435594,Vishwanath; Siddharth,0,0,10,10
1708256053262,MATH 189,A03,435595,Vishwanath; Siddharth,0,0,10,10
1708256053262,MATH 189,A04,435596,Vishwanath; Siddharth,0,0,10,10
1708256053262,MATH 189,A05,480706,Vishwanath; Siddharth,2,0,10,8
1708256053262,MATH 189,A06,481362,Vishwanath; Siddharth,6,0,10,4
1708256053788,MATH 200C,A00,430388,Bucur; Alina Ioana,15,0,15,0
1708256054314,MATH 202C,A00,430389,Rhoades; Brendon Patrick,15,0,15,0
1708256054846,MATH 203C,A00,430390,Izadi; Elham,15,0,15,0
1708256055373,MATH 204C,A00,430391,Sorensen; Claus M,15,0,15,0
1708256055899,MATH 208,A00,430392,Izadi; Elham,8,0,10,2
1708256056427,MATH 209,A00,430393,Pollack; Aaron,10,0,10,0
1708256056957,MATH 211A,A00,430394,Salehi Golsefidy; Alireza,10,0,10,0
1708256057483,MATH 211B,A00,430395,Seward; Brandon M.,10,0,10,0
1708256058011,MATH 212B,A01,480692,Komarova; Natalia,5,0,5,0
1708256058541,MATH 216C,A00,430429,Saab; Rayan,13,0,15,2
1708256059083,MATH 217,A00,430430,Li; Bo,13,0,15,2
1708256059612,MATH 218,A00,430431,Li; Bo,8,0,10,2
1708256060138,MATH 220C,A00,430432,Xiao; Ming,15,0,15,0
1708256060666,MATH 240C,A00,430433,Ebenfelt; Peter F,14,0,15,1
1708256061197,MATH 241B,A00,430434,Ioana; Adrian,14,0,15,1
1708256061723,MATH 243,A00,430435,Kunnawalkam Elayavalli; Sr,9,0,10,1
1708256062265,MATH 248,A00,430436,Bejenaru; Ioan,9,0,10,1
1708256062795,MATH 251C,A00,430437,Wenzl; Hans G,15,0,15,0
1708256063323,MATH 258,A00,430438,Spolaor; Luca,10,0,10,0
1708256063850,MATH 261C,A00,430439,Manners; Frederick,14,0,15,1
1708256064380,MATH 262A,A00,430440,Warnke; Lutz Peter,14,0,15,1
1708256064924,MATH 268,A00,430441,Buss; Samuel R,10,0,10,0
1708256065451,MATH 269,A00,430442,Rhoades; Brendon Patrick & Warnke; Lutz Peter,10,0,10,0
1708256065982,MATH 270C,A00,430445,Cheng; Li-Tien,15,0,15,0
1708256066510,MATH 273B,A00,430452,Zhu; Yuhua,15,0,15,0
1708256067038,MATH 276,A00,430458,Mc Culloch; Andrew Douglas & Amaro; Rommie E,0,0,0,0
1708256067563,MATH 277A,A00,430464,Dumitriu; Ioana,14,0,15,1
1708256068093,MATH 278A,A00,430470,Cheng; Li-Tien,9,0,10,1
1708256068619,MATH 278B,A00,430471,Cloninger; Alexander,10,0,10,0
1708256069147,MATH 278C,A00,430472,Nie; Jiawang,9,0,10,1
1708256069674,MATH 280C,A00,430485,Schweinsberg; Jason,13,0,15,2
1708256070201,MATH 281C,A00,430496,Arias-Castro; Ery,8,0,15,7
1708256070731,MATH 284,A00,430503,Xu; Ronghui,11,0,15,4
1708256071258,MATH 287C,A00,430520,Zhang; Danna,14,0,15,1
1708256071784,MATH 288,A00,430527,Carfagnini; Marco,9,0,10,1
1708256072311,MATH 289A,A00,430541,Novak; Jonathan I,14,0,15,1
1708256072836,MATH 290C,A00,430548,Roberts; Justin Deritter,13,0,15,2
1708256073365,MATH 292,A00,430660,Lu; Yunze,10,0,10,0
1708256073895,MATH 294,A00,430678,Fitzsimmons; Patrick J,11,0,15,4
1708256074421,MATH 295,A00,430692,Bejenaru; Ioan,15,0,15,0
1708256074950,MATH 297,001,430721,Gamst; Anthony Collins,0,0,0,0
1708256075479,MATS 200,A00,414457,Graeve; Olivia A,9995,0,9999,4
1708256076010,MATS 201C,A00,414465,Arzt; Eduard,38,0,50,12
1708256076538,MATS 236,A00,414466,Staff,17,0,20,3
1708256077068,MATS 252,A00,414467,Evdokimenko; Ekaterina,42,0,45,3
1708256077594,MATS 261B,A00,414468,Qiao; Yu,17,0,25,8
1708256078124,MATS 295,A00,414469,Graeve; Olivia A,9999,0,9999,0
1708256078124,MATS 295,B00,478858,Kummel; Andrew C,9999,0,9999,0
1708256078668,MCWP 40,001,414476,Montejo; Carolina,19,0,20,1
1708256078668,MCWP 40,004,414480,Wastal; Carrie King,13,0,15,2
1708256078668,MCWP 40,005,414481,Wastal; Carrie King,10,0,15,5
1708256078668,MCWP 40,006,414482,Wastal; Carrie King,12,0,15,3
1708256078668,MCWP 40,007,414483,Wastal; Carrie King,13,0,15,2
1708256078668,MCWP 40,008,414484,Wastal; Carrie King,15,0,15,0
1708256078668,MCWP 40,009,414487,Wastal; Carrie King,12,0,15,3
1708256078668,MCWP 40,014,414505,Staff,20,0,20,0
1708256078668,MCWP 40,015,494362,Wastal; Carrie King,14,0,15,1
1708256079254,MCWP 50,002,414534,Bartulis; Jason Michael,20,0,20,0
1708256079254,MCWP 50,003,414536,Bartulis; Jason Michael,20,0,20,0
1708256079254,MCWP 50,004,414538,Krone; Jarret,16,0,20,4
1708256079254,MCWP 50,005,414539,Krone; Jarret,19,0,20,1
1708256079254,MCWP 50,006,414540,Smith; Haydee Marie,16,0,20,4
1708256079254,MCWP 50,007,414544,Compas; Sean Matthew,14,0,20,6
1708256079254,MCWP 50,008,414549,Redela; Pamela Morgan,20,0,20,0
1708256079254,MCWP 50,011,414557,Carter; Andrea L,16,0,20,4
1708256079254,MCWP 50,012,414592,Silva; Kelly B,20,0,20,0
1708256079254,MCWP 50,013,414593,Silva; Kelly B,19,0,20,1
1708256079254,MCWP 50,014,414594,Carter; Andrea L,20,0,20,0
1708256079254,MCWP 50,016,414596,Morshed; Michael James,14,0,20,6
1708256079254,MCWP 50,017,414598,Morshed; Michael James,17,0,20,3
1708256079254,MCWP 50,019,414601,Redela; Pamela Morgan,17,0,20,3
1708256079254,MCWP 50,020,414606,Carter; Jennifer A,20,0,20,0
1708256079254,MCWP 50,021,414607,Carter; Jennifer A,19,0,20,1
1708256079254,MCWP 50,022,414649,Compas; Sean Matthew,11,0,20,9
1708256079254,MCWP 50,023,414650,Smith; Haydee Marie,20,0,20,0
1708256079254,MCWP 50,024,414651,Nies; Laurie Elizabeth,19,0,20,1
1708256079254,MCWP 50,025,414655,Nies; Laurie Elizabeth,18,0,20,2
1708256079254,MCWP 50,026,414656,Pham; Vincent Minhduc,19,0,20,1
1708256079254,MCWP 50,027,414657,Pham; Vincent Minhduc,20,0,20,0
1708256079254,MCWP 50,028,414668,Morshed; Michael James,16,0,20,4
1708256079254,MCWP 50,029,414669,Morshed; Michael James,19,0,20,1
1708256079783,MCWP 50R,A00,486838,Miller; Elizabeth Deen,19,0,20,1
1708256079783,MCWP 50R,B00,486843,Miller; Elizabeth Deen,16,0,20,4
1708256079783,MCWP 50R,C00,486844,Miller; Elizabeth Deen,19,0,20,1
1708256080310,MCWP 125,A00,414670,Wilson; Marion E.,20,0,20,0
1708256080310,MCWP 125,B00,414674,Guillen; Melinda,20,0,20,0
1708256080310,MCWP 125,C00,414678,Guillen; Melinda,20,0,20,0
1708256080310,MCWP 125,D00,414682,Guillen; Melinda,20,0,20,0
1708256080836,MED 231,A00,476440,Hurst; Samantha,7,0,7,0
1708256081371,MED 246,A00,492785,Gordts; Philip & Varki; Ajit P & Lewis; Amanda Lark & Godula; Kamil & Gagneux; Pascal & Esko; Jeffrey D. & Bode; Lars,10,0,10,0
1708256081899,MED 262,A00,492942,Koola; Jejo David,28,0,30,2
1708256082430,MED 267,A01,492789,Hogarth; Michael Andrew,25,0,30,5
1708256082956,MED 275,A00,464684,Liu; George Yenhsi,10,0,10,0
1708256083482,MED 276,A00,492786,Sitapati; Amy,23,0,25,2
1708256084015,MED 278,A00,492787,Carter; Hannah Kathryn & Mesirov; Jill P. & Curtius; Kathleen Mary,20,0,20,0
1708256084541,MED 296,001,464685,Chi; Neil C.,48,0,50,2
1708256084541,MED 296,002,464686,Hong; Kimberly N,49,0,50,1
1708256084541,MED 296,003,464687,Staff,50,0,50,0
1708256085070,MGT 3,A00,442429,Wagner; Timothy Ryan,95,0,98,3
1708256085596,MGT 4,A01,442443,Levkoff; Steven B.,0,0,5,5
1708256085596,MGT 4,A02,442444,Levkoff; Steven B.,4,0,5,1
1708256086123,MGT 5,A00,442446,Molloie Jr.; William H,184,0,196,12
1708256086650,MGT 12,A00,442447,Lindenberger; Wade Douglas,83,0,100,17
1708256086650,MGT 12,B00,442448,Lindenberger; Wade Douglas,71,0,100,29
1708256086650,MGT 12,C00,442449,Pecore; Joseph P.,88,0,100,12
1708256087179,MGT 16,A00,442452,Buchanan; Harold G,97,0,100,3
1708256087179,MGT 16,B00,442459,Buchanan; Harold G,92,0,100,8
1708256087179,MGT 16,C00,442461,Campbell; Robert Harold,113,0,120,7
1708256087179,MGT 16,D00,442475,Campbell; Robert Harold,118,0,120,2
1708256087708,MGT 18,A00,442477,McKay; Michael J,98,0,98,0
1708256087708,MGT 18,B00,442491,McKay; Michael J,96,0,98,2
1708256087708,MGT 18,C00,442493,McKay; Michael J,98,0,98,0
1708256087708,MGT 18,D00,442503,Chamberlain; Travis Dean,98,0,98,0
1708256088235,MGT 45,A00,442508,Pecore; Joseph P.,146,0,150,4
1708256088235,MGT 45,B00,442510,Pecore; Joseph P.,142,0,150,8
1708256088762,MGT 71,A00,442524,Lee; Hyun Seok,77,0,98,21
1708256089289,MGT 71R,A00,442526,Phiroz; Zal Navroze,77,0,98,21
1708256089819,MGT 100,A00,442541,Wilbur; Kenneth C,82,0,98,16
1708256089819,MGT 100,B00,442542,Wilbur; Kenneth C,89,0,98,9
1708256090345,MGT 103,A00,442543,Eberhard; Craig A,98,0,98,0
1708256090345,MGT 103,B00,442544,Eberhard; Craig A,95,0,98,3
1708256090345,MGT 103,C00,442545,Ehrich; Kristine R,90,0,98,8
1708256090345,MGT 103,D00,442547,Ehrich; Kristine R,96,0,98,2
1708256090345,MGT 103,E00,442548,Ehrich; Kristine R,97,0,98,1
1708256090345,MGT 103,F00,442549,Demill; Burritt,92,0,98,6
1708256090345,MGT 103,G00,442550,Bates; Kenneth Walter,97,0,98,1
1708256090874,MGT 105,A00,442558,Bates; Kenneth Walter,86,0,98,12
1708256091399,MGT 106,A00,442560,Eberhard; Craig A,95,0,98,3
1708256091930,MGT 109,A00,442574,Campbell; Colin Leslie,90,0,98,8
1708256092457,MGT 112,A00,442576,Somasundaram; Tyagarajan,96,0,98,2
1708256092457,MGT 112,B00,442590,Somasundaram; Tyagarajan,94,0,98,4
1708256092457,MGT 112,C00,442592,Zimmermann; Carsten,87,0,98,11
1708256092985,MGT 119,A00,442602,Staff,97,0,98,1
1708256092985,MGT 119,B00,442603,Anderson; Jon Marcus,96,0,98,2
1708256093516,MGT 121B,A00,442606,Klaas; Jeffrey David,94,0,98,4
1708256094042,MGT 128R,A00,442607,Krishnan; Viswanathan,84,0,98,14
1708256094574,MGT 131A,A00,442608,Houskeeper; Robert,148,0,150,2
1708256095101,MGT 131B,A00,442609,Houskeeper; Robert,100,0,100,0
1708256095627,MGT 132,A00,442610,Blakley; Bruce,97,0,98,1
1708256096157,MGT 137,A00,442611,Lindenberger; Wade Douglas,85,0,98,13
1708256096684,MGT 147,A00,442612,Anderson; John Charles,31,0,40,9
1708256097210,MGT 151R,A00,442613,Phiroz; Zal Navroze,92,0,98,6
1708256097740,MGT 153,A00,442650,Perols; Johan Lars,55,0,80,25
1708256098272,MGT 162,A00,442652,Demill; Burritt,81,0,98,17
1708256098272,MGT 162,B00,442654,Demill; Burritt,88,0,98,10
1708256098272,MGT 162,C00,442776,Staff,95,0,98,3
1708256098272,MGT 162,D00,442778,Staff,96,0,98,2
1708256098805,MGT 164,A00,442780,McKay; Mary A,97,0,98,1
1708256098805,MGT 164,B00,442849,McKay; Mary A,96,0,98,2
1708256098805,MGT 164,C00,442917,McKay; Mary A,97,0,98,1
1708256098805,MGT 164,D00,442949,Meyer; Alison Bloomfield,90,0,98,8
1708256099332,MGT 166,A00,443017,Moran; Cathleen L.,95,0,98,3
1708256099332,MGT 166,B00,443045,Moran; Cathleen L.,97,0,98,1
1708256099332,MGT 166,C00,443046,Moran; Cathleen L.,98,0,98,0
1708256099859,MGT 167,A00,443047,Klaas; Jeffrey David,93,0,98,5
1708256100387,MGT 171R,A00,443048,Phiroz; Zal Navroze,86,0,98,12
1708256100915,MGT 172,A00,443049,Hedges; Kathleen & Royal; Rebecca,116,0,120,4
1708256100915,MGT 172,B00,443050,Hedges; Kathleen,95,0,98,3
1708256100915,MGT 172,C00,443051,Zimmermann; Carsten,96,0,98,2
1708256101442,MGT 173,A00,443052,Hayes; Sherry Lorine,92,0,100,8
1708256101971,MGT 175,A00,443053,Gopal; Christopher S.,98,0,98,0
1708256102501,MGT 180,A00,443055,Bliss; Barbara Ann,139,0,150,11
1708256102501,MGT 180,B00,443069,Bliss; Barbara Ann,145,0,150,5
1708256103030,MGT 181,A00,443120,Buchanan; Harold G,147,0,150,3
1708256103556,MGT 183,A00,443121,Banerjee; Snehal,88,0,98,10
1708256104084,MGT 185,A00,443122,Dunn; Louis Jean,90,0,98,8
1708256104609,MGT 187,A00,443133,Dunn; Louis Jean,95,0,100,5
1708256105135,MGT 189,A00,443134,Avenancio-Leon; Carlos,98,0,98,0
1708256105661,MGT 227,A00,479242,Serra Garcia; Marta,19,0,20,1
1708256106187,MGT 259,A00,443135,Oveis; Christopher S,19,0,20,1
1708256106720,MGT 296,001,481416,Gneezy; Ayelet,3,0,3,0
1708256106720,MGT 296,002,481420,Amir; On,3,0,3,0
1708256106720,MGT 296,003,481466,Amir; On & Karmarkar; Uma R,3,0,3,0
1708256106720,MGT 296,004,481468,Liu; Jun,3,0,3,0
1708256106720,MGT 296,005,481469,Misra; Kanishka,3,0,3,0
1708256106720,MGT 296,006,481470,Erat; Sanjiv,3,0,3,0
1708256106720,MGT 296,007,481473,Timmermann; Allan,3,0,3,0
1708256106720,MGT 296,008,481474,Smith; Pamela Karen,3,0,3,0
1708256106720,MGT 296,009,481477,Zhang; Zhe,3,0,3,0
1708256106720,MGT 296,010,481478,Oveis; Christopher S,3,0,3,0
1708256106720,MGT 296,011,481479,Amir; On & Gneezy; Ayelet,3,0,3,0
1708256106720,MGT 296,012,481481,Wilbur; Kenneth C,3,0,3,0
1708256107257,MMW 13,A01,412918,Chang; Edmond Yi-Teh,15,0,16,1
1708256107257,MMW 13,A02,412928,Chang; Edmond Yi-Teh,16,0,16,0
1708256107257,MMW 13,A03,413017,Chang; Edmond Yi-Teh,16,0,16,0
1708256107257,MMW 13,A04,413018,Chang; Edmond Yi-Teh,16,0,16,0
1708256107257,MMW 13,A05,413019,Chang; Edmond Yi-Teh,15,0,16,1
1708256107257,MMW 13,A06,413020,Chang; Edmond Yi-Teh,16,0,16,0
1708256107257,MMW 13,A07,413021,Chang; Edmond Yi-Teh,15,0,16,1
1708256107257,MMW 13,A08,413023,Chang; Edmond Yi-Teh,16,0,16,0
1708256107257,MMW 13,A09,413024,Chang; Edmond Yi-Teh,16,0,16,0
1708256107257,MMW 13,A10,413025,Chang; Edmond Yi-Teh,16,0,16,0
1708256107257,MMW 13,A11,413026,Chang; Edmond Yi-Teh,16,0,16,0
1708256107257,MMW 13,A12,413027,Chang; Edmond Yi-Teh,16,0,16,0
1708256107257,MMW 13,A13,413028,Chang; Edmond Yi-Teh,0,0,0,0
1708256107257,MMW 13,A14,413029,Chang; Edmond Yi-Teh,0,0,0,0
1708256107257,MMW 13,A15,413030,Chang; Edmond Yi-Teh,14,0,16,2
1708256107257,MMW 13,A16,413031,Chang; Edmond Yi-Teh,15,0,16,1
1708256107257,MMW 13,A17,413032,Chang; Edmond Yi-Teh,16,0,16,0
1708256107257,MMW 13,A18,413034,Chang; Edmond Yi-Teh,14,0,16,2
1708256107257,MMW 13,A19,413035,Chang; Edmond Yi-Teh,16,0,16,0
1708256107257,MMW 13,A20,413036,Chang; Edmond Yi-Teh,16,0,16,0
1708256107257,MMW 13,A21,413037,Chang; Edmond Yi-Teh,0,0,0,0
1708256107257,MMW 13,A22,413038,Chang; Edmond Yi-Teh,0,0,0,0
1708256107257,MMW 13,B01,413290,Zhiri; Oumelbanine,15,0,16,1
1708256107257,MMW 13,B02,413291,Zhiri; Oumelbanine,15,0,16,1
1708256107257,MMW 13,B03,413308,Zhiri; Oumelbanine,14,0,16,2
1708256107257,MMW 13,B04,413322,Zhiri; Oumelbanine,14,0,16,2
1708256107257,MMW 13,B05,413343,Zhiri; Oumelbanine,12,0,16,4
1708256107257,MMW 13,B06,413344,Zhiri; Oumelbanine,14,0,16,2
1708256107257,MMW 13,B07,413524,Zhiri; Oumelbanine,16,0,16,0
1708256107257,MMW 13,B08,413584,Zhiri; Oumelbanine,16,0,16,0
1708256107257,MMW 13,B09,413588,Zhiri; Oumelbanine,15,0,16,1
1708256107257,MMW 13,B10,413590,Zhiri; Oumelbanine,16,0,16,0
1708256107257,MMW 13,B11,413779,Zhiri; Oumelbanine,12,0,16,4
1708256107257,MMW 13,B12,413780,Zhiri; Oumelbanine,9,0,16,7
1708256107257,MMW 13,B13,413781,Zhiri; Oumelbanine,0,0,0,0
1708256107257,MMW 13,B14,413782,Zhiri; Oumelbanine,0,0,0,0
1708256107257,MMW 13,B15,413808,Zhiri; Oumelbanine,16,0,16,0
1708256107257,MMW 13,B16,413815,Zhiri; Oumelbanine,15,0,16,1
1708256107257,MMW 13,B17,413816,Zhiri; Oumelbanine,15,0,16,1
1708256107257,MMW 13,B18,413817,Zhiri; Oumelbanine,12,0,16,4
1708256107257,MMW 13,B19,413822,Zhiri; Oumelbanine,16,0,16,0
1708256107257,MMW 13,B20,413823,Zhiri; Oumelbanine,14,0,16,2
1708256107257,MMW 13,B21,413825,Zhiri; Oumelbanine,0,0,0,0
1708256107257,MMW 13,B22,413826,Zhiri; Oumelbanine,0,0,0,0
1708256107257,MMW 13,B23,413827,Zhiri; Oumelbanine,16,0,16,0
1708256107257,MMW 13,B24,413834,Zhiri; Oumelbanine,15,0,16,1
1708256107257,MMW 13,C01,413859,Vitkus; Daniel J.,16,0,16,0
1708256107257,MMW 13,C02,413860,Vitkus; Daniel J.,16,0,16,0
1708256107257,MMW 13,C04,413868,Vitkus; Daniel J.,0,0,0,0
1708256107257,MMW 13,C05,413869,Vitkus; Daniel J.,16,0,16,0
1708256107257,MMW 13,C06,413871,Vitkus; Daniel J.,16,0,16,0
1708256107257,MMW 13,C07,413886,Vitkus; Daniel J.,16,0,16,0
1708256107257,MMW 13,C08,413908,Vitkus; Daniel J.,16,0,16,0
1708256107257,MMW 13,C09,413930,Vitkus; Daniel J.,16,0,16,0
1708256107257,MMW 13,C10,413952,Vitkus; Daniel J.,15,0,16,1
1708256107257,MMW 13,C11,413972,Vitkus; Daniel J.,16,0,16,0
1708256107257,MMW 13,C12,413991,Vitkus; Daniel J.,16,0,16,0
1708256107257,MMW 13,C13,414007,Vitkus; Daniel J.,0,0,0,0
1708256107257,MMW 13,C14,414017,Vitkus; Daniel J.,0,0,0,0
1708256107257,MMW 13,C15,414030,Vitkus; Daniel J.,16,0,16,0
1708256107257,MMW 13,C16,414032,Vitkus; Daniel J.,16,0,16,0
1708256107257,MMW 13,C17,414033,Vitkus; Daniel J.,15,0,16,1
1708256107257,MMW 13,C18,414034,Vitkus; Daniel J.,16,0,16,0
1708256107257,MMW 13,C19,414041,Vitkus; Daniel J.,16,0,16,0
1708256107257,MMW 13,C20,414056,Vitkus; Daniel J.,16,0,16,0
1708256107257,MMW 13,C21,414057,Vitkus; Daniel J.,15,0,16,1
1708256107257,MMW 13,C22,414059,Vitkus; Daniel J.,16,0,16,0
1708256107793,MMW 15,A01,414065,Chang; Edmond Yi-Teh,28,0,28,0
1708256107793,MMW 15,A02,414067,Chang; Edmond Yi-Teh,27,0,28,1
1708256107793,MMW 15,A03,414092,Chang; Edmond Yi-Teh,26,0,28,2
1708256107793,MMW 15,A04,414104,Chang; Edmond Yi-Teh,28,0,28,0
1708256107793,MMW 15,A05,414121,Chang; Edmond Yi-Teh,0,0,0,0
1708256107793,MMW 15,A06,414122,Chang; Edmond Yi-Teh,0,0,0,0
1708256107793,MMW 15,A07,414123,Chang; Edmond Yi-Teh,27,0,28,1
1708256107793,MMW 15,A08,414124,Chang; Edmond Yi-Teh,28,0,28,0
1708256107793,MMW 15,A09,414125,Chang; Edmond Yi-Teh,0,0,0,0
1708256107793,MMW 15,A10,414130,Chang; Edmond Yi-Teh,0,0,0,0
1708256107793,MMW 15,B01,414132,Radcliff; Pamela B.,27,0,28,1
1708256107793,MMW 15,B02,414134,Radcliff; Pamela B.,27,0,28,1
1708256107793,MMW 15,B03,414135,Radcliff; Pamela B.,26,0,28,2
1708256107793,MMW 15,B04,414136,Radcliff; Pamela B.,27,0,28,1
1708256107793,MMW 15,B05,414137,Radcliff; Pamela B.,28,0,28,0
1708256107793,MMW 15,B06,414138,Radcliff; Pamela B.,27,0,28,1
1708256107793,MMW 15,B07,414140,Radcliff; Pamela B.,26,0,28,2
1708256107793,MMW 15,B08,414141,Radcliff; Pamela B.,28,0,28,0
1708256107793,MMW 15,C01,414143,Prestholdt; Jeremy,0,0,0,0
1708256107793,MMW 15,C02,414144,Prestholdt; Jeremy,0,0,0,0
1708256107793,MMW 15,C03,414145,Prestholdt; Jeremy,24,0,28,4
1708256107793,MMW 15,C04,414147,Prestholdt; Jeremy,17,0,28,11
1708256107793,MMW 15,C05,414148,Prestholdt; Jeremy,28,0,28,0
1708256107793,MMW 15,C06,414149,Prestholdt; Jeremy,26,0,28,2
1708256107793,MMW 15,C07,414152,Prestholdt; Jeremy,25,0,28,3
1708256107793,MMW 15,C08,414153,Prestholdt; Jeremy,23,0,28,5
1708256108319,MSED 295,A00,477850,Rabin; Jeffrey Mark,5,0,5,0
1708256108319,MSED 295,B00,477852,Lo; Stanley M.,5,0,5,0
1708256108843,MSED 296C,A00,477853,Staff,14,0,15,1
1708256109377,MUS 1C,A01,416488,Ishov; Alexander Alexandrovich,24,0,25,1
1708256109377,MUS 1C,A02,416502,Ishov; Alexander Alexandrovich,25,0,25,0
1708256109377,MUS 1C,A03,416519,Ishov; Alexander Alexandrovich,25,0,25,0
1708256109377,MUS 1C,A04,416520,Ishov; Alexander Alexandrovich,25,0,25,0
1708256109377,MUS 1C,A05,416521,Ishov; Alexander Alexandrovich,25,0,25,0
1708256109905,MUS 2C,A01,416523,Richards; Stephanie F,30,0,30,0
1708256110436,MUS 2CK,A00,416524,Ohnishi; Takae,15,0,15,0
1708256110436,MUS 2CK,B00,416547,Ohnishi; Takae,15,0,15,0
1708256110962,MUS 2JK,A00,416548,Kenyatta; Kamau,15,0,15,0
1708256111490,MUS 4,A01,416562,Staff,25,0,25,0
1708256111490,MUS 4,A02,416634,Staff,24,0,25,1
1708256111490,MUS 4,A03,416644,Staff,25,0,25,0
1708256111490,MUS 4,A04,416659,Staff,24,0,25,1
1708256111490,MUS 4,A05,416667,Staff,25,0,25,0
1708256111490,MUS 4,A06,416757,Staff,25,0,25,0
1708256111490,MUS 4,A07,416830,Staff,25,0,25,0
1708256111490,MUS 4,A08,416953,Staff,23,0,25,2
1708256111490,MUS 4,A09,417005,Staff,25,0,25,0
1708256111490,MUS 4,A10,417007,Staff,24,0,25,1
1708256112023,MUS 7,A01,417048,Staff,23,0,24,1
1708256112023,MUS 7,A02,417102,Staff,23,0,24,1
1708256112023,MUS 7,A03,417103,Staff,23,0,24,1
1708256112023,MUS 7,A04,417114,Staff,22,0,24,2
1708256112550,MUS 8,A01,417119,Staff,14,0,20,6
1708256112550,MUS 8,A02,417163,Staff,16,0,20,4
1708256112550,MUS 8,A03,417164,Staff,16,0,20,4
1708256112550,MUS 8,A04,417165,Staff,17,0,20,3
1708256112550,MUS 8,A05,417194,Staff,18,0,20,2
1708256112550,MUS 8,A06,417198,Staff,20,0,20,0
1708256113082,MUS 11,A01,417201,Terrazas Perez; Wilfrido D,21,0,25,4
1708256113082,MUS 11,A02,417219,Terrazas Perez; Wilfrido D,23,0,25,2
1708256113082,MUS 11,A03,417220,Terrazas Perez; Wilfrido D,25,0,25,0
1708256113082,MUS 11,A04,417222,Terrazas Perez; Wilfrido D,25,0,25,0
1708256113082,MUS 11,A05,417223,Terrazas Perez; Wilfrido D,24,0,25,1
1708256113082,MUS 11,A06,417295,Terrazas Perez; Wilfrido D,23,0,25,2
1708256113082,MUS 11,A07,417297,Terrazas Perez; Wilfrido D,24,0,25,1
1708256113082,MUS 11,A08,417298,Terrazas Perez; Wilfrido D,25,0,25,0
1708256113609,MUS 12,A01,417300,Guy; Nancy,25,0,25,0
1708256113609,MUS 12,A02,417301,Guy; Nancy,25,0,25,0
1708256113609,MUS 12,A03,417302,Guy; Nancy,25,0,25,0
1708256113609,MUS 12,A04,417303,Guy; Nancy,25,0,25,0
1708256114135,MUS 13,A01,417305,Leslie Santana; Myrta,25,0,25,0
1708256114135,MUS 13,A02,417306,Leslie Santana; Myrta,25,0,25,0
1708256114135,MUS 13,A03,417307,Leslie Santana; Myrta,25,0,25,0
1708256114135,MUS 13,A04,417308,Leslie Santana; Myrta,25,0,25,0
1708256114670,MUS 15,A01,417327,Schaffer; Max Benjamin,18,0,20,2
1708256114670,MUS 15,A02,417331,Schaffer; Max Benjamin,19,0,20,1
1708256114670,MUS 15,A03,417358,Schaffer; Max Benjamin,19,0,20,1
1708256114670,MUS 15,A04,417359,Schaffer; Max Benjamin,17,0,20,3
1708256114670,MUS 15,A05,417360,Schaffer; Max Benjamin,20,0,20,0
1708256114670,MUS 15,A06,417370,Schaffer; Max Benjamin,20,0,20,0
1708256114670,MUS 15,A07,417371,Schaffer; Max Benjamin,17,0,20,3
1708256114670,MUS 15,A08,417372,Schaffer; Max Benjamin,18,0,20,2
1708256114670,MUS 15,A09,417378,Schaffer; Max Benjamin,19,0,20,1
1708256114670,MUS 15,A10,417379,Schaffer; Max Benjamin,19,0,20,1
1708256115195,MUS 17,A01,417381,Staff,22,0,25,3
1708256115195,MUS 17,A02,417406,Staff,24,0,25,1
1708256115195,MUS 17,A03,417420,Staff,24,0,25,1
1708256115195,MUS 17,A04,417594,Staff,24,0,25,1
1708256115195,MUS 17,A05,417595,Staff,25,0,25,0
1708256115195,MUS 17,A06,417605,Staff,21,0,25,4
1708256115195,MUS 17,A07,417606,Staff,25,0,25,0
1708256115195,MUS 17,A08,417627,Staff,25,0,25,0
1708256115195,MUS 17,A09,417628,Staff,21,0,25,4
1708256115195,MUS 17,A10,417629,Staff,24,0,25,1
1708256115195,MUS 17,A11,417630,Staff,25,0,25,0
1708256115195,MUS 17,A12,417631,Staff,24,0,25,1
1708256115195,MUS 17,A13,417632,Staff,25,0,25,0
1708256115195,MUS 17,A14,417633,Staff,25,0,25,0
1708256115723,MUS 32,001,418855,Dresser; Mark Stuart,10,0,10,0
1708256115723,MUS 32,002,418856,Kenyatta; Kamau,9,0,10,1
1708256115723,MUS 32,003,418864,Curtis; Charles Rector,10,0,10,0
1708256115723,MUS 32,004,418865,Carlstrom; Mitchell Kraig,9,0,10,1
1708256115723,MUS 32,005,418868,Terrazas Perez; Wilfrido D,10,0,10,0
1708256115723,MUS 32,006,418869,Ohnishi; Takae,10,0,10,0
1708256115723,MUS 32,007,418872,Burr; Anthony I,10,0,10,0
1708256115723,MUS 32,008,418873,Carlson; Erik Norman,10,0,10,0
1708256115723,MUS 32,009,418874,Blair; Kyle Adam,10,0,10,0
1708256115723,MUS 32,010,418875,Richards; Stephanie F,10,0,10,0
1708256116251,MUS 32V,A00,417634,Narucki; Susan M,10,0,10,0
1708256116251,MUS 32V,B00,417635,Staff,10,0,10,0
1708256116779,MUS 32VM,A00,417636,Staff,15,0,15,0
1708256117305,MUS 33C,A00,417637,Taylor; Alexander Lawther,20,0,20,0
1708256117835,MUS 43,A00,417647,Burr; Anthony I,83,0,90,7
1708256118361,MUS 95D,A00,417919,Staff,40,0,40,0
1708256118892,MUS 95E,A00,417933,Henson; Matthew Alexander,55,0,55,0
1708256119418,MUS 95G,A00,417935,Anderson; Kenneth,387,0,395,8
1708256119418,MUS 95G,B00,417937,Anderson; Kenneth,394,0,395,1
1708256119945,MUS 95JC,A00,417939,Kenyatta; Kamau,30,0,30,0
1708256120471,MUS 95L,A00,417940,Jones; Michael David,50,0,50,0
1708256120997,MUS 95W,A00,417946,Seshadri; Kartik,29,0,30,1
1708256120997,MUS 95W,B00,417948,Seshadri; Kartik,30,0,30,0
1708256121524,MUS 101C,A01,417951,Burr; Anthony I,33,0,35,2
1708256122051,MUS 103C,A00,417952,Davis; Anthony Curtis,14,0,15,1
1708256122580,MUS 103F,A00,417959,Obermueller; Karola,1,0,1,0
1708256123107,MUS 113,A00,418015,Narucki; Susan M,13,0,15,2
1708256123633,MUS 120C,A01,418032,Leslie Santana; Myrta,25,0,25,0
1708256124160,MUS 127,A00,418037,Richards; Stephanie F,92,0,100,8
1708256124686,MUS 130,A00,418047,Ohnishi; Takae,30,0,30,0
1708256125214,MUS 131,A00,418065,Roberts; Matana,30,0,30,0
1708256125741,MUS 132,001,418883,Dresser; Mark Stuart,10,0,10,0
1708256125741,MUS 132,002,418885,Kenyatta; Kamau,10,0,10,0
1708256125741,MUS 132,003,418886,Curtis; Charles Rector,10,0,10,0
1708256125741,MUS 132,004,418887,Carlstrom; Mitchell Kraig,10,0,10,0
1708256125741,MUS 132,005,418888,Jones; Michael David,10,0,10,0
1708256125741,MUS 132,006,418889,Terrazas Perez; Wilfrido D,10,0,10,0
1708256125741,MUS 132,007,418893,Ohnishi; Takae,10,0,10,0
1708256125741,MUS 132,008,418894,Burr; Anthony I,10,0,10,0
1708256125741,MUS 132,009,418896,Carlson; Erik Norman,10,0,10,0
1708256125741,MUS 132,010,418900,Blair; Kyle Adam,10,0,10,0
1708256125741,MUS 132,011,418932,Richards; Stephanie F,10,0,10,0
1708256125741,MUS 132,012,418933,Nourai; Keyarash,10,0,10,0
1708256126266,MUS 132R,A00,418067,Burr; Anthony I,5,0,5,0
1708256126266,MUS 132R,B00,418078,Jones; Michael David,5,0,5,0
1708256126792,MUS 132V,A00,418092,Narucki; Susan M,15,0,15,0
1708256126792,MUS 132V,B00,418096,Staff,15,0,15,0
1708256127317,MUS 134,A00,418098,Staff,40,0,40,0
1708256127844,MUS 137C,A00,418109,Kenyatta; Kamau,25,0,25,0
1708256128371,MUS 143,A00,418123,Burr; Anthony I,33,0,40,7
1708256128898,MUS 150,A00,418127,Davis; Anthony Curtis,28,0,30,2
1708256129427,MUS 151,A00,418129,Hankins; Sarah E.,20,0,30,10
1708256129953,MUS 160B,A00,418172,Staff,11,0,15,4
1708256129953,MUS 160B,B00,418175,Dubnov; Shlomo,14,0,15,1
1708256130481,MUS 172,A01,418178,Staff,36,0,40,4
1708256131009,MUS 174C,A00,418179,Erbe; Tom,24,0,27,3
1708256131538,MUS 175,A00,418247,Smyth; Tamara R.,28,0,30,2
1708256132067,MUS 177,A00,418265,Erbe; Tom,11,0,15,4
1708256132649,MUS 201A,A00,418267,Narucki; Susan M,15,0,15,0
1708256132649,MUS 201A,B00,418268,Dresser; Mark Stuart,13,0,15,2
1708256133182,MUS 203C,A00,418269,Lou; Michelle Siulai,15,0,15,0
1708256133709,MUS 203D,A00,418272,Davis; Anthony Curtis,4,0,5,1
1708256133709,MUS 203D,B00,418275,Obermueller; Karola,5,0,5,0
1708256133709,MUS 203D,C00,418277,Liang; Lei,5,0,5,0
1708256133709,MUS 203D,D00,418323,Lou; Michelle Siulai,5,0,5,0
1708256134236,MUS 204,A00,418324,Obermueller; Karola,24,0,25,1
1708256134763,MUS 205,A00,418325,Cimini; Amy Marie,22,0,25,3
1708256135289,MUS 206,A00,418326,Liang; Lei,13,0,15,2
1708256135289,MUS 206,B00,418327,Roberts; Matana,13,0,15,2
1708256135816,MUS 215C,A00,418328,Cimini; Amy Marie,14,0,15,1
1708256136343,MUS 232,001,418937,Dresser; Mark Stuart,9,0,10,1
1708256136343,MUS 232,002,418969,Kenyatta; Kamau,10,0,10,0
1708256136343,MUS 232,003,418971,Curtis; Charles Rector,10,0,10,0
1708256136343,MUS 232,004,418974,Terrazas Perez; Wilfrido D,10,0,10,0
1708256136343,MUS 232,005,418979,Ohnishi; Takae,10,0,10,0
1708256136343,MUS 232,006,418980,Burr; Anthony I,10,0,10,0
1708256136343,MUS 232,007,418981,Carlson; Erik Norman,10,0,10,0
1708256136343,MUS 232,008,418982,Richards; Stephanie F,10,0,10,0
1708256136343,MUS 232,009,418985,Narucki; Susan M,10,0,10,0
1708256136870,MUS 234,A00,418329,Staff,15,0,15,0
1708256137396,MUS 245,A00,418330,Carlson; Erik Norman,14,0,15,1
1708256137925,MUS 267,A00,418331,Erbe; Tom,15,0,15,0
1708256138450,MUS 270B,A00,418332,Staff,15,0,15,0
1708256138977,MUS 270D,A00,479231,Smyth; Tamara R.,15,0,15,0
1708256139507,NANO 103,A00,414714,Jahed Motlagh; Zeinab,40,0,40,0
1708256140033,NANO 108,A00,414740,Lubarda; Vlado,70,0,70,0
1708256140559,NANO 112,A01,414825,Vazquez Mena; Oscar,70,0,70,0
1708256141087,NANO 115L,A01,414830,Yang; Kesong,37,0,38,1
1708256141087,NANO 115L,B01,414832,Xu; Sheng,35,0,38,3
1708256141611,NANO 120B,A01,414835,Vecchio; Kenneth S,33,0,35,2
1708256141611,NANO 120B,B01,414841,Fenning; David,30,0,35,5
1708256142139,NANO 156,A00,414843,Fullerton; Eric E,24,0,30,6
1708256142665,NANO 158,A00,414844,Luo; Jian,29,0,30,1
1708256143192,NANO 175,A00,414850,Steinmetz; Nicole F,30,0,35,5
1708256143717,NANO 200,A00,414852,Jahed Motlagh; Zeinab,118,0,120,2
1708256144243,NANO 241,A00,414854,Pokorski; Jonathan Kyle,18,0,25,7
1708256144771,NANO 262,A00,414858,Wang; Joseph,50,0,50,0
1708256145296,NANO 271,A00,414862,Cubukcu; Ertugrul,22,0,25,3
1708256145821,NANO 272,A00,414877,Xu; Sheng,42,0,50,8
1708256146352,NANO 279,A00,414878,Liu; Ping,32,0,40,8
1708256146879,NANO 282,A00,414879,Steinmetz; Nicole F,30,0,30,0
1708256147408,NEU 200C,A00,455013,Staff,0,0,0,1
1708256147933,NEU 276,A01,479489,Staff,35,0,36,1
1708256148459,NEU 277,A00,479492,Risbrough; Victoria Blythe,0,0,0,0
1708256148984,NEU 296,001,464921,Evans; Sean Jeffrey,48,0,50,2
1708256148984,NEU 296,002,464922,Staff,50,0,50,0
1708256148984,NEU 296,003,464925,Staff,50,0,50,0
1708256149513,NEUG 221,A00,479490,Zheng; Binhai,15,0,15,0
1708256150039,NEUG 280,A00,479491,Chen; Xu,0,0,0,0
1708256150568,NEUG 296,A00,479493,Bloodgood; Brenda Laurie,9998,0,9999,1
1708256151096,OPTH 296,001,465054,Baxter; Sally Liu,49,0,50,1
1708256151096,OPTH 296,002,465068,Afshari; Natalie,49,0,50,1
1708256151096,OPTH 296,003,465074,Staff,50,0,50,0
1708256151625,ORTH 296,A00,465104,Staff,50,0,50,0
1708256151625,ORTH 296,001,465111,Staff,50,0,50,0
1708256151625,ORTH 296,002,465120,Staff,50,0,50,0
1708256152154,PATH 224,A01,494386,Ross; Camille,11,0,12,1
1708256152684,PATH 296,001,465373,Calcutt; Nigel A,49,0,50,1
1708256152684,PATH 296,002,465374,Staff,50,0,50,0
1708256152684,PATH 296,003,465375,Staff,50,0,50,0
1708256153214,PEDS 296,001,465527,Weiss; Katherine Jean,49,0,50,1
1708256153214,PEDS 296,002,465528,Staff,50,0,50,0
1708256153214,PEDS 296,003,465529,Staff,50,0,50,0
1708256153741,PH 196BH,A01,405158,Binkin; Nancy Jeanne,20,0,20,0
1708256154266,PHAR 219,A00,415016,Ross; Camille,1,0,1,0
1708256154792,PHAR 231,A00,415017,Furnari; Frank,20,0,20,0
1708256154792,PHAR 231,B00,415018,Lopez Ramirez; Miguel Alej,20,0,20,0
1708256155323,PHAR 276,A00,415020,Mc Culloch; Andrew Douglas & Amaro; Rommie E,1,0,1,0
1708256155852,PHAR 295,A00,415022,Brown; Joan Heller,15,0,15,0
1708256156377,PHIL 1,A00,415023,Harrell; Maralee Mae,58,0,60,2
1708256156907,PHIL 10,A01,415026,Grush; Rick Scott,40,0,44,4
1708256156907,PHIL 10,A02,415028,Grush; Rick Scott,42,0,44,2
1708256156907,PHIL 10,A03,415029,Grush; Rick Scott,0,0,0,0
1708256156907,PHIL 10,A04,415031,Grush; Rick Scott,0,0,0,0
1708256156907,PHIL 10,A05,415113,Grush; Rick Scott,43,0,44,1
1708256156907,PHIL 10,A06,415114,Grush; Rick Scott,43,0,44,1
1708256156907,PHIL 10,A07,415116,Grush; Rick Scott,44,0,44,0
1708256156907,PHIL 10,A08,415118,Grush; Rick Scott,43,0,44,1
1708256157434,PHIL 12,A01,415120,McKenzie; Kerry V.,28,0,30,2
1708256157434,PHIL 12,A02,415136,McKenzie; Kerry V.,30,0,30,0
1708256157434,PHIL 12,A03,415137,McKenzie; Kerry V.,27,0,30,3
1708256157434,PHIL 12,A04,415142,McKenzie; Kerry V.,30,0,30,0
1708256157966,PHIL 13,A01,415165,Brink; David O.,25,0,25,0
1708256157966,PHIL 13,A02,415179,Brink; David O.,22,0,25,3
1708256157966,PHIL 13,A03,415185,Brink; David O.,24,0,25,1
1708256157966,PHIL 13,A04,415201,Brink; David O.,25,0,25,0
1708256157966,PHIL 13,A05,415204,Brink; David O.,25,0,25,0
1708256157966,PHIL 13,A06,415220,Brink; David O.,25,0,25,0
1708256158499,PHIL 15,A01,415250,Fulkerson; Matthew Todd,26,0,30,4
1708256158499,PHIL 15,A02,415281,Fulkerson; Matthew Todd,29,0,30,1
1708256159033,PHIL 27,A01,415293,Brandt; Reuven A,20,0,25,5
1708256159033,PHIL 27,A02,415296,Brandt; Reuven A,0,0,0,0
1708256159033,PHIL 27,A03,415332,Brandt; Reuven A,22,0,25,3
1708256159033,PHIL 27,A04,415333,Brandt; Reuven A,22,0,25,3
1708256159033,PHIL 27,A05,415342,Brandt; Reuven A,20,0,25,5
1708256159033,PHIL 27,A06,415384,Brandt; Reuven A,24,0,25,1
1708256159033,PHIL 27,A07,415385,Brandt; Reuven A,25,0,25,0
1708256159033,PHIL 27,A08,415391,Brandt; Reuven A,0,0,0,0
1708256159033,PHIL 27,A09,415406,Brandt; Reuven A,0,0,0,0
1708256159033,PHIL 27,A10,415407,Brandt; Reuven A,0,0,0,0
1708256159560,PHIL 28,A01,415412,Lamey; Andy M.,24,0,25,1
1708256159560,PHIL 28,A02,415470,Lamey; Andy M.,20,0,25,5
1708256159560,PHIL 28,A03,415474,Lamey; Andy M.,0,0,0,0
1708256159560,PHIL 28,A04,415475,Lamey; Andy M.,22,0,25,3
1708256159560,PHIL 28,A05,415487,Lamey; Andy M.,24,0,25,1
1708256159560,PHIL 28,A06,415506,Lamey; Andy M.,21,0,25,4
1708256159560,PHIL 28,A07,415507,Lamey; Andy M.,25,0,25,0
1708256159560,PHIL 28,A08,415508,Lamey; Andy M.,24,0,25,1
1708256159560,PHIL 28,A09,415509,Lamey; Andy M.,24,0,25,1
1708256159560,PHIL 28,A10,415510,Lamey; Andy M.,0,0,0,0
1708256160084,PHIL 33,A01,415521,Hardimon; Michael O.,35,0,35,0
1708256160084,PHIL 33,A02,415522,Hardimon; Michael O.,35,0,35,0
1708256160614,PHIL 60,A00,415523,Marechal; Patricia,55,0,60,5
1708256161140,PHIL 102,A00,415524,Johnson; Monte,37,0,40,3
1708256161667,PHIL 106,A00,415544,Watkins; Eric,40,0,40,0
1708256162196,PHIL 112,A00,415545,Watkins; Eric,34,0,40,6
1708256162724,PHIL 115,A00,415548,Nelkin; Dana Kay,20,0,20,0
1708256163249,PHIL 120,A00,415549,Carr; Jennifer Rose,64,0,65,1
1708256163780,PHIL 134,A00,415552,Carr; Jennifer Rose,40,0,40,0
1708256164305,PHIL 150,A00,415553,Cohen; Jonathan David,38,0,40,2
1708256164830,PHIL 171,A00,415561,Brink; David O.,39,0,40,1
1708256165360,PHIL 172,A00,415563,Lamey; Andy M.,40,0,40,0
1708256165886,PHIL 174,A01,415576,Danks; David J,20,0,25,5
1708256165886,PHIL 174,A02,415582,Danks; David J,22,0,25,3
1708256165886,PHIL 174,A03,415583,Danks; David J,24,0,25,1
1708256165886,PHIL 174,A04,415584,Danks; David J,25,0,25,0
1708256166411,PHIL 175,A00,415585,Shields; Christopher John,40,0,40,0
1708256166941,PHIL 181,A00,415601,Tolley; Clinton,34,0,40,6
1708256167471,PHIL 209B,A00,415655,Serlin; David,4,0,5,1
1708256167997,PHIL 209C,A00,415658,Gates; Kelly,5,0,5,0
1708256168526,PHIL 210,A00,415659,Marechal; Patricia,20,0,20,0
1708256169051,PHIL 230,A00,415661,Grush; Rick Scott,20,0,20,0
1708256169578,PHIL 232,A00,415662,Sher; Gila,20,0,20,0
1708256170104,PHIL 260,A00,415675,Bazargan-Forward; Saba,20,0,20,0
1708256170632,PHIL 277,A00,479176,Tolley; Clinton,9,0,10,1
1708256171157,PHIL 285,A00,415685,Kovaka; Karenc,20,0,20,0
1708256171685,PHIL 287,A00,415697,Marechal; Patricia,5,0,5,0
1708256172214,PHIL 290,001,415701,Nelkin; Dana Kay,9999,0,9999,0
1708256172214,PHIL 290,002,415721,Bazargan-Forward; Saba,9999,0,9999,0
1708256172214,PHIL 290,003,415731,Brandt; Reuven A,9999,0,9999,0
1708256172214,PHIL 290,004,415743,Brink; David O.,9999,0,9999,0
1708256172214,PHIL 290,005,415747,Callender; Craig Adam,9999,0,9999,0
1708256172214,PHIL 290,006,415779,Carr; Jennifer Rose,9999,0,9999,0
1708256172214,PHIL 290,007,415780,Cartwright; Nancy D.,9999,0,9999,0
1708256172214,PHIL 290,008,415781,Cohen; Jonathan David,9999,0,9999,0
1708256172214,PHIL 290,009,415782,Danks; David J,9999,0,9999,0
1708256172214,PHIL 290,010,415783,Fulkerson; Matthew Todd,9999,0,9999,0
1708256172214,PHIL 290,011,415784,Grush; Rick Scott,9999,0,9999,0
1708256172214,PHIL 290,012,415785,Hardimon; Michael O.,9999,0,9999,0
1708256172214,PHIL 290,013,415786,Harrell; Maralee Mae,9999,0,9999,0
1708256172214,PHIL 290,014,415787,Johnson; Monte,9999,0,9999,0
1708256172214,PHIL 290,015,415788,Kovaka; Karenc,9999,0,9999,0
1708256172214,PHIL 290,016,415789,Lamey; Andy M.,9999,0,9999,0
1708256172214,PHIL 290,017,415790,Marechal; Patricia,9999,0,9999,0
1708256172214,PHIL 290,018,415791,McKenzie; Kerry V.,9999,0,9999,0
1708256172214,PHIL 290,019,415792,Rickless; Samuel Charles,9999,0,9999,0
1708256172214,PHIL 290,020,415793,Sher; Gila,9999,0,9999,0
1708256172214,PHIL 290,021,415794,Shields; Christopher John,9999,0,9999,0
1708256172214,PHIL 290,022,415805,Tolley; Clinton,9999,0,9999,0
1708256172214,PHIL 290,023,415806,Vargas; Manuel Rogelio,9999,0,9999,0
1708256172214,PHIL 290,024,415807,Watkins; Eric,9999,0,9999,0
1708256172214,PHIL 290,025,415815,Chen; Keming,9999,0,9999,0
1708256172743,PHIL 295,001,415816,Bazargan-Forward; Saba,9999,0,9999,0
1708256172743,PHIL 295,002,415857,Brandt; Reuven A,9999,0,9999,0
1708256172743,PHIL 295,003,415858,Brink; David O.,9999,0,9999,0
1708256172743,PHIL 295,004,415877,Callender; Craig Adam,9999,0,9999,0
1708256172743,PHIL 295,005,415878,Carr; Jennifer Rose,9999,0,9999,0
1708256172743,PHIL 295,006,415884,Cartwright; Nancy D.,9999,0,9999,0
1708256172743,PHIL 295,007,415885,Chen; Keming,9999,0,9999,0
1708256172743,PHIL 295,008,415891,Cohen; Jonathan David,9999,0,9999,0
1708256172743,PHIL 295,009,415892,Danks; David J,9999,0,9999,0
1708256172743,PHIL 295,010,415937,Fulkerson; Matthew Todd,9999,0,9999,0
1708256172743,PHIL 295,011,415940,Grush; Rick Scott,9999,0,9999,0
1708256172743,PHIL 295,012,415945,Hardimon; Michael O.,9999,0,9999,0
1708256172743,PHIL 295,013,415946,Harrell; Maralee Mae,9999,0,9999,0
1708256172743,PHIL 295,014,415953,Johnson; Monte,9999,0,9999,0
1708256172743,PHIL 295,015,415954,Kovaka; Karenc,9999,0,9999,0
1708256172743,PHIL 295,016,415957,Lamey; Andy M.,9999,0,9999,0
1708256172743,PHIL 295,017,415958,Marechal; Patricia,9999,0,9999,0
1708256172743,PHIL 295,018,415959,McKenzie; Kerry V.,9999,0,9999,0
1708256172743,PHIL 295,019,415960,Nelkin; Dana Kay,9999,0,9999,0
1708256172743,PHIL 295,020,415961,Rickless; Samuel Charles,9999,0,9999,0
1708256172743,PHIL 295,021,415987,Sher; Gila,9999,0,9999,0
1708256172743,PHIL 295,022,416027,Shields; Christopher John,9999,0,9999,0
1708256172743,PHIL 295,023,416030,Tolley; Clinton,9999,0,9999,0
1708256172743,PHIL 295,024,416033,Vargas; Manuel Rogelio,9999,0,9999,0
1708256172743,PHIL 295,025,416034,Watkins; Eric,9999,0,9999,0
1708256173270,PHYA 224,A00,442106,Sandstrom; Karin Marie,30,0,30,0
1708256173801,PHYS 1A,A00,441607,Gilbert; Dylan Paul,346,0,362,16
1708256174335,PHYS 1AL,001,441608,Arlett; Jessica Lynn & Yagil; Avi,30,0,30,0
1708256174335,PHYS 1AL,002,441609,Arlett; Jessica Lynn & Yagil; Avi,28,0,30,2
1708256174335,PHYS 1AL,003,441610,Arlett; Jessica Lynn & Yagil; Avi,26,0,30,4
1708256174335,PHYS 1AL,004,441611,Arlett; Jessica Lynn & Yagil; Avi,29,0,30,1
1708256174335,PHYS 1AL,005,441612,Arlett; Jessica Lynn & Yagil; Avi,28,0,30,2
1708256174335,PHYS 1AL,006,441616,Arlett; Jessica Lynn & Yagil; Avi,28,0,30,2
1708256174335,PHYS 1AL,007,441618,Arlett; Jessica Lynn & Yagil; Avi,26,0,30,4
1708256174335,PHYS 1AL,008,441620,Arlett; Jessica Lynn & Yagil; Avi,29,0,30,1
1708256174335,PHYS 1AL,009,441623,Arlett; Jessica Lynn & Yagil; Avi,29,0,30,1
1708256174335,PHYS 1AL,010,441625,Arlett; Jessica Lynn & Yagil; Avi,29,0,30,1
1708256174335,PHYS 1AL,011,441626,Arlett; Jessica Lynn & Yagil; Avi,29,0,30,1
1708256174335,PHYS 1AL,012,441627,Arlett; Jessica Lynn & Yagil; Avi,29,0,30,1
1708256174861,PHYS 1B,A00,441630,Groisman; Alexander,351,0,362,11
1708256175387,PHYS 1BL,001,441632,Arlett; Jessica Lynn & Yagil; Avi,28,0,30,2
1708256175387,PHYS 1BL,002,441634,Arlett; Jessica Lynn & Yagil; Avi,29,0,30,1
1708256175387,PHYS 1BL,003,441636,Arlett; Jessica Lynn & Yagil; Avi,29,0,30,1
1708256175387,PHYS 1BL,004,441637,Arlett; Jessica Lynn & Yagil; Avi,29,0,30,1
1708256175387,PHYS 1BL,005,441639,Arlett; Jessica Lynn & Yagil; Avi,29,0,30,1
1708256175387,PHYS 1BL,006,441641,Arlett; Jessica Lynn & Yagil; Avi,26,0,30,4
1708256175387,PHYS 1BL,007,441642,Arlett; Jessica Lynn & Yagil; Avi,23,0,30,7
1708256175387,PHYS 1BL,008,441643,Arlett; Jessica Lynn & Yagil; Avi,30,0,30,0
1708256175387,PHYS 1BL,009,441646,Arlett; Jessica Lynn & Yagil; Avi,29,0,30,1
1708256175387,PHYS 1BL,010,441648,Arlett; Jessica Lynn & Yagil; Avi,29,0,30,1
1708256175387,PHYS 1BL,011,441652,Arlett; Jessica Lynn & Yagil; Avi,29,0,30,1
1708256175387,PHYS 1BL,012,441654,Arlett; Jessica Lynn & Yagil; Avi,30,0,30,0
1708256175917,PHYS 1C,A00,441658,Popmintchev; Tenio,587,0,600,13
1708256175917,PHYS 1C,B00,441662,Popmintchev; Tenio,558,0,600,42
1708256176459,PHYS 1CL,001,441664,Arlett; Jessica Lynn & Yagil; Avi,29,0,30,1
1708256176459,PHYS 1CL,002,441665,Arlett; Jessica Lynn & Yagil; Avi,27,0,30,3
1708256176459,PHYS 1CL,003,441666,Arlett; Jessica Lynn & Yagil; Avi,25,0,30,5
1708256176459,PHYS 1CL,004,441667,Arlett; Jessica Lynn & Yagil; Avi,30,0,30,0
1708256176459,PHYS 1CL,005,441668,Arlett; Jessica Lynn & Yagil; Avi,28,0,30,2
1708256176459,PHYS 1CL,006,441669,Arlett; Jessica Lynn & Yagil; Avi,25,0,30,5
1708256176459,PHYS 1CL,007,441671,Arlett; Jessica Lynn & Yagil; Avi,27,0,30,3
1708256176459,PHYS 1CL,008,441673,Arlett; Jessica Lynn & Yagil; Avi,30,0,30,0
1708256176459,PHYS 1CL,009,441674,Arlett; Jessica Lynn & Yagil; Avi,26,0,30,4
1708256176459,PHYS 1CL,010,441676,Arlett; Jessica Lynn & Yagil; Avi,30,0,30,0
1708256176459,PHYS 1CL,011,441677,Arlett; Jessica Lynn & Yagil; Avi,30,0,30,0
1708256176459,PHYS 1CL,012,441683,Arlett; Jessica Lynn & Yagil; Avi,30,0,30,0
1708256176459,PHYS 1CL,013,441685,Arlett; Jessica Lynn & Yagil; Avi,28,0,30,2
1708256176459,PHYS 1CL,014,441687,Arlett; Jessica Lynn & Yagil; Avi,30,0,30,0
1708256176459,PHYS 1CL,015,441689,Arlett; Jessica Lynn & Yagil; Avi,17,0,30,13
1708256176459,PHYS 1CL,016,441692,Arlett; Jessica Lynn & Yagil; Avi,29,0,30,1
1708256176459,PHYS 1CL,017,441696,Arlett; Jessica Lynn & Yagil; Avi,24,0,30,6
1708256176459,PHYS 1CL,018,441698,Arlett; Jessica Lynn & Yagil; Avi,25,0,30,5
1708256176459,PHYS 1CL,019,441702,Arlett; Jessica Lynn & Yagil; Avi,25,0,30,5
1708256176459,PHYS 1CL,020,441705,Arlett; Jessica Lynn & Yagil; Avi,29,0,30,1
1708256176459,PHYS 1CL,021,441706,Arlett; Jessica Lynn & Yagil; Avi,30,0,30,0
1708256176459,PHYS 1CL,022,441707,Arlett; Jessica Lynn & Yagil; Avi,30,0,30,0
1708256176459,PHYS 1CL,023,441708,Arlett; Jessica Lynn & Yagil; Avi,27,0,30,3
1708256176459,PHYS 1CL,024,441710,Arlett; Jessica Lynn & Yagil; Avi,29,0,30,1
1708256176459,PHYS 1CL,025,441711,Arlett; Jessica Lynn & Yagil; Avi,28,0,30,2
1708256176459,PHYS 1CL,026,441712,Arlett; Jessica Lynn & Yagil; Avi,29,0,30,1
1708256176459,PHYS 1CL,027,441713,Arlett; Jessica Lynn & Yagil; Avi,26,0,30,4
1708256176459,PHYS 1CL,028,441714,Arlett; Jessica Lynn & Yagil; Avi,29,0,30,1
1708256176459,PHYS 1CL,029,441715,Arlett; Jessica Lynn & Yagil; Avi,25,0,30,5
1708256176459,PHYS 1CL,030,441717,Arlett; Jessica Lynn & Yagil; Avi,29,0,30,1
1708256176459,PHYS 1CL,031,441718,Arlett; Jessica Lynn & Yagil; Avi,27,0,30,3
1708256176459,PHYS 1CL,032,441721,Arlett; Jessica Lynn & Yagil; Avi,30,0,30,0
1708256176459,PHYS 1CL,033,441724,Arlett; Jessica Lynn & Yagil; Avi,28,0,30,2
1708256176459,PHYS 1CL,034,441726,Arlett; Jessica Lynn & Yagil; Avi,29,0,30,1
1708256176459,PHYS 1CL,035,441728,Arlett; Jessica Lynn & Yagil; Avi,29,0,30,1
1708256176459,PHYS 1CL,036,441729,Arlett; Jessica Lynn & Yagil; Avi,30,0,30,0
1708256176459,PHYS 1CL,037,441730,Arlett; Jessica Lynn & Yagil; Avi,27,0,30,3
1708256176459,PHYS 1CL,038,441732,Arlett; Jessica Lynn & Yagil; Avi,29,0,30,1
1708256176459,PHYS 1CL,039,441733,Arlett; Jessica Lynn & Yagil; Avi,27,0,30,3
1708256176459,PHYS 1CL,040,441734,Arlett; Jessica Lynn & Yagil; Avi,30,0,30,0
1708256176459,PHYS 1CL,041,441735,Arlett; Jessica Lynn & Yagil; Avi,29,0,30,1
1708256176459,PHYS 1CL,042,441766,Arlett; Jessica Lynn & Yagil; Avi,30,0,30,0
1708256176459,PHYS 1CL,043,441768,Arlett; Jessica Lynn & Yagil; Avi,29,0,30,1
1708256176459,PHYS 1CL,044,441770,Arlett; Jessica Lynn & Yagil; Avi,30,0,30,0
1708256176986,PHYS 2A,A01,460308,Bal; Gurleen K,28,0,30,2
1708256176986,PHYS 2A,A02,460320,Bal; Gurleen K,30,0,30,0
1708256176986,PHYS 2A,A03,460321,Bal; Gurleen K,29,0,30,1
1708256176986,PHYS 2A,A04,460325,Bal; Gurleen K,28,0,30,2
1708256176986,PHYS 2A,A05,460326,Bal; Gurleen K,29,0,30,1
1708256176986,PHYS 2A,A06,460327,Bal; Gurleen K,30,0,30,0
1708256176986,PHYS 2A,A07,460495,Bal; Gurleen K,28,0,30,2
1708256176986,PHYS 2A,A08,460535,Bal; Gurleen K,27,0,30,3
1708256176986,PHYS 2A,A09,460536,Bal; Gurleen K,30,0,30,0
1708256176986,PHYS 2A,A10,460537,Bal; Gurleen K,30,0,30,0
1708256176986,PHYS 2A,A11,460538,Bal; Gurleen K,30,0,30,0
1708256176986,PHYS 2A,A12,460539,Bal; Gurleen K,30,0,30,0
1708256177518,PHYS 2B,A01,460620,Barreiro Guerrero; Julio,30,0,30,0
1708256177518,PHYS 2B,A02,460625,Barreiro Guerrero; Julio,30,0,30,0
1708256177518,PHYS 2B,A03,460626,Barreiro Guerrero; Julio,29,0,30,1
1708256177518,PHYS 2B,A04,460716,Barreiro Guerrero; Julio,26,0,30,4
1708256177518,PHYS 2B,A05,460756,Barreiro Guerrero; Julio,29,0,30,1
1708256177518,PHYS 2B,A06,460837,Barreiro Guerrero; Julio,30,0,30,0
1708256177518,PHYS 2B,A07,460865,Barreiro Guerrero; Julio,30,0,30,0
1708256177518,PHYS 2B,A08,460866,Barreiro Guerrero; Julio,30,0,30,0
1708256177518,PHYS 2B,A09,460867,Barreiro Guerrero; Julio,29,0,30,1
1708256177518,PHYS 2B,A10,460868,Barreiro Guerrero; Julio,30,0,30,0
1708256177518,PHYS 2B,A11,460869,Barreiro Guerrero; Julio,30,0,30,0
1708256177518,PHYS 2B,A12,460874,Barreiro Guerrero; Julio,30,0,30,0
1708256177518,PHYS 2B,B01,469381,Barreiro Guerrero; Julio,30,0,30,0
1708256177518,PHYS 2B,B02,469382,Barreiro Guerrero; Julio,29,0,30,1
1708256177518,PHYS 2B,B03,469402,Barreiro Guerrero; Julio,27,0,30,3
1708256177518,PHYS 2B,B04,469403,Barreiro Guerrero; Julio,28,0,30,2
1708256177518,PHYS 2B,B05,469442,Barreiro Guerrero; Julio,30,0,30,0
1708256177518,PHYS 2B,B06,469449,Barreiro Guerrero; Julio,30,0,30,0
1708256177518,PHYS 2B,B07,469450,Barreiro Guerrero; Julio,29,0,30,1
1708256177518,PHYS 2B,B08,469451,Barreiro Guerrero; Julio,30,0,30,0
1708256177518,PHYS 2B,B09,469457,Barreiro Guerrero; Julio,29,0,30,1
1708256177518,PHYS 2B,B10,469460,Barreiro Guerrero; Julio,30,0,30,0
1708256177518,PHYS 2B,B11,469468,Barreiro Guerrero; Julio,30,0,30,0
1708256177518,PHYS 2B,B12,469475,Barreiro Guerrero; Julio,30,0,30,0
1708256178049,PHYS 2BL,A01,441779,Meyertholen; Andrew D.,21,0,24,3
1708256178049,PHYS 2BL,A02,441780,Meyertholen; Andrew D.,17,0,24,7
1708256178049,PHYS 2BL,A03,441781,Meyertholen; Andrew D.,20,0,24,4
1708256178049,PHYS 2BL,A04,441782,Meyertholen; Andrew D.,21,0,24,3
1708256178049,PHYS 2BL,A05,441784,Meyertholen; Andrew D.,23,0,24,1
1708256178049,PHYS 2BL,A06,441786,Meyertholen; Andrew D.,23,0,24,1
1708256178049,PHYS 2BL,A07,441788,Meyertholen; Andrew D.,23,0,24,1
1708256178049,PHYS 2BL,A08,441790,Meyertholen; Andrew D.,24,0,24,0
1708256178049,PHYS 2BL,A09,441792,Meyertholen; Andrew D.,24,0,24,0
1708256178049,PHYS 2BL,A10,441794,Meyertholen; Andrew D.,23,0,24,1
1708256178049,PHYS 2BL,A11,441796,Meyertholen; Andrew D.,22,0,24,2
1708256178049,PHYS 2BL,A12,441798,Meyertholen; Andrew D.,24,0,24,0
1708256178049,PHYS 2BL,A13,441800,Meyertholen; Andrew D.,24,0,24,0
1708256178049,PHYS 2BL,A14,441802,Meyertholen; Andrew D.,24,0,24,0
1708256178049,PHYS 2BL,A15,441804,Meyertholen; Andrew D.,23,0,24,1
1708256178577,PHYS 2C,A01,460540,Tan; Tzer Han,30,0,30,0
1708256178577,PHYS 2C,A02,460541,Tan; Tzer Han,28,0,30,2
1708256178577,PHYS 2C,A03,460542,Tan; Tzer Han,28,0,30,2
1708256178577,PHYS 2C,A04,460543,Tan; Tzer Han,28,0,30,2
1708256178577,PHYS 2C,A05,460544,Tan; Tzer Han,28,0,30,2
1708256178577,PHYS 2C,A06,460545,Tan; Tzer Han,29,0,30,1
1708256178577,PHYS 2C,A07,460553,Tan; Tzer Han,30,0,30,0
1708256178577,PHYS 2C,A08,460561,Tan; Tzer Han,30,0,30,0
1708256178577,PHYS 2C,A09,460562,Tan; Tzer Han,28,0,30,2
1708256178577,PHYS 2C,A10,460563,Tan; Tzer Han,29,0,30,1
1708256178577,PHYS 2C,A11,460567,Tan; Tzer Han,30,0,30,0
1708256178577,PHYS 2C,A12,460568,Tan; Tzer Han,28,0,30,2
1708256179108,PHYS 2CL,A01,441809,Ni; Kaixuan,25,0,28,3
1708256179108,PHYS 2CL,A02,441811,Ni; Kaixuan,27,0,28,1
1708256179108,PHYS 2CL,A03,441814,Ni; Kaixuan,23,0,28,5
1708256179108,PHYS 2CL,A04,441817,Ni; Kaixuan,28,0,28,0
1708256179108,PHYS 2CL,A05,441819,Ni; Kaixuan,26,0,28,2
1708256179108,PHYS 2CL,A06,441820,Ni; Kaixuan,27,0,28,1
1708256179634,PHYS 2D,A01,460569,Sharma; Vivek A.,24,0,25,1
1708256179634,PHYS 2D,A02,460574,Sharma; Vivek A.,24,0,25,1
1708256179634,PHYS 2D,A03,460575,Sharma; Vivek A.,25,0,25,0
1708256180161,PHYS 4B,A01,441829,Grinstein; Benjamin,34,0,38,4
1708256180161,PHYS 4B,A02,441831,Grinstein; Benjamin,30,0,32,2
1708256180161,PHYS 4B,A03,441832,Grinstein; Benjamin,30,0,30,0
1708256180161,PHYS 4B,A04,441833,Grinstein; Benjamin,30,0,30,0
1708256180690,PHYS 4E,A01,441907,Frano Pereira; Alex M,33,0,34,1
1708256180690,PHYS 4E,A02,441958,Frano Pereira; Alex M,34,0,34,0
1708256181214,PHYS 10,A01,441971,Burgasser; Adam Jonathan,118,0,120,2
1708256181740,PHYS 13,A01,441974,Wright; Shelley Adams,61,0,65,4
1708256182265,PHYS 87,A00,486898,Grinstein; Benjamin,19,0,20,1
1708256182795,PHYS 100C,A01,441978,Averitt; Richard Douglas,58,0,60,2
1708256183325,PHYS 105B,A01,441985,Green; Daniel Richard,37,0,40,3
1708256183851,PHYS 120,A01,441995,Arnold; Kam S,40,0,44,4
1708256183851,PHYS 120,A02,442011,Arnold; Kam S,41,0,44,3
1708256184381,PHYS 130A,A01,442032,Parker; Daniel E,74,0,75,1
1708256184907,PHYS 130B,A01,442056,Branson; James G,47,0,50,3
1708256185435,PHYS 139,A00,442057,Jun; Suckjoon,30,0,30,0
1708256185435,PHYS 139,B00,442059,Duarte; Javier Mauricio & Li; Aobo,42,0,50,8
1708256186031,PHYS 140A,A01,442065,Shotwell; Brian,49,0,50,1
1708256186560,PHYS 152B,A01,442067,Hirsch; Jorge Eduardo,16,0,20,4
1708256187090,PHYS 154,A01,442069,Jenkins; Elizabeth,29,0,30,1
1708256187616,PHYS 162,A01,442096,Keating; Brian,64,0,65,1
1708256188145,PHYS 170,A01,486870,Oh; Seungeun,39,0,40,1
1708256188671,PHYS 177,A00,442103,Dudko; Olga,20,0,20,0
1708256189196,PHYS 203B,A01,442132,Fogler; Michael M.,20,0,20,0
1708256189725,PHYS 210A,A01,442143,Hwa; Terence T.,20,0,20,0
1708256190249,PHYS 212C,A01,442200,Chivukula; Raja S,18,0,20,2
1708256190779,PHYS 215C,A00,442201,Intriligator; Kenneth Arthur,19,0,20,1
1708256191305,PHYS 225C,A01,442203,Flauger; Raphael M,19,0,20,1
1708256191830,PHYS 227,A00,442204,Tytler; David Robert,29,0,30,1
1708256192359,PHYS 230,A01,442206,McGreevy; John A.,20,0,20,0
1708256192888,PHYS 239,A00,442207,Goldenfeld; Nigel,20,0,20,0
1708256192888,PHYS 239,B00,442208,Duarte; Javier Mauricio & Li; Aobo,5,0,5,0
1708256193419,PHYS 244,A01,442280,Norman; Michael L,12,0,20,8
1708256193948,PHYS 250,A00,442300,Fogler; Michael M.,50,0,50,0
1708256194476,PHYS 251,A00,442307,Grinstein; Benjamin,20,0,20,0
1708256195004,PHYS 252,A00,442348,Diamond; Patrick H,10,0,10,0
1708256195530,PHYS 253,A00,442349,Theissen; Christopher Alexander,30,0,30,0
1708256196056,PHYS 254,A00,442352,Hwa; Terence T.,30,0,30,0
1708256196582,PHYS 255,A00,442423,Hwa; Terence T.,30,0,30,0
1708256197110,PHYS 258,A00,442426,Theissen; Christopher Alexander,30,0,30,0
1708256197639,PHYS 260,A00,442427,Frano Pereira; Alex M,50,0,50,0
1708256198165,PHYS 277,A00,442428,Dudko; Olga,20,0,20,0
1708256198696,POLI 5D,A01,419010,Dai; Yinlin,5,0,7,2
1708256198696,POLI 5D,A02,419020,Dai; Yinlin,7,0,7,0
1708256198696,POLI 5D,A03,419022,Dai; Yinlin,4,0,6,2
1708256198696,POLI 5D,A04,419040,Dai; Yinlin,5,0,5,0
1708256198696,POLI 5D,B01,419065,Dai; Yinlin,7,0,7,0
1708256198696,POLI 5D,B02,419068,Dai; Yinlin,7,0,7,0
1708256198696,POLI 5D,B03,419069,Dai; Yinlin,6,0,6,0
1708256198696,POLI 5D,B04,419070,Dai; Yinlin,5,0,5,0
1708256198696,POLI 5D,C01,487211,Staff,3,0,5,2
1708256199227,POLI 11D,A01,419072,Desposato; Scott,32,0,34,2
1708256199227,POLI 11D,A02,419073,Desposato; Scott,33,0,34,1
1708256199227,POLI 11D,A03,419082,Desposato; Scott,32,0,34,2
1708256199227,POLI 11D,A04,419123,Desposato; Scott,34,0,34,0
1708256199227,POLI 11D,A05,419124,Desposato; Scott,34,0,34,0
1708256199227,POLI 11D,A06,419125,Desposato; Scott,34,0,34,0
1708256199753,POLI 12D,A01,419127,Gartzke; Erik,29,0,34,5
1708256199753,POLI 12D,A02,419128,Gartzke; Erik,34,0,34,0
1708256199753,POLI 12D,A03,419129,Gartzke; Erik,34,0,34,0
1708256199753,POLI 12D,A04,419130,Gartzke; Erik,34,0,34,0
1708256199753,POLI 12D,A05,419131,Gartzke; Erik,32,0,34,2
1708256199753,POLI 12D,A06,419168,Gartzke; Erik,34,0,34,0
1708256200282,POLI 13DR,A01,477733,Draper; Matthew William,28,0,34,6
1708256200282,POLI 13DR,A02,477734,Draper; Matthew William,32,0,34,2
1708256200282,POLI 13DR,A03,477736,Draper; Matthew William,33,0,34,1
1708256200282,POLI 13DR,A04,477737,Draper; Matthew William,32,0,34,2
1708256200282,POLI 13DR,A05,477739,Draper; Matthew William,31,0,34,3
1708256200282,POLI 13DR,A06,477740,Draper; Matthew William,34,0,34,0
1708256200811,POLI 30D,A01,419179,Desposato; Scott,19,0,28,9
1708256200811,POLI 30D,A02,419180,Desposato; Scott,25,0,28,3
1708256200811,POLI 30D,A03,419181,Desposato; Scott,27,0,28,1
1708256200811,POLI 30D,A04,419182,Desposato; Scott,28,0,28,0
1708256200811,POLI 30D,A05,419187,Desposato; Scott,24,0,28,4
1708256200811,POLI 30D,A06,419189,Desposato; Scott,28,0,28,0
1708256201338,POLI 100E,A00,419191,Pitcher; Kennedy Anell,105,0,115,10
1708256201864,POLI 104P,A00,419192,Orfield; Michael Bennett,183,0,196,13
1708256202395,POLI 104U,A00,419193,Nichter; Maysa,88,0,115,27
1708256202921,POLI 108,A00,419194,Adida; Claire,293,0,295,2
1708256203448,POLI 110C,A00,419195,Soon; Valerie,47,0,50,3
1708256203973,POLI 120D,A00,419207,Hansen; Jan Eric,48,0,50,2
1708256204502,POLI 124A,A00,419209,Fortunato; David,48,0,50,2
1708256205028,POLI 131CR,A00,419211,Hoston; Germaine,41,0,50,9
1708256205028,POLI 131CR,B00,481592,Hoston; Germaine,10,0,10,0
1708256205557,POLI 136A,A00,419212,Roeder; Philip G,111,0,115,4
1708256206082,POLI 140D,A00,419213,Wong; Tak Kei,183,0,192,9
1708256206607,POLI 142D,A00,419214,Gartzke; Erik,227,0,230,3
1708256207137,POLI 145C,A00,419222,Fisk; David Lee,101,0,115,14
1708256207662,POLI 150A,A00,419225,Wong; Tak Kei,216,0,230,14
1708256208192,POLI 170A,A00,419226,Skillman; Rachel Diane,115,0,115,0
1708256208717,POLI 179,A00,419238,Staff,95,0,104,9
1708256209245,POLI 194,A00,455332,Hill; Seth J,0,0,0,0
1708256209771,POLI 194SD,A00,419248,Nichter; Maysa,999,0,999,0
1708256210299,POLI 197SD,001,419258,Nichter; Maysa,999,0,999,0
1708256210825,POLI 203B,A00,419265,Slantchev; Branislav,21,0,25,4
1708256211350,POLI 214R,A00,419275,Hoston; Germaine,23,0,25,2
1708256211879,POLI 219,A00,419289,Soon; Valerie,24,0,25,1
1708256212410,POLI 220A,A00,419299,Ferree; Karen E,21,0,25,4
1708256212935,POLI 233,A00,419333,Adida; Claire,23,0,25,2
1708256213463,POLI 243,A00,479118,Joseph; Michael F,23,0,25,2
1708256213987,POLI 251,A00,419334,Ban; Pamela M,23,0,25,2
1708256214515,POLI 257,A00,419335,Hill; Seth J,25,0,25,0
1708256215040,POLI 273,A00,419336,Mignozzetti; Umberto,16,0,25,9
1708256215565,POLI 280,A00,419337,Hafner-Burton; Emilie,18,0,25,7
1708256216090,POLI 281,A00,419338,Ban; Pamela M,21,0,25,4
1708256216617,POLI 282,A00,419339,Ferree; Karen E,19,0,25,6
1708256217141,POLI 283,A00,419340,Naoi; Megumi,23,0,25,2
1708256217669,POLI 285,A00,419341,Ingham; Sean,25,0,25,0
1708256218193,POLI 286,A00,419342,Mignozzetti; Umberto,23,0,25,2
1708256218722,POLI 288,A00,479174,Fowler; James,13,0,15,2
1708256219248,PSY 296,001,465760,Besterman; Aaron David,49,0,50,1
1708256219248,PSY 296,002,465765,Eyler; Lisa T.,49,0,50,1
1708256219248,PSY 296,003,465767,Patel; Ekta Himanshu,49,0,50,1
1708256219775,PSYC 3R,A00,419378,Pilegard; Celeste Cristine,314,0,325,11
1708256220299,PSYC 7,A00,419384,Powell; Lindsey Jane,288,0,295,7
1708256220835,PSYC 60,A01,460208,Lowe; Angela Beth,31,0,35,4
1708256220835,PSYC 60,A02,460209,Lowe; Angela Beth,28,0,35,7
1708256220835,PSYC 60,A03,460210,Lowe; Angela Beth,35,0,35,0
1708256220835,PSYC 60,A04,460211,Lowe; Angela Beth,33,0,35,2
1708256220835,PSYC 60,A05,460212,Lowe; Angela Beth,34,0,35,1
1708256220835,PSYC 60,A06,460213,Lowe; Angela Beth,35,0,35,0
1708256220835,PSYC 60,A07,460214,Lowe; Angela Beth,33,0,35,2
1708256220835,PSYC 60,B01,460215,Rose; Fred E.,35,0,35,0
1708256220835,PSYC 60,B02,460216,Rose; Fred E.,35,0,35,0
1708256220835,PSYC 60,B03,460218,Rose; Fred E.,35,0,35,0
1708256220835,PSYC 60,B04,460219,Rose; Fred E.,35,0,35,0
1708256220835,PSYC 60,B05,460220,Rose; Fred E.,32,0,35,3
1708256220835,PSYC 60,B06,460221,Rose; Fred E.,35,0,35,0
1708256220835,PSYC 60,B07,460222,Rose; Fred E.,35,0,35,0
1708256221360,PSYC 70,A01,460223,Pilegard; Celeste Cristine,29,0,35,6
1708256221360,PSYC 70,A02,460224,Pilegard; Celeste Cristine,32,0,35,3
1708256221360,PSYC 70,A03,460225,Pilegard; Celeste Cristine,34,0,35,1
1708256221360,PSYC 70,A04,460266,Pilegard; Celeste Cristine,33,0,35,2
1708256221360,PSYC 70,A05,460267,Pilegard; Celeste Cristine,35,0,35,0
1708256221360,PSYC 70,A06,460277,Pilegard; Celeste Cristine,34,0,35,1
1708256221890,PSYC 71,A01,419620,Staff,19,0,21,2
1708256221890,PSYC 71,A02,419662,Staff,20,0,21,1
1708256221890,PSYC 71,B01,419682,Geller; Emma Harlan,24,0,25,1
1708256221890,PSYC 71,B02,419732,Geller; Emma Harlan,26,0,26,0
1708256222417,PSYC 88,A00,419733,Dobkins; Karen R.,47,0,65,18
1708256222942,PSYC 100,A00,419734,Chapman; Eddie Nathaniel,388,0,410,22
1708256223469,PSYC 101,A00,419735,Walker; Caren Michelle,272,0,295,23
1708256223993,PSYC 102,A00,419779,Moranton; Nirelia Melbina-,292,0,295,3
1708256224524,PSYC 104,A00,419880,Fine; Rachel,267,0,295,28
1708256225053,PSYC 105,A00,419946,Lowe; Angela Beth,276,0,295,19
1708256225582,PSYC 111B,A01,419948,Geller; Emma Harlan,35,0,35,0
1708256226107,PSYC 116C,A01,420046,Lang; Ariel,25,0,25,0
1708256226635,PSYC 117,A01,420092,Bajic; Daniel Andrew,25,0,25,0
1708256227161,PSYC 118,A01,420095,Miller; Cory T.,37,0,45,8
1708256227686,PSYC 124,A00,420096,Chapman; Eddie Nathaniel,381,0,410,29
1708256228215,PSYC 127,A00,420097,Dickenson; Janna Alene,14,0,20,6
1708256228743,PSYC 132,A00,420121,Staff,114,0,120,6
1708256229268,PSYC 133R,A01,420172,Golden; Susan S. & Gorman; Michael R.,10,0,16,6
1708256229268,PSYC 133R,A02,420173,Golden; Susan S. & Gorman; Michael R.,16,0,16,0
1708256229268,PSYC 133R,A03,420175,Golden; Susan S. & Gorman; Michael R.,16,0,16,0
1708256229268,PSYC 133R,A04,420249,Golden; Susan S. & Gorman; Michael R.,13,0,16,3
1708256229793,PSYC 134,A00,420311,Kaye; Walter H.,296,0,300,4
1708256230318,PSYC 137,A00,420312,Lin; Chujun,292,0,295,3
1708256230843,PSYC 144,A00,420313,Wixted; John T,287,0,295,8
1708256231371,PSYC 147,A00,420315,Wong; Lauren Hitomi,120,0,146,26
1708256231897,PSYC 164,A00,420328,Kaplan; Paul,259,0,295,36
1708256232422,PSYC 172,A00,420336,Dickenson; Janna Alene,294,0,300,6
1708256232950,PSYC 178,A00,420337,Glaser; Dale,131,0,146,15
1708256233479,PSYC 179,A00,420338,Lacefield; Katharine I,256,0,328,72
1708256234004,PSYC 181,A00,420339,Anagnostaras; Stephan,333,0,350,17
1708256234529,PSYC 184,A00,420367,Wilson; Brent M,275,0,295,20
1708256235054,PSYC 188,A00,420368,Lacefield; Katharine I,234,0,300,66
1708256235585,PSYC 190,A00,420378,Barner; David A.,374,0,395,21
1708256236114,PSYC 193,B00,420626,Brashier; Nadia Marie,215,0,216,1
1708256236114,PSYC 193,C00,420643,Gremel; Christina M,33,0,35,2
1708256236645,PSYC 193L,A01,420817,Brown; Sandra A,65,0,65,0
1708256236645,PSYC 193L,B01,420830,Staff,26,0,30,4
1708256236645,PSYC 193L,C01,420832,Staff,49,0,49,0
1708256236645,PSYC 193L,D01,420834,Staff,27,0,30,3
1708256236645,PSYC 193L,E01,493996,Aron; Adam,24,0,24,0
1708256237174,PSYC 194C,A01,420905,Heyman; Gail D.,1,0,1,0
1708256237703,PSYC 205,A00,420906,Harris; Christine Renee,17,0,20,3
1708256238228,PSYC 218,A00,420907,Brady; Timothy Francis,11,0,20,9
1708256238757,PSYC 224,A00,420908,Gremel; Christina M,30,0,30,0
1708256239338,PSYC 242,A00,421469,Walker; Caren Michelle,27,0,30,3
1708256239863,PSYC 247,A00,421473,Walker; Caren Michelle,14,0,20,6
1708256240391,PSYC 270C,A00,421554,Dobkins; Karen R.,13,0,20,7
1708256241931,PSYC 272,A00,421561,Gentner; Tim,20,0,20,0
1708256242459,PSYC 274,A00,421564,McCullough; Michael E,29,0,30,1
1708256242984,PSYC 275,A00,421620,Staff,23,0,30,7
1708256243511,PSYC 276,A00,421622,McCullough; Michael E,14,0,20,6
1708256244036,PSYC 280,A00,421623,Serences; John Thomas,76,0,85,9
1708256244608,PSYC 296,001,421667,Anagnostaras; Stephan,9999,0,9999,0
1708256244608,PSYC 296,002,421773,Aron; Adam,9999,0,9999,0
1708256244608,PSYC 296,003,421794,Mukku; Dhananjaya,9999,0,9999,0
1708256244608,PSYC 296,004,421795,Barner; David A.,9998,0,9999,1
1708256244608,PSYC 296,005,421796,Schachner; Adena,9999,0,9999,0
1708256244608,PSYC 296,006,421797,Brown; Sandra A,9999,0,9999,0
1708256244608,PSYC 296,007,421798,Chapman; Eddie Nathaniel,9999,0,9999,0
1708256244608,PSYC 296,008,421799,Dickenson; Janna Alene,9999,0,9999,0
1708256244608,PSYC 296,009,421800,Dobkins; Karen R.,9998,0,9999,1
1708256244608,PSYC 296,010,421801,Fan; Judith Ellen,9999,0,9999,0
1708256244608,PSYC 296,011,421803,Ferreira; Victor,9999,0,9999,0
1708256244608,PSYC 296,012,421814,Geller; Emma Harlan,9998,0,9999,1
1708256244608,PSYC 296,013,422102,Gentner; Tim,9999,0,9999,0
1708256244608,PSYC 296,014,422103,Gorman; Michael R.,9999,0,9999,0
1708256244608,PSYC 296,015,422104,Gremel; Christina M,9999,0,9999,0
1708256244608,PSYC 296,016,422106,Harris; Christine Renee,9999,0,9999,0
1708256244608,PSYC 296,017,422107,Heyman; Gail D.,9999,0,9999,0
1708256244608,PSYC 296,018,422108,McCullough; Michael E,9999,0,9999,0
1708256244608,PSYC 296,019,422109,Mc Kenzie; Craig R.M.,9999,0,9999,0
1708256244608,PSYC 296,020,422122,Miller; Cory T.,9999,0,9999,0
1708256244608,PSYC 296,021,422123,Pashler; Harold E,9999,0,9999,0
1708256244608,PSYC 296,022,422124,Pilegard; Celeste Cristine,9999,0,9999,0
1708256244608,PSYC 296,023,422125,Powell; Lindsey Jane,9999,0,9999,0
1708256244608,PSYC 296,025,422127,Rickard; Timothy C.,9998,0,9999,1
1708256244608,PSYC 296,026,422128,Serences; John Thomas,9998,0,9999,1
1708256244608,PSYC 296,027,422130,Walker; Caren Michelle,9998,0,9999,1
1708256244608,PSYC 296,028,422132,Winkielman; Piotr,9999,0,9999,0
1708256244608,PSYC 296,029,422134,Wixted; John T,9996,0,9999,3
1708256244608,PSYC 296,030,422146,Brady; Timothy Francis,9998,0,9999,1
1708256244608,PSYC 296,031,422154,Carver; Leslie J.,9999,0,9999,0
1708256244608,PSYC 296,032,422161,Lin; Chujun,9999,0,9999,0
1708256244608,PSYC 296,033,422169,Brashier; Nadia Marie,9998,0,9999,1
1708256244608,PSYC 296,034,422177,Oesch; Nicholas W,9999,0,9999,0
1708256245133,RAD 296,001,465795,Staff,50,0,50,0
1708256245133,RAD 296,002,465796,Staff,50,0,50,0
1708256245133,RAD 296,003,465797,Staff,50,0,50,0
1708256245661,RELI 150,A00,419353,Rahimi; Babak,37,0,40,3
1708256246192,REV 87,A00,422721,Lyon; Antony J.,19,0,20,1
1708256246717,RMAS 296,001,465827,Murphy; James D,49,0,50,1
1708256246717,RMAS 296,002,465828,Staff,50,0,50,0
1708256246717,RMAS 296,003,465831,Staff,50,0,50,0
1708256247243,RMED 296,001,466791,Staff,50,0,50,0
1708256247243,RMED 296,002,466792,Staff,50,0,50,0
1708256247243,RMED 296,003,466793,Staff,50,0,50,0
1708256247775,SE 3,A01,446938,Van Den Einde; Yael Dahlia,50,0,52,2
1708256247775,SE 3,A02,446942,Van Den Einde; Yael Dahlia,49,0,52,3
1708256247775,SE 3,A03,446948,Van Den Einde; Yael Dahlia,52,0,53,1
1708256247775,SE 3,A04,446965,Van Den Einde; Yael Dahlia,53,0,53,0
1708256248317,SE 9,A01,447015,Kuester; Falko,30,0,34,4
1708256248317,SE 9,A02,447017,Kuester; Falko,33,0,33,0
1708256248317,SE 9,A03,447022,Kuester; Falko,31,0,33,2
1708256248862,SE 101B,A01,447040,Kosmatka; John B,55,0,56,1
1708256249387,SE 105,A01,447042,Qiao; Yu,118,0,120,2
1708256249913,SE 110A,A01,467467,Asaro; Robert J,56,0,56,0
1708256250442,SE 110B,A00,447045,Zhu; Qiang,122,0,125,3
1708256250974,SE 130B,A01,447049,Chadha; Mayank,92,0,100,8
1708256251501,SE 131A,A01,447059,Krysl; Petr,102,0,110,8
1708256252043,SE 132,A01,447078,Chen; Jiun-Shyan,48,0,50,2
1708256252809,SE 140B,A01,447086,Restrepo; Jose,29,0,34,5
1708256252809,SE 140B,A02,447123,Restrepo; Jose,21,0,33,12
1708256252809,SE 140B,A03,447124,Restrepo; Jose,30,0,33,3
1708256253349,SE 143B,A01,447133,Tehrani; Mehran,11,0,15,4
1708256253349,SE 143B,A02,447134,Tehrani; Mehran,12,0,15,3
1708256253896,SE 150A,A01,447136,Uang; Chia-Ming,94,0,100,6
1708256254422,SE 150B,A01,447214,Morrison; Machel Leigh,49,0,50,1
1708256254963,SE 151B,A00,447215,Shing; P. Benson,71,0,75,4
1708256255488,SE 160B,A01,467468,Kim; Hyunsun Alicia,91,0,100,9
1708256256017,SE 165,A00,447238,Farrar; Charles R.,9,0,10,1
1708256256543,SE 184,A00,447253,Hutchinson; Tara,20,0,20,0
1708256257068,SE 202,A00,447392,Kosmatka; John B,25,0,30,5
1708256257593,SE 204,A00,447482,Todd; Michael,12,0,20,8
1708256258120,SE 206,A00,447483,Conte; Joel P,30,0,30,0
1708256258650,SE 213,A00,447499,Palermo; Alessandro,17,0,30,13
1708256259176,SE 215,A00,447500,Zhu; Qiang,34,0,45,11
1708256259701,SE 222,A00,447507,Elgamal; Ahmed,30,0,30,0
1708256260235,SE 227,A00,447576,Hutchinson; Tara,20,0,25,5
1708256260762,SE 244,A00,447577,Elgamal; Ahmed,29,0,30,1
1708256261290,SE 247,A00,447580,Hutchinson; Tara,0,0,5,5
1708256261815,SE 251B,A00,447612,Qiao; Yu,15,0,25,10
1708256262339,SE 253B,A00,447613,Kim; Hyonny,28,0,30,2
1708256262865,SE 260B,A00,447614,Kim; Hyunsun Alicia,10,0,10,0
1708256263391,SE 265,A00,447615,Farrar; Charles R.,20,0,25,5
1708256263920,SE 266,A00,447616,Loh; Chin Hsiung,23,0,25,2
1708256264991,SE 280,A00,447650,Krysl; Petr,22,0,25,3
1708256265532,SE 281,A01,447658,Kuester; Falko,12,0,30,18
1708256266058,SE 290,A00,447659,Qiao; Yu,78,0,100,22
1708256266633,SE 296,001,447666,Asaro; Robert J,9999,0,9999,0
1708256266633,SE 296,002,447669,Chen; Jiun-Shyan,9999,0,9999,0
1708256266633,SE 296,003,447689,Conte; Joel P,9999,0,9999,0
1708256266633,SE 296,004,447690,Elgamal; Ahmed,9999,0,9999,0
1708256266633,SE 296,005,447728,Hutchinson; Tara,9999,0,9999,0
1708256266633,SE 296,006,447733,Jandaghi Semnani; Shabnam,9999,0,9999,0
1708256266633,SE 296,007,447734,Kim; Hyonny,9999,0,9999,0
1708256266633,SE 296,008,447737,Kim; Hyunsun Alicia,9999,0,9999,0
1708256266633,SE 296,009,447738,Kosmatka; John B,9999,0,9999,0
1708256266633,SE 296,010,447739,Krysl; Petr,9999,0,9999,0
1708256266633,SE 296,011,447740,Kuester; Falko,9999,0,9999,0
1708256266633,SE 296,012,447741,Lanza Di Scalea; Francesco,9999,0,9999,0
1708256266633,SE 296,013,447742,Loh; Kenneth J. H.,9999,0,9999,0
1708256266633,SE 296,014,447745,McCartney; John Scott,9999,0,9999,0
1708256266633,SE 296,015,447747,Morrison; Machel Leigh,9999,0,9999,0
1708256266633,SE 296,016,447749,Mosqueda; Gilberto,9999,0,9999,0
1708256266633,SE 296,017,447874,Qiao; Yu,9999,0,9999,0
1708256266633,SE 296,018,447875,Restrepo; Jose,9999,0,9999,0
1708256266633,SE 296,019,447886,Shing; P. Benson,9999,0,9999,0
1708256266633,SE 296,020,447887,Todd; Michael,9999,0,9999,0
1708256266633,SE 296,021,447888,Tomac; Ingrid,9999,0,9999,0
1708256266633,SE 296,022,447889,Tsampras; Georgios,9999,0,9999,0
1708256266633,SE 296,023,447890,Uang; Chia-Ming,9999,0,9999,0
1708256266633,SE 296,024,447931,Van Den Einde; Yael Dahlia,9999,0,9999,0
1708256266633,SE 296,025,447932,Zhu; Qiang,9999,0,9999,0
1708256266633,SE 296,026,448007,Tehrani; Mehran,9999,0,9999,0
1708256266633,SE 296,027,448008,Palermo; Alessandro,9999,0,9999,0
1708256266633,SE 296,028,492941,Farrar; Charles R.,9998,0,9999,1
1708256267160,SIO 10,A00,446025,Borsa; Adrian Antal,573,0,590,17
1708256267688,SIO 16,A00,446031,Gee; Jeffrey S,119,0,120,1
1708256268214,SIO 50,A01,446057,Cook; Geoffrey W,19,0,22,3
1708256268214,SIO 50,A02,446058,Cook; Geoffrey W,21,0,22,1
1708256268738,SIO 75,A00,446060,Norris; Richard D.,32,0,35,3
1708256269273,SIO 87,A00,479215,Feddersen; Falk & Morzfeld; Matthias,20,0,20,0
1708256269273,SIO 87,B00,489613,Cook; Geoffrey W,19,0,20,1
1708256269273,SIO 87,C00,489620,Cook; Geoffrey W,20,0,20,0
1708256269799,SIO 90,A00,446061,Staff,61,0,70,9
1708256270325,SIO 113,A01,446064,May; David Alexander,27,0,30,3
1708256271375,SIO 128,A00,446115,Bartlett; Douglas H,110,0,120,10
1708256271901,SIO 135,A01,446153,Fricker; Helen A.,16,0,17,1
1708256271901,SIO 135,A02,446156,Fricker; Helen A.,14,0,18,4
1708256272434,SIO 136,A01,446159,Kacev; David & Wegner; Nicholas Craig & Bartlett; Douglas H,31,0,33,2
1708256272434,SIO 136,A02,446160,Kacev; David & Wegner; Nicholas Craig & Bartlett; Douglas H,33,0,33,0
1708256272974,SIO 139,A00,446164,Kacev; David,66,0,70,4
1708256273499,SIO 141,A01,446173,Pomeroy; Robert S.,11,0,12,1
1708256274024,SIO 143,A01,446175,Andersson; Andreas Jerry,20,0,30,10
1708256274550,SIO 145,A01,446181,Choy; Carolyn Anela,6,0,18,12
1708256275076,SIO 152,A01,446184,Van Allen; Emily Joyce,8,0,10,2
1708256275076,SIO 152,A02,479204,Van Allen; Emily Joyce,10,0,10,0
1708256275605,SIO 153,A01,446188,Capaldi; Tomas,24,0,26,2
1708256276135,SIO 160,A00,446189,Stegman; David,21,0,25,4
1708256276663,SIO 164,A00,446193,Staff,27,0,35,8
1708256277189,SIO 173,A00,446194,Lutsko; Nicholas J.,28,0,30,2
1708256277716,SIO 174,A00,446197,Aluwihare; Lihini & Russell; Lynn M.,26,0,30,4
1708256278243,SIO 181,A01,446200,Tresguerres; Martin,18,0,25,7
1708256278243,SIO 181,A02,446201,Tresguerres; Martin,23,0,25,2
1708256278243,SIO 181,A03,446209,Tresguerres; Martin,24,0,25,1
1708256278243,SIO 181,A04,446211,Tresguerres; Martin,24,0,25,1
1708256278243,SIO 181,A05,446223,Tresguerres; Martin,24,0,25,1
1708256278243,SIO 181,A06,446236,Tresguerres; Martin,24,0,25,1
1708256278768,SIO 192,A00,479211,Gerwick; William Henry,20,0,20,0
1708256279294,SIO 194,A00,455340,Hill; Seth J,0,0,0,0
1708256279822,SIOB 262,A00,446243,Gerwick; William Henry,23,0,25,2
1708256280346,SIOB 269,A00,446244,Staff,19,0,20,1
1708256280876,SIOB 270,A01,446261,Allen; Andrew Ellis & Petrik; Colleen Mary,18,0,20,2
1708256281402,SIOB 278,A00,446273,Arcila; Dahiana K,13,0,15,2
1708256281402,SIOB 278,B00,481742,Aburto Oropeza; Marco Octavio,18,0,20,2
1708256281927,SIOB 279,A00,446286,Franks; Peter,31,0,35,4
1708256282455,SIOB 291,A00,446292,Hechinger; Ryan F.,20,0,20,0
1708256282981,SIOB 296,A00,446293,Mongiardino Koch; Nicolas,16,0,20,4
1708256283506,SIOB 297,A00,446294,Allen; Eric,66,0,70,4
1708256284032,SIOC 202B,A00,446312,Stramski; Dariusz & Gabriel; Anne Alice-Agnes,17,0,20,3
1708256284558,SIOC 203C,A01,446314,Young; William Roy,5,0,5,0
1708256285084,SIOC 207C,A00,492798,Vasconcelos; Manuela,5,0,5,0
1708256285615,SIOC 208,A00,446315,Merrifield; Mark A,16,0,20,4
1708256286141,SIOC 209,A00,478924,Werner; Bradley T.,11,0,15,4
1708256286141,SIOC 209,B00,479224,Watson-Parris; Duncan,15,0,25,10
1708256286141,SIOC 209,C00,480739,Ricke; Katharine L,24,0,24,0
1708256286666,SIOC 212B,A01,446324,Cessi; Paola,40,0,40,0
1708256287194,SIOC 217C,A00,446325,Lutsko; Nicholas J.,25,0,25,0
1708256287722,SIOC 220,A00,446326,Rudnick; Daniel Lars,13,0,15,2
1708256288249,SIOC 224,A00,446327,Eisenman; Ian,20,0,25,5
1708256288777,SIOC 228,A00,446328,Shi; Yuanyuan,1,0,10,9
1708256289306,SIOC 235,A00,446342,Xie; Shang-Ping,14,0,15,1
1708256289834,SIOC 251,A00,446343,Evan; Amato Tomas,19,0,20,1
1708256290359,SIOG 200B,A00,446344,Gabriel; Anne Alice-Agnes,9,0,10,1
1708256290887,SIOG 221,A00,446354,Parnell-Turner; Ross Ernes,29,0,30,1
1708256291418,SIOG 227B,A00,446355,Laske; Gabi & Shearer; Peter M,19,0,20,1
1708256291944,SIOG 228,A00,446356,Van Allen; Emily Joyce,7,0,20,13
1708256292472,SIOG 230,A00,446359,Constable; Catherine G,25,0,25,0
1708256293000,SIOG 232,A00,446360,Constable; Catherine G & Constable; Steven C,37,0,40,3
1708256293525,SIOG 234,A00,446361,Sandwell; David T,15,0,15,0
1708256294105,SIOG 236,A01,477658,Fricker; Helen A.,5,0,5,0
1708256294105,SIOG 236,A02,477685,Fricker; Helen A.,3,0,5,2
1708256294630,SIOG 239,A00,446362,Gabriel; Anne Alice-Agnes,19,0,20,1
1708256294630,SIOG 239,B00,481507,May; David Alexander,6,0,6,0
1708256294630,SIOG 239,C00,486863,Fialko; Yuri A.,15,0,15,0
1708256295158,SIOG 268,A00,446364,Barbeau; Katherine,12,0,15,3
1708256295686,SOCE 194,A00,455341,Hill; Seth J,0,0,0,0
1708256296211,SOCG 204,A00,446551,Ng; Kwai,0,0,8,8
1708256296736,SOCG 206,A00,446552,Alvarez; Camila Huerta,4,0,8,4
1708256297265,SOCG 214,A00,446553,Raudenbush; Danielle,3,0,8,5
1708256297790,SOCG 255B,A00,446602,Serlin; David,2,0,5,3
1708256298313,SOCG 255C,A00,446813,Gates; Kelly,3,0,5,2
1708256298838,SOCG 290,A00,446910,Thorpe; Charles Robert,0,0,10,10
1708256298838,SOCG 290,B00,446911,Goldman; Harvey Stern,1,0,10,9
1708256298838,SOCG 290,C00,446914,Lampland; Martha,5,0,10,5
1708256299365,SOCI 2,A01,446373,Rogers; Julia Ellen,28,0,30,2
1708256299365,SOCI 2,A02,446374,Rogers; Julia Ellen,29,0,30,1
1708256299365,SOCI 2,A03,446382,Rogers; Julia Ellen,29,0,30,1
1708256299365,SOCI 2,A04,446384,Rogers; Julia Ellen,30,0,30,0
1708256299365,SOCI 2,A05,446389,Rogers; Julia Ellen,30,0,30,0
1708256299365,SOCI 2,A06,446393,Rogers; Julia Ellen,29,0,30,1
1708256299893,SOCI 20,A01,446396,Calderon-Zaks; Michael Aar,33,0,34,1
1708256299893,SOCI 20,A02,446409,Calderon-Zaks; Michael Aar,34,0,34,0
1708256300420,SOCI 40,A01,446417,Raudenbush; Danielle,30,0,32,2
1708256300420,SOCI 40,A02,446419,Raudenbush; Danielle,31,0,32,1
1708256300420,SOCI 40,A03,446434,Raudenbush; Danielle,31,0,32,1
1708256300420,SOCI 40,A04,446436,Raudenbush; Danielle,28,0,32,4
1708256300420,SOCI 40,A05,446441,Raudenbush; Danielle,29,0,32,3
1708256300420,SOCI 40,A06,446445,Raudenbush; Danielle,32,0,32,0
1708256300961,SOCI 60,A01,446461,Sutton; April Marie,30,0,32,2
1708256300961,SOCI 60,A02,446468,Sutton; April Marie,30,0,32,2
1708256300961,SOCI 60,A03,446469,Sutton; April Marie,26,0,32,6
1708256300961,SOCI 60,A04,446471,Sutton; April Marie,31,0,32,1
1708256301507,SOCI 100,A01,446480,Payne; Christine Anna,28,0,30,2
1708256301507,SOCI 100,A02,446491,Payne; Christine Anna,29,0,30,1
1708256301507,SOCI 100,A03,446492,Payne; Christine Anna,28,0,30,2
1708256301507,SOCI 100,A04,446493,Payne; Christine Anna,27,0,30,3
1708256302038,SOCI 103M,A00,481672,Kilpatrick; Kevin,27,0,28,1
1708256302569,SOCI 104,A00,446494,Turner; Christena L.,28,0,30,2
1708256303094,SOCI 104Q,A00,446495,Rogers; Julia Ellen,27,0,30,3
1708256303621,SOCI 106,A00,446496,Payne; Christine Anna,25,0,30,5
1708256304145,SOCI 107,A00,446497,Staff,30,0,30,0
1708256304671,SOCI 109,A00,446498,Rona-Tas; Akos,20,0,25,5
1708256305201,SOCI 111,A00,446499,Ribas Norris; Janet Vanesa,54,0,56,2
1708256305729,SOCI 114,A00,446500,Lampland; Martha,73,0,75,2
1708256306259,SOCI 117,A01,446502,Jones; Gabrielle Anastasia,14,0,17,3
1708256306259,SOCI 117,A02,446516,Jones; Gabrielle Anastasia,17,0,17,0
1708256306259,SOCI 117,A03,458787,Jones; Gabrielle Anastasia,17,0,17,0
1708256306259,SOCI 117,A04,458835,Jones; Gabrielle Anastasia,19,0,19,0
1708256306784,SOCI 120T,A00,446518,Staff,56,0,56,0
1708256307308,SOCI 123,A00,446519,Staff,79,0,80,1
1708256307837,SOCI 125,A00,487186,Calderon-Zaks; Michael Aar,55,0,56,1
1708256308363,SOCI 126,A01,446532,Jones; Makeba,15,0,15,0
1708256308363,SOCI 126,A02,446533,Jones; Makeba,15,0,15,0
1708256308363,SOCI 126,A03,458839,Jones; Makeba,15,0,15,0
1708256308363,SOCI 126,A04,458840,Jones; Makeba,15,0,15,0
1708256308892,SOCI 133,A00,446534,Calderon-Zaks; Michael Aar,53,0,56,3
1708256309418,SOCI 135,A00,486886,Ruiz; Jonathan Joseph,55,0,56,1
1708256309943,SOCI 136,A00,486887,Ruiz; Jonathan Joseph,56,0,56,0
1708256310470,SOCI 139,A00,446535,Ribas Norris; Janet Vanesa,78,0,80,2
1708256310996,SOCI 140J,A00,446537,Estefan; Michel,75,0,100,25
1708256311526,SOCI 142,A00,477639,Crofts; Christine,43,0,50,7
1708256312057,SOCI 146,A00,446538,Summers; Valerie R.,113,0,120,7
1708256312586,SOCI 151,A00,446540,Goldman; Harvey Stern,56,0,56,0
1708256313115,SOCI 156,A00,446541,Ostovany; Khashayar,55,0,56,1
1708256313641,SOCI 157,A00,446542,Jules-Rosette; Bennetta W.,28,0,28,0
1708256314172,SOCI 159,A00,494493,Estefan; Michel,93,0,96,3
1708256314697,SOCI 161,A00,477638,Staff,45,0,45,0
1708256315226,SOCI 162,A00,477642,Staff,54,0,55,1
1708256315750,SOCI 165,A00,446543,Rona-Tas; Akos,49,0,56,7
1708256316276,SOCI 171,A00,446544,Thorpe; Charles Robert,56,0,56,0
1708256316806,SOCI 173,A00,482888,Crofts; Christine,92,0,100,8
1708256317334,SOCI 180,A00,446545,Ostovany; Khashayar,55,0,56,1
1708256317860,SOCI 183,A00,446546,Sutton; April Marie,43,0,45,2
1708256318385,SOCI 185,A00,494495,Staff,30,0,30,0
1708256318910,SOCI 188D,A00,446549,Kokinis; Troy Andreas,24,0,25,1
1708256319439,SOCI 198RA,001,446550,Ng; Kwai,30,0,30,0
1708256319969,SOMC 224C,A00,466928,Bhakta; Savita Ganapathi,160,0,160,0
1708256320499,SOMC 229,A00,466925,Hoang; Mai Phuong,160,0,160,0
1708256321025,SOMC 240,A00,466937,Coyne; Christopher John,150,0,150,0
1708256321554,SOMC 242,A00,466931,Kline; Ahnika Sarah,160,0,160,0
1708256322082,SOMC 244,A00,466939,Mandel; Jess,150,0,150,0
1708256322611,SOMC 245C,A01,466935,Noel; Geoffroy Pierre Jean,160,0,160,0
1708256323137,SOMC 246C,A00,487163,Eyler; Lisa T.,160,0,160,0
1708256323662,SOMC 247C,A50,466950,Calcutt; Nigel A,160,0,160,0
1708256324193,SOMC 248C,A00,466936,Joshi; Weena Erin,160,0,160,0
1708256324720,SOMC 255C,A00,466951,Allison; Matthew,160,0,160,0
1708256325248,SPPH 161R,A01,476600,Chambers; Christina D,99,0,100,1
1708256325774,SPPH 263B,A01,460901,Hook; Vivian Yuan-Ho,25,0,25,0
1708256326302,SPPS 200A,A00,460907,Luli; Alex J,99,0,99,0
1708256326828,SPPS 200B,A00,460928,Luli; Alex J,99,0,99,0
1708256327354,SPPS 200C,A00,460934,Luli; Alex J,95,0,99,4
1708256327883,SPPS 203,A00,460955,Painter; Nathan A.,83,0,99,16
1708256328410,SPPS 205,A01,460978,Bandeira; Nuno Filipe Cabrita,64,0,80,16
1708256328939,SPPS 209,A00,460979,Bounthavong; Mark,94,0,99,5
1708256329464,SPPS 210,001,460980,Gustafsson; Asa Birgitta,99,0,99,0
1708256329990,SPPS 211A,A00,460987,Ferguson; Fleur,85,0,99,14
1708256330519,SPPS 211B,A00,460991,Ferguson; Fleur,96,0,99,3
1708256331045,SPPS 211C,A00,460992,Ferguson; Fleur,95,0,99,4
1708256331571,SPPS 211D,A00,460993,Tsunoda; Shirley M.,99,0,99,0
1708256332097,SPPS 212C,A01,460995,Saunders; Ila Maewal,95,0,99,4
1708256332623,SPPS 213C,A00,460996,Awdishu; Linda,95,0,99,4
1708256333149,SPPS 218B,A00,460997,Mandyam; Chitra,95,0,99,4
1708256333679,SPPS 225,A01,460999,Reed; Chantal,83,0,99,16
1708256334205,SPPS 236,A00,461000,Reid; Erin G.,96,0,99,3
1708256334731,SPPS 237,A00,461002,Mimoto; Mizuho Stacy,96,0,99,3
1708256335257,SPPS 238,A00,461041,Beyhan; Sinem,96,0,99,3
1708256335782,SPPS 241,A01,461122,Tsunoda; Shirley M.,83,0,99,16
1708256336311,SPPS 249,A00,461123,Brandl; Katharina,96,0,99,3
1708256336836,SPPS 250,A00,461126,Tsunoda; Shirley M.,45,0,50,5
1708256337362,SPPS 251,A00,461127,Chen; Timothy,99,0,99,0
1708256337892,SPPS 252,A00,461128,Abdul-Mutakabbir; Jacinda,74,0,80,6
1708256338419,SPPS 254,A00,481670,Shapiro; Desiree Nicolette,77,0,80,3
1708256338947,SPPS 261,A00,461129,Chambers; Christina D,93,0,99,6
1708256339477,SPPS 278,A00,459983,Fricovsky; Eduardo Santiago,98,0,99,1
1708256340006,SPPS 280,A00,461259,Fricovsky; Eduardo Santiago,19,0,20,1
1708256340531,SPPS 283,A00,461283,Tsunoda; Shirley M.,96,0,99,3
1708256341059,SURG 261,A00,466973,Staff,50,0,50,0
1708256341594,SURG 296,001,467004,Agha Hosseini; Ava,49,0,50,1
1708256341594,SURG 296,002,467005,Hinchcliff; Katharine Moss,49,0,50,1
1708256341594,SURG 296,003,467006,Eliceiri; Brian,49,0,50,1
1708256342129,SYN 1,001,448577,Bishop; Graham,19,0,20,1
1708256342129,SYN 1,002,448578,Iatarola; Briana Marie,19,0,20,1
1708256342129,SYN 1,003,448579,Browne; Emily,20,0,20,0
1708256342129,SYN 1,004,448580,Vega; Adrian,20,0,20,0
1708256342129,SYN 1,005,448581,Browne; Emily,20,0,20,0
1708256342129,SYN 1,006,448582,Rock; Martin,20,0,20,0
1708256342129,SYN 1,007,448583,Rock; Martin,20,0,20,0
1708256342129,SYN 1,008,448584,Iatarola; Briana Marie,19,0,20,1
1708256342129,SYN 1,009,448585,Bishop; Graham,20,0,20,0
1708256342129,SYN 1,010,448586,Bishop; Graham,20,0,20,0
1708256342129,SYN 1,011,448587,Gladstein; Jill M,15,0,15,0
1708256342129,SYN 1,012,448588,Meyer; Leslie Rose,20,0,20,0
1708256342129,SYN 1,013,448589,Rosenberg; Ryan Glenn,20,0,20,0
1708256342129,SYN 1,014,448627,Rosenberg; Ryan Glenn,19,0,20,1
1708256342129,SYN 1,015,448630,Atkinson; Arthur Laird,20,0,20,0
1708256342129,SYN 1,016,448651,Hom; Kirstyn Courtney,20,0,20,0
1708256342129,SYN 1,017,448652,Difruscio; Mark,20,0,20,0
1708256342129,SYN 1,018,448669,Hom; Kirstyn Courtney,20,0,20,0
1708256342129,SYN 1,019,448674,Hom; Kirstyn Courtney,18,0,20,2
1708256342129,SYN 1,020,448675,Atkinson; Arthur Laird,20,0,20,0
1708256342129,SYN 1,021,448678,Gladstein; Jill M,15,0,15,0
1708256342129,SYN 1,022,448682,Iatarola; Briana Marie,20,0,20,0
1708256342129,SYN 1,023,448691,Birberick; Brittany Celest,20,0,20,0
1708256342129,SYN 1,024,448751,Birberick; Brittany Celest,20,0,20,0
1708256342129,SYN 1,027,448766,Deavenport; James Cary,19,0,20,1
1708256342129,SYN 1,028,448767,Meyer; Leslie Rose,20,0,20,0
1708256342129,SYN 1,029,448775,Tawater; Hanna Jean,20,0,20,0
1708256342129,SYN 1,030,448777,Tawater; Hanna Jean,20,0,20,0
1708256342129,SYN 1,031,448792,Deavenport; James Cary,20,0,20,0
1708256342129,SYN 1,032,480169,Tawater; Hanna Jean,18,0,20,2
1708256342655,SYN 1R,001,448793,Difruscio; Mark,20,0,20,0
1708256342655,SYN 1R,004,449146,Difruscio; Mark,20,0,20,0
1708256343202,SYN 100,A01,449148,Staff,11,0,15,4
1708256343202,SYN 100,A02,449149,Staff,15,0,15,0
1708256343202,SYN 100,B01,449164,Gladstein; Jill M,0,0,0,0
1708256343202,SYN 100,B02,449166,Gladstein; Jill M,0,0,0,1
1708256343202,SYN 100,C01,449244,Staff,7,0,15,8
1708256343202,SYN 100,C02,449274,Staff,13,0,15,2
1708256343202,SYN 100,D01,449278,Staff,20,0,20,0
1708256343202,SYN 100,D02,449279,Staff,20,0,20,0
1708256343202,SYN 100,E01,449281,Rock; Martin,9,0,15,6
1708256343202,SYN 100,E02,449282,Rock; Martin,14,0,15,1
1708256343202,SYN 100,F01,449304,Browne; Emily,12,0,15,3
1708256343202,SYN 100,F02,449306,Browne; Emily,14,0,15,1
1708256343202,SYN 100,I01,449390,Gormally; Brenna,0,0,0,0
1708256343202,SYN 100,I02,449391,Gormally; Brenna,0,0,0,0
1708256343202,SYN 100,J01,449401,Atkinson; Arthur Laird,11,0,15,4
1708256343202,SYN 100,J02,449402,Atkinson; Arthur Laird,14,0,15,1
1708256343202,SYN 100,K01,449404,Deavenport; James Cary,11,0,15,4
1708256343202,SYN 100,K02,449405,Deavenport; James Cary,14,0,15,1
1708256343202,SYN 100,L01,449408,Rosenberg; Ryan Glenn,10,0,15,5
1708256343202,SYN 100,L02,449420,Rosenberg; Ryan Glenn,15,0,15,0
1708256343733,SYN 150,001,450016,Vega; Adrian,19,0,19,0
1708256343733,SYN 150,003,450031,Birberick; Brittany Celest,20,0,20,0
1708256344259,SYN 150R,001,494950,Vega; Adrian,20,0,20,0
1708256345027,SYN 198,001,494388,Staff,9999,0,9999,0
1708256345573,TDAC 1,A00,450042,Walsh; Kim C.,14,0,20,6
1708256345573,TDAC 1,B00,450043,Walsh; Kim C.,11,0,20,9
1708256345573,TDAC 1,C00,450044,Walsh; Kim C.,15,0,20,5
1708256345573,TDAC 1,D00,486830,Basso; Beatrice,20,0,20,0
1708256345573,TDAC 1,E00,492912,Walsh; Kim C.,15,0,20,5
1708256345573,TDAC 1,F00,492936,Walsh; Kim C.,18,0,20,2
1708256346103,TDAC 101,A00,450895,Celik; Aysan Karagasli,18,0,20,2
1708256346631,TDAC 102,A00,450904,Walsh; Kim C.,20,0,20,0
1708256346631,TDAC 102,B00,450916,Harting; Carla Kelso,20,0,20,0
1708256347159,TDAC 108,A00,450917,Buescher; Stephen W.,18,0,20,2
1708256347741,TDAC 109,A00,450924,Blair; Kyle Adam,20,0,20,0
1708256348269,TDAC 122,A00,451025,Perry; Lamar,30,0,30,0
1708256348269,TDAC 122,B00,480845,Perry; Lamar,30,0,30,0
1708256348796,TDAC 123,A00,451026,Buescher; Stephen W.,30,0,30,0
1708256348796,TDAC 123,B00,451028,Celik; Aysan Karagasli,30,0,30,0
1708256348796,TDAC 123,C00,480851,Perry; Lamar,30,0,30,0
1708256349325,TDDE 101,A00,451030,Guirguis; Mark C,18,0,20,2
1708256349851,TDDE 112,A00,451032,Staff,20,0,20,0
1708256350376,TDDE 130,A00,451033,Guirguis; Mark C,19,0,20,1
1708256350906,TDDE 132,A00,451034,Guirguis; Mark C,20,0,20,0
1708256351433,TDDE 169A,A00,481304,Petrovich; Victoria A.,19,0,20,1
1708256351959,TDDM 1,A00,450045,Weinberg; Sadie,27,0,30,3
1708256352487,TDDM 101,A00,451067,Staff,29,0,30,1
1708256353013,TDDR 101,A00,451068,Powell; Lora,29,0,34,5
1708256353542,TDDR 102,A00,451069,Powell; Lora,19,0,20,1
1708256354070,TDDR 111,A00,451070,Castro; Robert Jess,15,0,16,1
1708256354070,TDDR 111,B00,451071,Castro; Robert Jess,15,0,16,1
1708256354597,TDDR 190,A00,451073,Perry; Lamar,1,0,1,0
1708256355142,TDGE 1,A01,450047,Salovey; Todd,20,0,20,0
1708256355142,TDGE 1,A02,450048,Salovey; Todd,20,0,20,0
1708256355142,TDGE 1,A03,450085,Salovey; Todd,18,0,20,2
1708256355142,TDGE 1,A04,450093,Salovey; Todd,20,0,20,0
1708256355142,TDGE 1,A05,450096,Salovey; Todd,19,0,20,1
1708256355142,TDGE 1,A06,450132,Salovey; Todd,16,0,20,4
1708256355670,TDGE 25,A00,450236,Harting; Carla Kelso,12,0,20,8
1708256355670,TDGE 25,B00,450240,Harting; Carla Kelso,16,0,20,4
1708256355670,TDGE 25,C00,450243,Harting; Carla Kelso,14,0,20,6
1708256355670,TDGE 25,D00,450388,Harting; Carla Kelso,16,0,20,4
1708256356196,TDGE 100,A01,451098,Salovey; Todd,24,0,25,1
1708256356196,TDGE 100,A02,451099,Salovey; Todd,24,0,25,1
1708256356724,TDGE 124,A00,451122,Fulton; Julia,168,0,200,32
1708256357250,TDGE 125,A00,480853,Havis; Allan,197,0,200,3
1708256357250,TDGE 125,B00,480886,Staff,216,0,220,4
1708256357781,TDGE 133,A00,481097,Brill; Robert L.,20,0,20,0
1708256358309,TDGE 196B,A00,493144,Barricelli; Marc Alexander,1,0,1,0
1708256358309,TDGE 196B,B00,493148,Buescher; Stephen W.,2,0,2,0
1708256358309,TDGE 196B,C00,493151,Burelle; Julie Sara Veronique,1,0,1,0
1708256358309,TDGE 196B,D00,493189,Castro; Robert Jess,2,0,2,0
1708256358309,TDGE 196B,E00,493190,Guirguis; Mark C,1,0,1,0
1708256358309,TDGE 196B,F00,493240,Iizuka; Naomi Hisako,1,0,1,0
1708256358309,TDGE 196B,G00,493241,Perry; Lamar,1,0,1,0
1708256358309,TDGE 196B,H00,493249,Powell; Lora,1,0,1,0
1708256358309,TDGE 196B,I00,493296,Stein; Deborah Isobel,6,0,6,0
1708256358836,TDGR 213C,A00,451385,Buescher; Stephen W.,10,0,10,0
1708256359364,TDGR 220A,A00,451386,Barricelli; Marc Alexander,10,0,10,0
1708256359892,TDGR 239,A00,451387,Blair; Kyle Adam,10,0,10,0
1708256360423,TDGR 240,A00,481306,Portes; Elizabeth Marie,5,0,5,0
1708256360949,TDGR 245,A00,451388,Perry; Lamar,7,0,7,0
1708256361474,TDGR 250,A00,451395,Iizuka; Naomi Hisako,8,0,10,2
1708256362001,TDGR 251,A00,451397,Iizuka; Naomi Hisako,9,0,10,1
1708256362001,TDGR 251,B00,451398,Stein; Deborah Isobel,9,0,10,1
1708256362527,TDGR 257B,A00,451399,Finch; Michael S,8,0,10,2
1708256363055,TDGR 278,A00,481307,Petrovich; Victoria A.,4,0,5,1
1708256363583,TDGR 279,A00,451400,Bokovikova; Alina V,9,0,10,1
1708256363583,TDGR 279,B00,451401,Brill; Robert L.,10,0,10,0
1708256363583,TDGR 279,C00,451402,Petrovich; Victoria A.,10,0,10,0
1708256363583,TDGR 279,D00,451403,McElver; Robert Harrison,10,0,10,0
1708256363583,TDGR 279,E00,451404,Kuhl; Christopher August,10,0,10,0
1708256364108,TDGR 286,A00,451405,Knox; Leila Elizabeth,9,0,10,1
1708256364637,TDGR 288,A00,451406,Powell; Lora,6,0,7,1
1708256365164,TDGR 292,A00,451407,Power; Jade Yukana,10,0,10,0
1708256365164,TDGR 292,B00,451408,Mehrishi; Rishika,10,0,10,0
1708256365693,TDGR 293,001,451417,Power; Jade Yukana,7,0,7,0
1708256365693,TDGR 293,002,451418,Burelle; Julie Sara Veronique,7,0,7,0
1708256365693,TDGR 293,003,451419,Yapp; Hentyle T,7,0,7,0
1708256365693,TDGR 293,005,451421,Anderson; Mysia Anyse,7,0,7,0
1708256366221,TDGR 294,001,451429,Burelle; Julie Sara Veronique,7,0,7,0
1708256366221,TDGR 294,002,451431,Power; Jade Yukana,7,0,7,0
1708256366221,TDGR 294,003,451432,Yapp; Hentyle T,7,0,7,0
1708256366746,TDGR 295,A00,451433,Barricelli; Marc Alexander,10,0,10,0
1708256367272,TDGR 296,A00,451489,Powell; Lora,6,0,7,1
1708256367272,TDGR 296,B00,451497,Porter; Lisa,6,0,7,1
1708256367799,TDHD 175,A00,451123,Jun; Grace Shin Hae,40,0,40,0
1708256368345,TDHD 176,A00,451124,Caligagan; Maria T.,40,0,40,0
1708256368871,TDHT 10,A00,450409,Power; Jade Yukana,20,0,20,0
1708256368871,TDHT 10,B00,450450,Power; Jade Yukana,19,0,20,1
1708256369398,TDHT 23,A01,450546,Salimi; Rana,24,0,24,0
1708256369398,TDHT 23,A02,450549,Salimi; Rana,22,0,24,2
1708256369398,TDHT 23,A03,450553,Salimi; Rana,24,0,24,0
1708256369928,TDHT 101,A00,451125,Anderson; Mysia Anyse,25,0,25,0
1708256369928,TDHT 101,B00,451126,Mehrishi; Rishika,23,0,25,2
1708256370458,TDHT 104,A00,451225,Basso; Beatrice,22,0,25,3
1708256370984,TDHT 109,A01,451227,Anderson; Mysia Anyse,25,0,25,0
1708256371509,TDHT 122,A00,451228,Power; Jade Yukana,21,0,25,4
1708256372038,TDMV 1,A00,450558,Caligagan; Maria T.,15,0,30,15
1708256372566,TDMV 2,A00,450627,Anabo; Cherry,24,0,30,6
1708256373094,TDMV 3,A00,450630,Arcidiacono; Kristin,37,0,40,3
1708256373621,TDMV 11,A00,481244,Fyall; DauntÉ Edward,30,0,30,0
1708256374147,TDMV 20,A00,450789,Smith; Alison D,38,0,40,2
1708256374674,TDMV 110,A00,451229,Caligagan; Maria T.,28,0,30,2
1708256375201,TDMV 111,A00,451234,Smith; Alison D,28,0,30,2
1708256375727,TDMV 120,A00,451260,Weinberg; Sadie,30,0,30,0
1708256375727,TDMV 120,B00,451261,Sammartano; Tonnie,30,0,30,0
1708256376255,TDMV 122,A00,451262,Staff,28,0,30,2
1708256376781,TDMV 123,A00,451263,Duran; Marcos Antonio,28,0,30,2
1708256377309,TDMV 130,A00,451272,Mack; Kara Shanai',30,0,30,0
1708256377833,TDMV 138,A00,451275,Jun; Grace Shin Hae,4,0,30,26
1708256378361,TDMV 140,A00,451276,Lima; Paulo Henrique,40,0,40,0
1708256378361,TDMV 140,B00,451308,Power; Jade Yukana,39,0,40,1
1708256378361,TDMV 140,C00,451371,Caligagan; Tony,40,0,40,0
1708256378361,TDMV 140,D00,451373,Corrales; Joseph Bernales,28,0,30,2
1708256378888,TDMV 141,A00,451374,Caligagan; Tony,26,0,30,4
1708256379414,TDMV 142,A00,451375,Blanco; Juan Carlos,25,0,40,15
1708256379944,TDMV 143,A00,451376,Fyall; DauntÉ Edward,39,0,40,1
1708256380473,TDMV 144,A00,451377,Anabo; Cherry,39,0,40,1
1708256380998,TDMV 149,A00,451378,Jun; Grace Shin Hae,36,0,40,4
1708256381524,TDPF 162,A00,451379,Alvarez; Ana Maria,40,0,40,0
1708256382053,TDPR 6,A01,450799,Guirguis; Mark C,50,0,50,0
1708256382053,TDPR 6,A02,450801,Guirguis; Mark C,50,0,50,0
1708256382578,TDPR 102,A00,451380,Guirguis; Mark C,20,0,20,0
1708256383103,TDPR 104,A00,451381,Powell; Lora,15,0,15,0
1708256383633,TDPW 1,A00,450808,Stein; Deborah Isobel,14,0,15,1
1708256383633,TDPW 1,B00,450864,Stein; Deborah Isobel,13,0,15,2
1708256383633,TDPW 1,C00,450865,Stein; Deborah Isobel,15,0,15,0
1708256383633,TDPW 1,D00,450868,Stein; Deborah Isobel,13,0,15,2
1708256383633,TDPW 1,E00,450874,Stein; Deborah Isobel,14,0,15,1
1708256384161,TDPW 102,A00,451382,Staff,18,0,20,2
1708256384686,TDPW 104,A00,481182,Staff,17,0,20,3
1708256385217,TDTR 10,A00,450881,Wilson; Terry A.,28,0,30,2
1708256385743,TDTR 15,A00,450882,Smith; Alison D,30,0,30,0
1708256386273,TMC 15,A00,479039,Hemans; Patricia Ann Benitez,25,0,25,0
1708256386799,TMC 87,A00,479049,Solomon; Amanda Lee Albaniel,20,0,20,0
1708256387325,UROL 296,001,467060,Anger; Jennifer Tash,49,0,50,1
1708256387325,UROL 296,002,467061,Staff,50,0,50,0
1708256387873,USP 3,A01,458852,Martin; Isaac,34,0,35,1
1708256387873,USP 3,A02,458853,Martin; Isaac,35,0,35,0
1708256387873,USP 3,A03,458861,Martin; Isaac,34,0,35,1
1708256387873,USP 3,A04,458862,Martin; Isaac,32,0,35,3
1708256388400,USP 4,A00,451772,Schwaller; Nora Louise,19,0,25,6
1708256388929,USP 5,A01,458863,Shenkman; Michael Thomas,33,0,35,2
1708256388929,USP 5,A02,458864,Shenkman; Michael Thomas,31,0,35,4
1708256389459,USP 15,A01,458931,Staff,33,0,35,2
1708256389459,USP 15,A02,459024,Staff,31,0,35,4
1708256389985,USP 25,A00,451786,Sun; Feiyang,57,0,60,3
1708256390514,USP 100,A00,451787,Moses; Kelema Lee,55,0,60,5
1708256391040,USP 108,A00,477594,Martin; Isaac,25,0,25,0
1708256391569,USP 119,A00,477595,Schwaller; Nora Louise,23,0,25,2
1708256392094,USP 124,A00,451790,Hinds; Juli Beth,62,0,70,8
1708256393636,USP 128B,A01,451910,Lewis; Leslie R,12,0,13,1
1708256394161,USP 142B,A01,451954,Lewis; Leslie R,24,0,25,1
1708256394687,USP 142C,A00,451977,Lerner; Amy M,0,0,0,0
1708256395212,USP 145,A00,451999,Yaghmaee; Saman,140,0,146,6
1708256395738,USP 150,A00,452165,Staff,44,0,50,6
1708256396267,USP 151,A00,452166,Staff,49,0,50,1
1708256396792,USP 152A,A01,459025,Weaver; Todd D,25,0,25,0
1708256396792,USP 152A,A02,459074,Weaver; Todd D,24,0,25,1
1708256397316,USP 152B,A00,452224,Moeder; Nathan L,21,0,25,4
1708256397843,USP 153,A00,452339,Shenkman; Michael Thomas,50,0,50,0
1708256398372,USP 158A,A00,452410,Sun; Feiyang,25,0,25,0
1708256398899,USP 159B,A00,452411,Gherini; Paul Pier-Carlo,6,0,8,2
1708256399430,USP 160,A00,452412,Wartell; Julie Dara,25,0,25,0
1708256399961,USP 164,A00,452413,Moses; Kelema Lee,22,0,25,3
1708256400493,USP 165C,A00,452442,Frank; Lawrence Douglas,20,0,20,0
1708256401020,USP 169,A00,452598,Bajaj; Ravi Siddharth,32,0,35,3
1708256401549,USP 170,A00,477593,Entezam; Maryam,60,0,60,0
1708256402132,USP 172,A00,452676,Peerson; Susan,19,0,25,6
1708256402661,USP 175,A00,452848,Velasco; Diego,18,0,20,2
1708256404206,USP 177A,A00,453084,Velasco; Diego,21,0,25,4
1708256404733,USP 177B,A00,453127,Peerson; Susan,22,0,25,3
1708256405258,USP 183,A00,453128,Sutton; April Marie,19,0,20,1
1708256405789,USP 188B,A00,453187,Pezzoli; Keith,30,0,30,0
1708256406313,USP 190,A00,453234,Pezzoli; Keith,0,0,0,1
1708256406839,USP 191B,A00,453240,Polat; Soydan Alihan,18,0,20,2
1708256407366,USP 193,A00,453251,Bussell; Mirle Rabinowitz,24,0,25,1
1708256407896,USP 194,A00,455342,Hill; Seth J,0,0,0,0
1708256408426,USP 265C,A00,453264,Frank; Lawrence Douglas,10,0,10,0
1708256408955,VIS 3,A01,453427,Staff,25,0,25,0
1708256408955,VIS 3,A02,453428,Staff,15,0,25,10
1708256408955,VIS 3,A03,453429,Staff,25,0,25,0
1708256408955,VIS 3,A04,453430,Staff,21,0,25,4
1708256408955,VIS 3,A05,453431,Staff,25,0,25,0
1708256408955,VIS 3,A06,453432,Staff,23,0,25,2
1708256408955,VIS 3,A07,453433,Staff,17,0,25,8
1708256408955,VIS 3,A08,453434,Staff,23,0,25,2
1708256408955,VIS 3,A09,453435,Staff,21,0,25,4
1708256408955,VIS 3,A10,453436,Staff,23,0,25,2
1708256409484,VIS 9,A00,453437,Camargo; William,116,0,146,30
1708256410010,VIS 10,A00,453438,Kiratli; Solen,189,0,200,11
1708256410557,VIS 21B,A01,453440,Shen; Kuiyi,31,0,32,1
1708256410557,VIS 21B,A02,453441,Shen; Kuiyi,31,0,32,1
1708256410557,VIS 21B,A03,453442,Shen; Kuiyi,31,0,32,1
1708256410557,VIS 21B,A04,453443,Shen; Kuiyi,32,0,32,0
1708256410557,VIS 21B,A05,453444,Shen; Kuiyi,32,0,32,0
1708256410557,VIS 21B,A06,453452,Shen; Kuiyi,32,0,32,0
1708256410557,VIS 21B,A07,453468,Shen; Kuiyi,30,0,32,2
1708256410557,VIS 21B,A08,453587,Shen; Kuiyi,32,0,32,0
1708256411085,VIS 22,A01,453589,Rose; Jordan M,32,0,32,0
1708256411085,VIS 22,A02,453590,Rose; Jordan M,32,0,32,0
1708256411085,VIS 22,A03,453615,Rose; Jordan M,31,0,32,1
1708256411085,VIS 22,A04,453616,Rose; Jordan M,32,0,32,0
1708256411085,VIS 22,A05,453617,Rose; Jordan M,30,0,32,2
1708256411085,VIS 22,A06,453618,Rose; Jordan M,30,0,32,2
1708256411085,VIS 22,A07,453620,Rose; Jordan M,32,0,32,0
1708256411085,VIS 22,A08,453621,Rose; Jordan M,32,0,32,0
1708256411085,VIS 22,A09,453635,Rose; Jordan M,32,0,32,0
1708256411085,VIS 22,A10,453636,Rose; Jordan M,32,0,32,0
1708256411610,VIS 31,A00,453637,Dominguez; Ricardo,133,0,146,13
1708256412140,VIS 41,A01,453644,D'Elena-Tweed; Jessica Erin,23,0,25,2
1708256412140,VIS 41,A02,453645,D'Elena-Tweed; Jessica Erin,22,0,25,3
1708256412140,VIS 41,A03,453646,D'Elena-Tweed; Jessica Erin,25,0,25,0
1708256412140,VIS 41,A04,453647,D'Elena-Tweed; Jessica Erin,18,0,25,7
1708256412140,VIS 41,A05,453648,D'Elena-Tweed; Jessica Erin,25,0,25,0
1708256412140,VIS 41,A06,453650,D'Elena-Tweed; Jessica Erin,24,0,25,1
1708256412666,VIS 70N,A01,453652,Garnett; Mariah J,21,0,22,1
1708256412666,VIS 70N,A02,453653,Garnett; Mariah J,21,0,22,1
1708256412666,VIS 70N,A03,453654,Garnett; Mariah J,22,0,22,0
1708256412666,VIS 70N,A04,453657,Garnett; Mariah J,22,0,22,0
1708256412666,VIS 70N,A05,453662,Garnett; Mariah J,20,0,22,2
1708256412666,VIS 70N,A06,453663,Garnett; Mariah J,22,0,22,0
1708256413195,VIS 83,A00,453664,Kester; Grant,137,0,146,9
1708256413736,VIS 101A,A00,453666,Cruz; Edwin Teddy,10,0,15,5
1708256414262,VIS 102,A00,453668,Cruz; Edwin Teddy,81,0,85,4
1708256414789,VIS 105A,A00,453669,Adler; Amy,29,0,30,1
1708256415316,VIS 105B,A00,453738,Herc-Balaszek; Malgorzata,25,0,30,5
1708256415316,VIS 105B,B00,453739,Staff,27,0,30,3
1708256415845,VIS 106A,A00,453740,Staff,22,0,25,3
1708256416371,VIS 106B,A00,453741,De Luca; Mara Julia,20,0,25,5
1708256416896,VIS 106C,A00,453746,Vangenderen; Monique Luise,11,0,15,4
1708256417421,VIS 107A,A00,453747,Gregoire; Mathieu,19,0,25,6
1708256417952,VIS 107B,A00,453748,Dean; Danielle Adobi,23,0,25,2
1708256418478,VIS 110A,A00,453749,Adler; Amy,13,0,15,2
1708256419003,VIS 110E,A00,453798,Gregoire; Mathieu,14,0,15,1
1708256419528,VIS 110F,A00,453799,Staff,15,0,15,0
1708256420053,VIS 110N,A00,453803,Dean; Danielle Adobi,15,0,15,0
1708256420580,VIS 123B,A00,453804,Gaines; Malik Julian,75,0,75,0
1708256421105,VIS 125BN,A00,453813,Welchman; John C.,75,0,75,0
1708256421634,VIS 126P,A00,453814,Wardwell; Mariana Razo,74,0,75,1
1708256422162,VIS 128E,A00,453815,Staff,75,0,75,0
1708256422688,VIS 129E,A00,453855,Shen; Kuiyi,12,0,15,3
1708256423217,VIS 131,A00,453859,Trigilio; Michael,12,0,15,3
1708256423217,VIS 131,B00,479342,Mangolte; Babette,15,0,15,0
1708256423745,VIS 133A,A00,454231,Barbosa; Erika Katrina,13,0,15,2
1708256424274,VIS 134,A00,454232,Yoldas; Pinar,59,0,75,16
1708256424800,VIS 141B,A00,454233,Stalbaum; Brett,12,0,15,3
1708256425331,VIS 145B,A00,454234,Alexander; Amy J,14,0,15,1
1708256425331,VIS 145B,B00,454235,Kiratli; Solen,8,0,15,7
1708256425873,VIS 147A,A01,454237,Stalbaum; Brett,20,0,22,2
1708256425873,VIS 147A,A02,454238,Stalbaum; Brett,18,0,22,4
1708256426417,VIS 157,A01,454240,Cartwright; Lisa,32,0,34,2
1708256426417,VIS 157,A02,454241,Cartwright; Lisa,32,0,34,2
1708256426959,VIS 159,A01,454243,Akten; Mehmet,34,0,34,0
1708256426959,VIS 159,A02,454244,Akten; Mehmet,32,0,34,2
1708256426959,VIS 159,A03,454300,Akten; Mehmet,30,0,34,4
1708256426959,VIS 159,A04,454301,Akten; Mehmet,33,0,34,1
1708256426959,VIS 159,A05,454302,Akten; Mehmet,30,0,34,4
1708256426959,VIS 159,A06,454307,Akten; Mehmet,33,0,34,1
1708256426959,VIS 159,A07,454308,Akten; Mehmet,34,0,34,0
1708256426959,VIS 159,A08,454309,Akten; Mehmet,33,0,34,1
1708256427486,VIS 160B,A00,454310,Alexander; Amy J,13,0,15,2
1708256427486,VIS 160B,B00,454311,Akten; Mehmet,14,0,15,1
1708256427486,VIS 160B,C00,454312,Stone; Patricia,12,0,15,3
1708256428026,VIS 164,A00,454313,Cross; Brian R,19,0,22,3
1708256428026,VIS 164,B00,454314,Camargo; William,22,0,22,0
1708256428553,VIS 165,A00,454315,Erdmann; Dean,22,0,22,0
1708256429082,VIS 167,A00,454316,Staff,18,0,22,4
1708256429607,VIS 169A,A00,454317,Mostajo; Lorena,21,0,22,1
1708256430133,VIS 171,A00,454318,Nakayama; Yue,21,0,22,1
1708256430659,VIS 174,A00,454319,Staff,19,0,22,3
1708256431184,VIS 177,A00,454320,Cho; Erica,21,0,22,1
1708256431709,VIS 178,A00,454321,Staff,0,0,0,0
1708256432234,VIS 179,A00,454322,Erdmann; Dean,22,0,22,0
1708256432762,VIS 180A,A00,454323,Nakayama; Yue,21,0,22,1
1708256433289,VIS 180B,A00,454341,Cross; Brian R,20,0,22,2
1708256433816,VIS 183A,A00,454342,Cho; Erica,17,0,22,5
1708256434342,VIS 185,A00,454343,Miller; Nicole L,18,0,22,4
1708256434870,VIS 190,A00,454360,Crandall; Jordan,15,0,15,0
1708256434870,VIS 190,B00,454361,D'Elena-Tweed; Jessica Erin,10,0,15,5
1708256435398,VIS 202,A00,454369,Miller; Nicole L,12,0,15,3
1708256435926,VIS 203,A00,454370,Garnett; Mariah J,8,0,15,7
1708256436467,VIS 206,A00,454376,Kester; Grant,10,0,15,5
1708256437009,VIS 208,A00,454377,Moss; Ceci,15,0,15,0
1708256437538,VIS 211,A00,454413,Segade; Alexandro Abraham,0,0,0,2
1708256438065,VIS 243,A00,454429,Rose; Jordan M,5,0,15,10
1708256438593,VIS 255,A00,454430,Welchman; John C.,8,0,15,7
1708256439121,VIS 262,A00,454431,Yoldas; Pinar,11,0,15,4
1708256439680,WCWP 10A,001,454442,Uriarte; Emma,17,0,20,3
1708256439680,WCWP 10A,002,454443,Uriarte; Emma,14,0,20,6
1708256439680,WCWP 10A,003,454479,Uriarte; Emma,19,0,20,1
1708256439680,WCWP 10A,004,454480,Staff,0,0,0,0
1708256439680,WCWP 10A,005,454484,Staff,0,0,0,0
1708256439680,WCWP 10A,006,454485,Staff,0,0,0,0
1708256439680,WCWP 10A,007,454487,Staff,0,0,0,0
1708256439680,WCWP 10A,008,454488,Susi; Natalie,14,0,20,6
1708256439680,WCWP 10A,009,454489,Staff,0,0,0,0
1708256439680,WCWP 10A,010,454490,Staff,0,0,0,0
1708256440321,WCWP 10B,001,454492,Ornelas; Tricia,20,0,20,0
1708256440321,WCWP 10B,002,454501,Ornelas; Tricia,20,0,20,0
1708256440321,WCWP 10B,003,454565,Gagnon; Jeffrey C,2,0,20,18
1708256440321,WCWP 10B,004,454604,Ornelas; Tricia,16,0,20,4
1708256440321,WCWP 10B,005,454668,Staff,16,0,16,0
1708256440321,WCWP 10B,006,454724,Staff,16,0,16,0
1708256440321,WCWP 10B,007,454725,Staff,14,0,16,2
1708256440321,WCWP 10B,008,454768,Staff,0,0,0,0
1708256440321,WCWP 10B,009,454769,Staff,0,0,0,0
1708256440321,WCWP 10B,010,454770,Staff,0,0,0,0
1708256440321,WCWP 10B,011,454771,Dhir; Simrita,16,0,20,4
1708256440321,WCWP 10B,012,454772,Dhir; Simrita,16,0,20,4
1708256440321,WCWP 10B,013,454773,Merryman; Walter,17,0,20,3
1708256440321,WCWP 10B,014,454774,Dhir; Simrita,18,0,20,2
1708256440321,WCWP 10B,015,454775,Merryman; Walter,17,0,20,3
1708256440321,WCWP 10B,016,454776,Merryman; Walter,18,0,20,2
1708256440321,WCWP 10B,017,454777,Welji; Haleema Nazir,14,0,16,2
1708256440321,WCWP 10B,018,478868,Staff,16,0,16,0
1708256440321,WCWP 10B,019,478869,Staff,0,0,0,0
1708256440321,WCWP 10B,020,478876,Staff,0,0,0,0
1708256440321,WCWP 10B,021,478877,Staff,0,0,0,0
1708256440321,WCWP 10B,022,478887,Staff,0,0,0,0
1708256440321,WCWP 10B,023,478889,Staff,16,0,16,0
1708256440321,WCWP 10B,024,478892,Staff,0,0,0,0
1708256440321,WCWP 10B,025,478907,Staff,0,0,0,0
1708256440870,WCWP 100,A00,454800,McCleary; Keith Long,20,0,20,0
1708256440870,WCWP 100,B00,454804,McCleary; Keith Long,20,0,20,0
1708256440870,WCWP 100,C00,454822,Twohig; Niall Ivan,19,0,20,1
1708256440870,WCWP 100,D00,454855,Young; Mark T,20,0,20,0
1708256440870,WCWP 100,E00,454860,Twohig; Niall Ivan,19,0,20,1
1708256440870,WCWP 100,F00,454932,Young; Mark T,20,0,20,0
1708256440870,WCWP 100,G00,454933,Young; Mark T,20,0,20,0
1708256441399,WES 207,A00,454941,Kastner; Ryan Charles,20,0,20,0
1708256441924,WES 265,A00,454942,Staff,19,0,20,1
1708256444029,AAS 10,A01,392963,Butler; Elizabeth Annette,34,0,34,0
1708256444029,AAS 10,A02,392965,Butler; Elizabeth Annette,33,0,34,1
1708256444557,AAS 170,A00,392977,Butler; Elizabeth Annette,31,0,32,1
1708256445082,AAS 198,001,479182,Childs; Dennis R.,20,0,20,0
1708256445608,AESE 261,A00,387945,Staff,33,0,33,0
1708256446137,AESE 278D,A00,387953,Staff,33,0,33,0
1708256446662,AESE 278E,A00,387954,Staff,33,0,33,0
1708256447193,AESE 279A,A00,387956,Staff,33,0,33,0
1708256447720,AIP 197P,001,494494,Goldfarb; Brian,9999,0,9999,0
1708256448245,ANAR 100,A00,387884,Shtienberg; Gilad,15,0,16,1
1708256448774,ANAR 104,A01,387886,Tamberino; Anthony Thomas,21,0,25,4
1708256449298,ANAR 111,A00,387888,Staff,36,0,36,0
1708256449825,ANAR 115,A00,387889,Shtienberg; Gilad,36,0,36,0
1708256450353,ANAR 120,A00,387890,Staff,36,0,36,0
1708256450879,ANAR 155,A00,387891,Braswell; Geoffrey E.,15,0,25,10
1708256451406,ANAR 164,A00,387892,Staff,32,0,35,3
1708256451936,ANBI 100,A00,489626,Fox; Patrick Keolu Ozer,39,0,40,1
1708256452463,ANBI 111,A00,387893,Hrvoj Mihic; Branka,37,0,40,3
1708256453550,ANBI 144,A00,387896,Wilder; Linnea Lorene,72,0,75,3
1708256454077,ANBI 149,A00,489628,Non; Amy L,0,0,0,0
1708256454603,ANBI 173,A00,387897,Wilder; Linnea Lorene,74,0,75,1
1708256455132,ANBI 174,A00,489627,Strum; Shirley C.,13,0,15,2
1708256455657,ANES 296,001,463968,Gabriel; Rodney A,49,0,50,1
1708256455657,ANES 296,002,463969,Staff,50,0,50,0
1708256455657,ANES 296,003,463970,Staff,50,0,50,0
1708256456186,ANSC 100,A00,387898,Bialecki; Jon Anthony,40,0,40,0
1708256456712,ANSC 101,A00,387900,Sloane; Julia Kathryn,34,0,40,6
1708256457242,ANSC 117,A00,387901,Martin Sandino; Amanda Maria Yoland,13,0,15,2
1708256457822,ANSC 134,A00,387902,Staff,38,0,40,2
1708256458353,ANSC 137,A00,387903,Stewart; Alexander B,80,0,80,0
1708256458880,ANSC 138,A00,387904,Parish; Steven Martin,14,0,15,1
1708256459410,ANSC 142,A00,387905,Stone; Annika Britt,34,0,40,6
1708256459937,ANSC 147,A00,387906,Stewart; Alexander B,40,0,40,0
1708256460462,ANSC 148,A00,387907,Olivas Hernandez; Olga Lid,92,0,92,0
1708256460993,ANSC 186,A00,387910,Hankins; Joseph D.,28,0,30,2
1708256461520,ANTH 2,A01,387863,Marchetto; Maria Carolina,37,0,40,3
1708256461520,ANTH 2,A02,387864,Marchetto; Maria Carolina,40,0,40,0
1708256461520,ANTH 2,A03,387865,Marchetto; Maria Carolina,36,0,40,4
1708256461520,ANTH 2,A04,387866,Marchetto; Maria Carolina,39,0,40,1
1708256462048,ANTH 3,A01,387868,Stroth; Luke Reyneri,28,0,30,2
1708256462048,ANTH 3,A02,387869,Stroth; Luke Reyneri,29,0,30,1
1708256462048,ANTH 3,A03,387870,Stroth; Luke Reyneri,30,0,30,0
1708256462048,ANTH 3,A04,387871,Stroth; Luke Reyneri,29,0,30,1
1708256462577,ANTH 10,A00,387872,Stewart; Alexander B,80,0,80,0
1708256463102,ANTH 21,A01,387874,Stone; Annika Britt,40,0,40,0
1708256463102,ANTH 21,A02,387875,Stone; Annika Britt,40,0,40,0
1708256463102,ANTH 21,A03,387876,Stone; Annika Britt,40,0,40,0
1708256463102,ANTH 21,A04,387877,Stone; Annika Britt,39,0,40,1
1708256463633,ANTH 23,A01,387879,Staff,40,0,40,0
1708256463633,ANTH 23,A02,387880,Staff,40,0,40,0
1708256463633,ANTH 23,A03,387881,Staff,40,0,40,0
1708256463633,ANTH 23,A04,387882,Staff,40,0,40,0
1708256464163,ANTH 24,A00,387883,Pedersen; David,40,0,40,0
1708256464691,ANTH 103,A00,387911,Staff,343,0,350,7
1708256465219,ANTH 105,A00,387912,Staff,73,0,75,2
1708256465746,ANTH 112,A00,387913,Staff,23,0,25,2
1708256466271,ANTH 120,A00,479486,Parish; Steven Martin,28,0,30,2
1708256466804,ANTH 128B,A01,387923,Lewis; Leslie R,12,0,12,0
1708256467333,ANTH 192,A00,387925,Varma; Saiba,20,0,20,0
1708256467858,ANTH 196C,A00,387927,Varma; Saiba,15,0,15,0
1708256468382,ANTH 212,A00,387931,Marchetto; Maria Carolina,25,0,25,0
1708256468382,ANTH 212,B00,479487,Semendeferi; Ekaterini,25,0,25,0
1708256468910,ANTH 220,A00,387932,Csordas; Thomas J.,9,0,12,3
1708256469437,ANTH 230,001,493297,Goldstein; Paul S,18,0,20,2
1708256469967,ANTH 260,A00,479223,Jenkins; Janis A.,25,0,25,0
1708256470496,ANTH 272,A00,387936,Serlin; David,5,0,5,0
1708256471021,ANTH 273,A00,387938,Gates; Kelly,5,0,5,0
1708256471549,ANTH 288,A00,387940,Braswell; Geoffrey E.,25,0,25,0
1708256472083,ANTH 295,001,493298,Algaze; Guillermo,3,0,3,0
1708256472083,ANTH 295,002,493299,Brenner; Suzanne A,3,0,3,0
1708256472083,ANTH 295,003,493300,Csordas; Thomas J.,3,0,3,0
1708256472083,ANTH 295,004,493422,Fox; Patrick Keolu Ozer,3,0,3,0
1708256472083,ANTH 295,005,493472,Gagneux; Pascal,3,0,3,0
1708256472083,ANTH 295,006,493515,Goldstein; Paul S,3,0,3,0
1708256472083,ANTH 295,007,493592,Hankins; Joseph D.,3,0,3,0
1708256472083,ANTH 295,008,493631,Jassal; Aftab,3,0,3,0
1708256472083,ANTH 295,009,493639,Jenkins; Janis A.,3,0,3,0
1708256472083,ANTH 295,010,493657,Kaiser; Bronwyn Nicole,3,0,3,0
1708256472083,ANTH 295,011,493692,Kang; Byung Chu,3,0,3,0
1708256472083,ANTH 295,012,493758,Marchetto; Maria Carolina,3,0,3,0
1708256472083,ANTH 295,013,493761,Non; Amy L,3,0,3,0
1708256472083,ANTH 295,014,493762,Pedersen; David,3,0,3,0
1708256472083,ANTH 295,015,493825,Rivera-Collazo; Isabel C,3,0,3,0
1708256472083,ANTH 295,016,493826,Varma; Saiba,3,0,3,0
1708256472083,ANTH 295,017,493828,Yeh; Rihan Wen Xin,3,0,3,0
1708256472611,ANTH 296,001,493830,Braswell; Geoffrey E.,3,0,3,0
1708256472611,ANTH 296,002,493836,Marchetto; Maria Carolina,3,0,3,0
1708256472611,ANTH 296,003,493838,Rivera-Collazo; Isabel C,3,0,3,0
1708256472611,ANTH 296,004,493840,Varma; Saiba,3,0,3,0
1708256472611,ANTH 296,005,493842,Algaze; Guillermo,3,0,3,0
1708256472611,ANTH 296,006,493845,Brenner; Suzanne A,3,0,3,0
1708256472611,ANTH 296,007,493846,Csordas; Thomas J.,3,0,3,0
1708256472611,ANTH 296,008,493907,Fox; Patrick Keolu Ozer,3,0,3,0
1708256472611,ANTH 296,009,493949,Gagneux; Pascal,3,0,3,0
1708256472611,ANTH 296,010,493960,Goldstein; Paul S,3,0,3,0
1708256472611,ANTH 296,011,493961,Hankins; Joseph D.,3,0,3,0
1708256472611,ANTH 296,012,493962,Jassal; Aftab,3,0,3,0
1708256472611,ANTH 296,013,493963,Jenkins; Janis A.,3,0,3,0
1708256472611,ANTH 296,014,493964,Kaiser; Bronwyn Nicole,3,0,3,0
1708256472611,ANTH 296,015,493965,Kang; Byung Chu,3,0,3,0
1708256472611,ANTH 296,016,493966,Levy; Thomas E,3,0,3,0
1708256472611,ANTH 296,017,493967,Non; Amy L,3,0,3,0
1708256472611,ANTH 296,018,493968,Pedersen; David,3,0,3,0
1708256472611,ANTH 296,019,493969,Postero; Nancy Grey,3,0,3,0
1708256472611,ANTH 296,020,493970,Semendeferi; Ekaterini,3,0,3,0
1708256472611,ANTH 296,021,493971,Yeh; Rihan Wen Xin,3,0,3,0
1708256473140,AUD 236,A00,480192,Harris; Jeffrey Paul,12,0,12,0
1708256473665,AUD 260,A00,480227,Spriggs; Meghan K,12,0,12,0
1708256474191,AUD 272,A00,480367,Zettner; Erika,12,0,12,0
1708256474719,AUD 275,A00,480369,Zettner; Erika,12,0,12,0
1708256475244,AUD 284,A00,480370,Zettner; Erika,12,0,12,0
1708256475244,AUD 284,B00,480372,Spriggs; Meghan K,12,0,12,0
1708256475769,AUD 291,A00,480374,Zettner; Erika,12,0,12,0
1708256476298,AUD 296,A00,480375,Zettner; Erika,12,0,12,0
1708256476298,AUD 296,B00,480376,Harris; Jeffrey Paul,12,0,12,0
1708256476298,AUD 296,C00,480377,Ryan; Allen F.,12,0,12,0
1708256476832,AWP 3,002,387672,Given; William Allan,9,0,9,0
1708256476832,AWP 3,003,387678,Staff,5,0,5,0
1708256476832,AWP 3,004,387681,Staff,0,0,0,0
1708256476832,AWP 3,007,387784,West; Geoffrey Scott,4,0,5,1
1708256476832,AWP 3,009,387786,Kolodezh; Samuel,5,0,5,0
1708256476832,AWP 3,010,387787,Gilbert; Peter W,5,0,5,0
1708256477357,AWP 4A,001,387791,Staff,12,0,12,0
1708256477357,AWP 4A,002,387792,Staff,0,0,0,0
1708256477909,AWP 4B,001,387793,Bolin; Jillian,0,0,0,0
1708256477909,AWP 4B,002,387794,Bolin; Jillian,0,0,0,0
1708256477909,AWP 4B,003,387795,Bauer; Holly Jean,0,0,0,0
1708256477909,AWP 4B,004,387796,Vaughn; Kelsey Sara,0,0,0,0
1708256477909,AWP 4B,005,387797,Vaughn; Kelsey Sara,0,0,0,0
1708256477909,AWP 4B,007,387799,Ajo; Frances Margaret,0,0,0,0
1708256477909,AWP 4B,008,387800,Ajo; Frances Margaret,0,0,0,0
1708256477909,AWP 4B,009,387801,Hall; Graham T,0,0,0,0
1708256477909,AWP 4B,010,387802,Hall; Graham T,0,0,0,0
1708256477909,AWP 4B,011,387803,Heiser; Jerrod A,0,0,0,0
1708256477909,AWP 4B,012,387804,Heiser; Jerrod A,0,0,0,0
1708256477909,AWP 4B,013,387805,Jones; William Jadie,0,0,0,0
1708256477909,AWP 4B,014,387806,Jones; William Jadie,0,0,0,0
1708256477909,AWP 4B,015,387807,Christie; Veronica Ann,0,0,0,0
1708256477909,AWP 4B,016,387808,Christie; Veronica Ann,0,0,0,0
1708256477909,AWP 4B,019,387820,Falcon; Jennifer A,0,0,0,0
1708256477909,AWP 4B,020,387821,Falcon; Jennifer A,0,0,0,0
1708256477909,AWP 4B,021,387822,Eastin; Schuyler E.,0,0,0,0
1708256477909,AWP 4B,023,387824,Coulter; Jane Elisabeth,0,0,0,0
1708256477909,AWP 4B,025,387826,O'Neil; Courtney L,0,0,0,0
1708256477909,AWP 4B,026,387827,O'Neil; Courtney L,0,0,0,0
1708256477909,AWP 4B,027,387828,Tsurska Svetina; Olena,0,0,0,0
1708256477909,AWP 4B,028,387829,Tsurska Svetina; Olena,0,0,0,0
1708256477909,AWP 4B,029,387830,Spicer; Jacqueline,0,0,0,0
1708256477909,AWP 4B,030,387831,Spicer; Jacqueline,0,0,0,0
1708256477909,AWP 4B,031,387832,Steinberg; Stacy A,0,0,0,0
1708256477909,AWP 4B,032,387833,Steinberg; Stacy A,0,0,0,0
1708256477909,AWP 4B,033,387834,Chandler; Bailee Daniele,0,0,0,0
1708256477909,AWP 4B,034,387835,Chandler; Bailee Daniele,0,0,0,0
1708256477909,AWP 4B,035,387836,Tiernan; Christa Michelle,0,0,0,0
1708256477909,AWP 4B,036,387837,Tiernan; Christa Michelle,0,0,0,0
1708256477909,AWP 4B,037,387840,Gardella; Alexander Drew,0,0,0,0
1708256477909,AWP 4B,038,387841,Gardella; Alexander Drew,0,0,0,0
1708256477909,AWP 4B,039,387857,Zimmerman; Guy,0,0,0,0
1708256477909,AWP 4B,040,387858,Zimmerman; Guy,0,0,0,0
1708256477909,AWP 4B,041,387859,Zroka; Amy Liane,0,0,0,0
1708256477909,AWP 4B,042,387860,Zroka; Amy Liane,0,0,0,0
1708256478436,BENG 87,A00,489656,Sah; Robert Lie-Yuan,20,0,20,0
1708256478436,BENG 87,B00,489657,Sah; Robert Lie-Yuan,20,0,20,0
1708256478436,BENG 87,C00,494754,Omens; Jeffrey Howard,20,0,20,0
1708256478964,BENG 100,A01,387959,Alexandrov; Ludmil B,26,0,28,2
1708256478964,BENG 100,A02,387960,Alexandrov; Ludmil B,26,0,28,2
1708256478964,BENG 100,A03,387984,Alexandrov; Ludmil B,26,0,28,2
1708256478964,BENG 100,A04,387985,Alexandrov; Ludmil B,25,0,28,3
1708256478964,BENG 100,A05,387986,Alexandrov; Ludmil B,27,0,28,1
1708256479494,BENG 102,A00,387987,Chapelin; Fanny,55,0,56,1
1708256480020,BENG 103B,A00,387993,Fraley; Stephanie I.,116,0,120,4
1708256480549,BENG 112B,A01,388053,Shi; Lingyan,26,0,30,4
1708256480549,BENG 112B,A02,388054,Shi; Lingyan,29,0,30,1
1708256481075,BENG 125,A00,388055,Hasty; Jeff M,120,0,160,40
1708256481605,BENG 133,A01,388866,Mali; Prashant Gulab Ram,36,0,40,4
1708256482133,BENG 140B,A01,388884,Cabrales; Pedro,28,0,30,2
1708256482133,BENG 140B,A02,388885,Cabrales; Pedro,30,0,30,0
1708256482133,BENG 140B,A03,388886,Cabrales; Pedro,26,0,30,4
1708256482660,BENG 160,A50,388889,Aguado; Brian Alberto,23,0,25,2
1708256482660,BENG 160,A51,388919,Aguado; Brian Alberto,25,0,25,0
1708256482660,BENG 160,A52,388920,Aguado; Brian Alberto,25,0,25,0
1708256483186,BENG 168,A01,388961,Khojah; Reem I,30,0,30,0
1708256483716,BENG 172,A50,389087,Omens; Jeffrey Howard & Cabrales; Pedro,15,0,20,5
1708256483716,BENG 172,A51,389088,Omens; Jeffrey Howard & Cabrales; Pedro,14,0,20,6
1708256484245,BENG 182,A01,389128,Bafna; Vineet,28,0,30,2
1708256484771,BENG 186A,A00,389130,Kwon; Ester Jihae,105,0,120,15
1708256485302,BENG 187A,A00,389289,Taylor Amos; Alyssa C,157,0,170,13
1708256485828,BENG 187D,A00,389290,Taylor Amos; Alyssa C,33,0,60,27
1708256485828,BENG 187D,B00,389300,Taylor Amos; Alyssa C,51,0,60,9
1708256485828,BENG 187D,C00,389302,Taylor Amos; Alyssa C,35,0,60,25
1708256486356,BENG 189,A00,389303,Contijoch; Francisco,26,0,30,4
1708256486882,BENG 193,A00,389328,Engler; Adam J.,0,0,0,0
1708256487412,BENG 196,A00,436038,Engler; Adam J.,9999,0,9999,0
1708256487939,BENG 197,A00,436081,Engler; Adam J.,9999,0,9999,0
1708256488464,BENG 203,A00,389385,Bafna; Vineet & Zhong; Sheng,20,0,20,0
1708256488997,BENG 207,A00,389386,Kwon; Ester Jihae,10,0,40,30
1708256488997,BENG 207,B00,389400,Taylor Amos; Alyssa C,8,0,30,22
1708256488997,BENG 207,C00,389432,Khojah; Reem I,20,0,40,20
1708256489523,BENG 209,A00,389456,Scholtes Acevedo; Claire,30,0,30,0
1708256490049,BENG 213,A00,389496,Palsson; Bernhard O.,16,0,20,4
1708256491104,BENG 224,A00,389515,Staff,0,0,0,0
1708256491633,BENG 226,A01,479043,Schmid-Schoenbein; Geert W,7,0,30,23
1708256492162,BENG 227,A00,389591,Fraley; Stephanie I.,55,0,120,65
1708256492688,BENG 230C,A00,389810,Mc Culloch; Andrew Douglas,43,0,90,47
1708256493217,BENG 232,A01,390161,Sah; Robert Lie-Yuan,6,0,50,44
1708256493743,BENG 233,A00,390290,Shah; Sameer B,33,0,50,17
1708256494269,BENG 234,A00,390291,Silva; Gabriel,20,0,56,36
1708256494799,BENG 235,A00,390318,Bintu; Bogdan,16,0,40,24
1708256495324,BENG 276,A00,390357,Mc Culloch; Andrew Douglas & Amaro; Rommie E,0,0,0,0
1708256495850,BENG 280C,A01,390443,McVeigh; Elliot R.,45,0,56,11
1708256496377,BENG 281,A00,390444,Kravets; Vira V.,50,0,110,60
1708256496903,BENG 283,A00,390445,Komives; Elizabeth A,4,0,4,0
1708256497429,BENG 292,A01,390623,Ross; Camille,20,0,20,0
1708256497958,BENG 294C,A00,390709,Engler; Adam J.,17,0,20,3
1708256498492,BENG 295,A00,436300,Watson; John Thomas,9999,0,9999,0
1708256499020,BGGN 205,A00,423656,Daugherty; Matthew Dorton,47,0,60,13
1708256499545,BGGN 207,A01,423703,Ross; Camille,0,0,0,0
1708256500071,BGGN 215,A00,423704,Petrie; Katherine Lynn,22,0,30,8
1708256500601,BGGN 216,A01,423855,Mueller; Liam O'Connor,37,0,50,13
1708256501127,BGGN 218,A00,423861,David; Michael,19,0,30,11
1708256501656,BGGN 223,A00,423862,Bier; Ethan,17,0,35,18
1708256502180,BGGN 230,A00,423863,Taylor; Susan S.,8,0,15,7
1708256502705,BGGN 232,A00,423864,Briggs; Steven & Troemel; Emily Ruth,25,0,30,5
1708256503231,BGGN 239,A01,424014,Kronenberg; Mitchell E.,30,0,30,0
1708256503760,BGGN 240,A01,424016,Juavinett; Ashley Lauren,0,0,6,6
1708256504288,BGGN 248,A00,424017,Halpain; Shelley,26,0,30,4
1708256504812,BGGN 249C,A00,424052,Staff,33,0,33,0
1708256505338,BGGN 250,A01,424091,Zou; Yimin,7,0,8,1
1708256505867,BGGN 252,A01,424093,Sejnowski; Terrence J,5,0,6,1
1708256506392,BGGN 255,A00,424094,Root; Cory Matthew,29,0,30,1
1708256506921,BGGN 262,A01,424096,Villa Rodriguez; Elizabeth,30,0,30,0
1708256507448,BGGN 267,A01,424099,Benna; Marcus K & Aljadeff; Johnatan,5,0,6,1
1708256507974,BGGN 270,A00,477483,Juavinett; Ashley Lauren,67,0,75,8
1708256508528,BGGN 271,001,481745,Ackerman; Susan,9998,0,9999,1
1708256508528,BGGN 271,002,481746,Akbari; Omar Sultan,9999,0,9999,0
1708256508528,BGGN 271,003,481747,Allen; Nicola J,9999,0,9999,0
1708256508528,BGGN 271,004,481748,Banegas; Matthew Patrick,9999,0,9999,0
1708256508528,BGGN 271,005,481749,Breen; Ellen C.,9998,0,9999,1
1708256508528,BGGN 271,006,481750,Briggs; Steven,9998,0,9999,1
1708256508528,BGGN 271,007,481751,Bui; Jack D,9999,0,9999,0
1708256508528,BGGN 271,008,481762,Busch; Wolfgang,9999,0,9999,0
1708256508528,BGGN 271,009,481763,Castle; Michael James,9999,0,9999,0
1708256508528,BGGN 271,010,481764,Chang; John Tzu-yu,9999,0,9999,0
1708256508528,BGGN 271,011,481765,Chen; Ju,9998,0,9999,1
1708256508528,BGGN 271,012,481766,Chen; Xu,9999,0,9999,0
1708256508528,BGGN 271,013,481767,Cheng; Christine Shiang-Ling,9999,0,9999,0
1708256508528,BGGN 271,014,481768,Cherqui; Stephanie,9999,0,9999,0
1708256508528,BGGN 271,015,481769,Cho; Yoshitake,9999,0,9999,0
1708256508528,BGGN 271,016,481770,Church; Kellie Breen,9998,0,9999,1
1708256508528,BGGN 271,017,481771,Cleland; Elsa Eleanor,9999,0,9999,0
1708256508528,BGGN 271,018,481779,Cohen; Shiran,9998,0,9999,1
1708256508528,BGGN 271,019,481814,Cook-Andersen; Heidi Leigh,9999,0,9999,0
1708256508528,BGGN 271,020,481815,Cooke; James Edward,9999,0,9999,0
1708256508528,BGGN 271,021,481816,Coufal; Nicole Gabriele,9998,0,9999,1
1708256508528,BGGN 271,022,481818,Crotty Alexander; Laura E,9999,0,9999,0
1708256508528,BGGN 271,023,481819,Daugherty; Matthew Dorton,9998,0,9999,1
1708256508528,BGGN 271,024,481820,De Guglielmo; Giordano,9998,0,9999,1
1708256508528,BGGN 271,025,481821,Doherty; Taylor Alan,9998,0,9999,1
1708256508528,BGGN 271,026,481822,Dulawa; Stephanie Carole,9999,0,9999,0
1708256508528,BGGN 271,027,481823,Esko; Jeffrey D.,9998,0,9999,1
1708256508528,BGGN 271,028,481824,Feldstein; Ariel E,9998,0,9999,1
1708256508528,BGGN 271,029,481825,Friedman; Rick Adam,9999,0,9999,0
1708256508528,BGGN 271,030,481826,Furnari; Frank,9999,0,9999,0
1708256508528,BGGN 271,031,481829,Ghosh; Pradipta,9998,0,9999,1
1708256508528,BGGN 271,032,481830,Gleeson; Joseph Gerard,9999,0,9999,0
1708256508528,BGGN 271,033,481831,Golden; Susan S.,9998,0,9999,1
1708256508528,BGGN 271,034,481832,Goren; Alon M,9998,0,9999,1
1708256508528,BGGN 271,035,481834,Gustafsson; Asa Birgitta,9999,0,9999,0
1708256508528,BGGN 271,036,481836,Hamdoun; Amr,9999,0,9999,0
1708256508528,BGGN 271,037,481837,Hao; Nan,9999,0,9999,0
1708256508528,BGGN 271,038,481840,Holway; David A.,9998,0,9999,1
1708256508528,BGGN 271,039,481841,Huffaker; Alisa,9998,0,9999,1
1708256508528,BGGN 271,040,481843,Sebat; Lilia Mikhailovna,9998,0,9999,1
1708256508528,BGGN 271,041,481889,Ideker; Trey,9999,0,9999,0
1708256508528,BGGN 271,042,481890,Jiang; Qingfei,9998,0,9999,1
1708256508528,BGGN 271,043,482311,Jin; Yishi,9999,0,9999,0
1708256508528,BGGN 271,044,482334,Joiner; William J.,9999,0,9999,0
1708256508528,BGGN 271,045,482353,Kaech; Susan Michelle,9998,0,9999,1
1708256508528,BGGN 271,046,482378,Karin; Michael,9999,0,9999,0
1708256508528,BGGN 271,047,482379,Kleinfeld; David,9999,0,9999,0
1708256508528,BGGN 271,048,482413,Koffler; Yacov,9999,0,9999,0
1708256508528,BGGN 271,049,482414,Komiyama; Takaki,9999,0,9999,0
1708256508528,BGGN 271,050,482415,Kryazhimskiy; Sergey A,9999,0,9999,0
1708256508528,BGGN 271,051,482416,Lawson; Mark Andrew,9999,0,9999,0
1708256508528,BGGN 271,052,482417,Lee; Yun Sok,9999,0,9999,0
1708256508528,BGGN 271,053,482451,Leutgeb; Stefan,9998,0,9999,1
1708256508528,BGGN 271,054,482452,Lo; Stanley M.,9999,0,9999,0
1708256508528,BGGN 271,055,482453,Lu; Pengzhe,9998,0,9999,1
1708256508528,BGGN 271,056,482454,Lykke-Andersen; Jens,9998,0,9999,1
1708256508528,BGGN 271,057,482456,McDonnell; Lisa Marie,9999,0,9999,0
1708256508528,BGGN 271,058,482461,McHugh; Colleen A,9998,0,9999,1
1708256508528,BGGN 271,059,482478,Meharena; Hiruy Sibhatu,9999,0,9999,0
1708256508528,BGGN 271,060,482497,Morris; Gerald P,9999,0,9999,0
1708256508528,BGGN 271,061,482499,Mukamel; Eran A,9998,0,9999,1
1708256508528,BGGN 271,062,482535,Muotri; Alysson,9999,0,9999,0
1708256508528,BGGN 271,063,482551,Muroyama; Andrew David,9999,0,9999,0
1708256508528,BGGN 271,064,482552,Neal; Sonya E,9999,0,9999,0
1708256508528,BGGN 271,065,482618,Nieh; James Charles,9999,0,9999,0
1708256508528,BGGN 271,066,482619,O'Donoghue; Anthony John,9999,0,9999,0
1708256508528,BGGN 271,067,482626,Pantham; Priyadarshini,9999,0,9999,0
1708256508528,BGGN 271,068,482633,Parast; Mana,9999,0,9999,0
1708256508528,BGGN 271,069,482634,Perry; Michael William,9999,0,9999,0
1708256508528,BGGN 271,070,482639,Pride; David Tevis,9999,0,9999,0
1708256508528,BGGN 271,071,482645,Pruneda-Paz; Jose L.,9999,0,9999,0
1708256508528,BGGN 271,072,482648,Rana; Tariq,9999,0,9999,0
1708256508528,BGGN 271,073,482650,Risbrough; Victoria Blythe,9999,0,9999,0
1708256508528,BGGN 271,074,482655,Rissman; Robert Andrew,9999,0,9999,0
1708256508528,BGGN 271,075,482656,Rosenfeld; Michael G,9999,0,9999,0
1708256508528,BGGN 271,076,482657,Saier; Milton H.,9999,0,9999,0
1708256508528,BGGN 271,077,482663,Sander; Maike,9999,0,9999,0
1708256508528,BGGN 271,078,482664,Schenk; Simon,9999,0,9999,0
1708256508528,BGGN 271,079,482665,Schoeneberg; Johannes,9998,0,9999,1
1708256508528,BGGN 271,080,482666,Schroeder; Julian I,9998,0,9999,1
1708256508528,BGGN 271,081,482667,Shaner; Nathan C.,9999,0,9999,0
1708256508528,BGGN 271,082,482668,Sheikh; Farah,9999,0,9999,0
1708256508528,BGGN 271,083,482669,Shurin; Jonathan,9999,0,9999,0
1708256508528,BGGN 271,084,482675,Sigurdson; Christina,9999,0,9999,0
1708256508528,BGGN 271,085,482676,Smith; David M.,9999,0,9999,0
1708256508528,BGGN 271,086,482677,Steinmetz; Nicole F,9999,0,9999,0
1708256508528,BGGN 271,087,482692,Su; Chih-Ying,9999,0,9999,0
1708256508528,BGGN 271,088,482694,Suel; Gurol Mehmet,9999,0,9999,0
1708256508528,BGGN 271,089,482695,Telese; Francesca,9999,0,9999,0
1708256508528,BGGN 271,090,482745,Thackray; Varykina G.,9999,0,9999,0
1708256508528,BGGN 271,091,482746,Towers; Christina Garlingt,9999,0,9999,0
1708256508528,BGGN 271,092,482747,Troemel; Emily Ruth,9997,0,9999,2
1708256508528,BGGN 271,093,482748,Tye; Kay M,9999,0,9999,0
1708256508528,BGGN 271,094,482749,Valdez-Jasso; Daniela,9998,0,9999,1
1708256508528,BGGN 271,095,482750,Wahlin; Karl Jonas,9997,0,9999,2
1708256508528,BGGN 271,096,482751,Welsbie; Derek,9999,0,9999,0
1708256508528,BGGN 271,097,482752,Wilkinson; Miles Frome,9999,0,9999,0
1708256508528,BGGN 271,098,482754,Yaksh; Tony L.,9999,0,9999,0
1708256508528,BGGN 271,099,482760,Yang; Jing,9999,0,9999,0
1708256508528,BGGN 271,100,482761,Yeo; Eugene Wei-Ming,9998,0,9999,1
1708256508528,BGGN 271,101,482763,Ying; Wei,9999,0,9999,0
1708256508528,BGGN 271,102,482764,Zarrinpar; Amir,9999,0,9999,0
1708256508528,BGGN 271,103,482765,Zengler; Karsten B,9999,0,9999,0
1708256508528,BGGN 271,104,482766,Zhang; Dong-Er,9999,0,9999,0
1708256508528,BGGN 271,105,482768,Zhao; Yunde,9999,0,9999,0
1708256508528,BGGN 271,106,482776,Zheng; Binhai,9999,0,9999,0
1708256508528,BGGN 271,107,482777,Zheng; Ye,9998,0,9999,1
1708256508528,BGGN 271,108,482806,Zuniga; Elina I,9999,0,9999,0
1708256509058,BGGN 273,A01,424101,Mueller; Liam O'Connor,43,0,50,7
1708256509590,BGGN 280,A00,424102,Ernst; Andreas,3,0,5,2
1708256509590,BGGN 280,C00,481361,Amaro; Rommie E,2,0,5,3
1708256510115,BGGN 281,A00,424103,Desai; Arshad & Oegema; Karen,0,0,5,5
1708256510645,BGGN 283,A00,424104,Rivera; Fabian Chavez,0,0,5,5
1708256510645,BGGN 283,B00,424105,Russell; Alistair B,4,0,5,1
1708256510645,BGGN 283,D00,424107,Wildonger; Jill Cathleen,1,0,5,4
1708256511224,BGGN 284,A00,424108,Glasgow; Stacey Marie,2,0,5,3
1708256511753,BGGN 285,A00,424109,Chisholm; Andrew D.,1,0,5,4
1708256511753,BGGN 285,B00,424110,Farley; Emma Kristen,2,0,5,3
1708256512279,BGGN 295,A00,424120,Tour; Ella,9,0,30,21
1708256512809,BGJC 204,A00,424138,Lu; Li-Fan & Chang; John Tzu-yu,9998,0,9999,1
1708256513335,BGJC 215,A00,424139,Cooke; James Edward & Lo; Stanley M.,10,0,10,0
1708256513944,BGRD 200,001,485528,Ackerman; Susan,9998,0,9999,1
1708256513944,BGRD 200,002,485529,Akbari; Omar Sultan,9999,0,9999,0
1708256513944,BGRD 200,003,485530,Allen; Eric,9999,0,9999,0
1708256513944,BGRD 200,004,485531,Allen; Nicola J,9999,0,9999,0
1708256513944,BGRD 200,005,485533,Amaro; Rommie E,9999,0,9999,0
1708256513944,BGRD 200,006,485535,Augustine; Vineet,9999,0,9999,0
1708256513944,BGRD 200,007,485536,Ayres; Janelle Samantha,9999,0,9999,0
1708256513944,BGRD 200,008,485538,Banegas; Matthew Patrick,9999,0,9999,0
1708256513944,BGRD 200,009,485539,Banghart; Matthew Ryan,9999,0,9999,0
1708256513944,BGRD 200,010,485542,Benna; Marcus K,9999,0,9999,0
1708256513944,BGRD 200,011,485543,Bennett; Eric J,9999,0,9999,0
1708256513944,BGRD 200,012,485545,Bloodgood; Brenda Laurie,9999,0,9999,0
1708256513944,BGRD 200,013,485546,Breen; Ellen C.,9998,0,9999,1
1708256513944,BGRD 200,014,485548,Briggs; Steven,9998,0,9999,1
1708256513944,BGRD 200,015,485549,Bui; Jack D,9999,0,9999,0
1708256513944,BGRD 200,016,485552,Busch; Wolfgang,9999,0,9999,0
1708256513944,BGRD 200,017,485621,Callaway; Edward M,9999,0,9999,0
1708256513944,BGRD 200,018,485622,Castle; Michael James,9999,0,9999,0
1708256513944,BGRD 200,019,485623,Chaim; Isaac,9999,0,9999,0
1708256513944,BGRD 200,020,485624,Chang; John Tzu-yu,9999,0,9999,0
1708256513944,BGRD 200,021,485625,Chen; Ju,9999,0,9999,0
1708256513944,BGRD 200,022,485626,Chen; Xu,9999,0,9999,0
1708256513944,BGRD 200,023,485627,Cheng; Christine Shiang-Ling,9999,0,9999,0
1708256513944,BGRD 200,024,485632,Cherqui; Stephanie,9999,0,9999,0
1708256513944,BGRD 200,025,485633,Cho; Yoshitake,9999,0,9999,0
1708256513944,BGRD 200,026,485634,Church; Kellie Breen,9999,0,9999,0
1708256513944,BGRD 200,027,485635,Cleland; Elsa Eleanor,9999,0,9999,0
1708256513944,BGRD 200,028,485636,Cohen; Shiran,9998,0,9999,1
1708256513944,BGRD 200,029,485639,Cook-Andersen; Heidi Leigh,9999,0,9999,0
1708256513944,BGRD 200,030,485686,Cooke; James Edward,9999,0,9999,0
1708256513944,BGRD 200,031,485688,Cooper; Kimberly Lynn,9999,0,9999,0
1708256513944,BGRD 200,032,485689,Coufal; Nicole Gabriele,9998,0,9999,1
1708256513944,BGRD 200,033,485690,Crotty Alexander; Laura E,9999,0,9999,0
1708256513944,BGRD 200,034,485691,Staff,9999,0,9999,0
1708256513944,BGRD 200,035,485692,De Guglielmo; Giordano,9999,0,9999,0
1708256513944,BGRD 200,036,485693,De Silva; Shermin,9999,0,9999,0
1708256513944,BGRD 200,037,485694,Desai; Arshad,9999,0,9999,0
1708256513944,BGRD 200,038,485695,Dickinson; Alexandra Jazz,9999,0,9999,0
1708256513944,BGRD 200,039,485717,Doherty; Taylor Alan,9998,0,9999,1
1708256513944,BGRD 200,040,485720,Dulawa; Stephanie Carole,9999,0,9999,0
1708256513944,BGRD 200,041,485721,Ecker; Joseph R,9999,0,9999,0
1708256513944,BGRD 200,042,485760,Engle; Dannielle D,9999,0,9999,0
1708256513944,BGRD 200,043,485761,Ernst; Andreas,9998,0,9999,1
1708256513944,BGRD 200,044,485766,Esko; Jeffrey D.,9998,0,9999,1
1708256513944,BGRD 200,045,485905,Evans; Ronald M,9999,0,9999,0
1708256513944,BGRD 200,046,485907,Staff,9999,0,9999,0
1708256513944,BGRD 200,047,485918,Feldstein; Ariel E,9998,0,9999,1
1708256513944,BGRD 200,048,485938,Friedman; Rick Adam,9999,0,9999,0
1708256513944,BGRD 200,049,485986,Furnari; Frank,9999,0,9999,0
1708256513944,BGRD 200,050,486018,Gage; Fred H,9999,0,9999,0
1708256513944,BGRD 200,051,486139,George; Monique Leana,9999,0,9999,0
1708256513944,BGRD 200,052,486140,Ghosh; Pradipta,9998,0,9999,1
1708256513944,BGRD 200,053,486141,Glass; Christopher,9998,0,9999,1
1708256513944,BGRD 200,054,486142,Gleeson; Joseph Gerard,9999,0,9999,0
1708256513944,BGRD 200,055,486143,Golden; Susan S.,9999,0,9999,0
1708256513944,BGRD 200,056,486144,Goldrath; Ananda,9999,0,9999,0
1708256513944,BGRD 200,057,486145,Goren; Alon M,9998,0,9999,1
1708256513944,BGRD 200,058,486146,Gustafsson; Asa Birgitta,9999,0,9999,0
1708256513944,BGRD 200,059,486164,Gutkind; Jorge Silvio,9999,0,9999,0
1708256513944,BGRD 200,060,486203,Hamdoun; Amr,9999,0,9999,0
1708256513944,BGRD 200,061,486204,Hampton; Randolph Y.,9999,0,9999,0
1708256513944,BGRD 200,062,486205,Hao; Nan,9999,0,9999,0
1708256513944,BGRD 200,063,486206,Staff,9999,0,9999,0
1708256513944,BGRD 200,064,486207,Hasty; Jeff M,9999,0,9999,0
1708256513944,BGRD 200,065,486208,Hollern; Daniel Patrick,9999,0,9999,0
1708256513944,BGRD 200,066,486209,Holway; David A.,9997,0,9999,2
1708256513944,BGRD 200,067,486214,Huffaker; Alisa,9998,0,9999,1
1708256513944,BGRD 200,068,486215,Hui; Enfu,9999,0,9999,0
1708256513944,BGRD 200,069,486216,Hwa; Terence T.,9999,0,9999,0
1708256513944,BGRD 200,070,486217,Sebat; Lilia Mikhailovna,9998,0,9999,1
1708256513944,BGRD 200,071,486218,Ideker; Trey,9999,0,9999,0
1708256513944,BGRD 200,072,486219,Jackrel; Sara,9998,0,9999,1
1708256513944,BGRD 200,073,486224,Jiang; Qingfei,9998,0,9999,1
1708256513944,BGRD 200,074,486225,Jin; Yishi,9999,0,9999,0
1708256513944,BGRD 200,075,486226,Joiner; William J.,9999,0,9999,0
1708256513944,BGRD 200,076,486227,Jun; Suckjoon,9999,0,9999,0
1708256513944,BGRD 200,077,486228,Kadonaga; James T,9998,0,9999,1
1708256513944,BGRD 200,078,486229,Kaech; Susan Michelle,9997,0,9999,2
1708256513944,BGRD 200,079,486237,Karin; Michael,9999,0,9999,0
1708256513944,BGRD 200,080,486238,Kleinfeld; David,9999,0,9999,0
1708256513944,BGRD 200,081,486239,Knight; Robin,9999,0,9999,0
1708256513944,BGRD 200,082,486335,Koffler; Yacov,9999,0,9999,0
1708256513944,BGRD 200,083,486336,Komiyama; Takaki,9999,0,9999,0
1708256513944,BGRD 200,084,486337,Kosuri; Pallav,9999,0,9999,0
1708256513944,BGRD 200,085,486353,Kryazhimskiy; Sergey A,9999,0,9999,0
1708256513944,BGRD 200,086,486354,Kurle; Carolyn M.,9999,0,9999,0
1708256513944,BGRD 200,087,486355,Law; Julie A,9999,0,9999,0
1708256513944,BGRD 200,088,486356,Lawson; Mark Andrew,9999,0,9999,0
1708256513944,BGRD 200,089,486357,Lee; Kuo Fen,9999,0,9999,0
1708256513944,BGRD 200,090,486376,Lee; Yun Sok,9999,0,9999,0
1708256513944,BGRD 200,091,486413,Leutgeb; Jill K.,9999,0,9999,0
1708256513944,BGRD 200,092,486414,Leutgeb; Stefan,9998,0,9999,1
1708256513944,BGRD 200,093,486415,Lim; Byungkook,9999,0,9999,0
1708256513944,BGRD 200,094,486419,Lo; Stanley M.,9999,0,9999,0
1708256513944,BGRD 200,095,486420,Looger; Loren Lee,9999,0,9999,0
1708256513944,BGRD 200,096,486422,Lovett-Barron; Matthew Rod,9999,0,9999,0
1708256513944,BGRD 200,097,486423,Lu; Li-Fan,9998,0,9999,1
1708256513944,BGRD 200,098,486424,Lu; Pengzhe,9998,0,9999,1
1708256513944,BGRD 200,099,486425,Lykke-Andersen; Jens,9998,0,9999,1
1708256513944,BGRD 200,100,486426,Lyumkis; Dmitry Evgenievich,9999,0,9999,0
1708256513944,BGRD 200,101,486427,Madigan; Cressida Ariana,9999,0,9999,0
1708256513944,BGRD 200,102,486428,Staff,9999,0,9999,0
1708256513944,BGRD 200,103,486429,Mayfield; Stephen P.,9998,0,9999,1
1708256513944,BGRD 200,104,486430,McDonnell; Lisa Marie,9999,0,9999,0
1708256513944,BGRD 200,105,486620,McHugh; Colleen A,9998,0,9999,1
1708256513944,BGRD 200,106,486621,Meharena; Hiruy Sibhatu,9999,0,9999,0
1708256513944,BGRD 200,107,486622,Staff,9999,0,9999,0
1708256513944,BGRD 200,108,486681,Morris; Gerald P,9999,0,9999,0
1708256513944,BGRD 200,109,486682,Mukamel; Eran A,9998,0,9999,1
1708256513944,BGRD 200,110,486683,Muotri; Alysson,9999,0,9999,0
1708256513944,BGRD 200,111,486684,Muroyama; Andrew David,9999,0,9999,0
1708256513944,BGRD 200,112,486687,Murre; Cornelis,9999,0,9999,0
1708256513944,BGRD 200,113,486691,Neal; Sonya E,9999,0,9999,0
1708256513944,BGRD 200,114,486692,Nieh; James Charles,9998,0,9999,1
1708256513944,BGRD 200,115,486693,Nimmerjahn; Axel,9999,0,9999,0
1708256513944,BGRD 200,116,486694,Nizet; Victor F.,9999,0,9999,0
1708256513944,BGRD 200,117,486695,O'Donoghue; Anthony John,9999,0,9999,0
1708256513944,BGRD 200,118,486706,Oegema; Karen,9999,0,9999,0
1708256513944,BGRD 200,119,486708,O'Shea; Clodagh,9999,0,9999,0
1708256513944,BGRD 200,120,486709,Pantham; Priyadarshini,9999,0,9999,0
1708256513944,BGRD 200,121,486715,Parast; Mana,9999,0,9999,0
1708256513944,BGRD 200,122,486716,Pasquinelli; Amy,9998,0,9999,1
1708256513944,BGRD 200,123,486718,Pekkurnaz Banghart; Gulcin,9999,0,9999,0
1708256513944,BGRD 200,124,486720,Perry; Michael William,9999,0,9999,0
1708256513944,BGRD 200,125,486721,Pfaff; Samuel,9999,0,9999,0
1708256513944,BGRD 200,126,486723,Pogliano; Joseph,9999,0,9999,0
1708256513944,BGRD 200,127,486724,Pogliano; Kit J.,9999,0,9999,0
1708256513944,BGRD 200,128,486727,Pride; David Tevis,9999,0,9999,0
1708256513944,BGRD 200,129,486728,Pruneda-Paz; Jose L.,9999,0,9999,0
1708256513944,BGRD 200,130,486733,Staff,9999,0,9999,0
1708256513944,BGRD 200,131,486734,Rana; Tariq,9999,0,9999,0
1708256513944,BGRD 200,132,486736,Reck-Peterson; Samara L,9999,0,9999,0
1708256513944,BGRD 200,133,486738,Rennison; Diana,9999,0,9999,0
1708256513944,BGRD 200,134,486741,Rifkin; Scott,9999,0,9999,0
1708256513944,BGRD 200,135,486743,Risbrough; Victoria Blythe,9999,0,9999,0
1708256513944,BGRD 200,136,486749,Rissman; Robert Andrew,9999,0,9999,0
1708256513944,BGRD 200,137,486750,Rivera; Fabian Chavez,9999,0,9999,0
1708256513944,BGRD 200,138,486753,Root; Cory Matthew,9999,0,9999,0
1708256513944,BGRD 200,139,486760,Rosenfeld; Michael G,9998,0,9999,1
1708256513944,BGRD 200,140,486763,Russell; Alistair B,9999,0,9999,0
1708256513944,BGRD 200,141,486766,Saier; Milton H.,9999,0,9999,0
1708256513944,BGRD 200,142,486768,Sander; Maike,9999,0,9999,0
1708256513944,BGRD 200,143,486770,Saphire; Erica Ollmann,9999,0,9999,0
1708256513944,BGRD 200,144,486771,Schenk; Simon,9999,0,9999,0
1708256513944,BGRD 200,145,486774,Schoeneberg; Johannes,9999,0,9999,0
1708256513944,BGRD 200,146,486777,Schroeder; Julian I,9998,0,9999,1
1708256513944,BGRD 200,147,486783,Shah; Sameer B,9999,0,9999,0
1708256513944,BGRD 200,148,486784,Shaner; Nathan C.,9999,0,9999,0
1708256513944,BGRD 200,149,486785,Shaw; Reuben,9999,0,9999,0
1708256513944,BGRD 200,150,486786,Sheikh; Farah,9999,0,9999,0
1708256513944,BGRD 200,151,486787,Staff,9999,0,9999,0
1708256513944,BGRD 200,152,486788,Signer; Robert,9999,0,9999,0
1708256513944,BGRD 200,153,486789,Sigurdson; Christina,9999,0,9999,0
1708256513944,BGRD 200,154,486790,Smith; David M.,9999,0,9999,0
1708256513944,BGRD 200,155,486791,Soncin; Francesca,9999,0,9999,0
1708256513944,BGRD 200,156,486792,Steinmetz; Nicole F,9999,0,9999,0
1708256513944,BGRD 200,157,486793,Su; Chih-Ying,9999,0,9999,0
1708256513944,BGRD 200,158,486794,Suel; Gurol Mehmet,9999,0,9999,0
1708256513944,BGRD 200,159,486795,Sun; Xin,9999,0,9999,0
1708256513944,BGRD 200,160,486796,Telese; Francesca,9999,0,9999,0
1708256513944,BGRD 200,161,486797,Thackray; Varykina G.,9999,0,9999,0
1708256513944,BGRD 200,162,486798,Towers; Christina Garlingt,9999,0,9999,0
1708256513944,BGRD 200,163,486799,Traver; David,9999,0,9999,0
1708256513944,BGRD 200,164,486800,Troemel; Emily Ruth,9998,0,9999,1
1708256513944,BGRD 200,165,486801,Tye; Kay M,9999,0,9999,0
1708256513944,BGRD 200,166,486802,Valdez-Jasso; Daniela,9998,0,9999,1
1708256513944,BGRD 200,167,486803,Vijayanand; Pandurangan,9999,0,9999,0
1708256513944,BGRD 200,168,486804,Villa Rodriguez; Elizabeth,9999,0,9999,0
1708256513944,BGRD 200,169,486805,Wahlin; Karl Jonas,9997,0,9999,2
1708256513944,BGRD 200,170,486806,Wang; Jean Yin Jen,9999,0,9999,0
1708256513944,BGRD 200,171,486807,Welsbie; Derek,9999,0,9999,0
1708256513944,BGRD 200,172,486808,Wildonger; Jill Cathleen,9998,0,9999,1
1708256513944,BGRD 200,173,486809,Wilkinson; Miles Frome,9999,0,9999,0
1708256513944,BGRD 200,174,486810,Winzeler; Elizabeth A,9999,0,9999,0
1708256513944,BGRD 200,175,486811,Yaksh; Tony L.,9999,0,9999,0
1708256513944,BGRD 200,176,486812,Yang; Jing,9999,0,9999,0
1708256513944,BGRD 200,177,486813,Staff,9999,0,9999,0
1708256513944,BGRD 200,178,486814,Yeo; Eugene Wei-Ming,9998,0,9999,1
1708256513944,BGRD 200,179,486815,Ying; Wei,9999,0,9999,0
1708256513944,BGRD 200,180,486816,Zarrinpar; Amir,9999,0,9999,0
1708256513944,BGRD 200,181,486817,Zengler; Karsten B,9999,0,9999,0
1708256513944,BGRD 200,182,486818,Zhang; Dong-Er,9999,0,9999,0
1708256513944,BGRD 200,183,486819,Zhao; Yunde,9999,0,9999,0
1708256513944,BGRD 200,184,486820,Zheng; Binhai,9999,0,9999,0
1708256513944,BGRD 200,185,486821,Zheng; Ye,9998,0,9999,1
1708256513944,BGRD 200,186,486822,Zuniga; Elina I,9999,0,9999,0
1708256514472,BGSE 200,A00,424140,Tour; Ella & Petrie; Katherine Lynn,9995,0,9999,4
1708256514998,BGSE 205,A00,424177,Bennett; Eric J,49,0,50,1
1708256514998,BGSE 205,B00,424179,Bennett; Eric J,48,0,50,2
1708256514998,BGSE 205,C00,424182,Bennett; Eric J,47,0,50,3
1708256514998,BGSE 205,D00,424184,Bennett; Eric J,46,0,50,4
1708256514998,BGSE 205,E00,424185,Bennett; Eric J,50,0,50,0
1708256515525,BIBC 100,A01,425401,Corbett; Kevin Daniel,150,0,158,8
1708256515525,BIBC 100,B01,477769,Amaro; Rommie E,156,0,158,2
1708256516055,BIBC 102,A01,425425,Bozinovic; Goran,255,0,256,1
1708256516055,BIBC 102,B01,425440,Hampton; Randolph Y.,250,0,256,6
1708256516055,BIBC 102,C01,486849,Flagg; Matthew Paul,61,0,120,59
1708256516588,BIBC 103,A01,425476,Grossman; Emily N,17,0,24,7
1708256516588,BIBC 103,A02,425509,Grossman; Emily N,21,0,24,3
1708256516588,BIBC 103,A03,425530,Grossman; Emily N,18,0,24,6
1708256516588,BIBC 103,A04,425536,Grossman; Emily N,22,0,24,2
1708256516588,BIBC 103,B01,425538,Boumechache; Miyyada,20,0,24,4
1708256516588,BIBC 103,B02,425539,Boumechache; Miyyada,24,0,24,0
1708256516588,BIBC 103,B03,425548,Boumechache; Miyyada,24,0,24,0
1708256516588,BIBC 103,B04,425549,Boumechache; Miyyada,24,0,24,0
1708256517113,BIBC 120,A01,425592,Coleman; Aaron B.,242,0,256,14
1708256517642,BIBC 194,A00,425609,Ernst; Andreas,21,0,27,6
1708256517642,BIBC 194,B00,477632,Saier; Milton H.,26,0,27,1
1708256517642,BIBC 194,C00,481360,Amaro; Rommie E,23,0,27,4
1708256517642,BIBC 194,D00,486852,Flagg; Matthew Paul,21,0,32,11
1708256518170,BICD 100,A01,470377,Troemel; Emily Ruth,127,0,128,1
1708256518170,BICD 100,A02,470378,Troemel; Emily Ruth,126,0,128,2
1708256518170,BICD 100,B01,470409,Reinagel; Pam,59,0,64,5
1708256518170,BICD 100,B02,470413,Reinagel; Pam,62,0,64,2
1708256518170,BICD 100,B03,470464,Reinagel; Pam,64,0,64,0
1708256518170,BICD 100,B04,470468,Reinagel; Pam,63,0,64,1
1708256518170,BICD 100,C01,470469,Beyhan; Sinem,51,0,64,13
1708256518170,BICD 100,C02,470605,Beyhan; Sinem,58,0,64,6
1708256518170,BICD 100,C03,470606,Beyhan; Sinem,60,0,64,4
1708256518170,BICD 100,C04,470607,Beyhan; Sinem,63,0,64,1
1708256518170,BICD 100,D01,477465,Nguyen; Vu Quang,158,0,160,2
1708256518698,BICD 100R,A01,425674,Smith; Laurie,29,0,34,5
1708256518698,BICD 100R,A02,425675,Smith; Laurie,30,0,34,4
1708256518698,BICD 100R,A03,425676,Smith; Laurie,30,0,34,4
1708256519227,BICD 104,A01,425696,Greenspan; Ralph J.,60,0,64,4
1708256519753,BICD 110,A01,470608,Muroyama; Andrew David,264,0,275,11
1708256519753,BICD 110,B01,425721,Ernst; Andreas,244,0,275,31
1708256520282,BICD 112,A01,458177,Cooper; Kimberly Lynn & Traver; David,10,0,32,22
1708256520282,BICD 112,A02,458180,Cooper; Kimberly Lynn & Traver; David,28,0,32,4
1708256520808,BICD 123,A01,425725,Zhao; Yunde,23,0,32,9
1708256521336,BICD 140,A01,425728,Lu; Li-Fan,227,0,240,13
1708256521863,BICD 158,A01,425730,Bier; Ethan,136,0,145,9
1708256522391,BICD 194,A00,425731,Desai; Arshad & Oegema; Karen,17,0,27,10
1708256522391,BICD 194,B00,481735,Wilhelm; James E.,29,0,32,3
1708256522917,BIEB 121,A00,425732,Butler; Shannon Rhey,21,0,32,11
1708256522917,BIEB 121,B00,425733,Butler; Shannon Rhey,24,0,32,8
1708256523445,BIEB 130,A01,425735,Kurle; Carolyn M.,243,0,295,52
1708256523973,BIEB 146,A01,425737,Petrie; Katherine Lynn,365,0,395,30
1708256524500,BIEB 148,A01,470637,Rose; Noah Hartmann,59,0,63,4
1708256524500,BIEB 148,A02,470638,Rose; Noah Hartmann,61,0,63,2
1708256525027,BIEB 154,A01,458184,Stockwell; Sarah R,29,0,30,1
1708256525027,BIEB 154,A02,458186,Stockwell; Sarah R,29,0,30,1
1708256525553,BIEB 176,A01,425741,De Silva; Shermin,56,0,64,8
1708256526080,BIEB 182,A01,458194,Roy; Kaustuv,25,0,32,7
1708256526080,BIEB 182,A02,458215,Roy; Kaustuv,31,0,32,1
1708256526616,BILD 1,A01,424267,Patrick; Gentry,249,0,250,1
1708256526616,BILD 1,B01,424272,Burg; Michael,231,0,250,19
1708256526616,BILD 1,C01,424293,Pickett; Brooke Elizabeth,245,0,250,5
1708256526616,BILD 1,D01,458292,Gonzalez Gamboa; Ivonne,48,0,50,2
1708256526616,BILD 1,D02,458295,Gonzalez Gamboa; Ivonne,50,0,50,0
1708256526616,BILD 1,D03,458296,Gonzalez Gamboa; Ivonne,50,0,50,0
1708256526616,BILD 1,D04,458297,Gonzalez Gamboa; Ivonne,49,0,50,1
1708256526616,BILD 1,D05,458303,Gonzalez Gamboa; Ivonne,50,0,50,0
1708256527143,BILD 2,A01,458304,Reyes Gonzalez; Catalina,53,0,56,3
1708256527143,BILD 2,A02,458307,Reyes Gonzalez; Catalina,55,0,56,1
1708256527143,BILD 2,A03,458313,Reyes Gonzalez; Catalina,55,0,56,1
1708256527143,BILD 2,A04,458320,Reyes Gonzalez; Catalina,56,0,56,0
1708256527143,BILD 2,B01,458324,Reyes Gonzalez; Catalina,47,0,56,9
1708256527143,BILD 2,B02,458327,Reyes Gonzalez; Catalina,54,0,56,2
1708256527143,BILD 2,B03,458339,Reyes Gonzalez; Catalina,56,0,56,0
1708256527143,BILD 2,B04,458340,Reyes Gonzalez; Catalina,56,0,56,0
1708256527143,BILD 2,C01,458387,Park; Ji Young,44,0,49,5
1708256527143,BILD 2,C02,458544,Park; Ji Young,46,0,49,3
1708256527143,BILD 2,C03,458557,Park; Ji Young,47,0,49,2
1708256527143,BILD 2,C04,458563,Park; Ji Young,46,0,49,3
1708256527670,BILD 3,A01,424312,Hammond; LaTisha Marie,331,0,350,19
1708256527670,BILD 3,B01,470107,Stockwell; Sarah R,66,0,70,4
1708256527670,BILD 3,B02,470110,Stockwell; Sarah R,70,0,70,0
1708256527670,BILD 3,B03,470116,Stockwell; Sarah R,70,0,70,0
1708256527670,BILD 3,B04,470123,Stockwell; Sarah R,67,0,70,3
1708256527670,BILD 3,B05,470150,Stockwell; Sarah R,70,0,70,0
1708256527670,BILD 3,C01,470159,Cooper; Kimberly Lynn,67,0,70,3
1708256527670,BILD 3,C02,470160,Cooper; Kimberly Lynn,69,0,70,1
1708256527670,BILD 3,C03,470164,Cooper; Kimberly Lynn,70,0,70,0
1708256527670,BILD 3,C04,470165,Cooper; Kimberly Lynn,69,0,70,1
1708256527670,BILD 3,C05,470374,Cooper; Kimberly Lynn,68,0,70,2
1708256528203,BILD 4,A01,424318,Staff,22,0,24,2
1708256528203,BILD 4,A02,424324,Staff,24,0,24,0
1708256528203,BILD 4,A03,424325,Staff,24,0,24,0
1708256528203,BILD 4,A04,424326,Staff,22,0,24,2
1708256528203,BILD 4,A05,424327,Staff,24,0,24,0
1708256528203,BILD 4,A06,424330,Staff,24,0,24,0
1708256528203,BILD 4,A07,424331,Staff,24,0,24,0
1708256528203,BILD 4,A08,424342,Staff,24,0,24,0
1708256528203,BILD 4,B01,424462,Pickett; Brooke Elizabeth,23,0,24,1
1708256528203,BILD 4,B02,424466,Pickett; Brooke Elizabeth,24,0,24,0
1708256528203,BILD 4,B03,424469,Pickett; Brooke Elizabeth,23,0,24,1
1708256528203,BILD 4,B04,424470,Pickett; Brooke Elizabeth,22,0,24,2
1708256528203,BILD 4,B05,424700,Pickett; Brooke Elizabeth,23,0,24,1
1708256528203,BILD 4,B06,424723,Pickett; Brooke Elizabeth,24,0,24,0
1708256528203,BILD 4,B07,424730,Pickett; Brooke Elizabeth,24,0,24,0
1708256528203,BILD 4,B08,424929,Pickett; Brooke Elizabeth,22,0,24,2
1708256528203,BILD 4,C01,424947,Gonzalez Gamboa; Ivonne,22,0,24,2
1708256528203,BILD 4,C02,424951,Gonzalez Gamboa; Ivonne,23,0,24,1
1708256528203,BILD 4,C03,424991,Gonzalez Gamboa; Ivonne,23,0,24,1
1708256528203,BILD 4,C04,424993,Gonzalez Gamboa; Ivonne,24,0,24,0
1708256528203,BILD 4,C05,424994,Gonzalez Gamboa; Ivonne,24,0,24,0
1708256528203,BILD 4,C06,425209,Gonzalez Gamboa; Ivonne,24,0,24,0
1708256528203,BILD 4,C07,425233,Gonzalez Gamboa; Ivonne,24,0,24,0
1708256528203,BILD 4,C08,425247,Gonzalez Gamboa; Ivonne,24,0,24,0
1708256528728,BILD 60,A01,425326,Hammond; LaTisha Marie,62,0,64,2
1708256529257,BILD 83,A00,425347,Pogliano; Joseph,25,0,30,5
1708256529783,BILD 87,A00,425368,Saier; Milton H.,20,0,20,0
1708256530309,BIMM 100,A01,425744,Cooper; Andrew Michael,303,0,320,17
1708256530309,BIMM 100,B01,425746,Cooper; Andrew Michael,315,0,320,5
1708256530838,BIMM 101,A01,425748,McDonnell; Lisa Marie,8,0,24,16
1708256530838,BIMM 101,A02,425749,McDonnell; Lisa Marie,23,0,24,1
1708256530838,BIMM 101,B01,425751,Day; Christopher D,22,0,24,2
1708256530838,BIMM 101,B02,425752,Day; Christopher D,24,0,24,0
1708256530838,BIMM 101,B03,425753,Day; Christopher D,22,0,24,2
1708256530838,BIMM 101,B04,425754,Day; Christopher D,24,0,24,0
1708256530838,BIMM 101,C01,425756,Rusert; Jessica Marie,16,0,24,8
1708256530838,BIMM 101,C02,425757,Rusert; Jessica Marie,23,0,24,1
1708256530838,BIMM 101,C03,425758,Rusert; Jessica Marie,23,0,24,1
1708256530838,BIMM 101,C04,425759,Rusert; Jessica Marie,23,0,24,1
1708256531367,BIMM 110,A01,425764,Niwa; Maho,55,0,56,1
1708256531367,BIMM 110,A02,425765,Niwa; Maho,56,0,56,0
1708256531367,BIMM 110,A03,425766,Niwa; Maho,56,0,56,0
1708256531367,BIMM 110,A04,425767,Niwa; Maho,55,0,56,1
1708256531894,BIMM 116R,A01,425771,Golden; Susan S. & Gorman; Michael R.,55,0,72,17
1708256531894,BIMM 116R,A02,425772,Golden; Susan S. & Gorman; Michael R.,53,0,72,19
1708256531894,BIMM 116R,A03,425773,Golden; Susan S. & Gorman; Michael R.,66,0,72,6
1708256531894,BIMM 116R,A04,425774,Golden; Susan S. & Gorman; Michael R.,70,0,72,2
1708256532422,BIMM 118,A01,425779,David; Michael,83,0,96,13
1708256532949,BIMM 120,A01,425792,Pirino; Giorgia,203,0,216,13
1708256532949,BIMM 120,B01,470639,Saier; Milton H.,201,0,216,15
1708256533475,BIMM 121,A01,425830,Gustafson-Brown; Cindy,18,0,24,6
1708256533475,BIMM 121,A02,425831,Gustafson-Brown; Cindy,21,0,24,3
1708256533475,BIMM 121,A03,425832,Gustafson-Brown; Cindy,24,0,24,0
1708256533475,BIMM 121,A04,425833,Gustafson-Brown; Cindy,23,0,24,1
1708256533475,BIMM 121,B01,425835,Pirino; Giorgia,17,0,24,7
1708256533475,BIMM 121,B02,425836,Pirino; Giorgia,24,0,24,0
1708256533475,BIMM 121,C01,425838,Park; Ji Young,6,0,24,18
1708256533475,BIMM 121,C02,425839,Park; Ji Young,20,0,24,4
1708256534005,BIMM 134,A01,425841,Burg; Michael,393,0,416,23
1708256534531,BIMM 143,A01,425843,Grant; Barry J,17,0,40,23
1708256534531,BIMM 143,B01,425845,Bozinovic; Goran,33,0,40,7
1708256535056,BIMM 182,A01,455012,Bafna; Vineet,28,0,50,22
1708256535581,BIMM 194,A00,425847,Rivera; Fabian Chavez,24,0,27,3
1708256535581,BIMM 194,B00,425868,Russell; Alistair B,16,0,27,11
1708256535581,BIMM 194,D00,425870,Wildonger; Jill Cathleen,14,0,27,13
1708256536110,BIOM 202,A00,390710,Corbett; Kevin Daniel,93,0,100,7
1708256536636,BIOM 219,A00,390713,Ross; Camille,0,0,0,7
1708256537161,BIOM 231,A00,455099,Furnari; Frank,0,0,0,0
1708256537161,BIOM 231,B00,455100,Lopez Ramirez; Miguel Alej,0,0,0,0
1708256537688,BIOM 242,A00,390714,Hamilton; Bruce Alan,20,0,20,0
1708256538218,BIOM 246,A00,492784,Gordts; Philip & Varki; Ajit P & Lewis; Amanda Lark & Godula; Kamil & Gagneux; Pascal & Esko; Jeffrey D. & Bode; Lars,0,0,0,0
1708256538744,BIOM 252,A00,390715,Ayyagari; Radha,27,0,28,1
1708256539269,BIOM 254,A00,390718,Corbett; Kevin Daniel,14,0,20,6
1708256539798,BIOM 272,A00,390722,Hangauer; Matthew John,16,0,20,4
1708256540324,BIOM 274,A00,390725,Sun; Bryan Kee-Hong,7,0,15,8
1708256540849,BIOM 283,A00,390728,Komives; Elizabeth A,2,0,2,0
1708256541374,BIOM 285,A00,390730,Gaulton; Kyle J,10,0,20,10
1708256541900,BIOM 295,A00,455083,Brown; Joan Heller,0,0,0,0
1708256542426,BIPN 100,A01,425872,Augustine; Vineet,240,0,245,5
1708256542426,BIPN 100,B01,425874,George; Monique Leana,240,0,245,5
1708256542426,BIPN 100,C01,458640,Maita; Isabella Vincenza,44,0,49,5
1708256542426,BIPN 100,C02,458646,Maita; Isabella Vincenza,48,0,49,1
1708256542426,BIPN 100,C03,458714,Maita; Isabella Vincenza,48,0,49,1
1708256542426,BIPN 100,C04,458716,Maita; Isabella Vincenza,48,0,49,1
1708256542426,BIPN 100,C05,458717,Maita; Isabella Vincenza,46,0,49,3
1708256542956,BIPN 105,A01,425877,Armour; Jon Christopher,12,0,21,9
1708256542956,BIPN 105,A02,425878,Armour; Jon Christopher,21,0,21,0
1708256542956,BIPN 105,A03,425879,Armour; Jon Christopher,10,0,21,11
1708256542956,BIPN 105,A04,425880,Armour; Jon Christopher,20,0,21,1
1708256543485,BIPN 120,A01,425882,Cooke; James Edward,370,0,395,25
1708256544011,BIPN 140,A01,425884,Hibbs; Ryan E.,183,0,192,9
1708256544541,BIPN 144,A01,425886,Zou; Yimin,153,0,158,5
1708256545068,BIPN 145,A01,425888,Maita; Isabella Vincenza,41,0,42,1
1708256545068,BIPN 145,B01,425918,Marino; Marc J,37,0,42,5
1708256545068,BIPN 145,B02,425954,Marino; Marc J,40,0,42,2
1708256545596,BIPN 147,A01,426086,Sejnowski; Terrence J,53,0,64,11
1708256546126,BIPN 152,A01,426112,Halpain; Shelley,97,0,128,31
1708256546654,BIPN 162,A01,426120,Juavinett; Ashley Lauren,17,0,30,13
1708256547182,BIPN 164,A01,455010,Benna; Marcus K & Aljadeff; Johnatan,120,0,120,0
1708256547710,BIPN 194,A00,426122,Glasgow; Stacey Marie,20,0,27,7
1708256548236,BISP 170,A00,426158,French; Kathleen Ann,26,0,30,4
1708256548764,BISP 182,A00,426168,Pogliano; Joseph,9999,0,9999,0
1708256549292,BISP 194,A00,426240,Chisholm; Andrew D.,11,0,27,16
1708256549292,BISP 194,B00,426241,Farley; Emma Kristen,25,0,27,2
1708256549818,BNFO 281,A00,427175,Gaasterland; Theresa,85,0,100,15
1708256550345,BNFO 283,A00,427211,Carter; Hannah Kathryn & Chavez; Alejandro,39,0,50,11
1708256550345,BNFO 283,B00,480483,Amariuta-Bartell; Tiffany & Dorrestein; Pieter,21,0,30,9
1708256550869,BNFO 294,B01,427269,Ross; Camille,47,0,50,3
1708256551422,CAT 3,A01,396994,Glaser; Amelia,15,0,15,0
1708256551422,CAT 3,A02,396995,Glaser; Amelia,15,0,15,0
1708256551422,CAT 3,A03,396996,Glaser; Amelia,7,0,15,8
1708256551422,CAT 3,A04,396997,Glaser; Amelia,12,0,15,3
1708256551422,CAT 3,A05,397004,Glaser; Amelia,15,0,15,0
1708256551422,CAT 3,A06,397039,Glaser; Amelia,11,0,15,4
1708256551422,CAT 3,A07,397040,Glaser; Amelia,13,0,15,2
1708256551422,CAT 3,A08,397084,Glaser; Amelia,15,0,15,0
1708256551422,CAT 3,A09,397269,Glaser; Amelia,13,0,15,2
1708256551422,CAT 3,A10,397270,Glaser; Amelia,0,0,15,15
1708256551422,CAT 3,A11,397271,Glaser; Amelia,9,0,15,6
1708256551422,CAT 3,A12,397272,Glaser; Amelia,12,0,15,3
1708256551422,CAT 3,A13,397273,Glaser; Amelia,15,0,15,0
1708256551422,CAT 3,A14,397274,Glaser; Amelia,14,0,15,1
1708256551422,CAT 3,B01,397276,Porter; Lisa,15,0,15,0
1708256551422,CAT 3,B02,397277,Porter; Lisa,15,0,15,0
1708256551422,CAT 3,B03,397278,Porter; Lisa,14,0,15,1
1708256551422,CAT 3,B04,397279,Porter; Lisa,15,0,15,0
1708256551422,CAT 3,B06,397281,Porter; Lisa,15,0,15,0
1708256551422,CAT 3,B07,397291,Porter; Lisa,15,0,15,0
1708256551422,CAT 3,B09,397293,Porter; Lisa,15,0,15,0
1708256551422,CAT 3,B10,397294,Porter; Lisa,15,0,15,0
1708256551422,CAT 3,B11,397295,Porter; Lisa,12,0,15,3
1708256551422,CAT 3,B12,397296,Porter; Lisa,14,0,15,1
1708256551422,CAT 3,B13,397297,Porter; Lisa,11,0,15,4
1708256551422,CAT 3,B14,397298,Porter; Lisa,15,0,15,0
1708256551422,CAT 3,B15,397299,Porter; Lisa,15,0,15,0
1708256551422,CAT 3,B16,397300,Porter; Lisa,15,0,15,0
1708256551422,CAT 3,C01,397302,Marchisotto; Jennifer Anne,13,0,15,2
1708256551422,CAT 3,C02,397308,Marchisotto; Jennifer Anne,9,0,15,6
1708256551422,CAT 3,C03,397309,Marchisotto; Jennifer Anne,9,0,15,6
1708256551422,CAT 3,C04,397315,Marchisotto; Jennifer Anne,11,0,15,4
1708256551422,CAT 3,C05,397316,Marchisotto; Jennifer Anne,14,0,15,1
1708256551422,CAT 3,C06,397322,Marchisotto; Jennifer Anne,15,0,15,0
1708256551422,CAT 3,C07,397323,Marchisotto; Jennifer Anne,15,0,15,0
1708256551422,CAT 3,C08,397329,Marchisotto; Jennifer Anne,15,0,15,0
1708256551422,CAT 3,C09,397333,Marchisotto; Jennifer Anne,15,0,15,0
1708256551422,CAT 3,C10,397336,Marchisotto; Jennifer Anne,15,0,15,0
1708256551422,CAT 3,C11,397354,Marchisotto; Jennifer Anne,13,0,15,2
1708256551422,CAT 3,C12,397357,Marchisotto; Jennifer Anne,15,0,15,0
1708256551422,CAT 3,C13,397364,Marchisotto; Jennifer Anne,14,0,15,1
1708256551422,CAT 3,C14,397367,Marchisotto; Jennifer Anne,14,0,15,1
1708256551422,CAT 3,C15,397369,Marchisotto; Jennifer Anne,15,0,15,0
1708256551422,CAT 3,C16,397373,Marchisotto; Jennifer Anne,15,0,15,0
1708256551422,CAT 3,C17,397374,Marchisotto; Jennifer Anne,15,0,15,0
1708256551422,CAT 3,C18,397380,Marchisotto; Jennifer Anne,14,0,15,1
1708256551422,CAT 3,D02,397405,Rahimi; Babak,13,0,15,2
1708256551422,CAT 3,D03,397408,Rahimi; Babak,14,0,15,1
1708256551422,CAT 3,D04,397415,Rahimi; Babak,15,0,15,0
1708256551422,CAT 3,D05,397416,Rahimi; Babak,15,0,15,0
1708256551422,CAT 3,D06,397422,Rahimi; Babak,15,0,15,0
1708256551422,CAT 3,D07,397426,Rahimi; Babak,14,0,15,1
1708256551422,CAT 3,D09,397447,Rahimi; Babak,11,0,15,4
1708256551422,CAT 3,D10,397450,Rahimi; Babak,13,0,15,2
1708256551422,CAT 3,D11,397625,Rahimi; Babak,13,0,15,2
1708256551422,CAT 3,D12,397630,Rahimi; Babak,15,0,15,0
1708256551422,CAT 3,D13,397631,Rahimi; Babak,14,0,15,1
1708256551422,CAT 3,D14,397635,Rahimi; Babak,14,0,15,1
1708256551948,CAT 3CE,A01,397642,Bronstein; Phoebe Malan,25,0,25,0
1708256552478,CAT 87,A00,397645,Bronstein; Phoebe Malan,19,0,20,1
1708256553003,CAT 90,A00,480731,Bronstein; Phoebe Malan,20,0,20,0
1708256553530,CAT 124,A01,397662,Knight; Amy,5,0,5,0
1708256553530,CAT 124,A02,397722,Knight; Amy,5,0,5,0
1708256553530,CAT 124,A03,397726,Knight; Amy,5,0,5,0
1708256553530,CAT 124,A04,397829,Knight; Amy,4,0,5,1
1708256554071,CAT 125,001,397832,Popko; Elizabeth Ashley,20,0,20,0
1708256554071,CAT 125,002,397833,Delaville; Romain,20,0,20,0
1708256554071,CAT 125,003,397834,Marchisotto; Jennifer Anne,18,0,20,2
1708256554071,CAT 125,004,397835,Bigham; David Joseph,20,0,20,0
1708256554071,CAT 125,005,397836,Bigham; David Joseph,19,0,20,1
1708256554071,CAT 125,006,397837,Bigham; David Joseph,16,0,20,4
1708256554071,CAT 125,007,397838,Vanderschuit; Maya Alysia,20,0,20,0
1708256554071,CAT 125,008,397839,Vanderschuit; Maya Alysia,20,0,20,0
1708256554071,CAT 125,009,397840,Vanderschuit; Maya Alysia,20,0,20,0
1708256554071,CAT 125,010,397841,Morales; Celeste Georgianna,15,0,16,1
1708256554071,CAT 125,011,397842,Morales; Celeste Georgianna,16,0,16,0
1708256554071,CAT 125,012,397881,Morales; Celeste Georgianna,19,0,20,1
1708256554071,CAT 125,013,397954,Rose; Becca Rae,18,0,20,2
1708256554071,CAT 125,014,397956,Rose; Becca Rae,20,0,20,0
1708256554071,CAT 125,015,397998,Rose; Becca Rae,19,0,20,1
1708256554071,CAT 125,016,397999,Tosun; Adriana,20,0,20,0
1708256554071,CAT 125,017,398001,Tosun; Adriana,20,0,20,0
1708256554071,CAT 125,018,398009,Irwin; Matthew Joseph,19,0,20,1
1708256554071,CAT 125,019,398010,Irwin; Matthew Joseph,18,0,20,2
1708256554071,CAT 125,020,398014,Irwin; Matthew Joseph,20,0,20,0
1708256554600,CAT 125R,A00,398015,Smith; Lauryn Alissa,19,0,20,1
1708256554600,CAT 125R,B00,398016,Smith; Lauryn Alissa,17,0,20,3
1708256554600,CAT 125R,C00,398017,Smith; Lauryn Alissa,19,0,20,1
1708256554600,CAT 125R,D00,398019,Tosun; Adriana,19,0,20,1
1708256554600,CAT 125R,E00,398020,Hyland; Tina Mae,12,0,20,8
1708256554600,CAT 125R,F00,398027,Hyland; Tina Mae,18,0,20,2
1708256554600,CAT 125R,G00,398028,Hyland; Tina Mae,18,0,20,2
1708256555128,CCE 1,A01,396087,Kenley Grounds; Nicole,40,0,40,0
1708256555128,CCE 1,B01,396142,Quijada; David,39,0,40,1
1708256555128,CCE 1,C01,396159,Bigley; Michele Heather,39,0,40,1
1708256555128,CCE 1,D01,396164,Bigley; Michele Heather,40,0,40,0
1708256555128,CCE 1,E01,396166,Lee; Kassandra,40,0,40,0
1708256555128,CCE 1,F01,396168,Lee; Kassandra,40,0,40,0
1708256555128,CCE 1,G01,396170,Staff,40,0,40,0
1708256555128,CCE 1,H01,396172,Staff,40,0,40,0
1708256555659,CENG 101B,A00,392993,Chen; Shaochen,44,0,45,1
1708256556185,CENG 101C,A00,392997,Li; Yanran,148,0,150,2
1708256556716,CENG 113,A00,393000,Chen; Zheng,69,0,70,1
1708256556716,CENG 113,B00,393001,Li; Wan-Lu,69,0,70,1
1708256557242,CENG 124B,A00,393036,Powell; Alyssa & Russ; Benjamin Edward,113,0,120,7
1708256557771,CENG 157,A00,393220,Opatkiewicz; Justin Paul,50,0,57,7
1708256558296,CENG 160,A00,393231,Powell; Alyssa,70,0,80,10
1708256558820,CENG 170,A01,393238,Drews; Aaron,27,0,30,3
1708256559346,CENG 175,A00,393239,Steinmetz; Nicole F,34,0,35,1
1708256559873,CENG 176B,A01,393285,Opatkiewicz; Justin Paul,46,0,52,6
1708256559873,CENG 176B,B01,393629,Zhang; Liangfang,40,0,49,9
1708256560401,CENG 205,A00,393681,Jahed Motlagh; Zeinab,53,0,60,7
1708256560926,CENG 257,A00,393682,Opatkiewicz; Justin Paul,10,0,13,3
1708256561456,CGS 87,A00,489609,Wesling; Megan E.,20,0,20,0
1708256561982,CGS 100B,A00,396181,Whitley; Leila Marie,28,0,30,2
1708256562506,CGS 109,A00,396194,Whitley; Leila Marie,19,0,20,1
1708256563036,CGS 112,A00,396220,Martin Sandino; Amanda Maria Yoland,22,0,25,3
1708256563561,CGS 114,A00,396223,Steelman; Katherine Wallis,14,0,16,2
1708256564089,CGS 116,A00,396295,Staff,19,0,20,1
1708256564668,CGS 117,A00,396306,Martin Sandino; Amanda Maria Yoland,14,0,15,1
1708256565194,CGS 118,A00,396314,Hankins; Joseph D.,28,0,29,1
1708256565737,CGS 128,A00,396366,Whitley; Leila Marie,14,0,15,1
1708256566262,CGS 137,A00,396865,Martin Sandino; Amanda Maria Yoland,16,0,19,3
1708256567806,CGS 150,A00,396901,Taylor-Garcia; Daphne,18,0,18,0
1708256568331,CGS 196B,A00,396904,Lo; Stanley M.,7,0,7,0
1708256568331,CGS 196B,B00,396973,Brenner; Suzanne A,7,0,7,0
1708256568331,CGS 196B,C00,396985,Jones; Makeba,7,0,7,0
1708256568860,CGS 198,001,396987,Anderson; Patrick W.,0,0,0,0
1708256568860,CGS 198,002,396988,Anderson; Patrick W.,0,0,0,0
1708256568860,CGS 198,003,396989,Anderson; Patrick W.,0,0,0,0
1708256568860,CGS 198,004,396990,Anderson; Patrick W.,0,0,0,0
1708256569385,CGS 200,A00,396991,Perez; Roy,0,0,0,3
1708256569930,CHEM 6A,A01,459563,Deshmukh; Lalit,40,0,40,0
1708256569930,CHEM 6A,A02,459564,Deshmukh; Lalit,35,0,40,5
1708256569930,CHEM 6A,A03,459565,Deshmukh; Lalit,31,0,40,9
1708256569930,CHEM 6A,A04,459566,Deshmukh; Lalit,30,0,38,8
1708256569930,CHEM 6A,A05,459567,Deshmukh; Lalit,40,0,40,0
1708256569930,CHEM 6A,A06,459568,Deshmukh; Lalit,37,0,40,3
1708256569930,CHEM 6A,A07,459569,Deshmukh; Lalit,37,0,40,3
1708256569930,CHEM 6A,A08,459570,Deshmukh; Lalit,0,0,0,0
1708256570477,CHEM 6B,A01,467314,Ortony; Julia Helen,39,0,40,1
1708256570477,CHEM 6B,A02,467322,Ortony; Julia Helen,32,0,40,8
1708256570477,CHEM 6B,A03,467323,Ortony; Julia Helen,40,0,40,0
1708256570477,CHEM 6B,A04,467325,Ortony; Julia Helen,31,0,40,9
1708256570477,CHEM 6B,A05,467326,Ortony; Julia Helen,39,0,40,1
1708256570477,CHEM 6B,A06,467346,Ortony; Julia Helen,40,0,40,0
1708256570477,CHEM 6B,B01,467360,Hopkins; Patrycja Anna,35,0,40,5
1708256570477,CHEM 6B,B02,467363,Hopkins; Patrycja Anna,38,0,40,2
1708256570477,CHEM 6B,B03,467364,Hopkins; Patrycja Anna,35,0,40,5
1708256570477,CHEM 6B,B04,467380,Hopkins; Patrycja Anna,40,0,40,0
1708256570477,CHEM 6B,B05,467381,Hopkins; Patrycja Anna,40,0,40,0
1708256570477,CHEM 6B,B06,467382,Hopkins; Patrycja Anna,39,0,40,1
1708256571037,CHEM 6C,A01,468994,Ternansky; Robert J.,39,0,40,1
1708256571037,CHEM 6C,A02,469054,Ternansky; Robert J.,38,0,40,2
1708256571037,CHEM 6C,A03,469065,Ternansky; Robert J.,39,0,40,1
1708256571037,CHEM 6C,A04,469069,Ternansky; Robert J.,40,0,40,0
1708256571037,CHEM 6C,A05,469080,Ternansky; Robert J.,40,0,40,0
1708256571037,CHEM 6C,B01,469318,Ternansky; Robert J.,39,0,40,1
1708256571037,CHEM 6C,B02,469319,Ternansky; Robert J.,40,0,40,0
1708256571037,CHEM 6C,B03,469320,Ternansky; Robert J.,39,0,40,1
1708256571037,CHEM 6C,B04,469321,Ternansky; Robert J.,40,0,40,0
1708256571037,CHEM 6C,B05,469322,Ternansky; Robert J.,40,0,40,0
1708256571037,CHEM 6C,C01,469323,Schurmeier; Kimberly,38,0,40,2
1708256571037,CHEM 6C,C02,469324,Schurmeier; Kimberly,36,0,40,4
1708256571037,CHEM 6C,C03,469325,Schurmeier; Kimberly,38,0,40,2
1708256571037,CHEM 6C,C04,469326,Schurmeier; Kimberly,36,0,40,4
1708256571037,CHEM 6C,C05,469327,Schurmeier; Kimberly,40,0,40,0
1708256571037,CHEM 6C,D01,460183,Schurmeier; Kimberly,39,0,40,1
1708256571037,CHEM 6C,D02,460184,Schurmeier; Kimberly,32,0,40,8
1708256571037,CHEM 6C,D03,460185,Schurmeier; Kimberly,26,0,40,14
1708256571037,CHEM 6C,D04,460186,Schurmeier; Kimberly,38,0,40,2
1708256571037,CHEM 6C,D05,460187,Schurmeier; Kimberly,40,0,40,0
1708256571037,CHEM 6C,E01,460188,Stallings; Dontarie M,24,0,40,16
1708256571037,CHEM 6C,E02,460190,Stallings; Dontarie M,25,0,40,15
1708256571037,CHEM 6C,E03,460191,Stallings; Dontarie M,3,0,20,17
1708256571037,CHEM 6C,E04,460192,Stallings; Dontarie M,36,0,40,4
1708256571037,CHEM 6C,E05,460193,Stallings; Dontarie M,37,0,40,3
1708256571563,CHEM 6CH,A01,459630,Tezcan; Faik,40,0,40,0
1708256572132,CHEM 7L,A01,393998,Jazzar; Rodolphe,0,0,0,3
1708256572132,CHEM 7L,A02,393999,Jazzar; Rodolphe,10,0,24,14
1708256572132,CHEM 7L,A03,394000,Jazzar; Rodolphe,21,0,24,3
1708256572132,CHEM 7L,A04,394001,Jazzar; Rodolphe,22,0,24,2
1708256572132,CHEM 7L,A05,394002,Jazzar; Rodolphe,18,0,24,6
1708256572132,CHEM 7L,A06,394003,Jazzar; Rodolphe,22,0,24,2
1708256572132,CHEM 7L,A07,394004,Jazzar; Rodolphe,18,0,21,3
1708256572132,CHEM 7L,A08,394005,Jazzar; Rodolphe,0,0,0,0
1708256572132,CHEM 7L,A09,394006,Jazzar; Rodolphe,20,0,24,4
1708256572132,CHEM 7L,A10,394007,Jazzar; Rodolphe,24,0,24,0
1708256572132,CHEM 7L,B01,394009,Jazzar; Rodolphe,0,0,0,1
1708256572132,CHEM 7L,B02,394010,Jazzar; Rodolphe,1,0,6,5
1708256572132,CHEM 7L,B03,394011,Jazzar; Rodolphe,15,0,24,9
1708256572132,CHEM 7L,B04,394012,Jazzar; Rodolphe,18,0,21,3
1708256572132,CHEM 7L,B05,394013,Jazzar; Rodolphe,0,0,0,0
1708256572132,CHEM 7L,B06,394014,Jazzar; Rodolphe,15,0,24,9
1708256572132,CHEM 7L,B07,394015,Jazzar; Rodolphe,18,0,24,6
1708256572132,CHEM 7L,B08,394016,Jazzar; Rodolphe,23,0,24,1
1708256572132,CHEM 7L,B09,394017,Jazzar; Rodolphe,24,0,24,0
1708256572132,CHEM 7L,B10,394018,Jazzar; Rodolphe,24,0,24,0
1708256572132,CHEM 7L,C01,394020,Staff,0,0,0,0
1708256572132,CHEM 7L,C02,394021,Staff,21,0,24,3
1708256572132,CHEM 7L,C03,394022,Staff,23,0,24,1
1708256572132,CHEM 7L,C04,394023,Staff,24,0,24,0
1708256572132,CHEM 7L,C05,394024,Staff,0,0,0,0
1708256572132,CHEM 7L,C06,394025,Staff,20,0,24,4
1708256572132,CHEM 7L,C07,394026,Staff,22,0,24,2
1708256572132,CHEM 7L,C08,394027,Staff,23,0,24,1
1708256572132,CHEM 7L,C09,394028,Staff,24,0,24,0
1708256572132,CHEM 7L,C10,394029,Staff,23,0,24,1
1708256572662,CHEM 11,A01,459661,Staff,42,0,44,2
1708256572662,CHEM 11,A02,459664,Staff,44,0,44,0
1708256572662,CHEM 11,A03,459702,Staff,42,0,44,2
1708256572662,CHEM 11,A04,459707,Staff,44,0,44,0
1708256572662,CHEM 11,A05,459708,Staff,43,0,44,1
1708256572662,CHEM 11,A06,459711,Staff,41,0,44,3
1708256573190,CHEM 40A,A01,459576,Albizati; Kim F.,36,0,40,4
1708256573190,CHEM 40A,A02,459577,Albizati; Kim F.,33,0,40,7
1708256573190,CHEM 40A,A03,459578,Albizati; Kim F.,37,0,40,3
1708256573190,CHEM 40A,A04,459579,Albizati; Kim F.,38,0,40,2
1708256573190,CHEM 40A,A05,459580,Albizati; Kim F.,40,0,40,0
1708256573190,CHEM 40A,A06,459581,Albizati; Kim F.,37,0,40,3
1708256573190,CHEM 40A,A07,459582,Albizati; Kim F.,38,0,40,2
1708256573190,CHEM 40A,A08,459588,Albizati; Kim F.,39,0,40,1
1708256573754,CHEM 40B,A01,467442,Weizman; Haim,29,0,40,11
1708256573754,CHEM 40B,A02,467443,Weizman; Haim,33,0,40,7
1708256573754,CHEM 40B,A03,467444,Weizman; Haim,39,0,40,1
1708256573754,CHEM 40B,A04,467445,Weizman; Haim,38,0,40,2
1708256573754,CHEM 40B,A05,467446,Weizman; Haim,39,0,40,1
1708256573754,CHEM 40B,A06,467447,Weizman; Haim,37,0,40,3
1708256573754,CHEM 40B,A07,467448,Weizman; Haim,31,0,40,9
1708256573754,CHEM 40B,A08,467449,Weizman; Haim,40,0,40,0
1708256573754,CHEM 40B,B01,467383,Molinski; Tadeusz,40,0,40,0
1708256573754,CHEM 40B,B02,467384,Molinski; Tadeusz,40,0,40,0
1708256573754,CHEM 40B,B03,467385,Molinski; Tadeusz,40,0,40,0
1708256573754,CHEM 40B,B04,467399,Molinski; Tadeusz,40,0,40,0
1708256573754,CHEM 40B,B05,467400,Molinski; Tadeusz,40,0,40,0
1708256573754,CHEM 40B,B06,467401,Molinski; Tadeusz,40,0,40,0
1708256573754,CHEM 40B,B07,467402,Molinski; Tadeusz,40,0,40,0
1708256573754,CHEM 40B,B08,467404,Molinski; Tadeusz,39,0,40,1
1708256574284,CHEM 41B,A01,459571,Klosterman; Jeremy K,40,0,40,0
1708256574284,CHEM 41B,A02,459572,Klosterman; Jeremy K,36,0,37,1
1708256574284,CHEM 41B,A03,459573,Klosterman; Jeremy K,40,0,40,0
1708256574810,CHEM 41C,A01,459589,Tor; Yitzhak,40,0,40,0
1708256574810,CHEM 41C,A02,459624,Tor; Yitzhak,38,0,40,2
1708256574810,CHEM 41C,A03,459625,Tor; Yitzhak,40,0,40,0
1708256574810,CHEM 41C,A04,459626,Tor; Yitzhak,40,0,40,0
1708256574810,CHEM 41C,A05,459627,Tor; Yitzhak,29,0,29,0
1708256574810,CHEM 41C,A06,459628,Tor; Yitzhak,38,0,40,2
1708256574810,CHEM 41C,A07,459629,Tor; Yitzhak,40,0,40,0
1708256575370,CHEM 43A,A01,394068,Lam; Tin Yiu,12,0,24,12
1708256575370,CHEM 43A,A02,394088,Lam; Tin Yiu,23,0,24,1
1708256575370,CHEM 43A,A03,394092,Lam; Tin Yiu,23,0,24,1
1708256575370,CHEM 43A,A04,394093,Lam; Tin Yiu,21,0,24,3
1708256575370,CHEM 43A,A05,394094,Lam; Tin Yiu,23,0,24,1
1708256575370,CHEM 43A,A06,394096,Lam; Tin Yiu,15,0,24,9
1708256575370,CHEM 43A,A07,394115,Lam; Tin Yiu,20,0,24,4
1708256575370,CHEM 43A,A08,394116,Lam; Tin Yiu,22,0,24,2
1708256575370,CHEM 43A,A09,394117,Lam; Tin Yiu,22,0,24,2
1708256575370,CHEM 43A,A10,394118,Lam; Tin Yiu,20,0,24,4
1708256575370,CHEM 43A,A11,394119,Lam; Tin Yiu,8,0,13,5
1708256575370,CHEM 43A,A12,394120,Lam; Tin Yiu,24,0,24,0
1708256575370,CHEM 43A,A13,394132,Lam; Tin Yiu,24,0,24,0
1708256575370,CHEM 43A,B01,394134,Lam; Tin Yiu,24,0,24,0
1708256575370,CHEM 43A,B02,394135,Lam; Tin Yiu,16,0,24,8
1708256575370,CHEM 43A,B03,394136,Lam; Tin Yiu,13,0,24,11
1708256575370,CHEM 43A,B04,394137,Lam; Tin Yiu,17,0,24,7
1708256575370,CHEM 43A,B05,394138,Lam; Tin Yiu,20,0,24,4
1708256575370,CHEM 43A,B06,394139,Lam; Tin Yiu,19,0,24,5
1708256575370,CHEM 43A,B07,394140,Lam; Tin Yiu,19,0,24,5
1708256575370,CHEM 43A,B08,394141,Lam; Tin Yiu,24,0,24,0
1708256575370,CHEM 43A,B09,394142,Lam; Tin Yiu,20,0,24,4
1708256575370,CHEM 43A,B10,394143,Lam; Tin Yiu,24,0,24,0
1708256575370,CHEM 43A,B11,394145,Lam; Tin Yiu,22,0,24,2
1708256575370,CHEM 43A,B12,394146,Lam; Tin Yiu,23,0,24,1
1708256575894,CHEM 96,A00,394159,Bussey; Thomas J,24,0,25,1
1708256576425,CHEM 100A,A01,394161,Li; Shaowei,16,0,22,6
1708256576425,CHEM 100A,A02,394162,Li; Shaowei,20,0,24,4
1708256576425,CHEM 100A,A03,394163,Li; Shaowei,22,0,24,2
1708256576425,CHEM 100A,A04,394164,Li; Shaowei,24,0,24,0
1708256576425,CHEM 100A,A05,394165,Li; Shaowei,24,0,24,0
1708256576425,CHEM 100A,A06,394166,Li; Shaowei,20,0,22,2
1708256576956,CHEM 100B,A01,394175,Pomeroy; Robert S.,19,0,25,6
1708256577482,CHEM 105A,A01,394177,Young; Mark,31,0,39,8
1708256577482,CHEM 105A,B01,394179,Young; Mark,0,0,0,0
1708256578027,CHEM 108,A01,394181,Staff,14,0,20,6
1708256578027,CHEM 108,A02,394182,Staff,23,0,24,1
1708256578027,CHEM 108,B01,394184,Staff,4,0,20,16
1708256578027,CHEM 108,B02,394185,Staff,23,0,24,1
1708256578554,CHEM 109,A01,394187,Piercy; Marc Anthony,17,0,20,3
1708256578554,CHEM 109,A02,394188,Piercy; Marc Anthony,22,0,24,2
1708256578554,CHEM 109,B01,394193,Piercy; Marc Anthony,12,0,20,8
1708256578554,CHEM 109,B02,394194,Piercy; Marc Anthony,23,0,24,1
1708256579083,CHEM 111,A00,394195,Thiemens; Mark H,97,0,100,3
1708256579613,CHEM 114B,A01,459574,Piercy; Marc Anthony,39,0,45,6
1708256579613,CHEM 114B,A02,459575,Piercy; Marc Anthony,40,0,45,5
1708256580137,CHEM 114C,A01,467286,Komives; Elizabeth A,32,0,44,12
1708256580137,CHEM 114C,A02,467287,Komives; Elizabeth A,42,0,44,2
1708256580137,CHEM 114C,A03,467290,Komives; Elizabeth A,42,0,44,2
1708256580137,CHEM 114C,A04,467295,Komives; Elizabeth A,43,0,44,1
1708256580665,CHEM 114D,A00,394198,Ghosh; Gourisankar,29,0,30,1
1708256581191,CHEM 118,A01,459788,Donoghue; Daniel J.,37,0,40,3
1708256581191,CHEM 118,A02,459800,Donoghue; Daniel J.,37,0,40,3
1708256581191,CHEM 118,A03,459807,Donoghue; Daniel J.,36,0,40,4
1708256581191,CHEM 118,A04,459809,Donoghue; Daniel J.,38,0,40,2
1708256581191,CHEM 118,A05,459811,Donoghue; Daniel J.,37,0,40,3
1708256581191,CHEM 118,A06,459826,Donoghue; Daniel J.,39,0,40,1
1708256581718,CHEM 119,A01,467427,Joseph; Simpson,35,0,40,5
1708256581718,CHEM 119,A02,467441,Joseph; Simpson,0,0,0,0
1708256582248,CHEM 120B,A01,467450,Griffith; Kent,37,0,40,3
1708256582248,CHEM 120B,A02,467451,Griffith; Kent,34,0,40,6
1708256582248,CHEM 120B,A03,467452,Griffith; Kent,35,0,40,5
1708256582774,CHEM 123,A00,394211,Schimpf; Alina M,0,0,0,1
1708256583304,CHEM 125,A00,394217,Tezcan; Faik,18,0,20,2
1708256583829,CHEM 126A,A01,459715,Yong; Haiwang,39,0,40,1
1708256583829,CHEM 126A,A02,459725,Yong; Haiwang,36,0,40,4
1708256584356,CHEM 126B,A01,467405,Tauber; Michael,36,0,40,4
1708256584356,CHEM 126B,A02,467406,Tauber; Michael,39,0,40,1
1708256584356,CHEM 126B,A03,467426,Tauber; Michael,39,0,40,1
1708256584887,CHEM 132,A01,460181,Galperin; Michael,42,0,45,3
1708256584887,CHEM 132,A02,460182,Galperin; Michael,37,0,45,8
1708256585412,CHEM 135,A01,394222,Tauber; Michael,15,0,15,0
1708256585938,CHEM 143B,A01,394229,Klosterman; Jeremy K,16,0,24,8
1708256585938,CHEM 143B,A02,394230,Klosterman; Jeremy K,21,0,24,3
1708256586466,CHEM 156,A00,394231,Romero; Erik Anthony,30,0,30,0
1708256586993,CHEM 157,A00,394232,Tor; Yitzhak,74,0,80,6
1708256587519,CHEM 165,A01,460194,Herzik; Mark Anthony,21,0,25,4
1708256588045,CHEM 167,A01,467296,Deshmukh; Lalit,39,0,40,1
1708256588045,CHEM 167,A02,467297,Deshmukh; Lalit,33,0,40,7
1708256588045,CHEM 167,A03,467298,Deshmukh; Lalit,37,0,40,3
1708256588045,CHEM 167,A04,467312,Deshmukh; Lalit,37,0,40,3
1708256588571,CHEM 173,A00,394284,Young; Mark,48,0,50,2
1708256589099,CHEM 174,A01,455015,Pomeroy; Robert S.,45,0,50,5
1708256589629,CHEM 186,A00,477716,Paesani; Francesco & Gilson; Michael K.,6,0,12,6
1708256590154,CHEM 188,A00,394294,Bussey; Thomas J,19,0,20,1
1708256590683,CHEM 214,A00,394336,Ghosh; Gourisankar,12,0,20,8
1708256591209,CHEM 217,A00,394341,Joseph; Simpson,25,0,30,5
1708256591738,CHEM 221,A00,394425,Taylor; Susan S.,10,0,20,10
1708256592264,CHEM 225,A00,394429,Tezcan; Faik,4,0,10,6
1708256592791,CHEM 227,A00,394430,Schimpf; Alina M,26,0,30,4
1708256593317,CHEM 229,A00,394431,Stauber; Julia Megan,13,0,20,7
1708256593844,CHEM 235,A01,394433,Tauber; Michael,20,0,20,0
1708256594373,CHEM 236,A00,394434,Kummel; Andrew C,14,0,15,1
1708256594897,CHEM 241,A00,394435,Pokorski; Jonathan Kyle,14,0,15,1
1708256595425,CHEM 250,A00,394436,Weizman; Haim,0,0,0,16
1708256595953,CHEM 256,A00,394437,Romero; Erik Anthony,15,0,20,5
1708256596495,CHEM 257,A00,394438,Tor; Yitzhak,23,0,30,7
1708256597026,CHEM 265,A01,460195,Herzik; Mark Anthony,13,0,20,7
1708256597552,CHEM 273,A00,394440,Young; Mark,13,0,20,7
1708256598093,CHEM 276,A00,394441,Mc Culloch; Andrew Douglas & Amaro; Rommie E,0,0,0,0
1708256598618,CHEM 283,A00,394443,Komives; Elizabeth A,2,0,4,2
1708256599142,CHEM 286,A00,477693,Paesani; Francesco & Gilson; Michael K.,26,0,34,8
1708256599672,CHEM 291,A00,394446,Komives; Elizabeth A,20,0,20,0
1708256600198,CHEM 294,A00,394447,Romero; Erik Anthony,50,0,50,0
1708256600726,CHIN 10CD,A01,394453,Liu; Mingming,17,0,17,0
1708256600726,CHIN 10CD,A02,394457,Liu; Mingming,18,0,18,0
1708256601252,CHIN 10CM,A01,394465,Chen; Pei-Chia,11,0,12,1
1708256601252,CHIN 10CM,A02,394466,Chen; Pei-Chia,12,0,12,0
1708256601252,CHIN 10CM,B01,394468,Liu; Mingming,11,0,13,2
1708256601252,CHIN 10CM,B02,394469,Liu; Mingming,13,0,13,0
1708256602816,CHIN 10CN,A01,394581,Xu; Li,14,0,14,0
1708256602816,CHIN 10CN,A02,394582,Xu; Li,14,0,14,0
1708256602816,CHIN 10CN,B01,394585,Xu; Li,14,0,14,0
1708256602816,CHIN 10CN,B02,394586,Xu; Li,13,0,14,1
1708256603341,CHIN 20CD,A01,394591,Wang; Xiao,11,0,12,1
1708256603341,CHIN 20CD,A02,394592,Wang; Xiao,11,0,12,1
1708256603872,CHIN 20CN,A01,394597,Anderson; Qin-Hong,7,0,8,1
1708256603872,CHIN 20CN,A02,394599,Anderson; Qin-Hong,8,0,8,0
1708256603872,CHIN 20CN,B01,394601,Anderson; Qin-Hong,14,0,15,1
1708256604397,CHIN 100CM,A00,394602,Anderson; Qin-Hong,19,0,20,1
1708256604926,CHIN 100CN,A00,394603,Chen; Pei-Chia,24,0,24,0
1708256605452,CHIN 169B,A00,394623,Wang; Xiao,19,0,20,1
1708256605977,CLAS 87,A00,394669,Herbst; Matthew,19,0,20,1
1708256606502,CLAS 121R,A01,394671,Herbst; Matthew,11,0,12,1
1708256606502,CLAS 121R,B01,486854,Herbst; Matthew,8,0,8,0
1708256607034,CLIN 294C,A00,476856,Wierenga; Christina E & Banks; Sarah Jane,20,0,20,0
1708256607558,CLIN 296,001,476768,Brookman; Lauren Irene,94,0,100,6
1708256607558,CLIN 296,002,476855,Brookman; Lauren Irene,10,0,10,0
1708256608086,CLRE 238R,A00,394675,Mehta; Ravindra L.,9998,0,9999,1
1708256609627,CLRE 254,A00,394678,Vaida; Florin,9999,0,9999,0
1708256610154,CLRE 256,A00,394685,Morris; Sheldon,9999,0,9999,0
1708256610680,CLRE 258,A00,394692,Mehta; Ravindra L.,9999,0,9999,0
1708256611209,CLRE 260,A00,394693,Cuomo; Raphael Eduardo,9999,0,9999,0
1708256611735,CLRE 264,A00,394696,Mehta; Ravindra L.,9999,0,9999,0
1708256612263,CLRE 267,A00,394703,Vaida; Florin,9999,0,9999,0
1708256612792,CLRE 297,001,394705,Cuomo; Raphael Eduardo,9999,0,9999,0
1708256613319,CMM 246,A00,492783,Gordts; Philip & Varki; Ajit P & Lewis; Amanda Lark & Godula; Kamil & Gagneux; Pascal & Esko; Jeffrey D. & Bode; Lars,9,0,10,1
1708256613848,CMM 250,A00,492943,Willert; Karl Heinrich,31,0,40,9
1708256614374,COGR 200B,A00,395746,Jack; Caroline Sarah,2,0,5,3
1708256614900,COGR 225B,A00,395750,Serlin; David,1,0,5,4
1708256615431,COGR 225C,A00,395753,Gates; Kelly,1,0,5,4
1708256615958,COGR 275,A00,395943,Goldfarb; Brian,6,0,10,4
1708256615958,COGR 275,B00,396046,Fattal; Alexander Leor,4,0,10,6
1708256615958,COGR 275,C00,396047,Kidman; Shawna F,4,0,10,6
1708256616485,COGR 280,A00,396048,Ahn; Patricia Jeehyun,6,0,10,4
1708256617011,COGS 1,A01,407484,Boyle; Mary E. T.,52,0,60,8
1708256617011,COGS 1,A02,407498,Boyle; Mary E. T.,54,0,60,6
1708256617011,COGS 1,A03,407504,Boyle; Mary E. T.,59,0,60,1
1708256617011,COGS 1,A04,407512,Boyle; Mary E. T.,57,0,60,3
1708256617011,COGS 1,A05,407513,Boyle; Mary E. T.,60,0,60,0
1708256617011,COGS 1,A06,407514,Boyle; Mary E. T.,58,0,60,2
1708256617011,COGS 1,A07,407515,Boyle; Mary E. T.,57,0,57,0
1708256617541,COGS 9,A01,407520,Shannon; Kyle Michael,54,0,60,6
1708256617541,COGS 9,A02,407521,Shannon; Kyle Michael,60,0,60,0
1708256617541,COGS 9,A03,407522,Shannon; Kyle Michael,59,0,60,1
1708256617541,COGS 9,A04,407524,Shannon; Kyle Michael,57,0,60,3
1708256617541,COGS 9,A05,407525,Shannon; Kyle Michael,59,0,60,1
1708256618068,COGS 10,A01,407527,Morgan; Eric,45,0,50,5
1708256618068,COGS 10,A02,407530,Morgan; Eric,46,0,50,4
1708256618068,COGS 10,A03,407531,Morgan; Eric,46,0,50,4
1708256618068,COGS 10,A04,407532,Morgan; Eric,47,0,50,3
1708256618068,COGS 10,A05,407534,Morgan; Eric,47,0,50,3
1708256618068,COGS 10,A06,407539,Morgan; Eric,50,0,50,0
1708256618068,COGS 10,A07,407628,Morgan; Eric,50,0,50,0
1708256618593,COGS 11,A01,407699,Boroditsky; Lera,179,0,180,1
1708256619118,COGS 12,A00,407702,Boroditsky; Lera,75,0,75,0
1708256619650,COGS 14A,A01,407706,Barrera; Steven James,51,0,57,6
1708256619650,COGS 14A,A02,407707,Barrera; Steven James,54,0,57,3
1708256619650,COGS 14A,A03,407712,Barrera; Steven James,0,0,0,1
1708256619650,COGS 14A,A04,407715,Barrera; Steven James,57,0,57,0
1708256619650,COGS 14A,A05,407717,Barrera; Steven James,55,0,56,1
1708256619650,COGS 14A,A06,407718,Barrera; Steven James,52,0,55,3
1708256619650,COGS 14A,A07,407720,Barrera; Steven James,49,0,55,6
1708256620176,COGS 14B,A01,407723,Hoffman; Drew Ellen,52,0,57,5
1708256620176,COGS 14B,A02,407726,Hoffman; Drew Ellen,48,0,55,7
1708256620176,COGS 14B,A03,407727,Hoffman; Drew Ellen,52,0,55,3
1708256620176,COGS 14B,A04,407729,Hoffman; Drew Ellen,52,0,55,3
1708256620176,COGS 14B,A05,407730,Hoffman; Drew Ellen,50,0,55,5
1708256620741,COGS 17,A01,407733,Johnson; Christine M.,50,0,50,0
1708256620741,COGS 17,A02,407734,Johnson; Christine M.,48,0,50,2
1708256620741,COGS 17,A03,407735,Johnson; Christine M.,46,0,50,4
1708256620741,COGS 17,A04,407740,Johnson; Christine M.,47,0,50,3
1708256620741,COGS 17,A05,407745,Johnson; Christine M.,48,0,50,2
1708256620741,COGS 17,A06,407824,Johnson; Christine M.,48,0,50,2
1708256620741,COGS 17,A07,407878,Johnson; Christine M.,50,0,55,5
1708256620741,COGS 17,A08,408015,Johnson; Christine M.,52,0,55,3
1708256621341,COGS 18,A01,408118,Ellis; Shannon Elizabeth,27,0,35,8
1708256621341,COGS 18,A02,408119,Ellis; Shannon Elizabeth,31,0,35,4
1708256621341,COGS 18,A03,408120,Ellis; Shannon Elizabeth,23,0,35,12
1708256621341,COGS 18,A04,408136,Ellis; Shannon Elizabeth,33,0,35,2
1708256621341,COGS 18,A05,408141,Ellis; Shannon Elizabeth,35,0,35,0
1708256621341,COGS 18,A06,408143,Ellis; Shannon Elizabeth,34,0,35,1
1708256621341,COGS 18,A07,408144,Ellis; Shannon Elizabeth,35,0,35,0
1708256621341,COGS 18,A08,408145,Ellis; Shannon Elizabeth,34,0,35,1
1708256621341,COGS 18,A09,408146,Ellis; Shannon Elizabeth,35,0,35,0
1708256621341,COGS 18,B01,408148,Ellis; Shannon Elizabeth,30,0,32,2
1708256621341,COGS 18,B02,408149,Ellis; Shannon Elizabeth,26,0,32,6
1708256621341,COGS 18,B03,408151,Ellis; Shannon Elizabeth,27,0,33,6
1708256621341,COGS 18,B04,408154,Ellis; Shannon Elizabeth,32,0,33,1
1708256621341,COGS 18,B05,408163,Ellis; Shannon Elizabeth,29,0,33,4
1708256621341,COGS 18,B06,408176,Ellis; Shannon Elizabeth,33,0,33,0
1708256621341,COGS 18,B07,408177,Ellis; Shannon Elizabeth,31,0,33,2
1708256621341,COGS 18,B08,408178,Ellis; Shannon Elizabeth,32,0,33,1
1708256621341,COGS 18,B09,408195,Ellis; Shannon Elizabeth,31,0,33,2
1708256621868,COGS 87,A00,408196,Deak; Gedeon O.,20,0,20,0
1708256621868,COGS 87,B00,479478,Fleischer; Jason G,20,0,20,0
1708256622399,COGS 100,A01,408262,Allen; Michael Gordon,54,0,56,2
1708256622399,COGS 100,A02,408263,Allen; Michael Gordon,52,0,56,4
1708256622399,COGS 100,A03,408264,Allen; Michael Gordon,55,0,56,1
1708256622399,COGS 100,A04,408265,Allen; Michael Gordon,56,0,56,0
1708256622399,COGS 100,A05,408266,Allen; Michael Gordon,56,0,56,0
1708256622399,COGS 100,A06,408349,Allen; Michael Gordon,55,0,56,1
1708256622925,COGS 101A,A01,408352,Morgan; Eric,60,0,60,0
1708256622925,COGS 101A,A02,408353,Morgan; Eric,58,0,60,2
1708256622925,COGS 101A,A03,408354,Morgan; Eric,57,0,60,3
1708256622925,COGS 101A,A04,408355,Morgan; Eric,59,0,60,1
1708256623449,COGS 101B,A01,408373,Barrera; Steven James,47,0,50,3
1708256623449,COGS 101B,A02,408380,Barrera; Steven James,46,0,50,4
1708256623449,COGS 101B,A03,408384,Barrera; Steven James,38,0,50,12
1708256623449,COGS 101B,A04,408385,Barrera; Steven James,37,0,50,13
1708256623977,COGS 101C,A01,408387,Trott; Sean Thomas,48,0,50,2
1708256623977,COGS 101C,A02,408388,Trott; Sean Thomas,43,0,50,7
1708256623977,COGS 101C,A03,408389,Trott; Sean Thomas,45,0,50,5
1708256624503,COGS 107A,A01,408396,Boyle; Mary E. T.,54,0,56,2
1708256624503,COGS 107A,A02,408397,Boyle; Mary E. T.,54,0,56,2
1708256624503,COGS 107A,A03,408399,Boyle; Mary E. T.,51,0,56,5
1708256624503,COGS 107A,A04,408409,Boyle; Mary E. T.,50,0,56,6
1708256624503,COGS 107A,A05,408410,Boyle; Mary E. T.,51,0,56,5
1708256624503,COGS 107A,A06,408411,Boyle; Mary E. T.,55,0,56,1
1708256625049,COGS 107B,A01,408413,Mooshagian; Eric Frederick,46,0,50,4
1708256625049,COGS 107B,A02,408414,Mooshagian; Eric Frederick,43,0,50,7
1708256625049,COGS 107B,A03,408428,Mooshagian; Eric Frederick,43,0,50,7
1708256625049,COGS 107B,A04,408434,Mooshagian; Eric Frederick,46,0,50,4
1708256625049,COGS 107B,A05,408435,Mooshagian; Eric Frederick,50,0,50,0
1708256625049,COGS 107B,A06,408446,Mooshagian; Eric Frederick,49,0,50,1
1708256625575,COGS 107C,A01,408500,Chiba; Andrea,51,0,60,9
1708256625575,COGS 107C,A02,408519,Chiba; Andrea,55,0,60,5
1708256625575,COGS 107C,A03,408524,Chiba; Andrea,56,0,60,4
1708256626107,COGS 108,A01,408532,Fleischer; Jason G,45,0,60,15
1708256626107,COGS 108,A02,408543,Fleischer; Jason G,58,0,60,2
1708256626107,COGS 108,A03,408544,Fleischer; Jason G,59,0,60,1
1708256626107,COGS 108,A04,408552,Fleischer; Jason G,32,0,60,28
1708256626107,COGS 108,A05,408554,Fleischer; Jason G,47,0,60,13
1708256626107,COGS 108,A06,408574,Fleischer; Jason G,43,0,60,17
1708256626107,COGS 108,A07,408576,Fleischer; Jason G,56,0,60,4
1708256626633,COGS 112,A01,408682,Hoffman; Drew Ellen,32,0,50,18
1708256626633,COGS 112,A02,408683,Hoffman; Drew Ellen,38,0,50,12
1708256626633,COGS 112,A03,408684,Hoffman; Drew Ellen,48,0,60,12
1708256627160,COGS 122,A01,408695,Dow; Steven P,21,0,50,29
1708256627690,COGS 125,A00,408697,Klemmer; Scott R,35,0,50,15
1708256628214,COGS 126,A01,408787,Hollan; James D.,44,0,50,6
1708256628740,COGS 138,A01,408866,Khosla; Meenakshi,71,0,75,4
1708256629286,COGS 142,A01,408868,Rossano; Federico,49,0,50,1
1708256629812,COGS 144,A01,408950,Rossano; Federico,48,0,50,2
1708256630338,COGS 155,A01,408993,Staff,49,0,50,1
1708256630868,COGS 157,A00,408994,Creel; Sarah,0,0,0,0
1708256631410,COGS 160,A00,409031,Deak; Gedeon O.,20,0,20,0
1708256631935,COGS 175,A01,409035,Rill; Bryan,67,0,75,8
1708256632464,COGS 178,A00,409274,Jernigan; Terry Lynne,67,0,70,3
1708256632993,COGS 179,A00,409278,Staff,40,0,40,0
1708256633519,COGS 184,A01,409317,Johnson; Christine M.,42,0,50,8
1708256634044,COGS 185,A01,409476,Tu; Zhuowen,33,0,50,17
1708256634044,COGS 185,A02,409525,Tu; Zhuowen,45,0,50,5
1708256634570,COGS 188,A01,409527,Fleischer; Jason G,44,0,75,31
1708256635113,COGS 190C,001,409528,Chiba; Andrea,9999,0,9999,0
1708256635113,COGS 190C,002,409530,Fleischer; Jason G,9999,0,9999,0
1708256635113,COGS 190C,003,409531,Boyle; Mary E. T.,9999,0,9999,0
1708256635113,COGS 190C,004,409532,Nitz; Douglas A.,9999,0,9999,0
1708256635113,COGS 190C,005,409535,Rangel; Lara M,9999,0,9999,0
1708256635113,COGS 190C,006,409536,Rossano; Federico,9999,0,9999,0
1708256635113,COGS 190C,007,409537,Deak; Gedeon O.,9999,0,9999,0
1708256635113,COGS 190C,008,409538,Trott; Sean Thomas,9999,0,9999,0
1708256635113,COGS 190C,009,409540,Creel; Sarah,9999,0,9999,0
1708256635113,COGS 190C,010,409541,Voytek; Bradley Thomas,9999,0,9999,0
1708256635113,COGS 190C,011,409542,Greene; Deanna Jacquelyn,9999,0,9999,0
1708256635113,COGS 190C,012,409543,Ellis; Shannon Elizabeth,9999,0,9999,0
1708256635113,COGS 190C,013,409546,Kirsh; David Joel,9999,0,9999,0
1708256635638,COGS 190D,A00,409547,Voytek; Bradley Thomas,20,0,20,0
1708256636165,COGS 194,A00,409548,Hill; Seth J,9999,0,9999,0
1708256636693,COGS 200,A01,406697,Creel; Sarah,0,0,0,0
1708256637221,COGS 205,A00,406698,Chiba; Andrea,20,0,20,0
1708256637746,COGS 209,A00,406699,Mukamel; Eran A,41,0,68,27
1708256638293,COGS 210C,001,406700,Kirsh; David Joel,9999,0,9999,0
1708256638293,COGS 210C,002,406701,Greene; Deanna Jacquelyn,9998,0,9999,1
1708256638293,COGS 210C,003,406702,Xia; Haijun,9999,0,9999,0
1708256638293,COGS 210C,004,406703,Nitz; Douglas A.,9998,0,9999,1
1708256638293,COGS 210C,005,406710,Hollan; James D.,9999,0,9999,0
1708256638293,COGS 210C,006,406713,De Sa; Virginia,9999,0,9999,0
1708256638293,COGS 210C,007,406714,Rossano; Federico,9999,0,9999,0
1708256638293,COGS 210C,008,406740,Kiyonaga; Anastasia,9999,0,9999,0
1708256638293,COGS 210C,009,406745,Guo; Philip J,9998,0,9999,1
1708256638293,COGS 210C,010,406746,Dow; Steven P,9999,0,9999,0
1708256638293,COGS 210C,011,406747,Bergen; Benjamin,9999,0,9999,0
1708256638293,COGS 210C,012,406758,Coulson; Seana M,9999,0,9999,0
1708256638819,COGS 211C,A00,406763,Coulson; Seana M,17,0,20,3
1708256639347,COGS 229,A00,406788,Hollan; James D. & Xia; Haijun,4,0,10,6
1708256639875,COGS 238,A00,406789,Bergen; Benjamin,17,0,20,3
1708256640399,COGS 278,A00,406794,Jernigan; Terry Lynne,18,0,20,2
1708256640949,COMM 10,A01,394711,Schmidt; Thomas Rainer,20,0,24,4
1708256640949,COMM 10,A02,394714,Schmidt; Thomas Rainer,24,0,24,0
1708256640949,COMM 10,A03,394716,Schmidt; Thomas Rainer,24,0,24,0
1708256640949,COMM 10,A04,394717,Schmidt; Thomas Rainer,22,0,24,2
1708256640949,COMM 10,A05,394731,Schmidt; Thomas Rainer,24,0,24,0
1708256640949,COMM 10,A06,394733,Schmidt; Thomas Rainer,24,0,24,0
1708256640949,COMM 10,A07,394740,Schmidt; Thomas Rainer,24,0,24,0
1708256640949,COMM 10,A08,394741,Schmidt; Thomas Rainer,24,0,24,0
1708256640949,COMM 10,A09,394751,Schmidt; Thomas Rainer,23,0,24,1
1708256640949,COMM 10,A10,394779,Schmidt; Thomas Rainer,24,0,24,0
1708256640949,COMM 10,A11,394809,Schmidt; Thomas Rainer,24,0,24,0
1708256640949,COMM 10,A12,394811,Schmidt; Thomas Rainer,24,0,24,0
1708256640949,COMM 10,A13,394818,Schmidt; Thomas Rainer,24,0,24,0
1708256640949,COMM 10,A14,394825,Schmidt; Thomas Rainer,23,0,24,1
1708256640949,COMM 10,A15,394828,Schmidt; Thomas Rainer,24,0,24,0
1708256640949,COMM 10,A16,394829,Schmidt; Thomas Rainer,0,0,0,0
1708256640949,COMM 10,A17,486828,Schmidt; Thomas Rainer,20,0,21,1
1708256641475,COMM 20,A01,394834,McKenna; Denise,69,0,70,1
1708256642001,COMM 80,A01,394849,Campbell; Robert Harold,120,0,120,0
1708256642549,COMM 100C,A01,394957,Kidman; Shawna F,24,0,25,1
1708256642549,COMM 100C,A02,394972,Kidman; Shawna F,25,0,25,0
1708256642549,COMM 100C,A03,394977,Kidman; Shawna F,22,0,25,3
1708256642549,COMM 100C,A04,394981,Kidman; Shawna F,25,0,25,0
1708256642549,COMM 100C,A05,394985,Kidman; Shawna F,24,0,25,1
1708256642549,COMM 100C,A06,394989,Kidman; Shawna F,23,0,25,2
1708256642549,COMM 100C,A07,394993,Kidman; Shawna F,24,0,25,1
1708256642549,COMM 100C,A08,394997,Kidman; Shawna F,23,0,25,2
1708256642549,COMM 100C,A09,394999,Kidman; Shawna F,25,0,25,0
1708256642549,COMM 100C,A10,395018,Kidman; Shawna F,25,0,25,0
1708256642549,COMM 100C,A11,395041,Kidman; Shawna F,24,0,25,1
1708256642549,COMM 100C,A12,395080,Kidman; Shawna F,24,0,25,1
1708256643076,COMM 101,A01,395135,Halm; Gavin Patrick,15,0,15,0
1708256643076,COMM 101,A02,395252,Halm; Gavin Patrick,15,0,15,0
1708256643076,COMM 101,A03,395253,Halm; Gavin Patrick,15,0,15,0
1708256643076,COMM 101,A04,395263,Halm; Gavin Patrick,15,0,15,0
1708256643604,COMM 101D,A00,395264,Martinico; Daniel J,13,0,16,3
1708256644130,COMM 101K,A00,395266,Ahn; Patricia Jeehyun,16,0,18,2
1708256644654,COMM 101N,A00,395267,Martinico; Daniel J,16,0,16,0
1708256645183,COMM 102C,A01,395270,Campion; Camille E,5,0,6,1
1708256645183,COMM 102C,A02,395271,Campion; Camille E,6,0,6,0
1708256645183,COMM 102C,A03,395272,Campion; Camille E,5,0,6,1
1708256645709,COMM 102M,A01,395285,Davis; Zeinabu I.,9,0,10,1
1708256645709,COMM 102M,A02,395288,Davis; Zeinabu I.,8,0,10,2
1708256646233,COMM 103D,A00,395343,Gates; Kelly,34,0,35,1
1708256646758,COMM 107,A00,395461,Serlin; David,33,0,35,2
1708256647285,COMM 109D,A00,395462,Halm; Gavin Patrick,72,0,75,3
1708256647814,COMM 110G,A00,395481,Whitworth-Smith; Andrew C,32,0,35,3
1708256648340,COMM 110M,A00,395482,Harb; Anthony Joseph,34,0,35,1
1708256648867,COMM 111A,A00,487217,Pavon Aramburu; Maria Laur,34,0,35,1
1708256649411,COMM 113T,A00,395516,Fields; Gary,35,0,35,0
1708256649936,COMM 114A,A00,395517,Zilberg; Elana,32,0,35,3
1708256650464,COMM 114B,A00,395523,Zilberg; Elana,19,0,20,1
1708256650992,COMM 114E,A00,487218,Pavon Aramburu; Maria Laur,34,0,35,1
1708256651520,COMM 114W,A00,395524,Walkover; Lillian B,17,0,18,1
1708256652046,COMM 126,A00,479341,Staff,26,0,30,4
1708256652575,COMM 132,A00,481491,Rojo Solis; Juan Jose,0,0,0,0
1708256653100,COMM 134,A00,395578,Abuelhiga; Soraya Jill,28,0,30,2
1708256653625,COMM 143,A00,395579,Rojo Solis; Juan Jose,28,0,30,2
1708256654154,COMM 146,A00,395584,Jack; Caroline Sarah,29,0,30,1
1708256654695,COMM 168,A00,395592,Harb; Anthony Joseph,29,0,30,1
1708256655219,COMM 170,A00,395608,Pavon Aramburu; Maria Laur,30,0,30,0
1708256655744,COMM 173,A00,395609,Alac; Morana,29,0,30,1
1708256656275,COMM 174,A00,395679,Alac; Morana,30,0,30,0
1708256656801,COMM 190,A00,395682,Abuelhiga; Soraya Jill,19,0,23,4
1708256656801,COMM 190,B00,395696,Staff,21,0,23,2
1708256656801,COMM 190,C00,395697,Fattal; Alexander Leor,22,0,23,1
1708256657349,CSE 8A,A50,459200,Miranda; Gregory Joseph,34,0,35,1
1708256657349,CSE 8A,A51,459205,Miranda; Gregory Joseph,34,0,35,1
1708256657349,CSE 8A,A52,459206,Miranda; Gregory Joseph,34,0,35,1
1708256657349,CSE 8A,A53,459212,Miranda; Gregory Joseph,34,0,35,1
1708256657349,CSE 8A,A54,459213,Miranda; Gregory Joseph,34,0,35,1
1708256657349,CSE 8A,A55,459232,Miranda; Gregory Joseph,34,0,35,1
1708256657875,CSE 11,A01,470735,Ochoa; Benjamin Lawrence,180,0,195,15
1708256658403,CSE 12,A01,470744,Cao; Yingjun,189,0,200,11
1708256658403,CSE 12,B01,470752,Miranda; Gregory Joseph,71,0,100,29
1708256658403,CSE 12,B02,470760,Miranda; Gregory Joseph,93,0,100,7
1708256658934,CSE 15L,A01,410174,Solares; Edwin A,6,0,10,4
1708256658934,CSE 15L,B01,410215,Solares; Edwin A,7,0,10,3
1708256658934,CSE 15L,C01,410305,Solares; Edwin A,3,0,10,7
1708256658934,CSE 15L,D01,410400,Solares; Edwin A,1,0,10,9
1708256659460,CSE 20,A01,470765,Minnes Kemp; Mor Mia,145,0,150,5
1708256659991,CSE 21,A01,470776,Jones; Miles E,68,0,73,5
1708256659991,CSE 21,A02,482889,Jones; Miles E,68,0,72,4
1708256660533,CSE 29,A01,494014,Soosai Raj; Adalbert Geral,48,0,50,2
1708256660533,CSE 29,A02,494016,Soosai Raj; Adalbert Geral,40,0,50,10
1708256660533,CSE 29,B01,494018,Shalev; Aaron D,16,0,20,4
1708256661062,CSE 30,A01,470784,Cao; Yingjun,141,0,150,9
1708256661062,CSE 30,B01,467469,Muller; P Keith,98,0,120,22
1708256661591,CSE 87,A00,410528,Moshiri; Niema,20,0,20,0
1708256662116,CSE 90,A00,486885,Minnes Kemp; Mor Mia,0,0,0,0
1708256662647,CSE 91,A00,486872,Minnes Kemp; Mor Mia,0,0,0,0
1708256662647,CSE 91,B00,486873,Minnes Kemp; Mor Mia,0,0,0,0
1708256663176,CSE 95,A00,410529,Minnes Kemp; Mor Mia,50,0,50,0
1708256663705,CSE 100,A01,470792,Sahoo; Debashis,54,0,70,16
1708256664229,CSE 100R,A01,410556,Moshiri; Niema,2,0,40,38
1708256664758,CSE 101,A01,470797,Jones; Miles E,14,0,44,30
1708256664758,CSE 101,A02,482892,Jones; Miles E,31,0,43,12
1708256665284,CSE 105,A01,470800,Micciancio; Daniele,85,0,98,13
1708256665810,CSE 107,A01,467479,Bellare; Mihir,141,0,146,5
1708256666334,CSE 109,A01,459538,Shang; Jingbo,0,0,25,25
1708256666867,CSE 110,A50,459395,Powell; Thomas Allan,49,0,50,1
1708256666867,CSE 110,A51,459512,Powell; Thomas Allan,37,0,50,13
1708256666867,CSE 110,A52,459513,Powell; Thomas Allan,46,0,50,4
1708256666867,CSE 110,A53,459514,Powell; Thomas Allan,48,0,50,2
1708256666867,CSE 110,A54,459515,Powell; Thomas Allan,47,0,50,3
1708256666867,CSE 110,A55,459516,Powell; Thomas Allan,45,0,50,5
1708256666867,CSE 110,A56,459517,Powell; Thomas Allan,47,0,48,1
1708256667392,CSE 112,A50,459518,Powell; Thomas Allan,132,0,146,14
1708256667919,CSE 120,A01,470808,Zhou; Yuan-Yuan,167,0,200,33
1708256668449,CSE 125,A00,410564,Voelker; Geoffrey M.,30,0,30,0
1708256668980,CSE 127,A01,467484,Fernandes; Earlence T,174,0,196,22
1708256669506,CSE 130,A01,467485,Polikarpova; Nadezhda,176,0,192,16
1708256670036,CSE 131,A01,459522,Ding; Yufei,36,0,50,14
1708256670561,CSE 132B,A01,470816,Deutsch; Alin Bernard,60,0,70,10
1708256671087,CSE 140,A01,410606,Orailoglu; Alex,99,0,100,1
1708256671087,CSE 140,B01,410622,Eldon; John,130,0,146,16
1708256671617,CSE 140L,A01,410655,Orailoglu; Alex,99,0,100,1
1708256671617,CSE 140L,B01,410658,Eldon; John,122,0,146,24
1708256672147,CSE 141,A01,467486,Zhao; Jishen,173,0,196,23
1708256672675,CSE 141L,A01,410685,Eldon; John,162,0,196,34
1708256674218,CSE 145,A01,410713,Kastner; Ryan Charles,25,0,25,0
1708256674745,CSE 150B,A01,470824,Gao; Sicun,310,0,362,52
1708256675274,CSE 156,A01,467487,Nakashole; Ndapandula,137,0,192,55
1708256675854,CSE 165,A01,410757,Weibel; Nadir & Schulze; Jurgen P.,40,0,50,10
1708256676380,CSE 168,A01,410759,Ramamoorthi; Ravi,24,0,25,1
1708256676380,CSE 168,A02,410761,Ramamoorthi; Ravi,24,0,25,1
1708256676909,CSE 175,A01,410764,Kumar; Rakesh,48,0,50,2
1708256677438,CSE 182,A01,455011,Bafna; Vineet,47,0,50,3
1708256677965,CSE 185,A01,410895,Gymrek; Melissa Ann,41,0,57,16
1708256677965,CSE 185,A02,479240,Gymrek; Melissa Ann,53,0,58,5
1708256678492,CSE 190,A00,410982,Grier; Daniel T,48,0,50,2
1708256678492,CSE 190,B00,410983,Riek; Laurel D,50,0,50,0
1708256678492,CSE 190,C00,410984,Staff,36,0,50,14
1708256678492,CSE 190,D00,481666,Saha; Barna & Impagliazzo; Russell,27,0,28,1
1708256679018,CSE 203A,A00,410985,Saha; Barna & Impagliazzo; Russell,0,0,0,0
1708256679546,CSE 209A,A00,410986,Grier; Daniel T,0,0,0,0
1708256680076,CSE 209B,A00,410987,Bellare; Mihir,0,0,0,0
1708256680601,CSE 217,A01,459553,Weibel; Nadir,0,0,0,0
1708256681127,CSE 218,A00,410989,Griswold; William G.,0,0,0,0
1708256681656,CSE 219,A00,410990,Hollan; James D. & Xia; Haijun,0,0,0,0
1708256682183,CSE 224,A01,470832,Snoeren; Alex C.,0,0,0,0
1708256682708,CSE 229A,A00,410993,Shalev; Aaron D,0,0,0,0
1708256683238,CSE 229C,A00,410994,Fernandes; Earlence T,0,0,0,0
1708256683762,CSE 231,A01,467488,Jhala; Ranjit,0,0,0,0
1708256684293,CSE 233,A00,410996,Vianu; Victor Dan,0,0,0,0
1708256684823,CSE 237D,A00,410998,Kastner; Ryan Charles,0,0,0,0
1708256685348,CSE 239A,A00,410999,Vianu; Victor Dan,0,0,0,0
1708256685878,CSE 239B,A00,411000,Coblenz; Michael J,0,0,0,0
1708256686403,CSE 240A,A00,411001,Chin; Bryan W.,0,0,0,0
1708256686933,CSE 252D,A00,411004,Chandraker; Manmohan Krishna,0,0,0,0
1708256687461,CSE 256,A00,411005,Nakashole; Ndapandula,0,0,0,0
1708256687989,CSE 260,A01,467491,Chin; Bryan W.,0,0,0,0
1708256688515,CSE 276B,A00,411007,Riek; Laurel D,0,0,0,0
1708256689040,CSE 276F,A01,459554,Su; Hao,0,0,0,0
1708256689569,CSE 283,A00,411009,Bafna; Vineet & Zhong; Sheng,0,0,0,0
1708256690097,CSE 290,A00,411010,Gao; Sicun,0,0,0,0
1708256690097,CSE 290,B00,411011,Chern; Albert Ren-Haur,0,0,0,0
1708256690097,CSE 290,C00,411012,Swanson; Steven James,0,0,0,0
1708256690097,CSE 290,E00,411013,Su; Hao,0,0,0,0
1708256690097,CSE 290,F00,411014,Riek; Laurel D,0,0,0,0
1708256690097,CSE 290,G00,411015,Gymrek; Melissa Ann,0,0,0,0
1708256690097,CSE 290,H00,479239,Dasgupta; Sanjoy & Gymrek; Melissa Ann,0,0,0,0
1708256690097,CSE 290,I00,481669,Bafna; Vineet,0,0,0,0
1708256690097,CSE 290,J00,494949,Paturi; Ramamohan,0,0,0,0
1708256690625,CSE 291,A00,411016,Li; Tzumao,0,0,0,0
1708256690625,CSE 291,B00,411017,Heninger; Nadia A,0,0,0,0
1708256690625,CSE 291,C00,411114,Chern; Albert Ren-Haur,0,0,0,0
1708256690625,CSE 291,D00,411115,Zhang; Yiying,0,0,0,0
1708256690625,CSE 291,E00,411116,Cheng; Chung Kuan,0,0,0,0
1708256690625,CSE 291,G00,411118,Lerner; Sorin,0,0,0,0
1708256690625,CSE 291,I00,481509,Shang; Jingbo,0,0,0,0
1708256690625,CSE 291,J00,494844,Savage; Stefan & Stefan; Deian,50,0,50,0
1708256691175,CSE 293,001,487239,Bafna; Vineet,9999,0,9999,0
1708256691175,CSE 293,002,487240,Bellare; Mihir,9999,0,9999,0
1708256691175,CSE 293,003,487241,Berg-Kirkpatrick; Taylor D,9999,0,9999,0
1708256691175,CSE 293,004,487242,Chandraker; Manmohan Krishna,9999,0,9999,0
1708256691175,CSE 293,005,487243,Cheng; Chung Kuan,9999,0,9999,0
1708256691175,CSE 293,006,487244,Christensen; Henrik I,9999,0,9999,0
1708256691175,CSE 293,007,487245,Coblenz; Michael J,9999,0,9999,0
1708256691175,CSE 293,008,487363,Cottrell; Garrison W,9999,0,9999,0
1708256691175,CSE 293,009,487366,Deutsch; Alin Bernard,9999,0,9999,0
1708256691175,CSE 293,010,487433,Esmaeilzadeh; Hadi,9999,0,9999,0
1708256691175,CSE 293,011,487434,Freund; Yoav,9999,0,9999,0
1708256691175,CSE 293,012,487455,Griswold; William G.,9999,0,9999,0
1708256691175,CSE 293,013,487469,Gymrek; Melissa Ann,9999,0,9999,0
1708256691175,CSE 293,014,487470,Heninger; Nadia A,9999,0,9999,0
1708256691175,CSE 293,015,487471,Impagliazzo; Russell,9999,0,9999,0
1708256691175,CSE 293,016,487472,Jhala; Ranjit,9999,0,9999,0
1708256691175,CSE 293,017,487473,Kahng; Andrew Byun,9999,0,9999,0
1708256691175,CSE 293,018,487474,Kane; Daniel Mertz,9999,0,9999,0
1708256691175,CSE 293,019,487475,Kriegman; David J,9999,0,9999,0
1708256691175,CSE 293,020,487476,Kumar; Arun Kumar,9999,0,9999,0
1708256691175,CSE 293,021,487477,Lerner; Sorin,9999,0,9999,0
1708256691175,CSE 293,022,487478,Lovett; Shachar,9999,0,9999,0
1708256691175,CSE 293,023,487520,McAuley; Julian John,9999,0,9999,0
1708256691175,CSE 293,024,487522,Micciancio; Daniele,9999,0,9999,0
1708256691175,CSE 293,025,487577,Orailoglu; Alex,9999,0,9999,0
1708256691175,CSE 293,026,487586,Pannuto; Patrick William,9999,0,9999,0
1708256691175,CSE 293,027,487598,Paturi; Ramamohan,9999,0,9999,0
1708256691175,CSE 293,028,487604,Polikarpova; Nadezhda,9999,0,9999,0
1708256691175,CSE 293,029,487609,Politz; Joseph Gibbs,9999,0,9999,0
1708256691175,CSE 293,030,487642,Porter; George M,9999,0,9999,0
1708256691175,CSE 293,031,487665,Porter; Leonard Emerson,9999,0,9999,0
1708256691175,CSE 293,032,487689,Ramamoorthi; Ravi,9999,0,9999,0
1708256691175,CSE 293,033,487698,Riek; Laurel D,9999,0,9999,0
1708256691175,CSE 293,034,487712,Sahoo; Debashis,9999,0,9999,0
1708256691175,CSE 293,035,487721,Saul; Lawrence,9999,0,9999,0
1708256691175,CSE 293,036,487735,Savage; Stefan,9999,0,9999,0
1708256691175,CSE 293,037,487744,Schulze; Jurgen P.,9999,0,9999,0
1708256691175,CSE 293,038,487758,Snoeren; Alex C.,9999,0,9999,0
1708256691175,CSE 293,039,487767,Shang; Jingbo,9999,0,9999,0
1708256691175,CSE 293,040,487790,Stefan; Deian,9999,0,9999,0
1708256691175,CSE 293,041,487817,Su; Hao,9999,0,9999,0
1708256691175,CSE 293,042,487827,Swanson; Steven James,9999,0,9999,0
1708256691175,CSE 293,043,487830,Tullsen; Dean Michael,9999,0,9999,0
1708256691175,CSE 293,044,487837,Vaccaro; Kristen Marie,9999,0,9999,0
1708256691175,CSE 293,045,487838,Voelker; Geoffrey M.,9999,0,9999,0
1708256691175,CSE 293,046,487842,Zhao; Jishen,9999,0,9999,0
1708256691175,CSE 293,047,487847,Zhou; Yuan-Yuan,9999,0,9999,0
1708256691175,CSE 293,048,487852,Gao; Sicun,9999,0,9999,0
1708256691175,CSE 293,049,487853,Weibel; Nadir,9999,0,9999,0
1708256691175,CSE 293,050,487854,Gupta; Rajesh K.,9999,0,9999,0
1708256691175,CSE 293,051,487855,Soosai Raj; Adalbert Geral,9999,0,9999,0
1708256691175,CSE 293,052,494373,Zhang; Hao,9999,0,9999,0
1708256691701,CSE 294,A00,411124,Voelker; Geoffrey M.,15,0,15,0
1708256692228,CSS 100,A01,396053,Trott; Sean Thomas,43,0,50,7
1708256692757,CSS 120,A01,479237,Mignozzetti; Umberto,47,0,50,3
1708256692757,CSS 120,A02,479238,Mignozzetti; Umberto,50,0,50,0
1708256693283,CSS 209,A00,396054,Styler; William Francis,21,0,35,14
1708256693813,CSS 296,001,396055,Mignozzetti; Umberto,0,0,0,1
1708256693813,CSS 296,002,396056,Styler; William Francis,0,0,0,1
1708256693813,CSS 296,003,396057,Broz; James Lawrence,0,0,0,2
1708256693813,CSS 296,004,396058,Elliott; Graham,0,0,0,5
1708256693813,CSS 296,005,396059,Sun; Feiyang,0,0,0,0
1708256693813,CSS 296,006,396060,Dewaard; Andrew Michael,0,0,0,0
1708256694341,DDPM 210,A00,400652,Ma; Joseph David,36,0,36,0
1708256694867,DDPM 211,A00,400653,Ma; Joseph David,36,0,36,0
1708256695393,DDPM 214,A00,400720,Ma; Joseph David,36,0,36,0
1708256695919,DERM 296,001,464131,Staff,50,0,50,0
1708256695919,DERM 296,002,464178,Staff,50,0,50,0
1708256695919,DERM 296,003,464181,Staff,50,0,50,0
1708256696454,DOC 3,A01,399409,Strom; Megan C.,0,0,0,0
1708256696454,DOC 3,A02,399414,Strom; Megan C.,0,0,0,0
1708256696454,DOC 3,A03,399432,Strom; Megan C.,0,0,0,0
1708256696454,DOC 3,A04,399461,Strom; Megan C.,0,0,0,0
1708256696454,DOC 3,A05,399470,Strom; Megan C.,0,0,0,0
1708256696454,DOC 3,A06,399476,Strom; Megan C.,0,0,0,0
1708256696454,DOC 3,A07,399547,Strom; Megan C.,0,0,0,0
1708256696454,DOC 3,A08,399548,Strom; Megan C.,0,0,0,0
1708256696454,DOC 3,A09,399675,Strom; Megan C.,0,0,0,0
1708256696454,DOC 3,A10,399687,Strom; Megan C.,0,0,0,0
1708256696454,DOC 3,A11,399704,Strom; Megan C.,0,0,0,0
1708256696454,DOC 3,A12,399707,Strom; Megan C.,0,0,0,0
1708256696454,DOC 3,A13,399714,Strom; Megan C.,0,0,0,0
1708256696454,DOC 3,A14,399721,Strom; Megan C.,0,0,0,0
1708256696454,DOC 3,A15,399765,Strom; Megan C.,0,0,0,0
1708256696454,DOC 3,A16,399766,Strom; Megan C.,0,0,0,0
1708256696454,DOC 3,B01,399786,Strom; Megan C.,0,0,0,0
1708256696454,DOC 3,B02,399787,Strom; Megan C.,0,0,0,0
1708256696454,DOC 3,B03,399788,Strom; Megan C.,0,0,0,0
1708256696454,DOC 3,B04,399845,Strom; Megan C.,0,0,0,0
1708256696454,DOC 3,B05,399846,Strom; Megan C.,0,0,0,0
1708256696454,DOC 3,B06,399895,Strom; Megan C.,0,0,0,0
1708256696454,DOC 3,B07,399916,Strom; Megan C.,0,0,0,0
1708256696454,DOC 3,B08,400073,Strom; Megan C.,0,0,0,0
1708256696454,DOC 3,B09,400074,Strom; Megan C.,0,0,0,0
1708256696454,DOC 3,B10,400076,Strom; Megan C.,0,0,0,0
1708256696454,DOC 3,B11,400077,Strom; Megan C.,0,0,0,0
1708256696454,DOC 3,B12,400078,Strom; Megan C.,0,0,0,0
1708256696454,DOC 3,B13,400079,Strom; Megan C.,0,0,0,0
1708256696454,DOC 3,B14,400080,Strom; Megan C.,0,0,0,0
1708256696454,DOC 3,B15,400081,Strom; Megan C.,0,0,0,0
1708256696454,DOC 3,B16,400082,Strom; Megan C.,0,0,0,0
1708256696454,DOC 3,C01,400084,Chapman; Dillon,0,0,0,0
1708256696454,DOC 3,C02,400085,Chapman; Dillon,0,0,0,0
1708256696454,DOC 3,C03,400086,Chapman; Dillon,0,0,0,0
1708256696454,DOC 3,C04,400087,Chapman; Dillon,0,0,0,0
1708256696454,DOC 3,C05,400113,Chapman; Dillon,0,0,0,0
1708256696454,DOC 3,C06,400114,Chapman; Dillon,0,0,0,0
1708256696454,DOC 3,C07,400117,Chapman; Dillon,0,0,0,0
1708256696454,DOC 3,C08,400118,Chapman; Dillon,0,0,0,0
1708256696454,DOC 3,C09,400119,Chapman; Dillon,0,0,0,0
1708256696454,DOC 3,C10,400121,Chapman; Dillon,0,0,0,0
1708256696454,DOC 3,C11,400122,Chapman; Dillon,0,0,0,0
1708256696454,DOC 3,C12,400126,Chapman; Dillon,0,0,0,0
1708256696454,DOC 3,C13,400157,Chapman; Dillon,0,0,0,0
1708256696454,DOC 3,C14,400240,Chapman; Dillon,0,0,0,0
1708256696454,DOC 3,C15,400241,Chapman; Dillon,0,0,0,0
1708256696454,DOC 3,C16,400242,Chapman; Dillon,0,0,0,0
1708256696454,DOC 3,D01,400253,Chapman; Dillon,0,0,0,0
1708256696454,DOC 3,D02,400294,Chapman; Dillon,0,0,0,0
1708256696454,DOC 3,D03,400295,Chapman; Dillon,0,0,0,0
1708256696454,DOC 3,D04,400430,Chapman; Dillon,0,0,0,0
1708256696454,DOC 3,D05,400438,Chapman; Dillon,0,0,0,0
1708256696454,DOC 3,D06,400439,Chapman; Dillon,0,0,0,0
1708256696454,DOC 3,D07,400441,Chapman; Dillon,0,0,0,0
1708256696454,DOC 3,D08,400442,Chapman; Dillon,0,0,0,0
1708256696454,DOC 3,D09,400443,Chapman; Dillon,0,0,0,0
1708256696454,DOC 3,D10,400445,Chapman; Dillon,0,0,0,0
1708256696454,DOC 3,D11,400446,Chapman; Dillon,0,0,0,0
1708256696454,DOC 3,D12,400447,Chapman; Dillon,0,0,0,0
1708256696454,DOC 3,D13,400448,Chapman; Dillon,0,0,0,0
1708256696454,DOC 3,D14,400646,Chapman; Dillon,0,0,0,0
1708256696454,DOC 3,D15,400647,Chapman; Dillon,0,0,0,0
1708256696454,DOC 3,D16,400648,Chapman; Dillon,0,0,0,0
1708256696982,DOC 100D,A00,400649,Pass; Natalye Joann,22,0,25,3
1708256696982,DOC 100D,B00,400650,Pass; Natalye Joann,25,0,25,0
1708256697520,DSC 10,A01,398041,Tiefenbruck; Janine LoBue,142,0,147,5
1708256697520,DSC 10,B01,398180,Tiefenbruck; Janine LoBue,144,0,147,3
1708256697520,DSC 10,C01,398400,Tiefenbruck; Janine LoBue,143,0,147,4
1708256698049,DSC 20,A01,398415,Langlois; Marina,200,0,200,0
1708256698575,DSC 30,A01,398436,Langlois; Marina,156,0,158,2
1708256698575,DSC 30,B01,398439,Langlois; Marina,144,0,150,6
1708256699103,DSC 40A,A01,398441,Rampure; Suraj,123,0,125,2
1708256699103,DSC 40A,B01,398443,Rampure; Suraj,125,0,125,0
1708256699632,DSC 40B,A01,398445,Staff,150,0,150,0
1708256700157,DSC 80,A01,398470,Lau; Samuel Ethan,70,0,70,0
1708256700157,DSC 80,B01,398541,Lau; Samuel Ethan,68,0,70,2
1708256700686,DSC 95,A01,398650,Rampure; Suraj,50,0,50,0
1708256701213,DSC 100,A01,398683,Salimi; Babak,147,0,150,3
1708256701740,DSC 102,A01,398708,Jin; Haojian,145,0,150,5
1708256702267,DSC 106,A01,398711,Wilber; Jared Dane,146,0,149,3
1708256702798,DSC 140A,A01,398724,Eldridge; Justin Matthew,98,0,100,2
1708256702798,DSC 140A,B01,479346,Ustun; Tevfik Berk,50,0,50,0
1708256703328,DSC 140B,A01,398726,Weng; Tsui-Wei (lily),144,0,150,6
1708256703855,DSC 190,A01,398738,Silberman; Jack,20,0,20,0
1708256703855,DSC 190,B01,479475,Ustun; Tevfik Berk,29,0,30,1
1708256703855,DSC 190,C01,481341,Rahman; Tauhidur,50,0,50,0
1708256704383,DSC 197,001,494360,Eldridge; Justin Matthew,9999,0,9999,0
1708256704907,DSC 214,A00,477322,Staff,21,0,60,39
1708256705432,DSC 231,A01,398863,Gupta; Rajesh K.,60,0,60,0
1708256705963,DSC 232R,A01,487133,Solares; Edwin A,38,0,60,22
1708256706489,DSC 240,A00,398957,Belkin; Mikhail,74,0,90,16
1708256707541,DSC 243,A00,398958,Ma; Yian,59,0,60,1
1708256708070,DSC 245,A00,398959,Huang; Biwei,41,0,60,19
1708256708596,DSC 253,A00,398960,Shang; Jingbo,0,0,30,30
1708256709122,DSC 258R,A01,398962,Shang; Jingbo,42,0,60,18
1708256709649,DSC 267R,A01,398964,Staff,56,0,60,4
1708256710177,DSC 291,A00,398965,Belkin; Mikhail,90,0,90,0
1708256710177,DSC 291,B00,398966,Weng; Tsui-Wei (lily),90,0,90,0
1708256710177,DSC 291,C00,398997,Staff,60,0,60,0
1708256710177,DSC 291,D00,398998,Zhang; Hao,40,0,40,0
1708256710177,DSC 291,E00,477386,Staff,50,0,50,0
1708256710706,DSC 293,A00,477388,Ustun; Tevfik Berk,9989,0,9999,10
1708256711231,DSC 295,A00,480826,Danks; David J,30,0,40,10
1708256711759,DSE 220,A00,398034,Dasgupta; Sanjoy,20,0,20,0
1708256712288,DSE 230,A00,398035,Nguyen; Mai Huong,20,0,20,0
1708256712814,DSE 260B,A00,398037,Altintas De Callaf; Ilkay,20,0,20,0
1708256713345,DSGN 1,A01,408210,Klemmer; Scott R,46,0,50,4
1708256713345,DSGN 1,A02,408245,Klemmer; Scott R,47,0,50,3
1708256713872,DSGN 119,A00,407467,Hollan; James D. & Xia; Haijun,76,0,90,14
1708256714400,DSGN 160,A00,494371,Aronoff-Spencer; Eliah Sea,15,0,20,5
1708256714928,DSGN 219,A00,474323,Hollan; James D. & Xia; Haijun,15,0,15,0
1708256715459,ECE 5,A01,428645,Morris; Karcher William,21,0,24,3
1708256715459,ECE 5,A02,428646,Morris; Karcher William,24,0,24,0
1708256715459,ECE 5,A03,428647,Morris; Karcher William,24,0,24,0
1708256715459,ECE 5,A04,428648,Morris; Karcher William,24,0,24,0
1708256715985,ECE 15,A01,428650,Sahay; Rajeev,119,0,120,1
1708256716510,ECE 16,A01,428652,Wang; Edward Jay,22,0,30,8
1708256717040,ECE 17,A01,428654,Sahay; Rajeev,48,0,60,12
1708256717568,ECE 25,A50,428657,Dey; Sujit,30,0,30,0
1708256717568,ECE 25,A51,428658,Dey; Sujit,30,0,30,0
1708256718095,ECE 30,A50,428674,Mir Arabbaygi; Siavash,27,0,30,3
1708256718095,ECE 30,A51,428675,Mir Arabbaygi; Siavash,28,0,30,2
1708256718095,ECE 30,A52,428676,Mir Arabbaygi; Siavash,28,0,30,2
1708256718095,ECE 30,A53,428679,Mir Arabbaygi; Siavash,29,0,30,1
1708256718095,ECE 30,A54,428680,Mir Arabbaygi; Siavash,30,0,30,0
1708256718626,ECE 35,A50,428684,Taur; Yuan,29,0,30,1
1708256718626,ECE 35,A51,428685,Taur; Yuan,30,0,30,0
1708256718626,ECE 35,A52,428686,Taur; Yuan,30,0,30,0
1708256718626,ECE 35,A53,428687,Taur; Yuan,29,0,30,1
1708256719152,ECE 45,A01,428689,Zeger; Kenneth A.,137,0,150,13
1708256719678,ECE 65,A50,428701,Baghdadchi; Saharnaz,28,0,30,2
1708256719678,ECE 65,A51,428742,Baghdadchi; Saharnaz,29,0,30,1
1708256719678,ECE 65,A52,428743,Baghdadchi; Saharnaz,30,0,30,0
1708256719678,ECE 65,A53,428754,Baghdadchi; Saharnaz,26,0,30,4
1708256719678,ECE 65,A54,428796,Baghdadchi; Saharnaz,30,0,30,0
1708256719678,ECE 65,A55,428797,Baghdadchi; Saharnaz,29,0,30,1
1708256719678,ECE 65,A56,428803,Baghdadchi; Saharnaz,30,0,30,0
1708256720211,ECE 100,A01,428978,Baghdadchi; Saharnaz,29,0,30,1
1708256720211,ECE 100,A02,428988,Baghdadchi; Saharnaz,30,0,30,0
1708256720211,ECE 100,A03,428989,Baghdadchi; Saharnaz,29,0,30,1
1708256720211,ECE 100,A04,429008,Baghdadchi; Saharnaz,29,0,30,1
1708256720737,ECE 101,A01,429017,Bharadia; Dinesh,57,0,60,3
1708256720737,ECE 101,A02,429019,Bharadia; Dinesh,60,0,60,0
1708256721266,ECE 103,A01,429027,Kuzum; Duygu,74,0,75,1
1708256721792,ECE 107,A01,429055,Fullerton; Eric E,73,0,75,2
1708256722318,ECE 108,A01,429068,Kang; Mingu,53,0,60,7
1708256722847,ECE 109,A01,429085,Orlitsky; Alon,97,0,100,3
1708256722847,ECE 109,A02,429098,Orlitsky; Alon,96,0,100,4
1708256723373,ECE 111,A01,429132,Turakhia; Yatish Girish,173,0,180,7
1708256723902,ECE 115,A01,429314,Yip; Michael,21,0,26,5
1708256724429,ECE 123,A01,429327,Sievenpiper; Daniel F.,56,0,60,4
1708256724956,ECE 125B,A50,429397,Esmaili; Gholamreza,23,0,24,1
1708256724956,ECE 125B,A51,429627,Esmaili; Gholamreza,23,0,24,1
1708256725485,ECE 134,A00,429630,Ng; Tse Nga,50,0,50,0
1708256726013,ECE 136L,A01,429634,Dayeh; Shadi Ahmad,3,0,5,2
1708256726013,ECE 136L,A02,429636,Dayeh; Shadi Ahmad,3,0,5,2
1708256726013,ECE 136L,A03,429637,Dayeh; Shadi Ahmad,5,0,5,0
1708256726013,ECE 136L,A04,429641,Dayeh; Shadi Ahmad,5,0,5,0
1708256726538,ECE 139,A00,429642,Nomura; Kenji,17,0,20,3
1708256727068,ECE 140B,A01,455349,Khoshabeh; Ramsin & Gessner; Richard K.,19,0,24,5
1708256727068,ECE 140B,A02,455351,Khoshabeh; Ramsin & Gessner; Richard K.,23,0,24,1
1708256727068,ECE 140B,A03,455354,Khoshabeh; Ramsin & Gessner; Richard K.,21,0,22,1
1708256727594,ECE 141B,A01,455355,Gessner; Richard K.,47,0,50,3
1708256728121,ECE 148,A01,492803,Silberman; Jack,0,0,0,0
1708256728653,ECE 153,A01,429655,Naghizadeh Ardabili; Parin,94,0,100,6
1708256729234,ECE 157A,A01,429657,Bharadia; Dinesh,22,0,25,3
1708256729761,ECE 158B,A01,429659,Zhang; Xinyu,14,0,20,6
1708256730291,ECE 161C,A00,429660,Cosman; Pamela C.,58,0,60,2
1708256730819,ECE 163,A00,429664,Hsueh; Tzu-Chien,95,0,100,5
1708256731347,ECE 165,A51,429672,Mercier; Patrick Philip,20,0,30,10
1708256731347,ECE 165,A52,429673,Mercier; Patrick Philip,22,0,30,8
1708256731347,ECE 165,A53,429674,Mercier; Patrick Philip,30,0,30,0
1708256731347,ECE 165,A54,429675,Mercier; Patrick Philip,30,0,30,0
1708256731873,ECE 171A,A01,429813,Zheng; Yang,96,0,100,4
1708256732399,ECE 175B,A01,429886,Xie; Pengtao,72,0,75,3
1708256732930,ECE 183,A01,430023,Mookherjea; Shayan,26,0,30,4
1708256733455,ECE 185,A01,430025,Papen; George C.,19,0,20,1
1708256733984,ECE 191,A00,430039,Zhang; Xinyu,30,0,30,0
1708256734510,ECE 196,A00,430040,Morris; Karcher William,18,0,24,6
1708256734510,ECE 196,B00,430045,Morris; Karcher William,23,0,24,1
1708256735036,ECE 198,001,430052,Nguyen; Truong Quang,9999,0,9999,0
1708256735586,ECE 200,001,438659,Atanasov; Nikolay A.,9999,0,9999,0
1708256735586,ECE 200,002,438660,Bharadia; Dinesh,9999,0,9999,0
1708256735586,ECE 200,003,438668,Cheng; Chung Kuan,9999,0,9999,0
1708256735586,ECE 200,004,438845,Cosman; Pamela C.,9999,0,9999,0
1708256735586,ECE 200,005,438846,Dayeh; Shadi Ahmad,9999,0,9999,0
1708256735586,ECE 200,006,438847,Fainman; Yeshaiahu,9999,0,9999,0
1708256735586,ECE 200,007,438848,Ford; Joseph Earl,9999,0,9999,0
1708256735586,ECE 200,008,438849,Franceschetti; Massimo,9999,0,9999,0
1708256735586,ECE 200,009,438850,Fullerton; Eric E,9999,0,9999,0
1708256735586,ECE 200,010,438851,Galton; Ian A,9999,0,9999,0
1708256735586,ECE 200,011,438852,Gilja; Vikash,9999,0,9999,0
1708256735586,ECE 200,012,438853,Hall; Drew A.,9999,0,9999,0
1708256735586,ECE 200,013,438854,Hsueh; Tzu-Chien,9999,0,9999,0
1708256735586,ECE 200,014,438855,Javidi; Tara,9999,0,9999,0
1708256735586,ECE 200,015,438865,Kahng; Andrew Byun,9999,0,9999,0
1708256735586,ECE 200,016,438866,Kim; Young-Han,9999,0,9999,0
1708256735586,ECE 200,017,438876,Koushanfar; Farinaz,9999,0,9999,0
1708256735586,ECE 200,018,438877,Kuzum; Duygu,9999,0,9999,0
1708256735586,ECE 200,019,438934,Le; Hanh-Phuc,9999,0,9999,0
1708256735586,ECE 200,020,438954,Lin; Bill,9999,0,9999,0
1708256735586,ECE 200,021,438955,Liu; Zhaowei,9999,0,9999,0
1708256735586,ECE 200,022,438957,Lo; Yu-Hwa,9999,0,9999,0
1708256735586,ECE 200,023,439086,Lomakin; Vitaliy,9999,0,9999,0
1708256735586,ECE 200,024,439087,Mercier; Patrick Philip,9999,0,9999,0
1708256735586,ECE 200,025,439088,Meyer; Florian,9999,0,9999,0
1708256735586,ECE 200,026,439090,Milstein; Laurence B.,9999,0,9999,0
1708256735586,ECE 200,027,439208,Mir Arabbaygi; Siavash,9999,0,9999,0
1708256735586,ECE 200,028,439209,Mookherjea; Shayan,9999,0,9999,0
1708256735586,ECE 200,029,439210,Morris; Karcher William,9999,0,9999,0
1708256735586,ECE 200,030,439211,Ng; Tse Nga,9999,0,9999,0
1708256735586,ECE 200,031,439219,Nguyen; Truong Quang,9999,0,9999,0
1708256735586,ECE 200,032,439220,Nomura; Kenji,9999,0,9999,0
1708256735586,ECE 200,033,439221,Orlitsky; Alon,9999,0,9999,0
1708256735586,ECE 200,034,439222,Pal; Piya,9999,0,9999,0
1708256735586,ECE 200,035,439223,Papen; George C.,9999,0,9999,0
1708256735586,ECE 200,036,439224,Radic; Stojan,9999,0,9999,0
1708256735586,ECE 200,037,439225,Rao; Bhaskar D.,9999,0,9999,0
1708256735586,ECE 200,038,439227,Rao; Ramesh R,9999,0,9999,0
1708256735586,ECE 200,039,439231,Rebeiz; Gabriel,9999,0,9999,0
1708256735586,ECE 200,040,439232,Sanford; John R,9999,0,9999,0
1708256735586,ECE 200,041,439302,Siegel; Paul H.,9999,0,9999,0
1708256735586,ECE 200,042,439303,Sievenpiper; Daniel F.,9999,0,9999,0
1708256735586,ECE 200,043,439305,Sworder; David D.,9999,0,9999,0
1708256735586,ECE 200,044,439306,Taur; Yuan,9999,0,9999,0
1708256735586,ECE 200,045,439419,Touri; Behrouz,9999,0,9999,0
1708256735586,ECE 200,046,439425,Trivedi; Mohan M.,9999,0,9999,0
1708256735586,ECE 200,047,439538,Vasconcelos; Nuno,9999,0,9999,0
1708256735586,ECE 200,048,439546,Wang; Xiaolong,9999,0,9999,0
1708256735586,ECE 200,049,439549,Xie; Pengtao,9999,0,9999,0
1708256735586,ECE 200,050,439551,Yip; Michael,9999,0,9999,0
1708256735586,ECE 200,051,439553,Zeger; Kenneth A.,9999,0,9999,0
1708256735586,ECE 200,052,439554,Zhang; Xinyu,9999,0,9999,0
1708256735586,ECE 200,053,439555,Zheng; Yang,9999,0,9999,0
1708256735586,ECE 200,054,439557,Turakhia; Yatish Girish,9999,0,9999,0
1708256735586,ECE 200,055,439558,Kang; Mingu,9999,0,9999,0
1708256735586,ECE 200,056,439560,Shi; Yuanyuan,9999,0,9999,0
1708256735586,ECE 200,057,439564,Wang; Edward Jay,9999,0,9999,0
1708256735586,ECE 200,058,439565,Antipa; Nicholas A,9999,0,9999,0
1708256735586,ECE 200,059,439566,Zheng; Yang,9999,0,9999,0
1708256735586,ECE 200,060,492991,Yu; Paul K L,9999,0,9999,0
1708256735586,ECE 200,061,492992,Ndao; Abdoulaye,9999,0,9999,0
1708256735586,ECE 200,062,493019,Naghizadeh Ardabili; Parin,9999,0,9999,0
1708256735586,ECE 200,063,493033,Sahay; Rajeev,9999,0,9999,0
1708256736112,ECE 208,A00,430053,Mir Arabbaygi; Siavash,0,0,0,0
1708256736641,ECE 212CN,A00,430054,Liu; Zhaowei,0,0,0,0
1708256737167,ECE 222C,A00,430055,Lomakin; Vitaliy,0,0,0,0
1708256737693,ECE 227,A00,430057,Franceschetti; Massimo,0,0,0,0
1708256738222,ECE 228,A00,430078,Shi; Yuanyuan,0,0,0,0
1708256738748,ECE 230C,A00,430079,Yu; Paul K L,0,0,0,0
1708256739273,ECE 235,A00,430081,Taur; Yuan,0,0,0,0
1708256739799,ECE 236B,A00,430082,Lo; Yu-Hwa,0,0,0,0
1708256740328,ECE 240C,A00,430083,Mookherjea; Shayan,0,0,0,0
1708256740854,ECE 250,A00,430115,Touri; Behrouz,0,0,0,0
1708256741384,ECE 251B,A00,430166,Vasconcelos; Manuela,0,0,0,0
1708256741911,ECE 258B,A00,430167,Milstein; Laurence B.,0,0,0,0
1708256742437,ECE 260C,A00,430168,Eldon; John,0,0,0,0
1708256742966,ECE 264B,A00,430169,Galton; Ian A,0,0,0,0
1708256743492,ECE 265B,A00,430170,Gudem; Prasad S.S.,0,0,0,0
1708256744018,ECE 266,A01,430273,Hall; Drew A.,0,0,0,0
1708256744545,ECE 271C,A00,430283,Vasconcelos; Nuno,0,0,0,0
1708256745071,ECE 272A,A01,430340,Poveda Fonseca; Jorge,0,0,0,0
1708256745600,ECE 273,A00,430352,Wang; Jun-Kun,0,0,0,0
1708256746126,ECE 276B,A00,430353,Atanasov; Nikolay A.,0,0,0,0
1708256746658,ECE 284,A00,430385,Wang; Edward,0,0,0,0
1708256747188,ECE 285,A00,430386,Wang; Xiaolong,0,0,0,0
1708256747188,ECE 285,B00,430387,Antipa; Nicholas A,0,0,0,0
1708256747715,ECON 1,A01,409576,Crane; Meredith Helen,87,0,100,13
1708256747715,ECON 1,A02,409577,Crane; Meredith Helen,96,0,100,4
1708256747715,ECON 1,A03,409578,Crane; Meredith Helen,97,0,100,3
1708256748239,ECON 2,A01,409580,Candido; Maria Teresa,70,0,75,5
1708256748765,ECON 3,A01,409582,Crane; Meredith Helen,109,0,120,11
1708256748765,ECON 3,A02,409583,Crane; Meredith Helen,114,0,115,1
1708256748765,ECON 3,A03,409584,Crane; Meredith Helen,110,0,115,5
1708256749294,ECON 4,A01,409586,Levkoff; Steven B.,88,0,92,4
1708256749294,ECON 4,A02,409587,Levkoff; Steven B.,89,0,90,1
1708256749822,ECON 5,A01,409589,Dai; Yinlin,53,0,58,5
1708256749822,ECON 5,A02,409590,Dai; Yinlin,56,0,58,2
1708256749822,ECON 5,A03,409591,Dai; Yinlin,54,0,54,0
1708256749822,ECON 5,A04,409593,Dai; Yinlin,55,0,55,0
1708256749822,ECON 5,B01,409595,Dai; Yinlin,57,0,58,1
1708256749822,ECON 5,B02,409596,Dai; Yinlin,49,0,49,0
1708256749822,ECON 5,B03,409597,Dai; Yinlin,59,0,59,0
1708256749822,ECON 5,B04,409598,Dai; Yinlin,55,0,55,0
1708256749822,ECON 5,C01,487209,Staff,40,0,45,5
1708256750349,ECON 100A,A01,409600,Famulari; Melissa,94,0,100,6
1708256750349,ECON 100A,A02,409601,Famulari; Melissa,98,0,100,2
1708256750349,ECON 100A,A03,409604,Famulari; Melissa,98,0,100,2
1708256750349,ECON 100A,B01,409610,Famulari; Melissa,76,0,80,4
1708256750879,ECON 100AH,A00,409612,Famulari; Melissa,19,0,20,1
1708256751405,ECON 100B,A01,409614,Grigoryan; Aram,109,0,120,11
1708256751405,ECON 100B,A02,409616,Grigoryan; Aram,117,0,120,3
1708256751405,ECON 100B,B01,409626,Grigoryan; Aram,47,0,50,3
1708256751405,ECON 100B,B02,409627,Grigoryan; Aram,49,0,50,1
1708256751934,ECON 100C,A01,409629,Levkoff; Steven B.,143,0,146,3
1708256751934,ECON 100C,B01,409632,Levkoff; Steven B.,143,0,146,3
1708256752459,ECON 106,A00,409633,Bowen; T. Renee,90,0,90,0
1708256752984,ECON 109T,A00,409634,Trevino; Isabel,18,0,20,2
1708256753509,ECON 110A,A01,409637,Staff,68,0,75,7
1708256754040,ECON 110B,A01,409663,Herreno Lopera; Juan,119,0,125,6
1708256754040,ECON 110B,A02,409682,Herreno Lopera; Juan,125,0,125,0
1708256754040,ECON 110B,B01,409734,Herreno Lopera; Juan,99,0,100,1
1708256754567,ECON 120A,A01,409739,Candido; Maria Teresa,84,0,90,6
1708256754567,ECON 120A,A02,409740,Candido; Maria Teresa,87,0,90,3
1708256754567,ECON 120A,B01,409742,Candido; Maria Teresa,85,0,90,5
1708256754567,ECON 120A,B02,409743,Candido; Maria Teresa,90,0,90,0
1708256755097,ECON 120B,A01,409748,Ma; Xinwei,128,0,130,2
1708256755097,ECON 120B,A02,409754,Ma; Xinwei,128,0,130,2
1708256755097,ECON 120B,B01,409756,Ma; Xinwei,25,0,40,15
1708256755629,ECON 120C,A01,409758,Sun; Yixiao,141,0,146,5
1708256755629,ECON 120C,B01,409762,Sun; Yixiao,144,0,146,2
1708256756161,ECON 129,A00,409763,Eckert; Fabian Paul,44,0,50,6
1708256756686,ECON 134,A00,409764,Gelber; Alexander Michael,45,0,50,5
1708256756686,ECON 134,B00,409765,Gelber; Alexander Michael,49,0,50,1
1708256757213,ECON 137,A00,409766,Niehaus; Paul,19,0,20,1
1708256757741,ECON 142,A00,409767,Trevino; Isabel,39,0,40,1
1708256757741,ECON 142,B00,409768,Trevino; Isabel,38,0,40,2
1708256758269,ECON 164,A00,409771,Muralidharan; Karthik,118,0,120,2
1708256758795,ECON 172A,A01,409773,Newhouse; Herbert S,67,0,75,8
1708256759321,ECON 172B,A01,409775,Newhouse; Herbert S,74,0,75,1
1708256759321,ECON 172B,B01,409777,Newhouse; Herbert S,71,0,75,4
1708256760373,ECON 191A,A00,409780,Cullen; Julie,20,0,20,0
1708256760905,ECON 200C,A00,409782,Du; Songzi,34,0,35,1
1708256761434,ECON 210C,A00,409784,Herreno Lopera; Juan & Wieland; Johannes Friedrich,35,0,35,0
1708256761962,ECON 220C,A00,409785,Sun; Yixiao,35,0,35,0
1708256762489,ECON 220F,A00,409786,Carson; Richard T,27,0,30,3
1708256763019,ECON 221,A00,409787,Zhu; Ying,25,0,25,0
1708256763545,ECON 241,A00,409788,Muralidharan; Karthik,18,0,20,2
1708256764074,ECON 243,A00,409789,Niehaus; Paul,18,0,20,2
1708256764601,ECON 248,A00,409790,Eckert; Fabian Paul,18,0,20,2
1708256765128,ECON 250C,A00,409791,Arnold; David Hall & Betts; Julian,25,0,25,0
1708256765656,ECON 268,A00,409792,Jacobsen; Mark,24,0,25,1
1708256766182,ECON 281,A00,409793,Meckel; Katherine Hunter,19,0,20,1
1708256766182,ECON 281,B00,409794,Herreno Lopera; Juan & Wieland; Johannes Friedrich,19,0,20,1
1708256766182,ECON 281,C00,477854,Herreno Lopera; Juan & Wieland; Johannes Friedrich,18,0,20,2
1708256766710,ECON 285,A00,409795,Eckert; Fabian Paul,20,0,20,0
1708256767239,ECON 286,A00,409796,Ma; Xinwei,15,0,15,0
1708256767239,ECON 286,B00,409797,Hamilton; James D.,15,0,15,0
1708256767239,ECON 286,C00,409798,Grigoryan; Aram,15,0,15,0
1708256767239,ECON 286,D00,409799,Niehaus; Paul,15,0,15,0
1708256767764,ECON 296,A00,409800,Eckert; Fabian Paul,20,0,20,0
1708256768294,EDS 31,A00,409801,Bussey; Thomas J,9,0,10,1
1708256768819,EDS 38,A01,409803,Chung; Luz Marina,25,0,25,0
1708256769345,EDS 39,A01,409805,Heinzman; Erica M.,24,0,25,1
1708256769875,EDS 102,A01,409807,Ambo; Theresa Jean,37,0,45,8
1708256770401,EDS 110R,A01,409809,Staff,42,0,50,8
1708256770401,EDS 110R,B01,481358,Staff,20,0,20,0
1708256770927,EDS 111,A00,479044,Wishard Guerra; Alison G.,56,0,60,4
1708256771457,EDS 117,A01,409818,Jones; Gabrielle Anastasia,21,0,23,2
1708256771457,EDS 117,A02,409819,Jones; Gabrielle Anastasia,23,0,23,0
1708256771457,EDS 117,A03,409820,Jones; Gabrielle Anastasia,22,0,23,1
1708256771457,EDS 117,A04,409821,Jones; Gabrielle Anastasia,21,0,21,0
1708256771983,EDS 118,A00,409828,Warstadt; Melissa Fawn,46,0,50,4
1708256772508,EDS 123,A00,409831,Bussey; Thomas J,10,0,10,0
1708256773035,EDS 124AR,A00,419352,Simon; Elizabeth A,81,0,100,19
1708256773035,EDS 124AR,B00,419377,Simon; Elizabeth A,97,0,100,3
1708256773035,EDS 124AR,C00,481485,Simon; Elizabeth A,25,0,25,0
1708256773035,EDS 124AR,D00,481490,Simon; Elizabeth A,25,0,25,0
1708256773559,EDS 124BR,A00,409838,Eguchi; Emi,52,0,75,23
1708256773559,EDS 124BR,B00,481363,Eguchi; Emi,25,0,25,0
1708256774089,EDS 125,A00,409839,Aragon; Maria Jose,48,0,50,2
1708256774615,EDS 126,A01,409843,Jones; Makeba,19,0,25,6
1708256774615,EDS 126,A02,409844,Jones; Makeba,25,0,25,0
1708256774615,EDS 126,A03,409846,Jones; Makeba,25,0,25,0
1708256774615,EDS 126,A04,409847,Jones; Makeba,25,0,25,0
1708256775140,EDS 128B,A01,409851,Pappas; Elizabeth,49,0,50,1
1708256775668,EDS 129C,A01,409906,Millstone; Rachel Diana,44,0,50,6
1708256776197,EDS 130,A01,409954,Mendez; Kathrina Mendoza,14,0,15,1
1708256776197,EDS 130,A02,409955,Mendez; Kathrina Mendoza,24,0,25,1
1708256776197,EDS 130,A03,409956,Mendez; Kathrina Mendoza,20,0,20,0
1708256776728,EDS 133,A01,409961,Bintliff; Amy S.V.,15,0,20,5
1708256776728,EDS 133,A02,409962,Bintliff; Amy S.V.,20,0,20,0
1708256776728,EDS 133,A03,489636,Bintliff; Amy S.V.,15,0,15,0
1708256777254,EDS 136,A01,409964,Chung; Luz Marina,30,0,30,0
1708256777254,EDS 136,A02,409977,Chung; Luz Marina,30,0,30,0
1708256777785,EDS 139,A00,479197,Millstone; Rachel Diana,42,0,50,8
1708256777785,EDS 139,B00,479198,Pappas; Elizabeth,49,0,50,1
1708256777785,EDS 139,C00,479199,Mendez; Kathrina Mendoza,58,0,60,2
1708256777785,EDS 139,D00,479200,Bintliff; Amy S.V.,56,0,60,4
1708256777785,EDS 139,E00,479201,Chung; Luz Marina,59,0,60,1
1708256777785,EDS 139,F00,479202,Bintliff; Amy S.V.,15,0,15,0
1708256777785,EDS 139,G00,479203,Mamas; Christoforos,27,0,30,3
1708256777785,EDS 139,H00,493997,Choi; Bailey Miyeon,28,0,30,2
1708256778310,EDS 141,A00,409979,Mamas; Christoforos,38,0,40,2
1708256778834,EDS 145,A01,409989,Choi; Bailey Miyeon,13,0,15,2
1708256778834,EDS 145,A02,409990,Choi; Bailey Miyeon,15,0,15,0
1708256779364,EDS 180,A00,409991,Chapman; Thandeka K,30,0,30,0
1708256779364,EDS 180,B00,409992,Ambo; Theresa Jean,24,0,25,1
1708256779364,EDS 180,C00,409993,Jones; Gabrielle Anastasia,20,0,20,0
1708256779364,EDS 180,D00,409994,Phuong; Andrew,24,0,24,0
1708256779889,EDS 198,001,487216,Eguchi; Emi,20,0,20,0
1708256780414,EDS 205B,A00,409995,Staff,40,0,45,5
1708256780414,EDS 205B,B00,409997,Staff,42,0,45,3
1708256780939,EDS 232,A00,409999,Hopkins; Megan Beth,9,0,12,3
1708256781467,EDS 255,A00,410001,Phuong; Andrew,14,0,15,1
1708256781993,EDS 257,A00,410003,Datnow; Amanda Lee,14,0,15,1
1708256782590,EDS 282,A00,479192,Daly; Alan J.,16,0,16,0
1708256783115,EDS 287B,A00,479193,Daly; Alan J.,16,0,16,0
1708256783640,EDS 288A,A00,410005,Staff,18,0,18,0
1708256784168,EDS 288C,A00,410007,Staff,18,0,18,0
1708256784694,EDS 289B,A01,410009,Daly; Alan J.,18,0,18,0
1708256785223,EDS 290,A00,410010,Black; Alison Michelle,30,0,30,0
1708256785223,EDS 290,B00,410012,Choi; Bailey Miyeon,29,0,30,1
1708256785223,EDS 290,C00,479205,Heinzman; Erica M.,0,0,0,0
1708256785749,EDS 291B,A01,479195,Daly; Alan J.,16,0,16,0
1708256786275,EDS 293B,A01,410016,Staff,18,0,18,0
1708256786804,EDS 294B,A00,479196,Burrell; Sade Renee,16,0,16,0
1708256787353,EDS 296,001,478927,Ambo; Theresa Jean,0,0,0,0
1708256787353,EDS 296,002,478935,Aragon; Maria Jose,0,0,0,1
1708256787353,EDS 296,003,478936,Chapman; Thandeka K,0,0,0,0
1708256787353,EDS 296,004,478942,Bintliff; Amy S.V.,0,0,0,0
1708256787353,EDS 296,005,478943,Clarke; Sherice Nicole,0,0,0,0
1708256787353,EDS 296,006,478967,Cohen; Shana R,0,0,0,1
1708256787353,EDS 296,007,478968,Datnow; Amanda Lee,0,0,0,0
1708256787353,EDS 296,008,478969,Daly; Alan J.,0,0,0,0
1708256787353,EDS 296,009,478970,Eguchi; Emi,0,0,0,0
1708256787353,EDS 296,010,478971,Fine; Sarah,0,0,0,0
1708256787353,EDS 296,011,478972,Jones; Gabrielle Anastasia,0,0,0,0
1708256787353,EDS 296,012,479020,Jones; Makeba,0,0,0,0
1708256787353,EDS 296,013,479021,Halter; Christopher P.,0,0,0,0
1708256787353,EDS 296,014,479027,Hofstetter; Carolyn,0,0,0,0
1708256787353,EDS 296,015,479028,Hopkins; Megan Beth,0,0,0,0
1708256787353,EDS 296,016,479034,Mamas; Christoforos,0,0,0,0
1708256787353,EDS 296,017,479035,Pollock; Mica,0,0,0,0
1708256787353,EDS 296,018,479036,Wishard Guerra; Alison G.,0,0,0,0
1708256787353,EDS 296,019,494549,Phuong; Andrew,0,0,0,0
1708256787880,EMED 296,001,464428,Singh; Sukhdeep,49,0,50,1
1708256787880,EMED 296,002,464438,Subramony; Rachna,49,0,50,1
1708256787880,EMED 296,003,464490,Staff,50,0,50,0
1708256788406,ENG 10,A00,399006,Evdokimenko; Ekaterina,30,0,30,0
1708256788934,ENG 100D,A00,399084,Ngo; Anh-Thu T.,33,0,50,17
1708256789461,ENG 100DR,A00,479230,Ngo; Anh-Thu T.,29,0,40,11
1708256789996,ENG 100L,A00,399163,Kleissl; Jan,6,0,6,0
1708256789996,ENG 100L,B00,399217,Bratton; Maryann,8,0,8,0
1708256789996,ENG 100L,C00,399218,Yu; Paul K L,8,0,8,0
1708256789996,ENG 100L,D00,399257,Bratton; Maryann,6,0,6,0
1708256789996,ENG 100L,E00,399258,de Oliveira; Mauricio,9,0,10,1
1708256789996,ENG 100L,F00,399314,Bratton; Maryann,7,0,7,0
1708256789996,ENG 100L,G00,399394,Boyle; Mary E. T.,14,0,15,1
1708256790527,ENVR 102,A00,400777,Daly; Heather Marie,19,0,20,1
1708256790527,ENVR 102,B00,400778,Montejo; Carolina,24,0,25,1
1708256790527,ENVR 102,C00,400791,Staff,23,0,25,2
1708256791055,ENVR 140,A01,400813,Siapno; Jacqueline A,12,0,15,3
1708256791055,ENVR 140,A02,400870,Siapno; Jacqueline A,15,0,15,0
1708256791055,ENVR 140,A03,400889,Siapno; Jacqueline A,15,0,15,0
1708256791055,ENVR 140,A04,400890,Siapno; Jacqueline A,15,0,15,0
1708256791583,ENVR 144,A01,400929,Herbst; Matthew,20,0,20,0
1708256792108,ERC 20,A00,400722,Evans; Ivan T,30,0,30,0
1708256792634,ESYS 103,A01,400931,Lerner; Amy M,32,0,34,2
1708256792634,ESYS 103,A02,400934,Lerner; Amy M,34,0,34,0
1708256792634,ESYS 103,A03,400938,Lerner; Amy M,28,0,34,6
1708256792634,ESYS 103,A04,400939,Lerner; Amy M,33,0,34,1
1708256792634,ESYS 103,A05,400940,Lerner; Amy M,34,0,34,0
1708256792634,ESYS 103,A06,400941,Lerner; Amy M,33,0,34,1
1708256793402,ESYS 187C,A01,400945,Hetherington; Elizabeth Dorsey,28,0,40,12
1708256793402,ESYS 187C,A02,400946,Hetherington; Elizabeth Dorsey,39,0,40,1
1708256793943,ETHN 3R,A01,400948,Streeby; Shelley,21,0,25,4
1708256793943,ETHN 3R,A02,401220,Streeby; Shelley,24,0,25,1
1708256793943,ETHN 3R,A03,401231,Streeby; Shelley,22,0,25,3
1708256793943,ETHN 3R,A04,401236,Streeby; Shelley,23,0,25,2
1708256793943,ETHN 3R,A05,401241,Streeby; Shelley,21,0,25,4
1708256793943,ETHN 3R,A06,401311,Streeby; Shelley,21,0,25,4
1708256793943,ETHN 3R,A07,401318,Streeby; Shelley,25,0,25,0
1708256793943,ETHN 3R,A08,401319,Streeby; Shelley,25,0,25,0
1708256793943,ETHN 3R,A09,401397,Streeby; Shelley,25,0,25,0
1708256793943,ETHN 3R,A10,401398,Streeby; Shelley,25,0,25,0
1708256793943,ETHN 3R,A11,401399,Streeby; Shelley,24,0,25,1
1708256793943,ETHN 3R,A12,401518,Streeby; Shelley,25,0,25,0
1708256793943,ETHN 3R,A13,401551,Streeby; Shelley,24,0,25,1
1708256793943,ETHN 3R,A14,401552,Streeby; Shelley,23,0,25,2
1708256794472,ETHN 30,A01,401554,Fuste; Jose Ignacio,24,0,25,1
1708256794472,ETHN 30,A02,401555,Fuste; Jose Ignacio,25,0,25,0
1708256794472,ETHN 30,A03,401556,Fuste; Jose Ignacio,25,0,25,0
1708256794472,ETHN 30,A04,401557,Fuste; Jose Ignacio,25,0,25,0
1708256794998,ETHN 100C,A00,401558,Museus; Samuel David,36,0,40,4
1708256795524,ETHN 101TV,A01,401560,Marez; Curtis F.,21,0,25,4
1708256795524,ETHN 101TV,A02,401564,Marez; Curtis F.,25,0,25,0
1708256796053,ETHN 108,A00,401584,Hankins; Sarah E.,25,0,29,4
1708256796579,ETHN 113A,A00,401657,Werner; Bradley T.,15,0,15,0
1708256797106,ETHN 114B,A00,401724,Frank; Ross H.,19,0,20,1
1708256797633,ETHN 120D,A01,401848,Alvarez; Luis A,8,0,10,2
1708256797633,ETHN 120D,A02,401853,Alvarez; Luis A,10,0,10,0
1708256798159,ETHN 125R,A00,401858,Sasaki; Christen T,39,0,50,11
1708256798689,ETHN 126,A00,401865,Tran; Ly Thi Hai,39,0,40,1
1708256799218,ETHN 127,A00,401866,Martin Sandino; Amanda Maria Yoland,24,0,25,1
1708256799743,ETHN 137,A00,401867,Martin Sandino; Amanda Maria Yoland,19,0,19,0
1708256800269,ETHN 139,A00,401992,Perreira; Christopher Michael,25,0,25,0
1708256800814,ETHN 143,A00,402059,Marez; Curtis F.,39,0,40,1
1708256801339,ETHN 144M,A00,402060,Jolivette; Andrew J,62,0,65,3
1708256801869,ETHN 150,A00,402158,Taylor-Garcia; Daphne,16,0,18,2
1708256802399,ETHN 153,A00,402160,Martinez-Matsuda; Veronica,24,0,25,1
1708256802925,ETHN 179,A00,402165,Richards; Stephanie F,23,0,25,2
1708256803454,ETHN 183,A00,402217,Steelman; Katherine Wallis,16,0,16,0
1708256803996,ETHN 186,A00,402313,Perez; Roy,15,0,15,0
1708256804522,ETHN 189,A00,479226,Museus; Samuel David,29,0,30,1
1708256805051,ETHN 196H,A00,402314,Espiritu; Yen,0,0,0,0
1708256805051,ETHN 196H,B00,402325,Perreira; Christopher Michael,0,0,0,0
1708256805051,ETHN 196H,C00,402344,Perez; Roy,0,0,0,0
1708256805051,ETHN 196H,D00,402345,Streeby; Shelley,0,0,0,0
1708256805051,ETHN 196H,E00,402346,Taylor-Garcia; Daphne,0,0,0,0
1708256805578,ETHN 200C,A00,402358,Fuste; Jose Ignacio,19,0,20,1
1708256806107,ETHN 230,A00,402359,Streeby; Shelley,16,0,20,4
1708256806633,ETHN 291,A00,402363,Perreira; Christopher Michael,16,0,20,4
1708256807173,EXPR 100,A00,477778,Staff,9999,0,9999,0
1708256807700,EXPR 105,A00,477779,Staff,9999,0,9999,0
1708256808227,EXPR 201,A00,477780,Staff,9999,0,9999,0
1708256808755,EXPR 205,A00,477781,Staff,9999,0,9999,0
1708256809282,FILM 87,A00,402794,Rahimi; Babak,19,0,20,1
1708256809282,FILM 87,B00,402796,Rahimi; Babak,20,0,20,0
1708256809282,FILM 87,C00,402821,Havis; Allan,19,0,20,1
1708256809809,FMPH 95,A00,481734,Larsen; Britta Ann,0,0,0,2
1708256810339,FMPH 101,A00,404648,Tan; Gene Brian,31,0,40,9
1708256810867,FMPH 102,A01,404692,Rana; Brinda Kanti,24,0,28,4
1708256810867,FMPH 102,A02,404714,Rana; Brinda Kanti,28,0,28,0
1708256810867,FMPH 102,B01,404739,Rana; Brinda Kanti,26,0,28,2
1708256810867,FMPH 102,B02,404746,Rana; Brinda Kanti,28,0,28,0
1708256811397,FMPH 110,A00,404747,Campbell; Chadwick Karl,52,0,55,3
1708256811397,FMPH 110,B00,404789,Zoumas-Morse; Christine E.,24,0,30,6
1708256811922,FMPH 120,A00,404792,Nguyen-Grozavu; France T.,48,0,60,12
1708256812449,FMPH 130,A00,404859,Gould; Carlos Francisco,48,0,55,7
1708256812449,FMPH 130,B00,479047,Ciborowski; Haley Minae,52,0,55,3
1708256812974,FMPH 155,A00,404864,Fielding-Miller; Rebecca,65,0,65,0
1708256813502,FMPH 161,A00,404865,Zoumas-Morse; Christine E.,27,0,35,8
1708256814029,FMPH 191,A00,404866,Eikey; Elizabeth Victoria,35,0,35,0
1708256814555,FMPH 194,A00,404938,Larsen; Britta Ann,0,0,0,0
1708256814555,FMPH 194,B00,404939,Marquez; Becky,0,0,0,0
1708256814555,FMPH 194,C00,404949,Nguyen-Grozavu; France T.,0,0,0,0
1708256814555,FMPH 194,D00,404950,Stone; Matthew David,0,0,0,0
1708256814555,FMPH 194,E00,404958,White; Anne Elizabeth Clar,0,0,0,0
1708256814555,FMPH 194,F00,404969,Zoumas-Morse; Christine E.,0,0,0,0
1708256815084,FMPH 223,A00,404977,Vaida; Florin,7,0,26,19
1708256815608,FMPH 225,A00,404978,Zou; Jingjing,0,0,0,0
1708256816149,FMPH 291,A00,404992,Salem; Rany Mansour,15,0,15,0
1708256816149,FMPH 291,C00,405005,Schwartzman; Armin,0,0,0,11
1708256816149,FMPH 291,D00,479113,Shadyab; Aladdin Hassan,0,0,0,0
1708256816149,FMPH 291,E00,479114,Shadyab; Aladdin Hassan,0,0,0,0
1708256816149,FMPH 291,F00,479115,Wynn; Adriane Michelle,0,0,0,3
1708256816149,FMPH 291,G00,479116,Xu; Ronghui,0,0,0,10
1708256816149,FMPH 291,H00,479119,Vaida; Florin,0,0,0,2
1708256816678,FPM 258C,A00,405129,Chen; Brian Hwa-Yang,11,0,15,4
1708256817205,FPM 259C,A00,405130,Nguyen; Annie Lu & Araneta; Maria Rosario Gorrez,4,0,5,1
1708256817732,FPM 278,A00,405131,Strong; David R,13,0,15,2
1708256818259,FPM 280C,A01,405133,Banegas; Matthew Patrick,10,0,10,0
1708256818787,FPM 296,001,464651,Johnson; Michelle Lee,49,0,50,1
1708256818787,FPM 296,002,464652,Staff,50,0,50,0
1708256818787,FPM 296,003,464653,Staff,50,0,50,0
1708256819312,FPM 297,001,479175,Vaida; Florin,9999,0,9999,0
1708256819312,FPM 297,002,494007,Strong; David R,9999,0,9999,0
1708256819312,FPM 297,003,494364,Bazzi; Angela Robertson,9999,0,9999,0
1708256819841,GLBH 20,A00,405134,Elwardani; Nile Regina,143,0,146,3
1708256820366,GLBH 100,A00,405135,Bhavsar; Radhika,68,0,70,2
1708256820366,GLBH 100,B00,477773,Villarino; Margarita,39,0,44,5
1708256820366,GLBH 100,C00,477855,Jenkins; Janis A.,20,0,20,0
1708256820366,GLBH 100,D00,481337,Mishra; Jyoti,40,0,40,0
1708256820895,GLBH 101,A00,405136,Sloane; Julia Kathryn,40,0,40,0
1708256821421,GLBH 107,A00,405137,Wilson; Brenda K,63,0,70,7
1708256821950,GLBH 111,A01,486865,Burgos; Jose L.,0,0,0,0
1708256821950,GLBH 111,B01,486867,Burgos; Jose L.,0,0,0,0
1708256822476,GLBH 114W,A00,405138,Walkover; Lillian B,17,0,17,0
1708256823001,GLBH 118,A00,405140,Wilson; Brenda K,31,0,32,1
1708256823529,GLBH 147,A00,405141,Stewart; Alexander B,40,0,40,0
1708256824055,GLBH 148,A00,405142,Olivas Hernandez; Olga Lid,93,0,100,7
1708256824581,GLBH 150B,A00,486855,Sanchez; Giselle,0,0,0,0
1708256825107,GLBH 181,A00,405154,Burgos; Jose L.,211,0,216,5
1708256825637,GLBH 215,A00,479241,Walkover; Lillian B,18,0,18,0
1708256826163,GLBH 260,A00,480722,Elwardani; Nile Regina,18,0,18,0
1708256826692,GSS 20,A00,405155,Siapno; Jacqueline A,25,0,30,5
1708256827216,GSS 25,A00,405156,Batarseh; Amanda Alicia,24,0,30,6
1708256827743,HDS 1,A01,405160,Reese; Clarissa Jane,25,0,25,0
1708256827743,HDS 1,A02,405168,Reese; Clarissa Jane,25,0,25,0
1708256827743,HDS 1,A03,405169,Reese; Clarissa Jane,22,0,25,3
1708256827743,HDS 1,A04,405170,Reese; Clarissa Jane,24,0,25,1
1708256827743,HDS 1,A05,405171,Reese; Clarissa Jane,23,0,25,2
1708256827743,HDS 1,A06,405172,Reese; Clarissa Jane,24,0,25,1
1708256827743,HDS 1,A07,405173,Reese; Clarissa Jane,24,0,25,1
1708256828273,HDS 60,A01,405175,Warstadt; Melissa Fawn,34,0,35,1
1708256828273,HDS 60,A02,405176,Warstadt; Melissa Fawn,33,0,35,2
1708256828798,HDS 95,A00,405177,Staff,38,0,40,2
1708256829323,HDS 120,A00,405178,Staff,0,0,0,0
1708256829851,HDS 122,A00,405179,Rodriguez; Victoria Calip,64,0,75,11
1708256830376,HDS 150,A00,405180,Staff,20,0,20,0
1708256830376,HDS 150,B00,405181,Staff,20,0,20,0
1708256830376,HDS 150,C00,405182,Staff,20,0,20,0
1708256830903,HDS 181,A01,405185,Bjorklund; Peter,30,0,30,0
1708256831432,HDS 191,A01,405187,Reese; Clarissa Jane,40,0,40,0
1708256831432,HDS 191,B01,405194,Staff,25,0,25,0
1708256831957,HIAF 113,A00,403736,Prestholdt; Jeremy,74,0,75,1
1708256832486,HIAF 114,A00,403738,Gyamfi; Bright,49,0,50,1
1708256833012,HIEA 132,A00,403740,Kletzer; Benjamin Nathan,25,0,30,5
1708256833539,HIEA 154,A00,403741,Henry; Todd A.,62,0,64,2
1708256834063,HIEU 139,A00,403742,Strasser; Ulrike,52,0,56,4
1708256834590,HIEU 171,A00,403743,Hansen; Jan Eric,62,0,64,2
1708256835116,HIEU 176,A00,403744,Hertz; Deborah,14,0,15,1
1708256835643,HIEU 183,A00,403800,Gallant; Thomas W.,15,0,15,0
1708256836223,HIEU 276,A00,403862,Hertz; Deborah,0,0,0,0
1708256836752,HIGL 127,A00,403802,Ivey; James Alexander,56,0,56,0
1708256837277,HIGR 201,A00,494372,Pineda De Avila; Nydia,9,0,10,1
1708256837802,HIGR 205,A00,403863,Strasser; Ulrike,11,0,15,4
1708256838619,HIGR 217C,A00,403864,Lu; Weijing,9,0,10,1
1708256839146,HIGR 239,A00,403865,Serlin; David,4,0,5,1
1708256839670,HIGR 240,A00,403875,Gates; Kelly,2,0,5,3
1708256840199,HILA 101,A00,403818,LeNeave; Kimiko Nicole,62,0,64,2
1708256840724,HILA 119,A00,403819,Kozameh; Sara J,47,0,50,3
1708256841253,HILA 144,A00,403821,Kozameh; Sara J,50,0,50,0
1708256841782,HILD 2C,A01,402843,Hendrickson; Gerald M.,31,0,32,1
1708256841782,HILD 2C,A02,403030,Hendrickson; Gerald M.,31,0,32,1
1708256841782,HILD 2C,A03,403042,Hendrickson; Gerald M.,32,0,32,0
1708256841782,HILD 2C,A04,403048,Hendrickson; Gerald M.,30,0,32,2
1708256841782,HILD 2C,A05,403049,Hendrickson; Gerald M.,32,0,32,0
1708256841782,HILD 2C,A06,403098,Hendrickson; Gerald M.,32,0,32,0
1708256842309,HILD 7C,A01,403501,Bermudez; Rosie Cano,27,0,32,5
1708256842309,HILD 7C,A02,403513,Bermudez; Rosie Cano,30,0,32,2
1708256842309,HILD 7C,A03,403570,Bermudez; Rosie Cano,32,0,32,0
1708256842309,HILD 7C,A04,403572,Bermudez; Rosie Cano,32,0,32,0
1708256842309,HILD 7C,A05,403587,Bermudez; Rosie Cano,32,0,32,0
1708256842309,HILD 7C,A06,403588,Bermudez; Rosie Cano,32,0,32,0
1708256842309,HILD 7C,A07,403589,Bermudez; Rosie Cano,29,0,32,3
1708256842309,HILD 7C,A08,403590,Bermudez; Rosie Cano,32,0,32,0
1708256842309,HILD 7C,A09,403601,Bermudez; Rosie Cano,30,0,32,2
1708256842309,HILD 7C,A10,403602,Bermudez; Rosie Cano,32,0,32,0
1708256842309,HILD 7C,A11,403603,Bermudez; Rosie Cano,32,0,32,0
1708256842309,HILD 7C,A12,403604,Bermudez; Rosie Cano,32,0,32,0
1708256842835,HILD 12,A01,403607,Henry; Todd A.,32,0,32,0
1708256842835,HILD 12,A02,403608,Henry; Todd A.,31,0,32,1
1708256842835,HILD 12,A03,403609,Henry; Todd A.,32,0,32,0
1708256842835,HILD 12,A04,403699,Henry; Todd A.,32,0,32,0
1708256842835,HILD 12,A05,403700,Henry; Todd A.,32,0,32,0
1708256842835,HILD 12,A06,403701,Henry; Todd A.,32,0,32,0
1708256843365,HILD 30,A01,403703,Soleiman; Matthew Teymour,29,0,32,3
1708256843365,HILD 30,A02,403704,Soleiman; Matthew Teymour,30,0,32,2
1708256843888,HINE 118,A00,403822,Kayali; Hasan,50,0,50,0
1708256844417,HISC 119,A00,403823,Golan; Tal,26,0,30,4
1708256844943,HISC 123,A00,403839,Pineda De Avila; Nydia,44,0,50,6
1708256845470,HITO 87,A00,403707,Patterson; Patrick H.,15,0,15,0
1708256845470,HITO 87,B00,403709,Patterson; Patrick H.,15,0,15,0
1708256845470,HITO 87,C00,403735,Schneewind; Sarah,15,0,15,0
1708256845996,HITO 100,B00,403841,Klann; Mary Cameron,24,0,25,1
1708256846525,HITO 170,A00,403842,Watts; Edward J.,8,0,10,2
1708256847050,HITO 193,A00,455333,Hill; Seth J,0,0,0,0
1708256847576,HIUS 114A,A00,403843,Lewandoski; Julia Mavis,52,0,56,4
1708256848106,HIUS 120D,A01,403854,Alvarez; Luis A,8,0,10,2
1708256848106,HIUS 120D,A02,403855,Alvarez; Luis A,10,0,10,0
1708256848632,HIUS 136,A00,403857,Martinez-Matsuda; Veronica,21,0,25,4
1708256849160,HIUS 144,A00,403858,Martinez-Matsuda; Veronica,55,0,56,1
1708256849160,HIUS 144,B00,403859,Vandevelde; Kenneth Joseph,54,0,56,2
1708256849160,HIUS 144,C00,403860,Klann; Mary Cameron,52,0,56,4
1708256849160,HIUS 144,D00,403861,Lewandoski; Julia Mavis,55,0,56,1
1708256849733,HUM 2,A01,422723,Watts; Edward J.,16,0,16,0
1708256849733,HUM 2,A02,422735,Watts; Edward J.,15,0,16,1
1708256849733,HUM 2,A03,422736,Watts; Edward J.,15,0,16,1
1708256849733,HUM 2,A04,422737,Watts; Edward J.,16,0,16,0
1708256849733,HUM 2,A05,422738,Watts; Edward J.,15,0,16,1
1708256849733,HUM 2,A06,422760,Watts; Edward J.,15,0,16,1
1708256849733,HUM 2,A07,422778,Watts; Edward J.,16,0,16,0
1708256849733,HUM 2,A08,422793,Watts; Edward J.,16,0,16,0
1708256849733,HUM 2,A09,422794,Watts; Edward J.,16,0,16,0
1708256849733,HUM 2,A10,422795,Watts; Edward J.,16,0,16,0
1708256849733,HUM 2,B01,422805,Markman; Kristina,13,0,16,3
1708256849733,HUM 2,B02,422806,Markman; Kristina,14,0,16,2
1708256849733,HUM 2,B03,422807,Markman; Kristina,14,0,16,2
1708256849733,HUM 2,B04,422808,Markman; Kristina,16,0,16,0
1708256849733,HUM 2,B05,422809,Markman; Kristina,16,0,16,0
1708256849733,HUM 2,B06,422842,Markman; Kristina,16,0,16,0
1708256849733,HUM 2,B07,422843,Markman; Kristina,15,0,16,1
1708256849733,HUM 2,B08,422848,Markman; Kristina,16,0,16,0
1708256849733,HUM 2,B09,422850,Markman; Kristina,15,0,16,1
1708256849733,HUM 2,B10,422851,Markman; Kristina,12,0,16,4
1708256849733,HUM 2,B11,422852,Markman; Kristina,15,0,16,1
1708256849733,HUM 2,B12,422853,Markman; Kristina,16,0,16,0
1708256849733,HUM 2,C01,422855,Rodriguez; Bretton Sigfred,15,0,16,1
1708256849733,HUM 2,C02,422856,Rodriguez; Bretton Sigfred,16,0,16,0
1708256849733,HUM 2,C03,422859,Rodriguez; Bretton Sigfred,15,0,16,1
1708256849733,HUM 2,C04,423106,Rodriguez; Bretton Sigfred,12,0,16,4
1708256849733,HUM 2,C05,423107,Rodriguez; Bretton Sigfred,15,0,16,1
1708256849733,HUM 2,C06,423108,Rodriguez; Bretton Sigfred,14,0,16,2
1708256849733,HUM 2,C07,423109,Rodriguez; Bretton Sigfred,15,0,16,1
1708256849733,HUM 2,C08,423110,Rodriguez; Bretton Sigfred,15,0,16,1
1708256849733,HUM 2,C09,423133,Rodriguez; Bretton Sigfred,14,0,16,2
1708256849733,HUM 2,C10,423134,Rodriguez; Bretton Sigfred,14,0,16,2
1708256849733,HUM 2,C11,423135,Rodriguez; Bretton Sigfred,16,0,16,0
1708256849733,HUM 2,C12,423136,Rodriguez; Bretton Sigfred,15,0,16,1
1708256849733,HUM 2,C13,423137,Rodriguez; Bretton Sigfred,16,0,16,0
1708256849733,HUM 2,C14,423138,Rodriguez; Bretton Sigfred,16,0,16,0
1708256849733,HUM 2,D01,423140,West; Geoffrey Scott,13,0,16,3
1708256849733,HUM 2,D02,423141,West; Geoffrey Scott,15,0,16,1
1708256849733,HUM 2,D03,423142,West; Geoffrey Scott,15,0,16,1
1708256849733,HUM 2,D04,423143,West; Geoffrey Scott,14,0,16,2
1708256849733,HUM 2,D05,423144,West; Geoffrey Scott,16,0,16,0
1708256849733,HUM 2,D06,423145,West; Geoffrey Scott,16,0,16,0
1708256849733,HUM 2,D07,423146,West; Geoffrey Scott,16,0,16,0
1708256849733,HUM 2,D08,423158,West; Geoffrey Scott,16,0,16,0
1708256849733,HUM 2,D09,423169,West; Geoffrey Scott,16,0,16,0
1708256849733,HUM 2,D10,423174,West; Geoffrey Scott,16,0,16,0
1708256849733,HUM 2,D11,423175,West; Geoffrey Scott,16,0,16,0
1708256849733,HUM 2,D12,423179,West; Geoffrey Scott,15,0,16,1
1708256849733,HUM 2,D13,423188,West; Geoffrey Scott,15,0,16,1
1708256849733,HUM 2,D14,423204,West; Geoffrey Scott,16,0,16,0
1708256850275,HUM 5,A01,423221,Lyon; Antony J.,26,0,30,4
1708256850275,HUM 5,A02,423232,Lyon; Antony J.,24,0,30,6
1708256850275,HUM 5,A03,423237,Lyon; Antony J.,18,0,30,12
1708256850275,HUM 5,A04,423240,Lyon; Antony J.,25,0,30,5
1708256850275,HUM 5,A05,423242,Lyon; Antony J.,28,0,30,2
1708256850275,HUM 5,A06,423244,Lyon; Antony J.,23,0,30,7
1708256850275,HUM 5,A07,423247,Lyon; Antony J.,27,0,30,3
1708256850275,HUM 5,A08,423254,Lyon; Antony J.,27,0,30,3
1708256850275,HUM 5,B01,423286,Patterson; Patrick H.,28,0,30,2
1708256850275,HUM 5,B02,423291,Patterson; Patrick H.,29,0,30,1
1708256850275,HUM 5,B03,423294,Patterson; Patrick H.,28,0,30,2
1708256850275,HUM 5,B04,423297,Patterson; Patrick H.,29,0,30,1
1708256850275,HUM 5,B05,423313,Patterson; Patrick H.,30,0,30,0
1708256850275,HUM 5,B06,423318,Patterson; Patrick H.,30,0,30,0
1708256850275,HUM 5,B07,423362,Patterson; Patrick H.,29,0,30,1
1708256850275,HUM 5,B08,423363,Patterson; Patrick H.,29,0,30,1
1708256850275,HUM 5,C01,423365,Caldwell; Michael Alan,22,0,30,8
1708256850275,HUM 5,C02,423474,Caldwell; Michael Alan,24,0,30,6
1708256850275,HUM 5,C03,423528,Caldwell; Michael Alan,30,0,30,0
1708256850275,HUM 5,C04,423529,Caldwell; Michael Alan,27,0,30,3
1708256850275,HUM 5,C05,423545,Caldwell; Michael Alan,30,0,30,0
1708256850275,HUM 5,C06,423546,Caldwell; Michael Alan,30,0,30,0
1708256850275,HUM 5,C07,423547,Caldwell; Michael Alan,29,0,30,1
1708256850275,HUM 5,C08,423548,Caldwell; Michael Alan,28,0,30,2
1708256850799,INTL 101,A01,404350,Day; Joel Keith,23,0,25,2
1708256850799,INTL 101,A02,404356,Day; Joel Keith,25,0,25,0
1708256850799,INTL 101,A03,404357,Day; Joel Keith,24,0,25,1
1708256850799,INTL 101,A04,404360,Day; Joel Keith,25,0,25,0
1708256851330,INTL 102,A01,404375,Fisk; David Lee,25,0,25,0
1708256851330,INTL 102,A02,404376,Fisk; David Lee,22,0,25,3
1708256851330,INTL 102,A03,404377,Fisk; David Lee,20,0,25,5
1708256851330,INTL 102,A04,404381,Fisk; David Lee,25,0,25,0
1708256851858,INTL 190,A00,404396,Samphantharak; Krislert,24,0,25,1
1708256851858,INTL 190,B00,404402,McIntosh; Justin Daniel,24,0,25,1
1708256851858,INTL 190,C00,404403,Vos; Stacie N.,24,0,25,1
1708256851858,INTL 190,D00,404404,Nadkarni; Vidya,24,0,25,1
1708256851858,INTL 190,E00,404407,Scott; Jeffrey F,25,0,25,0
1708256851858,INTL 190,F00,404409,Auerbach; Bradford C,25,0,25,0
1708256851858,INTL 190,G00,404442,Auerbach; Bradford C,25,0,25,0
1708256851858,INTL 190,H00,404465,Segui; Alan S,25,0,25,0
1708256851858,INTL 190,I00,404481,Segui; Alan S,25,0,25,0
1708256853453,JAPN 10C,A01,403881,Iwamoto; Naoki,15,0,15,0
1708256853453,JAPN 10C,B01,403884,McKee; Mayumi Mochizuki,15,0,15,0
1708256853453,JAPN 10C,C01,403887,Sato; Kyoko,10,0,10,0
1708256853453,JAPN 10C,C02,403888,Sato; Kyoko,10,0,10,0
1708256853453,JAPN 10C,D01,403890,Inada; Minori,8,0,10,2
1708256853453,JAPN 10C,D02,403891,Inada; Minori,10,0,10,0
1708256853453,JAPN 10C,E01,403893,Sato; Kyoko,10,0,10,0
1708256853453,JAPN 10C,E02,403894,Sato; Kyoko,10,0,10,0
1708256853453,JAPN 10C,F01,403896,McKee; Mayumi Mochizuki,10,0,10,0
1708256853453,JAPN 10C,F02,403897,McKee; Mayumi Mochizuki,10,0,10,0
1708256853453,JAPN 10C,G01,403899,Homma; Kunihiko,10,0,10,0
1708256853453,JAPN 10C,G02,403900,Homma; Kunihiko,10,0,10,0
1708256853453,JAPN 10C,H01,403902,Maruyama; Rie,10,0,10,0
1708256853453,JAPN 10C,H02,403903,Maruyama; Rie,9,0,10,1
1708256853453,JAPN 10C,I01,403905,Inada; Minori,10,0,10,0
1708256853453,JAPN 10C,I02,403906,Inada; Minori,9,0,10,1
1708256853453,JAPN 10C,J01,403915,Iwamoto; Naoki,10,0,10,0
1708256853453,JAPN 10C,J02,403916,Iwamoto; Naoki,9,0,10,1
1708256853453,JAPN 10C,K01,403918,Ross; Kayoko F,10,0,10,0
1708256853453,JAPN 10C,K02,403928,Ross; Kayoko F,10,0,10,0
1708256853453,JAPN 10C,L01,403935,Homma; Kunihiko,9,0,10,1
1708256853453,JAPN 10C,L02,403936,Homma; Kunihiko,10,0,10,0
1708256853453,JAPN 10C,M02,403939,Kamioka; Sachiko,13,0,15,2
1708256853453,JAPN 10C,N01,479041,Iwamoto; Naoki,15,0,15,0
1708256853994,JAPN 10CR,A01,403982,Inada; Minori,12,0,12,0
1708256853994,JAPN 10CR,A02,403983,Inada; Minori,12,0,12,0
1708256854553,JAPN 20C,A01,403988,Homma; Kunihiko,10,0,12,2
1708256854553,JAPN 20C,B02,404029,Kamioka; Sachiko,10,0,12,2
1708256854553,JAPN 20C,C01,404033,Takeda; Izumi,8,0,12,4
1708256854553,JAPN 20C,D02,404114,Kamioka; Sachiko,11,0,12,1
1708256854553,JAPN 20C,E01,404135,Simpson; Junko Tokuda,12,0,12,0
1708256855080,JAPN 130C,A01,404144,Maruyama; Rie,9,0,9,0
1708256855080,JAPN 130C,A02,404145,Maruyama; Rie,9,0,9,0
1708256855080,JAPN 130C,B01,404147,Simpson; Junko Tokuda,8,0,9,1
1708256855080,JAPN 130C,B02,404148,Simpson; Junko Tokuda,9,0,9,0
1708256855609,JAPN 135C,A00,404176,Ross; Kayoko F,16,0,16,0
1708256855609,JAPN 135C,B00,404253,Takeda; Izumi,14,0,16,2
1708256856134,JAPN 140C,A00,404255,Sato; Kyoko,18,0,20,2
1708256856663,JAPN 150C,A00,404258,McKee; Mayumi Mochizuki,14,0,14,0
1708256857192,JAPN 190,A00,404260,Miyao; Daisuke,17,0,20,3
1708256857717,JAPN 196B,001,487237,Turner; Christena L.,9999,0,9999,0
1708256858245,JWSP 3,A01,404485,Shuster; Alana,20,0,20,0
1708256858770,LATI 10,A01,405201,Kennemore; Amy Michelle,27,0,30,3
1708256858770,LATI 10,A02,405202,Kennemore; Amy Michelle,27,0,30,3
1708256858770,LATI 10,A03,405208,Kennemore; Amy Michelle,28,0,30,2
1708256859310,LATI 50,A01,405214,Kokinis; Troy Andreas,34,0,35,1
1708256859310,LATI 50,A02,405215,Kokinis; Troy Andreas,34,0,35,1
1708256859838,LATI 130,A01,482880,Alvarez; Camila Huerta,29,0,30,1
1708256860363,LATI 160,A01,477482,Kokinis; Troy Andreas,30,0,30,0
1708256860889,LATI 180,A00,405221,Kennemore; Amy Michelle,28,0,30,2
1708256860889,LATI 180,B00,405222,Mostajo; Lorena,30,0,30,0
1708256861420,LIAB 1C,A00,405278,Saab; Dima,13,0,14,1
1708256861420,LIAB 1C,B00,405279,Saab; Dima,11,0,14,3
1708256861953,LIAB 1CX,A00,405281,Akjeje; Abdelhak,19,0,20,1
1708256861953,LIAB 1CX,B00,405291,Akjeje; Abdelhak,20,0,20,0
1708256862479,LIAB 1F,A00,482814,El Cheddadi; Youniss,14,0,14,0
1708256863005,LIDS 19,001,492979,Goodall; Grant Todd,9999,0,9999,0
1708256863005,LIDS 19,002,492980,Goodall; Grant Todd,9999,0,9999,0
1708256863005,LIDS 19,003,492981,Goodall; Grant Todd,9999,0,9999,0
1708256863005,LIDS 19,004,492982,Goodall; Grant Todd,9999,0,9999,0
1708256863005,LIDS 19,005,492983,Goodall; Grant Todd,9999,0,9999,0
1708256863005,LIDS 19,006,492984,Goodall; Grant Todd,9999,0,9999,0
1708256863005,LIDS 19,007,492985,Goodall; Grant Todd,9999,0,9999,0
1708256863005,LIDS 19,008,492986,Goodall; Grant Todd,9999,0,9999,0
1708256863005,LIDS 19,009,492987,Goodall; Grant Todd,9999,0,9999,0
1708256863005,LIDS 19,010,492988,Goodall; Grant Todd,9999,0,9999,0
1708256863005,LIDS 19,011,492989,Goodall; Grant Todd,9999,0,9999,0
1708256863005,LIDS 19,012,492990,Goodall; Grant Todd,9999,0,9999,0
1708256863537,LIFR 1A,A00,405299,Van Moer; Vinciane G,13,0,14,1
1708256863537,LIFR 1A,B00,405300,Van Moer; Vinciane G,13,0,14,1
1708256863537,LIFR 1A,C00,405301,Van Moer; Vinciane G,13,0,14,1
1708256863537,LIFR 1A,D00,405307,Van Moer; Vinciane G,14,0,14,0
1708256864063,LIFR 1AX,A00,405308,Van Moer; Vinciane G,27,0,28,1
1708256864063,LIFR 1AX,B00,405309,Van Moer; Vinciane G,27,0,28,1
1708256864588,LIFR 1C,A00,405310,Van Moer; Vinciane G,14,0,14,0
1708256864588,LIFR 1C,B00,405311,Van Moer; Vinciane G,12,0,14,2
1708256864588,LIFR 1C,C00,405325,Van Moer; Vinciane G,13,0,14,1
1708256864588,LIFR 1C,D00,405326,Van Moer; Vinciane G,11,0,14,3
1708256865117,LIFR 1CX,A00,405332,Van Moer; Vinciane G,25,0,28,3
1708256865117,LIFR 1CX,B00,405333,Van Moer; Vinciane G,27,0,28,1
1708256865642,LIFR 1D,A00,405334,Van Moer; Vinciane G,13,0,14,1
1708256865642,LIFR 1D,B00,405335,Van Moer; Vinciane G,13,0,14,1
1708256865642,LIFR 1D,C00,405336,Van Moer; Vinciane G,13,0,14,1
1708256865642,LIFR 1D,D00,405337,Van Moer; Vinciane G,13,0,14,1
1708256866167,LIFR 1DX,A00,405338,Van Moer; Vinciane G,25,0,28,3
1708256866167,LIFR 1DX,B00,405394,Van Moer; Vinciane G,27,0,28,1
1708256866696,LIFR 11,001,405395,Goodall; Grant Todd,999,0,999,0
1708256867221,LIGM 1C,A00,405398,Fischer-Grunski; Eva K,12,0,14,2
1708256867221,LIGM 1C,B00,405400,Fischer-Grunski; Eva K,13,0,14,1
1708256867221,LIGM 1C,C00,405403,Fischer-Grunski; Eva K,13,0,14,1
1708256867221,LIGM 1C,D00,405404,Fischer-Grunski; Eva K,13,0,14,1
1708256867750,LIGM 1CX,A00,405407,Fischer-Grunski; Eva K,27,0,28,1
1708256867750,LIGM 1CX,B00,405408,Fischer-Grunski; Eva K,26,0,28,2
1708256868274,LIGM 11,001,405464,Goodall; Grant Todd,999,0,999,0
1708256868803,LIGN 8,A00,411133,McIntosh; Justin Daniel,232,0,240,8
1708256869331,LIGN 17,A00,411141,Kehler; Andrew Scott,287,0,300,13
1708256869862,LIGN 101,A01,411144,Staff,28,0,30,2
1708256869862,LIGN 101,A02,411147,Staff,29,0,30,1
1708256869862,LIGN 101,A03,411154,Staff,27,0,30,3
1708256869862,LIGN 101,A04,411163,Staff,29,0,30,1
1708256870388,LIGN 120,A01,411165,Ackerman; Farrell,28,0,30,2
1708256870388,LIGN 120,A02,411177,Ackerman; Farrell,23,0,27,4
1708256870920,LIGN 130,A01,411223,Staff,29,0,30,1
1708256870920,LIGN 130,A02,411231,Staff,30,0,30,0
1708256870920,LIGN 130,A03,411232,Staff,29,0,30,1
1708256871446,LIGN 141,A00,411276,Rose; Sharon,37,0,40,3
1708256871972,LIGN 144,A00,411277,Lott; Margaret S.,22,0,24,2
1708256872502,LIGN 148,A00,411278,Mayberry; Rachel,71,0,75,4
1708256873032,LIGN 165,A00,411279,Bergen; Leon,41,0,70,29
1708256873557,LIGN 168,A01,411281,Styler; William Francis,65,0,70,5
1708256874099,LIGN 175,A00,482816,Rodriguez Aispuro; Alejandro,35,0,40,5
1708256874629,LIGN 230,A00,411293,Caponigro; Ivano,19,0,20,1
1708256875155,LIGN 238,A00,411308,Bergen; Benjamin,20,0,20,0
1708256875681,LIGN 252,A00,411309,Bergen; Leon,28,0,30,2
1708256876210,LIGN 256,A00,411310,Nakashole; Ndapandula,0,0,5,5
1708256876736,LIGN 272,A00,482887,Kluender; Robert,10,0,10,0
1708256877264,LIHL 112P,A00,405228,Pagkalinawan; Leticia Cant,27,0,28,1
1708256877790,LIHL 114P,A00,405229,Nguyen; Hoan Thi,26,0,28,2
1708256878316,LIHL 117P,A00,405256,Sadegholvad; Elham,27,0,28,1
1708256878844,LIHL 118,A00,405257,Chen; Areana Yen,28,0,28,0
1708256879369,LIHL 124P,A00,405262,Nguyen; Hoan Thi,28,0,28,0
1708256879898,LIHL 132P,A00,405263,Pagkalinawan; Leticia Cant,28,0,28,0
1708256880422,LIHL 134P,A00,405269,Nguyen; Hoan Thi,28,0,28,0
1708256880947,LIHL 138,A00,405270,Chen; Areana Yen,27,0,28,1
1708256881477,LIIT 1C,A00,405465,Carnelos; Chiara,12,0,14,2
1708256881477,LIIT 1C,B00,405466,Carnelos; Chiara,14,0,14,0
1708256882003,LIIT 1CX,A00,405594,Carnelos; Chiara,28,0,28,0
1708256882532,LIPO 1C,A00,405595,Paladini; Denise,13,0,14,1
1708256882532,LIPO 1C,B00,405596,Paladini; Denise,14,0,14,0
1708256883058,LIPO 1CX,A00,405597,De Abreu; Cassia,28,0,28,0
1708256883585,LISL 1A,C00,405600,Lott; Margaret S.,13,0,14,1
1708256883585,LISL 1A,D00,405601,Lott; Margaret S.,10,0,14,4
1708256883585,LISL 1A,E00,405602,Lott; Margaret S.,13,0,14,1
1708256883585,LISL 1A,F00,405603,Lott; Margaret S.,13,0,14,1
1708256884130,LISL 1AR,A00,480605,Lott; Margaret S.,13,0,15,2
1708256884130,LISL 1AR,B00,480606,Lott; Margaret S.,14,0,15,1
1708256884656,LISL 1AX,A00,405754,Lott; Margaret S.,26,0,28,2
1708256884656,LISL 1AX,B00,405755,Lott; Margaret S.,23,0,28,5
1708256885184,LISL 1C,A00,405776,Lott; Margaret S.,13,0,14,1
1708256885184,LISL 1C,B00,405779,Lott; Margaret S.,14,0,14,0
1708256885184,LISL 1C,C00,405785,Lott; Margaret S.,14,0,14,0
1708256885184,LISL 1C,D00,405787,Lott; Margaret S.,9,0,14,5
1708256885184,LISL 1C,E00,405827,Lott; Margaret S.,12,0,14,2
1708256885184,LISL 1C,F00,405830,Lott; Margaret S.,13,0,14,1
1708256885714,LISL 1CX,A00,405844,Lott; Margaret S.,25,0,28,3
1708256885714,LISL 1CX,B00,405848,Lott; Margaret S.,25,0,28,3
1708256885714,LISL 1CX,C00,405849,Lott; Margaret S.,28,0,28,0
1708256886238,LISL 1D,A00,405850,Lott; Margaret S.,8,0,14,6
1708256886238,LISL 1D,B00,405851,Lott; Margaret S.,13,0,14,1
1708256886238,LISL 1D,C00,405852,Lott; Margaret S.,10,0,14,4
1708256886767,LISL 1DX,A00,405854,Lott; Margaret S.,17,0,22,5
1708256886767,LISL 1DX,B00,405855,Lott; Margaret S.,18,0,22,4
1708256887294,LISP 1A,001,405856,Munoz Sanchez; Alicia,11,0,14,3
1708256887294,LISP 1A,002,405857,Munoz Sanchez; Alicia,13,0,14,1
1708256887294,LISP 1A,003,405858,Munoz Sanchez; Alicia,14,0,14,0
1708256887294,LISP 1A,004,405861,Munoz Sanchez; Alicia,14,0,14,0
1708256887820,LISP 1AX,001,405862,Munoz Sanchez; Alicia,28,0,28,0
1708256887820,LISP 1AX,002,405863,Munoz Sanchez; Alicia,25,0,28,3
1708256888347,LISP 1C,001,405864,Munoz Sanchez; Alicia,13,0,14,1
1708256888347,LISP 1C,002,405865,Munoz Sanchez; Alicia,12,0,14,2
1708256888347,LISP 1C,003,405879,Munoz Sanchez; Alicia,12,0,14,2
1708256888347,LISP 1C,004,405880,Munoz Sanchez; Alicia,13,0,14,1
1708256888347,LISP 1C,005,405881,Munoz Sanchez; Alicia,12,0,14,2
1708256888347,LISP 1C,006,405882,Munoz Sanchez; Alicia,12,0,14,2
1708256888347,LISP 1C,007,405904,Munoz Sanchez; Alicia,14,0,14,0
1708256888347,LISP 1C,008,405905,Munoz Sanchez; Alicia,14,0,14,0
1708256888347,LISP 1C,009,405908,Munoz Sanchez; Alicia,14,0,14,0
1708256888347,LISP 1C,010,405917,Munoz Sanchez; Alicia,13,0,14,1
1708256888876,LISP 1CX,001,405922,Munoz Sanchez; Alicia,24,0,28,4
1708256888876,LISP 1CX,002,405990,Munoz Sanchez; Alicia,26,0,28,2
1708256888876,LISP 1CX,003,406007,Munoz Sanchez; Alicia,27,0,28,1
1708256888876,LISP 1CX,004,406008,Munoz Sanchez; Alicia,25,0,28,3
1708256888876,LISP 1CX,005,406015,Munoz Sanchez; Alicia,26,0,28,2
1708256889421,LISP 1D,001,406016,Munoz Sanchez; Alicia,12,0,14,2
1708256889421,LISP 1D,002,406017,Munoz Sanchez; Alicia,13,0,14,1
1708256889421,LISP 1D,003,406018,Munoz Sanchez; Alicia,14,0,14,0
1708256889421,LISP 1D,004,406019,Munoz Sanchez; Alicia,11,0,14,3
1708256889421,LISP 1D,005,406020,Munoz Sanchez; Alicia,13,0,14,1
1708256889421,LISP 1D,006,406021,Munoz Sanchez; Alicia,10,0,14,4
1708256889421,LISP 1D,007,406022,Munoz Sanchez; Alicia,12,0,14,2
1708256889421,LISP 1D,008,406023,Munoz Sanchez; Alicia,13,0,14,1
1708256889421,LISP 1D,009,406024,Munoz Sanchez; Alicia,11,0,14,3
1708256889421,LISP 1D,010,406025,Munoz Sanchez; Alicia,12,0,14,2
1708256889421,LISP 1D,011,406026,Munoz Sanchez; Alicia,13,0,14,1
1708256889421,LISP 1D,012,406027,Munoz Sanchez; Alicia,13,0,14,1
1708256889421,LISP 1D,013,406028,Munoz Sanchez; Alicia,12,0,14,2
1708256889421,LISP 1D,014,406029,Munoz Sanchez; Alicia,12,0,14,2
1708256889421,LISP 1D,015,406030,Munoz Sanchez; Alicia,10,0,14,4
1708256889421,LISP 1D,016,406031,Munoz Sanchez; Alicia,14,0,14,0
1708256889421,LISP 1D,017,406032,Munoz Sanchez; Alicia,14,0,14,0
1708256889421,LISP 1D,018,406033,Munoz Sanchez; Alicia,12,0,14,2
1708256889421,LISP 1D,019,406034,Munoz Sanchez; Alicia,13,0,14,1
1708256889421,LISP 1D,020,406035,Munoz Sanchez; Alicia,14,0,14,0
1708256889421,LISP 1D,021,406036,Munoz Sanchez; Alicia,13,0,14,1
1708256889421,LISP 1D,022,406037,Munoz Sanchez; Alicia,14,0,14,0
1708256889421,LISP 1D,023,406038,Munoz Sanchez; Alicia,14,0,14,0
1708256889421,LISP 1D,024,406039,Munoz Sanchez; Alicia,13,0,14,1
1708256889948,LISP 1DX,001,406040,Munoz Sanchez; Alicia,28,0,28,0
1708256889948,LISP 1DX,002,406041,Munoz Sanchez; Alicia,27,0,28,1
1708256889948,LISP 1DX,003,406127,Munoz Sanchez; Alicia,24,0,28,4
1708256889948,LISP 1DX,004,406128,Munoz Sanchez; Alicia,17,0,28,11
1708256889948,LISP 1DX,005,406418,Munoz Sanchez; Alicia,24,0,28,4
1708256889948,LISP 1DX,006,406536,Munoz Sanchez; Alicia,27,0,28,1
1708256889948,LISP 1DX,007,406561,Munoz Sanchez; Alicia,23,0,28,5
1708256889948,LISP 1DX,008,406576,Munoz Sanchez; Alicia,25,0,28,3
1708256889948,LISP 1DX,009,406679,Munoz Sanchez; Alicia,28,0,28,0
1708256889948,LISP 1DX,010,406691,Munoz Sanchez; Alicia,26,0,28,2
1708256889948,LISP 1DX,011,406692,Munoz Sanchez; Alicia,28,0,28,0
1708256889948,LISP 1DX,012,406693,Munoz Sanchez; Alicia,28,0,28,0
1708256890476,LISP 17,001,406694,Munoz Sanchez; Alicia,18,0,20,2
1708256891056,LISP 18,001,406695,Munoz Sanchez; Alicia,20,0,20,0
1708256891583,LTAM 105,A00,412520,Ruiz; Ariana,28,0,40,12
1708256892111,LTCH 101,A00,479214,Zhu; Ping,39,0,40,1
1708256892638,LTCS 87,A00,492906,Nguyen; Hoang Tan,20,0,20,0
1708256892638,LTCS 87,B00,492907,Nguyen; Hoang Tan,20,0,20,0
1708256893167,LTCS 150,A00,412543,Liao; Ping H,39,0,40,1
1708256893693,LTCS 225,A00,412819,Mendoza; Andrea,14,0,15,1
1708256894218,LTCS 250,A00,412821,Lee; Jin-Kyung,15,0,15,0
1708256894746,LTEA 110B,A00,412548,Liao; Ping H,60,0,60,0
1708256895271,LTEA 120A,A00,479216,Zhu; Ping,36,0,40,4
1708256895799,LTEA 120C,A00,412552,Fiss; Geraldine Anna,295,0,300,5
1708256896325,LTEA 132,A00,412561,Mendoza; Andrea,51,0,60,9
1708256896851,LTEA 141,A00,412565,Lee; Jin-Kyung,37,0,40,3
1708256897378,LTEN 23,A01,411317,Vijay; Ameeth Varma,24,0,25,1
1708256897378,LTEN 23,A02,411318,Vijay; Ameeth Varma,24,0,25,1
1708256897378,LTEN 23,A03,411371,Vijay; Ameeth Varma,25,0,25,0
1708256897378,LTEN 23,A04,411375,Vijay; Ameeth Varma,24,0,25,1
1708256897908,LTEN 28,A01,411632,Blanco; John D,25,0,25,0
1708256897908,LTEN 28,A02,411697,Blanco; John D,25,0,25,0
1708256897908,LTEN 28,A03,411698,Blanco; John D,25,0,25,0
1708256897908,LTEN 28,A04,411709,Blanco; John D,25,0,25,0
1708256897908,LTEN 28,A05,411719,Blanco; John D,25,0,25,0
1708256897908,LTEN 28,A06,411744,Blanco; John D,25,0,25,0
1708256897908,LTEN 28,A07,411780,Blanco; John D,25,0,25,0
1708256897908,LTEN 28,A08,411820,Blanco; John D,25,0,25,0
1708256898433,LTEN 110,A00,486891,Vitkus; Daniel J.,38,0,40,2
1708256898961,LTEN 144,A00,412570,Vijay; Ameeth Varma,39,0,40,1
1708256899487,LTEN 180,A00,412581,Perreira; Christopher Michael,18,0,25,7
1708256900014,LTEN 181,A00,412582,Mukherjee; Silpa,55,0,60,5
1708256900544,LTEN 245,A00,412824,Johnson; Sara E.,13,0,15,2
1708256901071,LTEN 259,A00,412825,Streeby; Shelley,13,0,15,2
1708256901600,LTEU 111,A00,412588,Kontje; Todd Curtis,38,0,40,2
1708256902125,LTEU 140,A00,480172,De Marchi Gherini; Adriana,36,0,37,1
1708256902650,LTEU 141,A00,412592,Cohen; Alain J. J.,40,0,40,0
1708256903180,LTFR 2A,A01,411996,Ploye; Catherine,25,0,25,0
1708256903709,LTFR 2C,A00,411997,Ploye; Catherine,24,0,25,1
1708256904236,LTFR 142,A00,412597,Zhiri; Oumelbanine,20,0,20,0
1708256904761,LTGK 3,A00,412001,Murray; Kourtney Kristine,30,0,30,0
1708256905286,LTGM 2C,A00,412002,Fischer-Grunski; Eva K,25,0,25,0
1708256905819,LTKO 1C,A01,412029,Cho; Hye Jin,24,0,25,1
1708256905819,LTKO 1C,B01,412164,Cho; Hye Jin,23,0,25,2
1708256905819,LTKO 1C,C01,412168,Cho; Hye Jin,25,0,25,0
1708256905819,LTKO 1C,D01,412353,Yim; Nancy,24,0,25,1
1708256905819,LTKO 1C,E01,412372,Yim; Nancy,25,0,25,0
1708256906348,LTKO 2C,A01,412374,Yim; Nancy,21,0,25,4
1708256906873,LTKO 130P,A00,412601,Lee; Jeyseon,25,0,25,0
1708256907398,LTKO 135,A00,412606,Lee; Jeyseon,25,0,25,0
1708256907922,LTLA 3,A00,412375,Murray; Kourtney Kristine,36,0,40,4
1708256908452,LTRU 1C,A01,412491,Wells; Patricia Rebecca,24,0,25,1
1708256908977,LTRU 104A,A01,412614,Wells; Patricia Rebecca,20,0,20,0
1708256909503,LTSP 2A,A01,412493,Lampell; Toni,24,0,25,1
1708256910035,LTSP 2B,A01,412497,Lampell; Toni,22,0,25,3
1708256910035,LTSP 2B,B01,479218,Lampell; Toni,24,0,25,1
1708256910565,LTSP 2C,A01,412499,Mastromartino; Alexandra L,23,0,25,2
1708256911090,LTSP 2D,A00,412500,Dominguez; Noelia,24,0,25,1
1708256911619,LTSP 2E,A00,412501,Mastromartino; Alexandra L,24,0,25,1
1708256911619,LTSP 2E,B00,412502,Mastromartino; Alexandra L,25,0,25,0
1708256912144,LTSP 87,A00,479212,Bessett; Ryan Matthew,20,0,20,0
1708256912673,LTSP 100B,A00,412619,Dominguez; Noelia,25,0,25,0
1708256912673,LTSP 100B,B00,412623,Dominguez; Noelia,24,0,25,1
1708256913202,LTSP 116,A00,412628,Blanco; John D,28,0,30,2
1708256913730,LTSP 135A,A00,412631,Parra; Max,27,0,30,3
1708256914256,LTSP 174,A00,479213,Staff,28,0,30,2
1708256914782,LTTH 115,A00,412632,Kontje; Todd Curtis,35,0,40,5
1708256915311,LTTH 210C,A00,412826,Batarseh; Amanda Alicia,14,0,15,1
1708256915838,LTTH 255,A00,412827,Ali; Mohammad Kazim,13,0,15,2
1708256916368,LTTH 260,A00,412828,Kim; Joo Ok,30,0,30,0
1708256916899,LTWL 19C,A00,412503,Kelting; Edward William,40,0,40,0
1708256917425,LTWL 101,A00,412633,Kelting; Edward William,39,0,40,1
1708256917950,LTWL 114,A00,412656,Fiss; Geraldine Anna,60,0,60,0
1708256918489,LTWL 123,A00,412674,Lampert-Weissig; Lisa,31,0,40,9
1708256919016,LTWL 172,A00,412729,De Marchi Gherini; Adriana,37,0,40,3
1708256919543,LTWL 183,A00,412731,Cohen; Alain J. J.,38,0,40,2
1708256920073,LTWL 184,A00,479219,Mukherjee; Silpa,38,0,40,2
1708256920600,LTWL 194A,A00,489635,Vijay; Ameeth Varma,27,0,31,4
1708256921133,LTWR 8A,A01,412505,Springer; Anna Joy,24,0,25,1
1708256921133,LTWR 8A,A02,412506,Springer; Anna Joy,24,0,25,1
1708256921133,LTWR 8A,A03,412507,Springer; Anna Joy,25,0,25,0
1708256921133,LTWR 8A,A04,412508,Springer; Anna Joy,23,0,25,2
1708256921659,LTWR 8C,A01,412511,Forbes; Camille,23,0,25,2
1708256921659,LTWR 8C,A02,412512,Forbes; Camille,25,0,25,0
1708256921659,LTWR 8C,A03,412514,Forbes; Camille,25,0,25,0
1708256921659,LTWR 8C,A04,412519,Forbes; Camille,24,0,25,1
1708256922188,LTWR 100,A00,412734,Forbes; Camille,7,0,15,8
1708256922716,LTWR 113,A00,412816,Carroll; Amy Sara,28,0,30,2
1708256923245,LTWR 114,A00,412817,Springer; Anna Joy,23,0,30,7
1708256923771,LTWR 126,A00,412818,Hoang; Lily Kim,25,0,30,5
1708256924297,LTWR 215,A00,412880,Carroll; Amy Sara,19,0,20,1
1708256924836,MAE 3,A01,435606,Qi; Huihui,16,0,20,4
1708256924836,MAE 3,A02,435607,Qi; Huihui,15,0,20,5
1708256924836,MAE 3,A03,435608,Qi; Huihui,19,0,20,1
1708256924836,MAE 3,B01,435618,Delson; Nathan Joseph & Mullin; Jennifer S,20,0,20,0
1708256924836,MAE 3,B02,435626,Delson; Nathan Joseph & Mullin; Jennifer S,20,0,20,0
1708256924836,MAE 3,B03,435666,Delson; Nathan Joseph & Mullin; Jennifer S,20,0,20,0
1708256924836,MAE 3,B04,435679,Delson; Nathan Joseph & Mullin; Jennifer S,20,0,20,0
1708256924836,MAE 3,B05,494545,Delson; Nathan Joseph & Mullin; Jennifer S,20,0,20,0
1708256925363,MAE 8,A01,435688,Pham; Hieu Tan,197,0,200,3
1708256925893,MAE 30B,A00,435689,Lubarda; Marko,128,0,130,2
1708256925893,MAE 30B,B00,435701,Ghazinejad; Maziar,117,0,130,13
1708256926420,MAE 101B,A00,435702,Saintillan; David,146,0,150,4
1708256926420,MAE 101B,B00,435703,Nomura; Keiko K.,138,0,146,8
1708256926945,MAE 101C,A00,435704,Sadeghizadeh; Zahra,53,0,65,12
1708256927474,MAE 101D,A00,435705,Chen; Renkun,14,0,20,6
1708256928000,MAE 105,A00,435706,Becker; Janet Maria,115,0,120,5
1708256928527,MAE 107,A00,435707,Lindsey; Stephanie,48,0,50,2
1708256928527,MAE 107,B00,435708,Davidson; Michael R,55,0,60,5
1708256929057,MAE 119,A00,435710,Hidalgo-Gonzalez; Patricia,100,0,120,20
1708256929583,MAE 120,A00,435722,Arefiev; Alexey,49,0,65,16
1708256930112,MAE 125,A00,435723,Kleissl; Jan,60,0,65,5
1708256930640,MAE 131A,A00,435724,Qi; Huihui,119,0,125,6
1708256930640,MAE 131A,B00,435725,Meyers; Marc,123,0,125,2
1708256931166,MAE 143B,A00,435726,Morimoto; Tania,114,0,120,6
1708256931166,MAE 143B,B00,435727,Herbert; Sylvia Lee,117,0,120,3
1708256931166,MAE 143B,C00,435728,Diagne; Mamadou Lamine,107,0,120,13
1708256931696,MAE 145,A00,435729,Martinez; Sonia,41,0,60,19
1708256932222,MAE 148,A01,492802,Silberman; Jack,14,0,24,10
1708256932748,MAE 150,A00,435730,Pham; Hieu Tan,51,0,60,9
1708256933275,MAE 152,A00,435731,Llewellyn Smith; Stefan G.,14,0,14,0
1708256933275,MAE 152,B00,435747,Llewellyn Smith; Stefan G.,12,0,14,2
1708256933275,MAE 152,C00,435748,Llewellyn Smith; Stefan G.,12,0,14,2
1708256933275,MAE 152,D00,435749,Llewellyn Smith; Stefan G.,8,0,14,6
1708256933275,MAE 152,E00,435750,Llewellyn Smith; Stefan G.,13,0,14,1
1708256933808,MAE 155B,A01,435752,Hwang; John T,36,0,50,14
1708256933808,MAE 155B,B01,435768,Anderson; Mark Ronald,27,0,50,23
1708256933808,MAE 155B,C01,494006,Saha; Abhishek,0,0,0,0
1708256934338,MAE 156B,A01,435770,Tustaniwskyj; Jerry I,32,0,40,8
1708256934338,MAE 156B,B01,435772,Ghazinejad; Maziar,35,0,40,5
1708256934338,MAE 156B,C01,435774,Delson; Nathan Joseph,38,0,40,2
1708256934338,MAE 156B,D01,435776,Saha; Abhishek,31,0,40,9
1708256934867,MAE 166,A00,435777,Fullerton; Eric E,44,0,50,6
1708256935397,MAE 170,A01,435779,Lubarda; Marko,30,0,32,2
1708256935397,MAE 170,A02,435780,Lubarda; Marko,27,0,32,5
1708256935397,MAE 170,A03,435781,Lubarda; Marko,32,0,32,0
1708256935397,MAE 170,A04,435782,Lubarda; Marko,31,0,32,1
1708256935397,MAE 170,A05,435783,Lubarda; Marko,29,0,32,3
1708256935397,MAE 170,A06,435784,Lubarda; Marko,30,0,32,2
1708256935397,MAE 170,B01,435786,Evdokimenko; Ekaterina,23,0,24,1
1708256935397,MAE 170,B02,435787,Evdokimenko; Ekaterina,20,0,24,4
1708256935397,MAE 170,B03,435788,Evdokimenko; Ekaterina,23,0,24,1
1708256935397,MAE 170,B04,435789,Evdokimenko; Ekaterina,23,0,24,1
1708256935397,MAE 170,B05,435790,Evdokimenko; Ekaterina,19,0,24,5
1708256935397,MAE 170,B06,435791,Evdokimenko; Ekaterina,23,0,24,1
1708256935925,MAE 180,A00,479477,Sadeghizadeh; Zahra,55,0,60,5
1708256936455,MAE 184,A00,435792,Anderson; Mark Ronald,6,0,50,44
1708256936988,MAE 190,A00,435793,Beg; Farhat N.,17,0,20,3
1708256936988,MAE 190,B00,479209,Gerardo; Hortense Flotilde,12,0,15,3
1708256937513,MAE 202,A00,435794,Bandaru; Prabhakar,32,0,70,38
1708256938045,MAE 205,A00,435804,Hwang; John T & Tynan; George Robert & Seshadri; Kalyanasundaram & Rangamani; Padmini & Bandaru; Prabhakar,9990,0,9999,9
1708256938572,MAE 207,A00,435805,Beg; Farhat N.,9,0,10,1
1708256938572,MAE 207,B00,435815,Campbell; Edward Michael,6,0,10,4
1708256938572,MAE 207,C00,477499,Gerardo; Hortense Flotilde,6,0,30,24
1708256939098,MAE 209,A00,435816,Scholtes Acevedo; Claire,25,0,30,5
1708256939624,MAE 210C,A00,435817,Becker; Janet Maria,22,0,30,8
1708256940153,MAE 211,A00,435818,Seshadri; Kalyanasundaram,20,0,30,10
1708256940678,MAE 214A,A00,435819,Sarkar; Sutanu,27,0,35,8
1708256941205,MAE 217C,A00,435820,Marinoni; Alessandro,10,0,10,0
1708256941734,MAE 221C,A00,435821,Seshadri; Kalyanasundaram,9,0,15,6
1708256942260,MAE 221D,A00,435822,Poulikakos; Lisa Voula,23,0,30,7
1708256942786,MAE 224A,A00,435823,Pawlak; Geno Ronald,5,0,10,5
1708256943315,MAE 227,A00,435824,Hidalgo-Gonzalez; Patricia,21,0,35,14
1708256943843,MAE 231A,A00,435825,Boechler; Nicholas Sebastia,14,0,30,16
1708256944428,MAE 240,A00,435826,Rosengren; Aaron,19,0,30,11
1708256944959,MAE 242,A00,435827,Martinez; Sonia,0,0,45,45
1708256945488,MAE 249,A00,435842,Tolley; Michael Thomas,0,0,35,35
1708256946014,MAE 253,A00,435891,Staff,24,0,25,1
1708256946541,MAE 256,A00,435949,Coimbra; Carlos F.,6,0,10,4
1708256947068,MAE 263,A00,435987,Rangamani; Padmini,10,0,10,0
1708256947593,MAE 266,A00,435988,Evdokimenko; Ekaterina,7,0,30,23
1708256948122,MAE 271C,A00,435990,Arzt; Eduard,10,0,10,0
1708256948648,MAE 281B,A00,435991,Cortes; Jorge,9,0,25,16
1708256949178,MAE 288A,A00,435998,McEneaney; William Michael,6,0,40,34
1708256949704,MAE 288B,A00,435999,Bitmead; Robert R.,41,0,45,4
1708256950233,MAE 290C,A00,436008,Schmidt; Oliver,26,0,30,4
1708256950758,MAE 294C,A01,436010,Young; William Roy,19,0,20,1
1708256951283,MATH 2,A01,431271,Staff,31,0,35,4
1708256951283,MATH 2,B01,431273,Staff,29,0,35,6
1708256951283,MATH 2,C01,431275,Staff,31,0,35,4
1708256951810,MATH 3C,A01,431277,Safii; Soheil,12,0,15,3
1708256951810,MATH 3C,A02,431278,Safii; Soheil,12,0,15,3
1708256951810,MATH 3C,A03,431279,Safii; Soheil,12,0,15,3
1708256951810,MATH 3C,A04,431280,Safii; Soheil,15,0,15,0
1708256951810,MATH 3C,A05,431281,Safii; Soheil,14,0,15,1
1708256951810,MATH 3C,A06,431282,Safii; Soheil,15,0,15,0
1708256952338,MATH 10A,A01,431284,Bowers; Adam R.,20,0,30,10
1708256952338,MATH 10A,A02,431285,Bowers; Adam R.,18,0,30,12
1708256952338,MATH 10A,A03,431369,Bowers; Adam R.,28,0,30,2
1708256952338,MATH 10A,A04,431395,Bowers; Adam R.,27,0,30,3
1708256952338,MATH 10A,A05,431450,Bowers; Adam R.,28,0,30,2
1708256952338,MATH 10A,A06,431508,Bowers; Adam R.,30,0,30,0
1708256952338,MATH 10A,B01,431572,Kowalenko; Ethan J,24,0,30,6
1708256952338,MATH 10A,B02,431573,Kowalenko; Ethan J,29,0,30,1
1708256952338,MATH 10A,B03,431574,Kowalenko; Ethan J,30,0,30,0
1708256952338,MATH 10A,B04,431576,Kowalenko; Ethan J,30,0,30,0
1708256952338,MATH 10A,B05,431577,Kowalenko; Ethan J,30,0,30,0
1708256952338,MATH 10A,B06,431583,Kowalenko; Ethan J,30,0,30,0
1708256952877,MATH 10B,A01,431595,Habib; Yousaf,29,0,36,7
1708256952877,MATH 10B,A02,431597,Habib; Yousaf,35,0,36,1
1708256952877,MATH 10B,A03,431669,Habib; Yousaf,37,0,37,0
1708256952877,MATH 10B,A04,431670,Habib; Yousaf,36,0,37,1
1708256952877,MATH 10B,A05,431671,Habib; Yousaf,70,0,70,0
1708256952877,MATH 10B,B01,431673,Habib; Yousaf,25,0,33,8
1708256952877,MATH 10B,B02,431712,Habib; Yousaf,33,0,33,0
1708256952877,MATH 10B,B03,431713,Habib; Yousaf,33,0,33,0
1708256952877,MATH 10B,B04,431714,Habib; Yousaf,33,0,33,0
1708256952877,MATH 10B,B05,431715,Habib; Yousaf,60,0,60,0
1708256952877,MATH 10B,C01,431717,Bach; Quang Tran,57,0,60,3
1708256952877,MATH 10B,C02,431718,Bach; Quang Tran,18,0,34,16
1708256952877,MATH 10B,C03,431719,Bach; Quang Tran,34,0,34,0
1708256952877,MATH 10B,C04,431720,Bach; Quang Tran,33,0,34,1
1708256952877,MATH 10B,C05,431721,Bach; Quang Tran,32,0,34,2
1708256952877,MATH 10B,D01,431723,Staff,28,0,34,6
1708256952877,MATH 10B,D02,431724,Staff,34,0,34,0
1708256952877,MATH 10B,D03,431725,Staff,34,0,34,0
1708256952877,MATH 10B,D04,431726,Staff,34,0,34,0
1708256952877,MATH 10B,D05,431727,Staff,57,0,60,3
1708256953404,MATH 10C,A01,431741,Staff,94,0,96,2
1708256953404,MATH 10C,A02,431742,Staff,39,0,40,1
1708256953404,MATH 10C,B01,431744,Staff,95,0,96,1
1708256953404,MATH 10C,B02,431746,Staff,27,0,40,13
1708256953404,MATH 10C,C01,431748,Pardo Guerra; Sebastian,30,0,40,10
1708256953404,MATH 10C,C02,431885,Pardo Guerra; Sebastian,40,0,40,0
1708256953404,MATH 10C,C03,431895,Pardo Guerra; Sebastian,32,0,33,1
1708256953404,MATH 10C,C04,431896,Pardo Guerra; Sebastian,32,0,32,0
1708256953932,MATH 11,A01,431933,Rava; Denise,82,0,100,18
1708256953932,MATH 11,A02,431960,Rava; Denise,66,0,70,4
1708256953932,MATH 11,A03,431971,Rava; Denise,39,0,40,1
1708256953932,MATH 11,B01,432053,Staff,99,0,100,1
1708256953932,MATH 11,B02,432064,Staff,37,0,45,8
1708256953932,MATH 11,B03,432073,Staff,44,0,45,1
1708256954461,MATH 18,A01,432082,Mackall; Eoin Travis,65,0,70,5
1708256954461,MATH 18,A02,432086,Mackall; Eoin Travis,68,0,70,2
1708256954461,MATH 18,B01,432089,Suk; Andrew Hoon,39,0,40,1
1708256954461,MATH 18,B02,432090,Suk; Andrew Hoon,35,0,40,5
1708256954461,MATH 18,B03,432091,Suk; Andrew Hoon,33,0,40,7
1708256954461,MATH 18,B04,432092,Suk; Andrew Hoon,30,0,40,10
1708256954461,MATH 18,B05,432093,Suk; Andrew Hoon,34,0,35,1
1708256954461,MATH 18,B06,432094,Suk; Andrew Hoon,33,0,35,2
1708256954461,MATH 18,B07,432095,Suk; Andrew Hoon,98,0,100,2
1708256954461,MATH 18,B08,432096,Suk; Andrew Hoon,100,0,100,0
1708256954461,MATH 18,B09,432097,Suk; Andrew Hoon,98,0,100,2
1708256954461,MATH 18,B10,432098,Suk; Andrew Hoon,69,0,70,1
1708256954994,MATH 20A,A01,432101,Briones; Jor-el Thomas Caparas,30,0,40,10
1708256954994,MATH 20A,A02,432102,Briones; Jor-el Thomas Caparas,98,0,100,2
1708256954994,MATH 20A,B01,432104,Briones; Jor-el Thomas Caparas,99,0,100,1
1708256954994,MATH 20A,B02,432105,Briones; Jor-el Thomas Caparas,40,0,40,0
1708256955521,MATH 20B,A01,432107,Quarfoot; David James,33,0,35,2
1708256955521,MATH 20B,A02,432108,Quarfoot; David James,18,0,35,17
1708256955521,MATH 20B,A03,432109,Quarfoot; David James,32,0,35,3
1708256955521,MATH 20B,A04,432110,Quarfoot; David James,34,0,35,1
1708256955521,MATH 20B,A05,432331,Quarfoot; David James,26,0,32,6
1708256955521,MATH 20B,A06,432411,Quarfoot; David James,31,0,32,1
1708256955521,MATH 20B,B01,432413,Mackall; Eoin Travis,62,0,65,3
1708256955521,MATH 20B,B02,432443,Mackall; Eoin Travis,65,0,65,0
1708256955521,MATH 20B,B03,432444,Mackall; Eoin Travis,60,0,60,0
1708256955521,MATH 20B,B04,432471,Mackall; Eoin Travis,60,0,60,0
1708256956050,MATH 20C,A01,432473,Ohm; Ko Woon,26,0,38,12
1708256956050,MATH 20C,A02,432474,Ohm; Ko Woon,36,0,38,2
1708256956050,MATH 20C,A03,432475,Ohm; Ko Woon,34,0,37,3
1708256956050,MATH 20C,A04,432546,Ohm; Ko Woon,36,0,37,1
1708256956050,MATH 20C,A05,432550,Ohm; Ko Woon,88,0,90,2
1708256956050,MATH 20C,B01,432568,Ohm; Ko Woon,43,0,45,2
1708256956050,MATH 20C,B02,432594,Ohm; Ko Woon,40,0,45,5
1708256956050,MATH 20C,B03,432609,Ohm; Ko Woon,85,0,90,5
1708256956050,MATH 20C,C01,432613,Cheng; Hsiao-Bing,67,0,70,3
1708256956050,MATH 20C,C02,432614,Cheng; Hsiao-Bing,68,0,70,2
1708256956050,MATH 20C,C03,432615,Cheng; Hsiao-Bing,70,0,70,0
1708256956050,MATH 20C,D01,432617,Cheng; Hsiao-Bing,69,0,70,1
1708256956050,MATH 20C,D02,432618,Cheng; Hsiao-Bing,68,0,70,2
1708256956050,MATH 20C,D03,432619,Cheng; Hsiao-Bing,70,0,70,0
1708256956585,MATH 20D,A01,432622,Hammock; Frances H,58,0,60,2
1708256956585,MATH 20D,A02,432623,Hammock; Frances H,58,0,60,2
1708256956585,MATH 20D,A03,432658,Hammock; Frances H,35,0,35,0
1708256956585,MATH 20D,A04,432660,Hammock; Frances H,35,0,35,0
1708256956585,MATH 20D,B01,432702,Hammock; Frances H,66,0,70,4
1708256956585,MATH 20D,B02,432703,Hammock; Frances H,70,0,70,0
1708256956585,MATH 20D,B03,432766,Hammock; Frances H,30,0,30,0
1708256956585,MATH 20D,B04,432782,Hammock; Frances H,20,0,30,10
1708256956585,MATH 20D,C01,432811,Sheng; Hongyi,60,0,60,0
1708256956585,MATH 20D,C02,432931,Sheng; Hongyi,60,0,60,0
1708256956585,MATH 20D,C03,432945,Sheng; Hongyi,27,0,30,3
1708256956585,MATH 20D,C04,432949,Sheng; Hongyi,30,0,30,0
1708256957113,MATH 20E,A01,433007,Eggers; John Dietrich,70,0,80,10
1708256957113,MATH 20E,A02,433070,Eggers; John Dietrich,77,0,80,3
1708256957113,MATH 20E,A03,433079,Eggers; John Dietrich,32,0,35,3
1708256957113,MATH 20E,B01,433092,Staff,86,0,90,4
1708256957113,MATH 20E,B02,433093,Staff,90,0,90,0
1708256957113,MATH 20E,C01,433237,Bach; Quang Tran,52,0,60,8
1708256957113,MATH 20E,C02,433238,Bach; Quang Tran,69,0,70,1
1708256957113,MATH 20E,C03,433239,Bach; Quang Tran,70,0,70,0
1708256957643,MATH 31CH,A01,433241,Rabin; Jeffrey Mark,35,0,35,0
1708256958168,MATH 95,A00,433242,Stevens; Laura Jeanne,30,0,30,0
1708256958696,MATH 100C,A01,433244,Pollack; Aaron,31,0,35,4
1708256958696,MATH 100C,A02,433245,Pollack; Aaron,35,0,35,0
1708256959228,MATH 102,A01,433298,Ophir; Amit,29,0,30,1
1708256959228,MATH 102,A02,433369,Ophir; Amit,30,0,30,0
1708256959228,MATH 102,A03,433373,Ophir; Amit,30,0,30,0
1708256959228,MATH 102,A04,433374,Ophir; Amit,29,0,30,1
1708256959228,MATH 102,B01,433572,Zhang; Ming,28,0,30,2
1708256959228,MATH 102,B02,433732,Zhang; Ming,30,0,30,0
1708256959228,MATH 102,B03,433733,Zhang; Ming,30,0,30,0
1708256959228,MATH 102,B04,433734,Zhang; Ming,29,0,30,1
1708256959754,MATH 103B,A01,433793,Lu; Yunze,23,0,30,7
1708256959754,MATH 103B,A02,433795,Lu; Yunze,30,0,30,0
1708256959754,MATH 103B,A03,433830,Lu; Yunze,28,0,30,2
1708256959754,MATH 103B,B01,433845,Lahiri; Aranya,24,0,30,6
1708256959754,MATH 103B,B02,433846,Lahiri; Aranya,28,0,30,2
1708256959754,MATH 103B,B03,433847,Lahiri; Aranya,27,0,30,3
1708256960290,MATH 109,A01,433849,Aycock; Jon Merrill,6,0,10,4
1708256960290,MATH 109,A02,433850,Aycock; Jon Merrill,9,0,10,1
1708256960290,MATH 109,B01,433852,Klevdal; Christian Sleek,10,0,10,0
1708256960290,MATH 109,B02,433859,Klevdal; Christian Sleek,10,0,10,0
1708256960290,MATH 109,C01,433861,Treuer; John N,5,0,10,5
1708256960290,MATH 109,C02,433862,Treuer; John N,10,0,10,0
1708256960290,MATH 109,D01,433864,Treuer; John N,8,0,10,2
1708256960290,MATH 109,D02,433865,Treuer; John N,8,0,10,2
1708256960290,MATH 109,E01,433868,Sheng; Hongyi,10,0,10,0
1708256960290,MATH 109,E02,433869,Sheng; Hongyi,19,0,20,1
1708256960816,MATH 110,A01,433871,Pillai; Mohandas K,24,0,35,11
1708256960816,MATH 110,A02,433872,Pillai; Mohandas K,33,0,35,2
1708256961344,MATH 112B,A01,480683,Komarova; Natalia,27,0,27,0
1708256961875,MATH 120B,A01,433885,Xiao; Ming,32,0,35,3
1708256961875,MATH 120B,A02,433886,Xiao; Ming,34,0,35,1
1708256962402,MATH 121B,A01,433888,Stevens; Laura Jeanne,29,0,30,1
1708256962932,MATH 140B,A01,433890,Seward; Brandon M.,31,0,35,4
1708256962932,MATH 140B,A02,433891,Seward; Brandon M.,35,0,35,0
1708256963458,MATH 140C,A01,433895,Spolaor; Luca,32,0,35,3
1708256963458,MATH 140C,A02,433896,Spolaor; Luca,35,0,35,0
1708256963991,MATH 142B,A01,433966,Eggers; John Dietrich,25,0,35,10
1708256963991,MATH 142B,A02,434063,Eggers; John Dietrich,32,0,35,3
1708256963991,MATH 142B,B01,434071,Sanchez; Anthony,32,0,35,3
1708256963991,MATH 142B,B02,434083,Sanchez; Anthony,34,0,35,1
1708256963991,MATH 142B,C01,434094,Kunnawalkam Elayavalli; Sr,31,0,35,4
1708256963991,MATH 142B,C02,434095,Kunnawalkam Elayavalli; Sr,34,0,35,1
1708256964517,MATH 144,A01,434097,Cloninger; Alexander,30,0,30,0
1708256965045,MATH 150B,A01,434104,Parise; Davide,33,0,35,2
1708256965574,MATH 152,A01,434107,Grier; Daniel T,20,0,40,20
1708256966106,MATH 154,A01,434109,Wesley; William J,31,0,35,4
1708256966106,MATH 154,A02,434119,Wesley; William J,35,0,35,0
1708256966106,MATH 154,A03,434120,Wesley; William J,35,0,35,0
1708256966106,MATH 154,A04,434121,Wesley; William J,34,0,35,1
1708256966106,MATH 154,B01,434126,Aliabadi Sr.; Mohsen,26,0,35,9
1708256966106,MATH 154,B02,434127,Aliabadi Sr.; Mohsen,34,0,35,1
1708256966106,MATH 154,B03,434138,Aliabadi Sr.; Mohsen,35,0,35,0
1708256966106,MATH 154,B04,434139,Aliabadi Sr.; Mohsen,35,0,35,0
1708256966631,MATH 163,A01,434144,Bowers; Adam R.,0,0,5,5
1708256967160,MATH 170A,A01,434148,Nag; Panchali,36,0,36,0
1708256967160,MATH 170A,A02,434149,Nag; Panchali,36,0,36,0
1708256967160,MATH 170A,A03,434150,Nag; Panchali,36,0,37,1
1708256967160,MATH 170A,A04,434151,Nag; Panchali,36,0,36,0
1708256967687,MATH 170B,A01,434155,Huang; Lei,31,0,35,4
1708256967687,MATH 170B,A02,434160,Huang; Lei,35,0,35,0
1708256967687,MATH 170B,A03,434161,Huang; Lei,35,0,35,0
1708256967687,MATH 170B,A04,434162,Huang; Lei,35,0,35,0
1708256968212,MATH 170C,A01,434176,Leok; Melvin,30,0,35,5
1708256968212,MATH 170C,A02,434300,Leok; Melvin,34,0,35,1
1708256968743,MATH 171B,A01,434576,Nie; Jiawang,24,0,35,11
1708256968743,MATH 171B,A02,434583,Nie; Jiawang,35,0,35,0
1708256968743,MATH 171B,A03,434584,Nie; Jiawang,35,0,35,0
1708256968743,MATH 171B,A04,434609,Nie; Jiawang,35,0,35,0
1708256969270,MATH 180A,A01,434638,Gartland; Christopher John,29,0,30,1
1708256969270,MATH 180A,A02,434821,Gartland; Christopher John,28,0,30,2
1708256969270,MATH 180A,A03,434833,Gartland; Christopher John,24,0,30,6
1708256969270,MATH 180A,A04,434839,Gartland; Christopher John,30,0,30,0
1708256969270,MATH 180A,A05,434843,Gartland; Christopher John,30,0,30,0
1708256969270,MATH 180A,A06,434895,Gartland; Christopher John,30,0,30,0
1708256969798,MATH 180B,A01,435085,Gartland; Christopher John,30,0,35,5
1708256969798,MATH 180B,A02,435086,Gartland; Christopher John,35,0,35,0
1708256969798,MATH 180B,A03,435087,Gartland; Christopher John,34,0,35,1
1708256969798,MATH 180B,A04,435088,Gartland; Christopher John,35,0,35,0
1708256970323,MATH 180C,A01,435090,Carfagnini; Marco,29,0,35,6
1708256970323,MATH 180C,A02,435091,Carfagnini; Marco,35,0,35,0
1708256970323,MATH 180C,A03,435092,Carfagnini; Marco,32,0,35,3
1708256970323,MATH 180C,A04,435113,Carfagnini; Marco,35,0,35,0
1708256970852,MATH 181A,A01,435279,Zhang; Danna,30,0,35,5
1708256970852,MATH 181A,A02,435300,Zhang; Danna,35,0,35,0
1708256970852,MATH 181A,A03,435301,Zhang; Danna,21,0,35,14
1708256970852,MATH 181A,A04,435302,Zhang; Danna,31,0,35,4
1708256971378,MATH 181B,A01,435315,Rava; Denise,33,0,35,2
1708256971378,MATH 181B,A02,435316,Rava; Denise,32,0,35,3
1708256971378,MATH 181B,A03,435317,Rava; Denise,33,0,35,2
1708256971378,MATH 181B,A04,435318,Rava; Denise,35,0,35,0
1708256971909,MATH 183,A01,435320,Quarfoot; David James,26,0,35,9
1708256971909,MATH 183,A02,435321,Quarfoot; David James,35,0,35,0
1708256971909,MATH 183,A03,435322,Quarfoot; David James,32,0,35,3
1708256971909,MATH 183,A04,435323,Quarfoot; David James,34,0,35,1
1708256971909,MATH 183,A05,435327,Quarfoot; David James,34,0,35,1
1708256971909,MATH 183,A06,435329,Quarfoot; David James,33,0,35,2
1708256972435,MATH 184,A01,435337,Verstraete; Jacques Allan,32,0,35,3
1708256972435,MATH 184,A02,435338,Verstraete; Jacques Allan,35,0,35,0
1708256972435,MATH 184,A03,435339,Verstraete; Jacques Allan,34,0,35,1
1708256972435,MATH 184,A04,435347,Verstraete; Jacques Allan,30,0,35,5
1708256972962,MATH 185,A01,435432,Arias-Castro; Ery,15,0,30,15
1708256972962,MATH 185,A02,435436,Arias-Castro; Ery,30,0,30,0
1708256972962,MATH 185,A03,435437,Arias-Castro; Ery,30,0,30,0
1708256972962,MATH 185,A04,435438,Arias-Castro; Ery,30,0,30,0
1708256973492,MATH 187A,A01,435443,Agrawal; Shishir,15,0,30,15
1708256973492,MATH 187A,A02,435444,Agrawal; Shishir,30,0,30,0
1708256973492,MATH 187A,A03,435503,Agrawal; Shishir,28,0,30,2
1708256973492,MATH 187A,A04,435507,Agrawal; Shishir,30,0,30,0
1708256973492,MATH 187A,A05,435554,Agrawal; Shishir,22,0,30,8
1708256973492,MATH 187A,A06,435558,Agrawal; Shishir,28,0,30,2
1708256974023,MATH 187B,A01,435570,Bucur; Alina Ioana,24,0,35,11
1708256974023,MATH 187B,A02,435571,Bucur; Alina Ioana,35,0,35,0
1708256974551,MATH 188,A01,435573,Kunnawalkam Elayavalli; Sr,35,0,35,0
1708256975077,MATH 189,A01,435577,Vishwanath; Siddharth,0,0,10,10
1708256975077,MATH 189,A02,435594,Vishwanath; Siddharth,0,0,10,10
1708256975077,MATH 189,A03,435595,Vishwanath; Siddharth,0,0,10,10
1708256975077,MATH 189,A04,435596,Vishwanath; Siddharth,0,0,10,10
1708256975077,MATH 189,A05,480706,Vishwanath; Siddharth,2,0,10,8
1708256975077,MATH 189,A06,481362,Vishwanath; Siddharth,6,0,10,4
1708256975611,MATH 200C,A00,430388,Bucur; Alina Ioana,15,0,15,0
1708256976140,MATH 202C,A00,430389,Rhoades; Brendon Patrick,15,0,15,0
1708256976666,MATH 203C,A00,430390,Izadi; Elham,15,0,15,0
1708256977195,MATH 204C,A00,430391,Sorensen; Claus M,15,0,15,0
1708256977721,MATH 208,A00,430392,Izadi; Elham,8,0,10,2
1708256978249,MATH 209,A00,430393,Pollack; Aaron,10,0,10,0
1708256978777,MATH 211A,A00,430394,Salehi Golsefidy; Alireza,10,0,10,0
1708256979303,MATH 211B,A00,430395,Seward; Brandon M.,10,0,10,0
1708256979830,MATH 212B,A01,480692,Komarova; Natalia,5,0,5,0
1708256980358,MATH 216C,A00,430429,Saab; Rayan,13,0,15,2
1708256980885,MATH 217,A00,430430,Li; Bo,13,0,15,2
1708256981415,MATH 218,A00,430431,Li; Bo,8,0,10,2
1708256981941,MATH 220C,A00,430432,Xiao; Ming,15,0,15,0
1708256982466,MATH 240C,A00,430433,Ebenfelt; Peter F,14,0,15,1
1708256982995,MATH 241B,A00,430434,Ioana; Adrian,14,0,15,1
1708256983520,MATH 243,A00,430435,Kunnawalkam Elayavalli; Sr,9,0,10,1
1708256984049,MATH 248,A00,430436,Bejenaru; Ioan,9,0,10,1
1708256984578,MATH 251C,A00,430437,Wenzl; Hans G,15,0,15,0
1708256985103,MATH 258,A00,430438,Spolaor; Luca,10,0,10,0
1708256985631,MATH 261C,A00,430439,Manners; Frederick,14,0,15,1
1708256986157,MATH 262A,A00,430440,Warnke; Lutz Peter,14,0,15,1
1708256986682,MATH 268,A00,430441,Buss; Samuel R,10,0,10,0
1708256987222,MATH 269,A00,430442,Rhoades; Brendon Patrick & Warnke; Lutz Peter,10,0,10,0
1708256987748,MATH 270C,A00,430445,Cheng; Li-Tien,15,0,15,0
1708256988274,MATH 273B,A00,430452,Zhu; Yuhua,15,0,15,0
1708256988799,MATH 276,A00,430458,Mc Culloch; Andrew Douglas & Amaro; Rommie E,0,0,0,0
1708256989328,MATH 277A,A00,430464,Dumitriu; Ioana,14,0,15,1
1708256989853,MATH 278A,A00,430470,Cheng; Li-Tien,9,0,10,1
1708256990382,MATH 278B,A00,430471,Cloninger; Alexander,10,0,10,0
1708256990909,MATH 278C,A00,430472,Nie; Jiawang,9,0,10,1
1708256991438,MATH 280C,A00,430485,Schweinsberg; Jason,13,0,15,2
1708256991965,MATH 281C,A00,430496,Arias-Castro; Ery,8,0,15,7
1708256992497,MATH 284,A00,430503,Xu; Ronghui,11,0,15,4
1708256993028,MATH 287C,A00,430520,Zhang; Danna,14,0,15,1
1708256993554,MATH 288,A00,430527,Carfagnini; Marco,9,0,10,1
1708256994078,MATH 289A,A00,430541,Novak; Jonathan I,14,0,15,1
1708256994607,MATH 290C,A00,430548,Roberts; Justin Deritter,13,0,15,2
1708256995132,MATH 292,A00,430660,Lu; Yunze,10,0,10,0
1708256995658,MATH 294,A00,430678,Fitzsimmons; Patrick J,11,0,15,4
1708256996186,MATH 295,A00,430692,Bejenaru; Ioan,15,0,15,0
1708256996713,MATH 297,001,430721,Gamst; Anthony Collins,0,0,0,0
1708256997238,MATS 200,A00,414457,Graeve; Olivia A,9995,0,9999,4
1708256997839,MATS 201C,A00,414465,Arzt; Eduard,38,0,50,12
1708256998366,MATS 236,A00,414466,Staff,17,0,20,3
1708256998894,MATS 252,A00,414467,Evdokimenko; Ekaterina,42,0,45,3
1708256999421,MATS 261B,A00,414468,Qiao; Yu,17,0,25,8
1708256999946,MATS 295,A00,414469,Graeve; Olivia A,9999,0,9999,0
1708256999946,MATS 295,B00,478858,Kummel; Andrew C,9999,0,9999,0
1708257000481,MCWP 40,001,414476,Montejo; Carolina,19,0,20,1
1708257000481,MCWP 40,004,414480,Wastal; Carrie King,13,0,15,2
1708257000481,MCWP 40,005,414481,Wastal; Carrie King,10,0,15,5
1708257000481,MCWP 40,006,414482,Wastal; Carrie King,12,0,15,3
1708257000481,MCWP 40,007,414483,Wastal; Carrie King,13,0,15,2
1708257000481,MCWP 40,008,414484,Wastal; Carrie King,15,0,15,0
1708257000481,MCWP 40,009,414487,Wastal; Carrie King,12,0,15,3
1708257000481,MCWP 40,014,414505,Staff,20,0,20,0
1708257000481,MCWP 40,015,494362,Wastal; Carrie King,14,0,15,1
1708257001012,MCWP 50,002,414534,Bartulis; Jason Michael,20,0,20,0
1708257001012,MCWP 50,003,414536,Bartulis; Jason Michael,20,0,20,0
1708257001012,MCWP 50,004,414538,Krone; Jarret,16,0,20,4
1708257001012,MCWP 50,005,414539,Krone; Jarret,19,0,20,1
1708257001012,MCWP 50,006,414540,Smith; Haydee Marie,16,0,20,4
1708257001012,MCWP 50,007,414544,Compas; Sean Matthew,14,0,20,6
1708257001012,MCWP 50,008,414549,Redela; Pamela Morgan,20,0,20,0
1708257001012,MCWP 50,011,414557,Carter; Andrea L,16,0,20,4
1708257001012,MCWP 50,012,414592,Silva; Kelly B,20,0,20,0
1708257001012,MCWP 50,013,414593,Silva; Kelly B,19,0,20,1
1708257001012,MCWP 50,014,414594,Carter; Andrea L,20,0,20,0
1708257001012,MCWP 50,016,414596,Morshed; Michael James,14,0,20,6
1708257001012,MCWP 50,017,414598,Morshed; Michael James,17,0,20,3
1708257001012,MCWP 50,019,414601,Redela; Pamela Morgan,17,0,20,3
1708257001012,MCWP 50,020,414606,Carter; Jennifer A,20,0,20,0
1708257001012,MCWP 50,021,414607,Carter; Jennifer A,19,0,20,1
1708257001012,MCWP 50,022,414649,Compas; Sean Matthew,11,0,20,9
1708257001012,MCWP 50,023,414650,Smith; Haydee Marie,20,0,20,0
1708257001012,MCWP 50,024,414651,Nies; Laurie Elizabeth,19,0,20,1
1708257001012,MCWP 50,025,414655,Nies; Laurie Elizabeth,18,0,20,2
1708257001012,MCWP 50,026,414656,Pham; Vincent Minhduc,19,0,20,1
1708257001012,MCWP 50,027,414657,Pham; Vincent Minhduc,20,0,20,0
1708257001012,MCWP 50,028,414668,Morshed; Michael James,16,0,20,4
1708257001012,MCWP 50,029,414669,Morshed; Michael James,19,0,20,1
1708257001538,MCWP 50R,A00,486838,Miller; Elizabeth Deen,19,0,20,1
1708257001538,MCWP 50R,B00,486843,Miller; Elizabeth Deen,16,0,20,4
1708257001538,MCWP 50R,C00,486844,Miller; Elizabeth Deen,19,0,20,1
1708257002068,MCWP 125,A00,414670,Wilson; Marion E.,20,0,20,0
1708257002068,MCWP 125,B00,414674,Guillen; Melinda,20,0,20,0
1708257002068,MCWP 125,C00,414678,Guillen; Melinda,20,0,20,0
1708257002068,MCWP 125,D00,414682,Guillen; Melinda,20,0,20,0
1708257002592,MED 231,A00,476440,Hurst; Samantha,7,0,7,0
1708257003119,MED 246,A00,492785,Gordts; Philip & Varki; Ajit P & Lewis; Amanda Lark & Godula; Kamil & Gagneux; Pascal & Esko; Jeffrey D. & Bode; Lars,10,0,10,0
1708257003649,MED 262,A00,492942,Koola; Jejo David,28,0,30,2
1708257004175,MED 267,A01,492789,Hogarth; Michael Andrew,25,0,30,5
1708257004703,MED 275,A00,464684,Liu; George Yenhsi,10,0,10,0
1708257005230,MED 276,A00,492786,Sitapati; Amy,23,0,25,2
1708257005756,MED 278,A00,492787,Carter; Hannah Kathryn & Mesirov; Jill P. & Curtius; Kathleen Mary,20,0,20,0
1708257006285,MED 296,001,464685,Chi; Neil C.,48,0,50,2
1708257006285,MED 296,002,464686,Hong; Kimberly N,49,0,50,1
1708257006285,MED 296,003,464687,Staff,50,0,50,0
1708257006812,MGT 3,A00,442429,Wagner; Timothy Ryan,95,0,98,3
1708257007337,MGT 4,A01,442443,Levkoff; Steven B.,0,0,5,5
1708257007337,MGT 4,A02,442444,Levkoff; Steven B.,4,0,5,1
1708257007868,MGT 5,A00,442446,Molloie Jr.; William H,184,0,196,12
1708257008394,MGT 12,A00,442447,Lindenberger; Wade Douglas,83,0,100,17
1708257008394,MGT 12,B00,442448,Lindenberger; Wade Douglas,71,0,100,29
1708257008394,MGT 12,C00,442449,Pecore; Joseph P.,88,0,100,12
1708257008921,MGT 16,A00,442452,Buchanan; Harold G,97,0,100,3
1708257008921,MGT 16,B00,442459,Buchanan; Harold G,92,0,100,8
1708257008921,MGT 16,C00,442461,Campbell; Robert Harold,113,0,120,7
1708257008921,MGT 16,D00,442475,Campbell; Robert Harold,118,0,120,2
1708257009448,MGT 18,A00,442477,McKay; Michael J,98,0,98,0
1708257009448,MGT 18,B00,442491,McKay; Michael J,96,0,98,2
1708257009448,MGT 18,C00,442493,McKay; Michael J,98,0,98,0
1708257009448,MGT 18,D00,442503,Chamberlain; Travis Dean,98,0,98,0
1708257009986,MGT 45,A00,442508,Pecore; Joseph P.,146,0,150,4
1708257009986,MGT 45,B00,442510,Pecore; Joseph P.,142,0,150,8
1708257010515,MGT 71,A00,442524,Lee; Hyun Seok,77,0,98,21
1708257011042,MGT 71R,A00,442526,Phiroz; Zal Navroze,77,0,98,21
1708257011571,MGT 100,A00,442541,Wilbur; Kenneth C,82,0,98,16
1708257011571,MGT 100,B00,442542,Wilbur; Kenneth C,89,0,98,9
1708257012104,MGT 103,A00,442543,Eberhard; Craig A,98,0,98,0
1708257012104,MGT 103,B00,442544,Eberhard; Craig A,95,0,98,3
1708257012104,MGT 103,C00,442545,Ehrich; Kristine R,90,0,98,8
1708257012104,MGT 103,D00,442547,Ehrich; Kristine R,96,0,98,2
1708257012104,MGT 103,E00,442548,Ehrich; Kristine R,97,0,98,1
1708257012104,MGT 103,F00,442549,Demill; Burritt,92,0,98,6
1708257012104,MGT 103,G00,442550,Bates; Kenneth Walter,97,0,98,1
1708257012629,MGT 105,A00,442558,Bates; Kenneth Walter,86,0,98,12
1708257013155,MGT 106,A00,442560,Eberhard; Craig A,95,0,98,3
1708257013681,MGT 109,A00,442574,Campbell; Colin Leslie,90,0,98,8
1708257014207,MGT 112,A00,442576,Somasundaram; Tyagarajan,96,0,98,2
1708257014207,MGT 112,B00,442590,Somasundaram; Tyagarajan,94,0,98,4
1708257014207,MGT 112,C00,442592,Zimmermann; Carsten,87,0,98,11
1708257014733,MGT 119,A00,442602,Staff,97,0,98,1
1708257014733,MGT 119,B00,442603,Anderson; Jon Marcus,96,0,98,2
1708257015263,MGT 121B,A00,442606,Klaas; Jeffrey David,94,0,98,4
1708257015790,MGT 128R,A00,442607,Krishnan; Viswanathan,84,0,98,14
1708257016317,MGT 131A,A00,442608,Houskeeper; Robert,148,0,150,2
1708257016842,MGT 131B,A00,442609,Houskeeper; Robert,100,0,100,0
1708257017368,MGT 132,A00,442610,Blakley; Bruce,97,0,98,1
1708257017897,MGT 137,A00,442611,Lindenberger; Wade Douglas,85,0,98,13
1708257018423,MGT 147,A00,442612,Anderson; John Charles,31,0,40,9
1708257018948,MGT 151R,A00,442613,Phiroz; Zal Navroze,92,0,98,6
1708257019479,MGT 153,A00,442650,Perols; Johan Lars,55,0,80,25
1708257020005,MGT 162,A00,442652,Demill; Burritt,81,0,98,17
1708257020005,MGT 162,B00,442654,Demill; Burritt,88,0,98,10
1708257020005,MGT 162,C00,442776,Staff,95,0,98,3
1708257020005,MGT 162,D00,442778,Staff,96,0,98,2
1708257020537,MGT 164,A00,442780,McKay; Mary A,97,0,98,1
1708257020537,MGT 164,B00,442849,McKay; Mary A,96,0,98,2
1708257020537,MGT 164,C00,442917,McKay; Mary A,97,0,98,1
1708257020537,MGT 164,D00,442949,Meyer; Alison Bloomfield,90,0,98,8
1708257021064,MGT 166,A00,443017,Moran; Cathleen L.,95,0,98,3
1708257021064,MGT 166,B00,443045,Moran; Cathleen L.,97,0,98,1
1708257021064,MGT 166,C00,443046,Moran; Cathleen L.,98,0,98,0
1708257021588,MGT 167,A00,443047,Klaas; Jeffrey David,93,0,98,5
1708257022118,MGT 171R,A00,443048,Phiroz; Zal Navroze,86,0,98,12
1708257022646,MGT 172,A00,443049,Hedges; Kathleen & Royal; Rebecca,116,0,120,4
1708257022646,MGT 172,B00,443050,Hedges; Kathleen,95,0,98,3
1708257022646,MGT 172,C00,443051,Zimmermann; Carsten,96,0,98,2
1708257023172,MGT 173,A00,443052,Hayes; Sherry Lorine,92,0,100,8
1708257023701,MGT 175,A00,443053,Gopal; Christopher S.,98,0,98,0
1708257024225,MGT 180,A00,443055,Bliss; Barbara Ann,139,0,150,11
1708257024225,MGT 180,B00,443069,Bliss; Barbara Ann,145,0,150,5
1708257024752,MGT 181,A00,443120,Buchanan; Harold G,147,0,150,3
1708257025278,MGT 183,A00,443121,Banerjee; Snehal,88,0,98,10
1708257025803,MGT 185,A00,443122,Dunn; Louis Jean,90,0,98,8
1708257026329,MGT 187,A00,443133,Dunn; Louis Jean,95,0,100,5
1708257026856,MGT 189,A00,443134,Avenancio-Leon; Carlos,98,0,98,0
1708257027381,MGT 227,A00,479242,Serra Garcia; Marta,19,0,20,1
1708257027909,MGT 259,A00,443135,Oveis; Christopher S,19,0,20,1
1708257028434,MGT 296,001,481416,Gneezy; Ayelet,3,0,3,0
1708257028434,MGT 296,002,481420,Amir; On,3,0,3,0
1708257028434,MGT 296,003,481466,Amir; On & Karmarkar; Uma R,3,0,3,0
1708257028434,MGT 296,004,481468,Liu; Jun,3,0,3,0
1708257028434,MGT 296,005,481469,Misra; Kanishka,3,0,3,0
1708257028434,MGT 296,006,481470,Erat; Sanjiv,3,0,3,0
1708257028434,MGT 296,007,481473,Timmermann; Allan,3,0,3,0
1708257028434,MGT 296,008,481474,Smith; Pamela Karen,3,0,3,0
1708257028434,MGT 296,009,481477,Zhang; Zhe,3,0,3,0
1708257028434,MGT 296,010,481478,Oveis; Christopher S,3,0,3,0
1708257028434,MGT 296,011,481479,Amir; On & Gneezy; Ayelet,3,0,3,0
1708257028434,MGT 296,012,481481,Wilbur; Kenneth C,3,0,3,0
1708257028992,MMW 13,A01,412918,Chang; Edmond Yi-Teh,15,0,16,1
1708257028992,MMW 13,A02,412928,Chang; Edmond Yi-Teh,16,0,16,0
1708257028992,MMW 13,A03,413017,Chang; Edmond Yi-Teh,16,0,16,0
1708257028992,MMW 13,A04,413018,Chang; Edmond Yi-Teh,16,0,16,0
1708257028992,MMW 13,A05,413019,Chang; Edmond Yi-Teh,15,0,16,1
1708257028992,MMW 13,A06,413020,Chang; Edmond Yi-Teh,16,0,16,0
1708257028992,MMW 13,A07,413021,Chang; Edmond Yi-Teh,15,0,16,1
1708257028992,MMW 13,A08,413023,Chang; Edmond Yi-Teh,16,0,16,0
1708257028992,MMW 13,A09,413024,Chang; Edmond Yi-Teh,16,0,16,0
1708257028992,MMW 13,A10,413025,Chang; Edmond Yi-Teh,16,0,16,0
1708257028992,MMW 13,A11,413026,Chang; Edmond Yi-Teh,16,0,16,0
1708257028992,MMW 13,A12,413027,Chang; Edmond Yi-Teh,16,0,16,0
1708257028992,MMW 13,A13,413028,Chang; Edmond Yi-Teh,0,0,0,0
1708257028992,MMW 13,A14,413029,Chang; Edmond Yi-Teh,0,0,0,0
1708257028992,MMW 13,A15,413030,Chang; Edmond Yi-Teh,14,0,16,2
1708257028992,MMW 13,A16,413031,Chang; Edmond Yi-Teh,15,0,16,1
1708257028992,MMW 13,A17,413032,Chang; Edmond Yi-Teh,16,0,16,0
1708257028992,MMW 13,A18,413034,Chang; Edmond Yi-Teh,14,0,16,2
1708257028992,MMW 13,A19,413035,Chang; Edmond Yi-Teh,16,0,16,0
1708257028992,MMW 13,A20,413036,Chang; Edmond Yi-Teh,16,0,16,0
1708257028992,MMW 13,A21,413037,Chang; Edmond Yi-Teh,0,0,0,0
1708257028992,MMW 13,A22,413038,Chang; Edmond Yi-Teh,0,0,0,0
1708257028992,MMW 13,B01,413290,Zhiri; Oumelbanine,15,0,16,1
1708257028992,MMW 13,B02,413291,Zhiri; Oumelbanine,15,0,16,1
1708257028992,MMW 13,B03,413308,Zhiri; Oumelbanine,14,0,16,2
1708257028992,MMW 13,B04,413322,Zhiri; Oumelbanine,14,0,16,2
1708257028992,MMW 13,B05,413343,Zhiri; Oumelbanine,12,0,16,4
1708257028992,MMW 13,B06,413344,Zhiri; Oumelbanine,14,0,16,2
1708257028992,MMW 13,B07,413524,Zhiri; Oumelbanine,16,0,16,0
1708257028992,MMW 13,B08,413584,Zhiri; Oumelbanine,16,0,16,0
1708257028992,MMW 13,B09,413588,Zhiri; Oumelbanine,15,0,16,1
1708257028992,MMW 13,B10,413590,Zhiri; Oumelbanine,16,0,16,0
1708257028992,MMW 13,B11,413779,Zhiri; Oumelbanine,12,0,16,4
1708257028992,MMW 13,B12,413780,Zhiri; Oumelbanine,9,0,16,7
1708257028992,MMW 13,B13,413781,Zhiri; Oumelbanine,0,0,0,0
1708257028992,MMW 13,B14,413782,Zhiri; Oumelbanine,0,0,0,0
1708257028992,MMW 13,B15,413808,Zhiri; Oumelbanine,16,0,16,0
1708257028992,MMW 13,B16,413815,Zhiri; Oumelbanine,15,0,16,1
1708257028992,MMW 13,B17,413816,Zhiri; Oumelbanine,15,0,16,1
1708257028992,MMW 13,B18,413817,Zhiri; Oumelbanine,12,0,16,4
1708257028992,MMW 13,B19,413822,Zhiri; Oumelbanine,16,0,16,0
1708257028992,MMW 13,B20,413823,Zhiri; Oumelbanine,14,0,16,2
1708257028992,MMW 13,B21,413825,Zhiri; Oumelbanine,0,0,0,0
1708257028992,MMW 13,B22,413826,Zhiri; Oumelbanine,0,0,0,0
1708257028992,MMW 13,B23,413827,Zhiri; Oumelbanine,16,0,16,0
1708257028992,MMW 13,B24,413834,Zhiri; Oumelbanine,15,0,16,1
1708257028992,MMW 13,C01,413859,Vitkus; Daniel J.,16,0,16,0
1708257028992,MMW 13,C02,413860,Vitkus; Daniel J.,16,0,16,0
1708257028992,MMW 13,C04,413868,Vitkus; Daniel J.,0,0,0,0
1708257028992,MMW 13,C05,413869,Vitkus; Daniel J.,16,0,16,0
1708257028992,MMW 13,C06,413871,Vitkus; Daniel J.,16,0,16,0
1708257028992,MMW 13,C07,413886,Vitkus; Daniel J.,16,0,16,0
1708257028992,MMW 13,C08,413908,Vitkus; Daniel J.,16,0,16,0
1708257028992,MMW 13,C09,413930,Vitkus; Daniel J.,16,0,16,0
1708257028992,MMW 13,C10,413952,Vitkus; Daniel J.,15,0,16,1
1708257028992,MMW 13,C11,413972,Vitkus; Daniel J.,16,0,16,0
1708257028992,MMW 13,C12,413991,Vitkus; Daniel J.,16,0,16,0
1708257028992,MMW 13,C13,414007,Vitkus; Daniel J.,0,0,0,0
1708257028992,MMW 13,C14,414017,Vitkus; Daniel J.,0,0,0,0
1708257028992,MMW 13,C15,414030,Vitkus; Daniel J.,16,0,16,0
1708257028992,MMW 13,C16,414032,Vitkus; Daniel J.,16,0,16,0
1708257028992,MMW 13,C17,414033,Vitkus; Daniel J.,15,0,16,1
1708257028992,MMW 13,C18,414034,Vitkus; Daniel J.,16,0,16,0
1708257028992,MMW 13,C19,414041,Vitkus; Daniel J.,16,0,16,0
1708257028992,MMW 13,C20,414056,Vitkus; Daniel J.,16,0,16,0
1708257028992,MMW 13,C21,414057,Vitkus; Daniel J.,15,0,16,1
1708257028992,MMW 13,C22,414059,Vitkus; Daniel J.,16,0,16,0
1708257029527,MMW 15,A01,414065,Chang; Edmond Yi-Teh,28,0,28,0
1708257029527,MMW 15,A02,414067,Chang; Edmond Yi-Teh,27,0,28,1
1708257029527,MMW 15,A03,414092,Chang; Edmond Yi-Teh,26,0,28,2
1708257029527,MMW 15,A04,414104,Chang; Edmond Yi-Teh,28,0,28,0
1708257029527,MMW 15,A05,414121,Chang; Edmond Yi-Teh,0,0,0,0
1708257029527,MMW 15,A06,414122,Chang; Edmond Yi-Teh,0,0,0,0
1708257029527,MMW 15,A07,414123,Chang; Edmond Yi-Teh,27,0,28,1
1708257029527,MMW 15,A08,414124,Chang; Edmond Yi-Teh,28,0,28,0
1708257029527,MMW 15,A09,414125,Chang; Edmond Yi-Teh,0,0,0,0
1708257029527,MMW 15,A10,414130,Chang; Edmond Yi-Teh,0,0,0,0
1708257029527,MMW 15,B01,414132,Radcliff; Pamela B.,27,0,28,1
1708257029527,MMW 15,B02,414134,Radcliff; Pamela B.,27,0,28,1
1708257029527,MMW 15,B03,414135,Radcliff; Pamela B.,26,0,28,2
1708257029527,MMW 15,B04,414136,Radcliff; Pamela B.,27,0,28,1
1708257029527,MMW 15,B05,414137,Radcliff; Pamela B.,28,0,28,0
1708257029527,MMW 15,B06,414138,Radcliff; Pamela B.,27,0,28,1
1708257029527,MMW 15,B07,414140,Radcliff; Pamela B.,26,0,28,2
1708257029527,MMW 15,B08,414141,Radcliff; Pamela B.,28,0,28,0
1708257029527,MMW 15,C01,414143,Prestholdt; Jeremy,0,0,0,0
1708257029527,MMW 15,C02,414144,Prestholdt; Jeremy,0,0,0,0
1708257029527,MMW 15,C03,414145,Prestholdt; Jeremy,24,0,28,4
1708257029527,MMW 15,C04,414147,Prestholdt; Jeremy,17,0,28,11
1708257029527,MMW 15,C05,414148,Prestholdt; Jeremy,28,0,28,0
1708257029527,MMW 15,C06,414149,Prestholdt; Jeremy,26,0,28,2
1708257029527,MMW 15,C07,414152,Prestholdt; Jeremy,25,0,28,3
1708257029527,MMW 15,C08,414153,Prestholdt; Jeremy,23,0,28,5
1708257030054,MSED 295,A00,477850,Rabin; Jeffrey Mark,5,0,5,0
1708257030054,MSED 295,B00,477852,Lo; Stanley M.,5,0,5,0
1708257030579,MSED 296C,A00,477853,Staff,14,0,15,1
1708257031111,MUS 1C,A01,416488,Ishov; Alexander Alexandrovich,24,0,25,1
1708257031111,MUS 1C,A02,416502,Ishov; Alexander Alexandrovich,25,0,25,0
1708257031111,MUS 1C,A03,416519,Ishov; Alexander Alexandrovich,25,0,25,0
1708257031111,MUS 1C,A04,416520,Ishov; Alexander Alexandrovich,25,0,25,0
1708257031111,MUS 1C,A05,416521,Ishov; Alexander Alexandrovich,25,0,25,0
1708257031636,MUS 2C,A01,416523,Richards; Stephanie F,30,0,30,0
1708257032161,MUS 2CK,A00,416524,Ohnishi; Takae,15,0,15,0
1708257032161,MUS 2CK,B00,416547,Ohnishi; Takae,15,0,15,0
1708257032690,MUS 2JK,A00,416548,Kenyatta; Kamau,15,0,15,0
1708257033217,MUS 4,A01,416562,Staff,25,0,25,0
1708257033217,MUS 4,A02,416634,Staff,24,0,25,1
1708257033217,MUS 4,A03,416644,Staff,25,0,25,0
1708257033217,MUS 4,A04,416659,Staff,24,0,25,1
1708257033217,MUS 4,A05,416667,Staff,25,0,25,0
1708257033217,MUS 4,A06,416757,Staff,25,0,25,0
1708257033217,MUS 4,A07,416830,Staff,25,0,25,0
1708257033217,MUS 4,A08,416953,Staff,23,0,25,2
1708257033217,MUS 4,A09,417005,Staff,25,0,25,0
1708257033217,MUS 4,A10,417007,Staff,24,0,25,1
1708257033748,MUS 7,A01,417048,Staff,23,0,24,1
1708257033748,MUS 7,A02,417102,Staff,23,0,24,1
1708257033748,MUS 7,A03,417103,Staff,23,0,24,1
1708257033748,MUS 7,A04,417114,Staff,22,0,24,2
1708257034276,MUS 8,A01,417119,Staff,14,0,20,6
1708257034276,MUS 8,A02,417163,Staff,16,0,20,4
1708257034276,MUS 8,A03,417164,Staff,16,0,20,4
1708257034276,MUS 8,A04,417165,Staff,17,0,20,3
1708257034276,MUS 8,A05,417194,Staff,18,0,20,2
1708257034276,MUS 8,A06,417198,Staff,20,0,20,0
1708257034802,MUS 11,A01,417201,Terrazas Perez; Wilfrido D,21,0,25,4
1708257034802,MUS 11,A02,417219,Terrazas Perez; Wilfrido D,23,0,25,2
1708257034802,MUS 11,A03,417220,Terrazas Perez; Wilfrido D,25,0,25,0
1708257034802,MUS 11,A04,417222,Terrazas Perez; Wilfrido D,25,0,25,0
1708257034802,MUS 11,A05,417223,Terrazas Perez; Wilfrido D,24,0,25,1
1708257034802,MUS 11,A06,417295,Terrazas Perez; Wilfrido D,23,0,25,2
1708257034802,MUS 11,A07,417297,Terrazas Perez; Wilfrido D,24,0,25,1
1708257034802,MUS 11,A08,417298,Terrazas Perez; Wilfrido D,25,0,25,0
1708257035331,MUS 12,A01,417300,Guy; Nancy,25,0,25,0
1708257035331,MUS 12,A02,417301,Guy; Nancy,25,0,25,0
1708257035331,MUS 12,A03,417302,Guy; Nancy,25,0,25,0
1708257035331,MUS 12,A04,417303,Guy; Nancy,25,0,25,0
1708257035857,MUS 13,A01,417305,Leslie Santana; Myrta,25,0,25,0
1708257035857,MUS 13,A02,417306,Leslie Santana; Myrta,25,0,25,0
1708257035857,MUS 13,A03,417307,Leslie Santana; Myrta,25,0,25,0
1708257035857,MUS 13,A04,417308,Leslie Santana; Myrta,25,0,25,0
1708257036386,MUS 15,A01,417327,Schaffer; Max Benjamin,18,0,20,2
1708257036386,MUS 15,A02,417331,Schaffer; Max Benjamin,19,0,20,1
1708257036386,MUS 15,A03,417358,Schaffer; Max Benjamin,19,0,20,1
1708257036386,MUS 15,A04,417359,Schaffer; Max Benjamin,17,0,20,3
1708257036386,MUS 15,A05,417360,Schaffer; Max Benjamin,20,0,20,0
1708257036386,MUS 15,A06,417370,Schaffer; Max Benjamin,20,0,20,0
1708257036386,MUS 15,A07,417371,Schaffer; Max Benjamin,17,0,20,3
1708257036386,MUS 15,A08,417372,Schaffer; Max Benjamin,18,0,20,2
1708257036386,MUS 15,A09,417378,Schaffer; Max Benjamin,19,0,20,1
1708257036386,MUS 15,A10,417379,Schaffer; Max Benjamin,19,0,20,1
1708257036913,MUS 17,A01,417381,Staff,22,0,25,3
1708257036913,MUS 17,A02,417406,Staff,24,0,25,1
1708257036913,MUS 17,A03,417420,Staff,24,0,25,1
1708257036913,MUS 17,A04,417594,Staff,24,0,25,1
1708257036913,MUS 17,A05,417595,Staff,25,0,25,0
1708257036913,MUS 17,A06,417605,Staff,21,0,25,4
1708257036913,MUS 17,A07,417606,Staff,25,0,25,0
1708257036913,MUS 17,A08,417627,Staff,25,0,25,0
1708257036913,MUS 17,A09,417628,Staff,21,0,25,4
1708257036913,MUS 17,A10,417629,Staff,24,0,25,1
1708257036913,MUS 17,A11,417630,Staff,25,0,25,0
1708257036913,MUS 17,A12,417631,Staff,24,0,25,1
1708257036913,MUS 17,A13,417632,Staff,25,0,25,0
1708257036913,MUS 17,A14,417633,Staff,25,0,25,0
1708257037439,MUS 32,001,418855,Dresser; Mark Stuart,10,0,10,0
1708257037439,MUS 32,002,418856,Kenyatta; Kamau,9,0,10,1
1708257037439,MUS 32,003,418864,Curtis; Charles Rector,10,0,10,0
1708257037439,MUS 32,004,418865,Carlstrom; Mitchell Kraig,9,0,10,1
1708257037439,MUS 32,005,418868,Terrazas Perez; Wilfrido D,10,0,10,0
1708257037439,MUS 32,006,418869,Ohnishi; Takae,10,0,10,0
1708257037439,MUS 32,007,418872,Burr; Anthony I,10,0,10,0
1708257037439,MUS 32,008,418873,Carlson; Erik Norman,10,0,10,0
1708257037439,MUS 32,009,418874,Blair; Kyle Adam,10,0,10,0
1708257037439,MUS 32,010,418875,Richards; Stephanie F,10,0,10,0
1708257037969,MUS 32V,A00,417634,Narucki; Susan M,10,0,10,0
1708257037969,MUS 32V,B00,417635,Staff,10,0,10,0
1708257038501,MUS 32VM,A00,417636,Staff,15,0,15,0
1708257039030,MUS 33C,A00,417637,Taylor; Alexander Lawther,20,0,20,0
1708257039558,MUS 43,A00,417647,Burr; Anthony I,83,0,90,7
1708257040087,MUS 95D,A00,417919,Staff,40,0,40,0
1708257040617,MUS 95E,A00,417933,Henson; Matthew Alexander,55,0,55,0
1708257041142,MUS 95G,A00,417935,Anderson; Kenneth,387,0,395,8
1708257041142,MUS 95G,B00,417937,Anderson; Kenneth,394,0,395,1
1708257041671,MUS 95JC,A00,417939,Kenyatta; Kamau,30,0,30,0
1708257042197,MUS 95L,A00,417940,Jones; Michael David,50,0,50,0
1708257042722,MUS 95W,A00,417946,Seshadri; Kartik,29,0,30,1
1708257042722,MUS 95W,B00,417948,Seshadri; Kartik,30,0,30,0
1708257043247,MUS 101C,A01,417951,Burr; Anthony I,33,0,35,2
1708257043772,MUS 103C,A00,417952,Davis; Anthony Curtis,14,0,15,1
1708257044302,MUS 103F,A00,417959,Obermueller; Karola,1,0,1,0
1708257044828,MUS 113,A00,418015,Narucki; Susan M,13,0,15,2
1708257045356,MUS 120C,A01,418032,Leslie Santana; Myrta,25,0,25,0
1708257045885,MUS 127,A00,418037,Richards; Stephanie F,92,0,100,8
1708257046412,MUS 130,A00,418047,Ohnishi; Takae,30,0,30,0
1708257046940,MUS 131,A00,418065,Roberts; Matana,30,0,30,0
1708257047467,MUS 132,001,418883,Dresser; Mark Stuart,10,0,10,0
1708257047467,MUS 132,002,418885,Kenyatta; Kamau,10,0,10,0
1708257047467,MUS 132,003,418886,Curtis; Charles Rector,10,0,10,0
1708257047467,MUS 132,004,418887,Carlstrom; Mitchell Kraig,10,0,10,0
1708257047467,MUS 132,005,418888,Jones; Michael David,10,0,10,0
1708257047467,MUS 132,006,418889,Terrazas Perez; Wilfrido D,10,0,10,0
1708257047467,MUS 132,007,418893,Ohnishi; Takae,10,0,10,0
1708257047467,MUS 132,008,418894,Burr; Anthony I,10,0,10,0
1708257047467,MUS 132,009,418896,Carlson; Erik Norman,10,0,10,0
1708257047467,MUS 132,010,418900,Blair; Kyle Adam,10,0,10,0
1708257047467,MUS 132,011,418932,Richards; Stephanie F,10,0,10,0
1708257047467,MUS 132,012,418933,Nourai; Keyarash,10,0,10,0
1708257047995,MUS 132R,A00,418067,Burr; Anthony I,5,0,5,0
1708257047995,MUS 132R,B00,418078,Jones; Michael David,5,0,5,0
1708257048525,MUS 132V,A00,418092,Narucki; Susan M,15,0,15,0
1708257048525,MUS 132V,B00,418096,Staff,15,0,15,0
1708257049050,MUS 134,A00,418098,Staff,40,0,40,0
1708257049577,MUS 137C,A00,418109,Kenyatta; Kamau,25,0,25,0
1708257050102,MUS 143,A00,418123,Burr; Anthony I,33,0,40,7
1708257050628,MUS 150,A00,418127,Davis; Anthony Curtis,28,0,30,2
1708257051211,MUS 151,A00,418129,Hankins; Sarah E.,20,0,30,10
1708257051742,MUS 160B,A00,418172,Staff,11,0,15,4
1708257051742,MUS 160B,B00,418175,Dubnov; Shlomo,14,0,15,1
1708257052267,MUS 172,A01,418178,Staff,36,0,40,4
1708257052793,MUS 174C,A00,418179,Erbe; Tom,24,0,27,3
1708257053317,MUS 175,A00,418247,Smyth; Tamara R.,28,0,30,2
1708257053844,MUS 177,A00,418265,Erbe; Tom,11,0,15,4
1708257054369,MUS 201A,A00,418267,Narucki; Susan M,15,0,15,0
1708257054369,MUS 201A,B00,418268,Dresser; Mark Stuart,13,0,15,2
1708257054898,MUS 203C,A00,418269,Lou; Michelle Siulai,15,0,15,0
1708257055423,MUS 203D,A00,418272,Davis; Anthony Curtis,4,0,5,1
1708257055423,MUS 203D,B00,418275,Obermueller; Karola,5,0,5,0
1708257055423,MUS 203D,C00,418277,Liang; Lei,5,0,5,0
1708257055423,MUS 203D,D00,418323,Lou; Michelle Siulai,5,0,5,0
1708257055947,MUS 204,A00,418324,Obermueller; Karola,24,0,25,1
1708257056477,MUS 205,A00,418325,Cimini; Amy Marie,22,0,25,3
1708257057005,MUS 206,A00,418326,Liang; Lei,13,0,15,2
1708257057005,MUS 206,B00,418327,Roberts; Matana,13,0,15,2
1708257057531,MUS 215C,A00,418328,Cimini; Amy Marie,14,0,15,1
1708257058057,MUS 232,001,418937,Dresser; Mark Stuart,9,0,10,1
1708257058057,MUS 232,002,418969,Kenyatta; Kamau,10,0,10,0
1708257058057,MUS 232,003,418971,Curtis; Charles Rector,10,0,10,0
1708257058057,MUS 232,004,418974,Terrazas Perez; Wilfrido D,10,0,10,0
1708257058057,MUS 232,005,418979,Ohnishi; Takae,10,0,10,0
1708257058057,MUS 232,006,418980,Burr; Anthony I,10,0,10,0
1708257058057,MUS 232,007,418981,Carlson; Erik Norman,10,0,10,0
1708257058057,MUS 232,008,418982,Richards; Stephanie F,10,0,10,0
1708257058057,MUS 232,009,418985,Narucki; Susan M,10,0,10,0
1708257058586,MUS 234,A00,418329,Staff,15,0,15,0
1708257059110,MUS 245,A00,418330,Carlson; Erik Norman,14,0,15,1
1708257059635,MUS 267,A00,418331,Erbe; Tom,15,0,15,0
1708257060162,MUS 270B,A00,418332,Staff,15,0,15,0
1708257060689,MUS 270D,A00,479231,Smyth; Tamara R.,15,0,15,0
1708257061220,NANO 103,A00,414714,Jahed Motlagh; Zeinab,40,0,40,0
1708257061745,NANO 108,A00,414740,Lubarda; Vlado,70,0,70,0
1708257062270,NANO 112,A01,414825,Vazquez Mena; Oscar,70,0,70,0
1708257062802,NANO 115L,A01,414830,Yang; Kesong,37,0,38,1
1708257062802,NANO 115L,B01,414832,Xu; Sheng,35,0,38,3
1708257063328,NANO 120B,A01,414835,Vecchio; Kenneth S,33,0,35,2
1708257063328,NANO 120B,B01,414841,Fenning; David,30,0,35,5
1708257063857,NANO 156,A00,414843,Fullerton; Eric E,24,0,30,6
1708257064384,NANO 158,A00,414844,Luo; Jian,29,0,30,1
1708257064909,NANO 175,A00,414850,Steinmetz; Nicole F,30,0,35,5
1708257065438,NANO 200,A00,414852,Jahed Motlagh; Zeinab,118,0,120,2
1708257065964,NANO 241,A00,414854,Pokorski; Jonathan Kyle,18,0,25,7
1708257066492,NANO 262,A00,414858,Wang; Joseph,50,0,50,0
1708257067017,NANO 271,A00,414862,Cubukcu; Ertugrul,22,0,25,3
1708257067543,NANO 272,A00,414877,Xu; Sheng,42,0,50,8
1708257068071,NANO 279,A00,414878,Liu; Ping,32,0,40,8
1708257068596,NANO 282,A00,414879,Steinmetz; Nicole F,30,0,30,0
1708257069119,NEU 200C,A00,455013,Staff,0,0,0,1
1708257069649,NEU 276,A01,479489,Staff,35,0,36,1
1708257070176,NEU 277,A00,479492,Risbrough; Victoria Blythe,0,0,0,0
1708257070702,NEU 296,001,464921,Evans; Sean Jeffrey,48,0,50,2
1708257070702,NEU 296,002,464922,Staff,50,0,50,0
1708257070702,NEU 296,003,464925,Staff,50,0,50,0
1708257071232,NEUG 221,A00,479490,Zheng; Binhai,15,0,15,0
1708257071758,NEUG 280,A00,479491,Chen; Xu,0,0,0,0
1708257072288,NEUG 296,A00,479493,Bloodgood; Brenda Laurie,9998,0,9999,1
1708257072815,OPTH 296,001,465054,Baxter; Sally Liu,49,0,50,1
1708257072815,OPTH 296,002,465068,Afshari; Natalie,49,0,50,1
1708257072815,OPTH 296,003,465074,Staff,50,0,50,0
1708257073341,ORTH 296,A00,465104,Staff,50,0,50,0
1708257073341,ORTH 296,001,465111,Staff,50,0,50,0
1708257073341,ORTH 296,002,465120,Staff,50,0,50,0
1708257073866,PATH 224,A01,494386,Ross; Camille,11,0,12,1
1708257074395,PATH 296,001,465373,Calcutt; Nigel A,49,0,50,1
1708257074395,PATH 296,002,465374,Staff,50,0,50,0
1708257074395,PATH 296,003,465375,Staff,50,0,50,0
1708257074921,PEDS 296,001,465527,Weiss; Katherine Jean,49,0,50,1
1708257074921,PEDS 296,002,465528,Staff,50,0,50,0
1708257074921,PEDS 296,003,465529,Staff,50,0,50,0
1708257075448,PH 196BH,A01,405158,Binkin; Nancy Jeanne,20,0,20,0
1708257075978,PHAR 219,A00,415016,Ross; Camille,1,0,1,0
1708257076504,PHAR 231,A00,415017,Furnari; Frank,20,0,20,0
1708257076504,PHAR 231,B00,415018,Lopez Ramirez; Miguel Alej,20,0,20,0
1708257077036,PHAR 276,A00,415020,Mc Culloch; Andrew Douglas & Amaro; Rommie E,1,0,1,0
1708257077561,PHAR 295,A00,415022,Brown; Joan Heller,15,0,15,0
1708257078087,PHIL 1,A00,415023,Harrell; Maralee Mae,58,0,60,2
1708257078618,PHIL 10,A01,415026,Grush; Rick Scott,40,0,44,4
1708257078618,PHIL 10,A02,415028,Grush; Rick Scott,42,0,44,2
1708257078618,PHIL 10,A03,415029,Grush; Rick Scott,0,0,0,0
1708257078618,PHIL 10,A04,415031,Grush; Rick Scott,0,0,0,0
1708257078618,PHIL 10,A05,415113,Grush; Rick Scott,43,0,44,1
1708257078618,PHIL 10,A06,415114,Grush; Rick Scott,43,0,44,1
1708257078618,PHIL 10,A07,415116,Grush; Rick Scott,44,0,44,0
1708257078618,PHIL 10,A08,415118,Grush; Rick Scott,43,0,44,1
1708257079145,PHIL 12,A01,415120,McKenzie; Kerry V.,28,0,30,2
1708257079145,PHIL 12,A02,415136,McKenzie; Kerry V.,30,0,30,0
1708257079145,PHIL 12,A03,415137,McKenzie; Kerry V.,27,0,30,3
1708257079145,PHIL 12,A04,415142,McKenzie; Kerry V.,30,0,30,0
1708257079673,PHIL 13,A01,415165,Brink; David O.,25,0,25,0
1708257079673,PHIL 13,A02,415179,Brink; David O.,22,0,25,3
1708257079673,PHIL 13,A03,415185,Brink; David O.,24,0,25,1
1708257079673,PHIL 13,A04,415201,Brink; David O.,25,0,25,0
1708257079673,PHIL 13,A05,415204,Brink; David O.,25,0,25,0
1708257079673,PHIL 13,A06,415220,Brink; David O.,25,0,25,0
1708257080203,PHIL 15,A01,415250,Fulkerson; Matthew Todd,26,0,30,4
1708257080203,PHIL 15,A02,415281,Fulkerson; Matthew Todd,29,0,30,1
1708257080731,PHIL 27,A01,415293,Brandt; Reuven A,20,0,25,5
1708257080731,PHIL 27,A02,415296,Brandt; Reuven A,0,0,0,0
1708257080731,PHIL 27,A03,415332,Brandt; Reuven A,22,0,25,3
1708257080731,PHIL 27,A04,415333,Brandt; Reuven A,22,0,25,3
1708257080731,PHIL 27,A05,415342,Brandt; Reuven A,20,0,25,5
1708257080731,PHIL 27,A06,415384,Brandt; Reuven A,24,0,25,1
1708257080731,PHIL 27,A07,415385,Brandt; Reuven A,25,0,25,0
1708257080731,PHIL 27,A08,415391,Brandt; Reuven A,0,0,0,0
1708257080731,PHIL 27,A09,415406,Brandt; Reuven A,0,0,0,0
1708257080731,PHIL 27,A10,415407,Brandt; Reuven A,0,0,0,0
1708257081264,PHIL 28,A01,415412,Lamey; Andy M.,24,0,25,1
1708257081264,PHIL 28,A02,415470,Lamey; Andy M.,20,0,25,5
1708257081264,PHIL 28,A03,415474,Lamey; Andy M.,0,0,0,0
1708257081264,PHIL 28,A04,415475,Lamey; Andy M.,22,0,25,3
1708257081264,PHIL 28,A05,415487,Lamey; Andy M.,24,0,25,1
1708257081264,PHIL 28,A06,415506,Lamey; Andy M.,21,0,25,4
1708257081264,PHIL 28,A07,415507,Lamey; Andy M.,25,0,25,0
1708257081264,PHIL 28,A08,415508,Lamey; Andy M.,24,0,25,1
1708257081264,PHIL 28,A09,415509,Lamey; Andy M.,24,0,25,1
1708257081264,PHIL 28,A10,415510,Lamey; Andy M.,0,0,0,0
1708257081792,PHIL 33,A01,415521,Hardimon; Michael O.,35,0,35,0
1708257081792,PHIL 33,A02,415522,Hardimon; Michael O.,35,0,35,0
1708257082319,PHIL 60,A00,415523,Marechal; Patricia,55,0,60,5
1708257082848,PHIL 102,A00,415524,Johnson; Monte,37,0,40,3
1708257083379,PHIL 106,A00,415544,Watkins; Eric,40,0,40,0
1708257083905,PHIL 112,A00,415545,Watkins; Eric,34,0,40,6
1708257084431,PHIL 115,A00,415548,Nelkin; Dana Kay,20,0,20,0
1708257084962,PHIL 120,A00,415549,Carr; Jennifer Rose,64,0,65,1
1708257085500,PHIL 134,A00,415552,Carr; Jennifer Rose,40,0,40,0
1708257086029,PHIL 150,A00,415553,Cohen; Jonathan David,38,0,40,2
1708257086555,PHIL 171,A00,415561,Brink; David O.,39,0,40,1
1708257087080,PHIL 172,A00,415563,Lamey; Andy M.,40,0,40,0
1708257087605,PHIL 174,A01,415576,Danks; David J,20,0,25,5
1708257087605,PHIL 174,A02,415582,Danks; David J,22,0,25,3
1708257087605,PHIL 174,A03,415583,Danks; David J,24,0,25,1
1708257087605,PHIL 174,A04,415584,Danks; David J,25,0,25,0
1708257088134,PHIL 175,A00,415585,Shields; Christopher John,40,0,40,0
1708257088660,PHIL 181,A00,415601,Tolley; Clinton,34,0,40,6
1708257089187,PHIL 209B,A00,415655,Serlin; David,4,0,5,1
1708257089715,PHIL 209C,A00,415658,Gates; Kelly,5,0,5,0
1708257090239,PHIL 210,A00,415659,Marechal; Patricia,20,0,20,0
1708257090767,PHIL 230,A00,415661,Grush; Rick Scott,20,0,20,0
1708257091294,PHIL 232,A00,415662,Sher; Gila,20,0,20,0
1708257091818,PHIL 260,A00,415675,Bazargan-Forward; Saba,20,0,20,0
1708257092344,PHIL 277,A00,479176,Tolley; Clinton,9,0,10,1
1708257092870,PHIL 285,A00,415685,Kovaka; Karenc,20,0,20,0
1708257093395,PHIL 287,A00,415697,Marechal; Patricia,5,0,5,0
1708257093931,PHIL 290,001,415701,Nelkin; Dana Kay,9999,0,9999,0
1708257093931,PHIL 290,002,415721,Bazargan-Forward; Saba,9999,0,9999,0
1708257093931,PHIL 290,003,415731,Brandt; Reuven A,9999,0,9999,0
1708257093931,PHIL 290,004,415743,Brink; David O.,9999,0,9999,0
1708257093931,PHIL 290,005,415747,Callender; Craig Adam,9999,0,9999,0
1708257093931,PHIL 290,006,415779,Carr; Jennifer Rose,9999,0,9999,0
1708257093931,PHIL 290,007,415780,Cartwright; Nancy D.,9999,0,9999,0
1708257093931,PHIL 290,008,415781,Cohen; Jonathan David,9999,0,9999,0
1708257093931,PHIL 290,009,415782,Danks; David J,9999,0,9999,0
1708257093931,PHIL 290,010,415783,Fulkerson; Matthew Todd,9999,0,9999,0
1708257093931,PHIL 290,011,415784,Grush; Rick Scott,9999,0,9999,0
1708257093931,PHIL 290,012,415785,Hardimon; Michael O.,9999,0,9999,0
1708257093931,PHIL 290,013,415786,Harrell; Maralee Mae,9999,0,9999,0
1708257093931,PHIL 290,014,415787,Johnson; Monte,9999,0,9999,0
1708257093931,PHIL 290,015,415788,Kovaka; Karenc,9999,0,9999,0
1708257093931,PHIL 290,016,415789,Lamey; Andy M.,9999,0,9999,0
1708257093931,PHIL 290,017,415790,Marechal; Patricia,9999,0,9999,0
1708257093931,PHIL 290,018,415791,McKenzie; Kerry V.,9999,0,9999,0
1708257093931,PHIL 290,019,415792,Rickless; Samuel Charles,9999,0,9999,0
1708257093931,PHIL 290,020,415793,Sher; Gila,9999,0,9999,0
1708257093931,PHIL 290,021,415794,Shields; Christopher John,9999,0,9999,0
1708257093931,PHIL 290,022,415805,Tolley; Clinton,9999,0,9999,0
1708257093931,PHIL 290,023,415806,Vargas; Manuel Rogelio,9999,0,9999,0
1708257093931,PHIL 290,024,415807,Watkins; Eric,9999,0,9999,0
1708257093931,PHIL 290,025,415815,Chen; Keming,9999,0,9999,0
1708257094458,PHIL 295,001,415816,Bazargan-Forward; Saba,9999,0,9999,0
1708257094458,PHIL 295,002,415857,Brandt; Reuven A,9999,0,9999,0
1708257094458,PHIL 295,003,415858,Brink; David O.,9999,0,9999,0
1708257094458,PHIL 295,004,415877,Callender; Craig Adam,9999,0,9999,0
1708257094458,PHIL 295,005,415878,Carr; Jennifer Rose,9999,0,9999,0
1708257094458,PHIL 295,006,415884,Cartwright; Nancy D.,9999,0,9999,0
1708257094458,PHIL 295,007,415885,Chen; Keming,9999,0,9999,0
1708257094458,PHIL 295,008,415891,Cohen; Jonathan David,9999,0,9999,0
1708257094458,PHIL 295,009,415892,Danks; David J,9999,0,9999,0
1708257094458,PHIL 295,010,415937,Fulkerson; Matthew Todd,9999,0,9999,0
1708257094458,PHIL 295,011,415940,Grush; Rick Scott,9999,0,9999,0
1708257094458,PHIL 295,012,415945,Hardimon; Michael O.,9999,0,9999,0
1708257094458,PHIL 295,013,415946,Harrell; Maralee Mae,9999,0,9999,0
1708257094458,PHIL 295,014,415953,Johnson; Monte,9999,0,9999,0
1708257094458,PHIL 295,015,415954,Kovaka; Karenc,9999,0,9999,0
1708257094458,PHIL 295,016,415957,Lamey; Andy M.,9999,0,9999,0
1708257094458,PHIL 295,017,415958,Marechal; Patricia,9999,0,9999,0
1708257094458,PHIL 295,018,415959,McKenzie; Kerry V.,9999,0,9999,0
1708257094458,PHIL 295,019,415960,Nelkin; Dana Kay,9999,0,9999,0
1708257094458,PHIL 295,020,415961,Rickless; Samuel Charles,9999,0,9999,0
1708257094458,PHIL 295,021,415987,Sher; Gila,9999,0,9999,0
1708257094458,PHIL 295,022,416027,Shields; Christopher John,9999,0,9999,0
1708257094458,PHIL 295,023,416030,Tolley; Clinton,9999,0,9999,0
1708257094458,PHIL 295,024,416033,Vargas; Manuel Rogelio,9999,0,9999,0
1708257094458,PHIL 295,025,416034,Watkins; Eric,9999,0,9999,0
1708257094988,PHYA 224,A00,442106,Sandstrom; Karin Marie,30,0,30,0
1708257095514,PHYS 1A,A00,441607,Gilbert; Dylan Paul,346,0,362,16
1708257096048,PHYS 1AL,001,441608,Arlett; Jessica Lynn & Yagil; Avi,30,0,30,0
1708257096048,PHYS 1AL,002,441609,Arlett; Jessica Lynn & Yagil; Avi,28,0,30,2
1708257096048,PHYS 1AL,003,441610,Arlett; Jessica Lynn & Yagil; Avi,26,0,30,4
1708257096048,PHYS 1AL,004,441611,Arlett; Jessica Lynn & Yagil; Avi,29,0,30,1
1708257096048,PHYS 1AL,005,441612,Arlett; Jessica Lynn & Yagil; Avi,28,0,30,2
1708257096048,PHYS 1AL,006,441616,Arlett; Jessica Lynn & Yagil; Avi,28,0,30,2
1708257096048,PHYS 1AL,007,441618,Arlett; Jessica Lynn & Yagil; Avi,26,0,30,4
1708257096048,PHYS 1AL,008,441620,Arlett; Jessica Lynn & Yagil; Avi,29,0,30,1
1708257096048,PHYS 1AL,009,441623,Arlett; Jessica Lynn & Yagil; Avi,29,0,30,1
1708257096048,PHYS 1AL,010,441625,Arlett; Jessica Lynn & Yagil; Avi,29,0,30,1
1708257096048,PHYS 1AL,011,441626,Arlett; Jessica Lynn & Yagil; Avi,29,0,30,1
1708257096048,PHYS 1AL,012,441627,Arlett; Jessica Lynn & Yagil; Avi,29,0,30,1
1708257096573,PHYS 1B,A00,441630,Groisman; Alexander,351,0,362,11
1708257097103,PHYS 1BL,001,441632,Arlett; Jessica Lynn & Yagil; Avi,28,0,30,2
1708257097103,PHYS 1BL,002,441634,Arlett; Jessica Lynn & Yagil; Avi,29,0,30,1
1708257097103,PHYS 1BL,003,441636,Arlett; Jessica Lynn & Yagil; Avi,29,0,30,1
1708257097103,PHYS 1BL,004,441637,Arlett; Jessica Lynn & Yagil; Avi,29,0,30,1
1708257097103,PHYS 1BL,005,441639,Arlett; Jessica Lynn & Yagil; Avi,29,0,30,1
1708257097103,PHYS 1BL,006,441641,Arlett; Jessica Lynn & Yagil; Avi,26,0,30,4
1708257097103,PHYS 1BL,007,441642,Arlett; Jessica Lynn & Yagil; Avi,23,0,30,7
1708257097103,PHYS 1BL,008,441643,Arlett; Jessica Lynn & Yagil; Avi,30,0,30,0
1708257097103,PHYS 1BL,009,441646,Arlett; Jessica Lynn & Yagil; Avi,29,0,30,1
1708257097103,PHYS 1BL,010,441648,Arlett; Jessica Lynn & Yagil; Avi,29,0,30,1
1708257097103,PHYS 1BL,011,441652,Arlett; Jessica Lynn & Yagil; Avi,29,0,30,1
1708257097103,PHYS 1BL,012,441654,Arlett; Jessica Lynn & Yagil; Avi,30,0,30,0
1708257097630,PHYS 1C,A00,441658,Popmintchev; Tenio,587,0,600,13
1708257097630,PHYS 1C,B00,441662,Popmintchev; Tenio,558,0,600,42
1708257098174,PHYS 1CL,001,441664,Arlett; Jessica Lynn & Yagil; Avi,29,0,30,1
1708257098174,PHYS 1CL,002,441665,Arlett; Jessica Lynn & Yagil; Avi,27,0,30,3
1708257098174,PHYS 1CL,003,441666,Arlett; Jessica Lynn & Yagil; Avi,25,0,30,5
1708257098174,PHYS 1CL,004,441667,Arlett; Jessica Lynn & Yagil; Avi,30,0,30,0
1708257098174,PHYS 1CL,005,441668,Arlett; Jessica Lynn & Yagil; Avi,28,0,30,2
1708257098174,PHYS 1CL,006,441669,Arlett; Jessica Lynn & Yagil; Avi,25,0,30,5
1708257098174,PHYS 1CL,007,441671,Arlett; Jessica Lynn & Yagil; Avi,27,0,30,3
1708257098174,PHYS 1CL,008,441673,Arlett; Jessica Lynn & Yagil; Avi,30,0,30,0
1708257098174,PHYS 1CL,009,441674,Arlett; Jessica Lynn & Yagil; Avi,26,0,30,4
1708257098174,PHYS 1CL,010,441676,Arlett; Jessica Lynn & Yagil; Avi,30,0,30,0
1708257098174,PHYS 1CL,011,441677,Arlett; Jessica Lynn & Yagil; Avi,30,0,30,0
1708257098174,PHYS 1CL,012,441683,Arlett; Jessica Lynn & Yagil; Avi,30,0,30,0
1708257098174,PHYS 1CL,013,441685,Arlett; Jessica Lynn & Yagil; Avi,28,0,30,2
1708257098174,PHYS 1CL,014,441687,Arlett; Jessica Lynn & Yagil; Avi,30,0,30,0
1708257098174,PHYS 1CL,015,441689,Arlett; Jessica Lynn & Yagil; Avi,17,0,30,13
1708257098174,PHYS 1CL,016,441692,Arlett; Jessica Lynn & Yagil; Avi,29,0,30,1
1708257098174,PHYS 1CL,017,441696,Arlett; Jessica Lynn & Yagil; Avi,24,0,30,6
1708257098174,PHYS 1CL,018,441698,Arlett; Jessica Lynn & Yagil; Avi,25,0,30,5
1708257098174,PHYS 1CL,019,441702,Arlett; Jessica Lynn & Yagil; Avi,25,0,30,5
1708257098174,PHYS 1CL,020,441705,Arlett; Jessica Lynn & Yagil; Avi,29,0,30,1
1708257098174,PHYS 1CL,021,441706,Arlett; Jessica Lynn & Yagil; Avi,30,0,30,0
1708257098174,PHYS 1CL,022,441707,Arlett; Jessica Lynn & Yagil; Avi,30,0,30,0
1708257098174,PHYS 1CL,023,441708,Arlett; Jessica Lynn & Yagil; Avi,27,0,30,3
1708257098174,PHYS 1CL,024,441710,Arlett; Jessica Lynn & Yagil; Avi,29,0,30,1
1708257098174,PHYS 1CL,025,441711,Arlett; Jessica Lynn & Yagil; Avi,28,0,30,2
1708257098174,PHYS 1CL,026,441712,Arlett; Jessica Lynn & Yagil; Avi,29,0,30,1
1708257098174,PHYS 1CL,027,441713,Arlett; Jessica Lynn & Yagil; Avi,26,0,30,4
1708257098174,PHYS 1CL,028,441714,Arlett; Jessica Lynn & Yagil; Avi,29,0,30,1
1708257098174,PHYS 1CL,029,441715,Arlett; Jessica Lynn & Yagil; Avi,25,0,30,5
1708257098174,PHYS 1CL,030,441717,Arlett; Jessica Lynn & Yagil; Avi,29,0,30,1
1708257098174,PHYS 1CL,031,441718,Arlett; Jessica Lynn & Yagil; Avi,27,0,30,3
1708257098174,PHYS 1CL,032,441721,Arlett; Jessica Lynn & Yagil; Avi,30,0,30,0
1708257098174,PHYS 1CL,033,441724,Arlett; Jessica Lynn & Yagil; Avi,28,0,30,2
1708257098174,PHYS 1CL,034,441726,Arlett; Jessica Lynn & Yagil; Avi,29,0,30,1
1708257098174,PHYS 1CL,035,441728,Arlett; Jessica Lynn & Yagil; Avi,29,0,30,1
1708257098174,PHYS 1CL,036,441729,Arlett; Jessica Lynn & Yagil; Avi,30,0,30,0
1708257098174,PHYS 1CL,037,441730,Arlett; Jessica Lynn & Yagil; Avi,27,0,30,3
1708257098174,PHYS 1CL,038,441732,Arlett; Jessica Lynn & Yagil; Avi,29,0,30,1
1708257098174,PHYS 1CL,039,441733,Arlett; Jessica Lynn & Yagil; Avi,27,0,30,3
1708257098174,PHYS 1CL,040,441734,Arlett; Jessica Lynn & Yagil; Avi,30,0,30,0
1708257098174,PHYS 1CL,041,441735,Arlett; Jessica Lynn & Yagil; Avi,29,0,30,1
1708257098174,PHYS 1CL,042,441766,Arlett; Jessica Lynn & Yagil; Avi,30,0,30,0
1708257098174,PHYS 1CL,043,441768,Arlett; Jessica Lynn & Yagil; Avi,29,0,30,1
1708257098174,PHYS 1CL,044,441770,Arlett; Jessica Lynn & Yagil; Avi,30,0,30,0
1708257098706,PHYS 2A,A01,460308,Bal; Gurleen K,28,0,30,2
1708257098706,PHYS 2A,A02,460320,Bal; Gurleen K,30,0,30,0
1708257098706,PHYS 2A,A03,460321,Bal; Gurleen K,29,0,30,1
1708257098706,PHYS 2A,A04,460325,Bal; Gurleen K,28,0,30,2
1708257098706,PHYS 2A,A05,460326,Bal; Gurleen K,29,0,30,1
1708257098706,PHYS 2A,A06,460327,Bal; Gurleen K,30,0,30,0
1708257098706,PHYS 2A,A07,460495,Bal; Gurleen K,28,0,30,2
1708257098706,PHYS 2A,A08,460535,Bal; Gurleen K,27,0,30,3
1708257098706,PHYS 2A,A09,460536,Bal; Gurleen K,30,0,30,0
1708257098706,PHYS 2A,A10,460537,Bal; Gurleen K,30,0,30,0
1708257098706,PHYS 2A,A11,460538,Bal; Gurleen K,30,0,30,0
1708257098706,PHYS 2A,A12,460539,Bal; Gurleen K,30,0,30,0
1708257099240,PHYS 2B,A01,460620,Barreiro Guerrero; Julio,30,0,30,0
1708257099240,PHYS 2B,A02,460625,Barreiro Guerrero; Julio,30,0,30,0
1708257099240,PHYS 2B,A03,460626,Barreiro Guerrero; Julio,29,0,30,1
1708257099240,PHYS 2B,A04,460716,Barreiro Guerrero; Julio,26,0,30,4
1708257099240,PHYS 2B,A05,460756,Barreiro Guerrero; Julio,29,0,30,1
1708257099240,PHYS 2B,A06,460837,Barreiro Guerrero; Julio,30,0,30,0
1708257099240,PHYS 2B,A07,460865,Barreiro Guerrero; Julio,30,0,30,0
1708257099240,PHYS 2B,A08,460866,Barreiro Guerrero; Julio,30,0,30,0
1708257099240,PHYS 2B,A09,460867,Barreiro Guerrero; Julio,29,0,30,1
1708257099240,PHYS 2B,A10,460868,Barreiro Guerrero; Julio,30,0,30,0
1708257099240,PHYS 2B,A11,460869,Barreiro Guerrero; Julio,30,0,30,0
1708257099240,PHYS 2B,A12,460874,Barreiro Guerrero; Julio,30,0,30,0
1708257099240,PHYS 2B,B01,469381,Barreiro Guerrero; Julio,30,0,30,0
1708257099240,PHYS 2B,B02,469382,Barreiro Guerrero; Julio,29,0,30,1
1708257099240,PHYS 2B,B03,469402,Barreiro Guerrero; Julio,27,0,30,3
1708257099240,PHYS 2B,B04,469403,Barreiro Guerrero; Julio,28,0,30,2
1708257099240,PHYS 2B,B05,469442,Barreiro Guerrero; Julio,30,0,30,0
1708257099240,PHYS 2B,B06,469449,Barreiro Guerrero; Julio,30,0,30,0
1708257099240,PHYS 2B,B07,469450,Barreiro Guerrero; Julio,29,0,30,1
1708257099240,PHYS 2B,B08,469451,Barreiro Guerrero; Julio,30,0,30,0
1708257099240,PHYS 2B,B09,469457,Barreiro Guerrero; Julio,29,0,30,1
1708257099240,PHYS 2B,B10,469460,Barreiro Guerrero; Julio,30,0,30,0
1708257099240,PHYS 2B,B11,469468,Barreiro Guerrero; Julio,30,0,30,0
1708257099240,PHYS 2B,B12,469475,Barreiro Guerrero; Julio,30,0,30,0
1708257099768,PHYS 2BL,A01,441779,Meyertholen; Andrew D.,21,0,24,3
1708257099768,PHYS 2BL,A02,441780,Meyertholen; Andrew D.,17,0,24,7
1708257099768,PHYS 2BL,A03,441781,Meyertholen; Andrew D.,20,0,24,4
1708257099768,PHYS 2BL,A04,441782,Meyertholen; Andrew D.,21,0,24,3
1708257099768,PHYS 2BL,A05,441784,Meyertholen; Andrew D.,23,0,24,1
1708257099768,PHYS 2BL,A06,441786,Meyertholen; Andrew D.,23,0,24,1
1708257099768,PHYS 2BL,A07,441788,Meyertholen; Andrew D.,23,0,24,1
1708257099768,PHYS 2BL,A08,441790,Meyertholen; Andrew D.,24,0,24,0
1708257099768,PHYS 2BL,A09,441792,Meyertholen; Andrew D.,24,0,24,0
1708257099768,PHYS 2BL,A10,441794,Meyertholen; Andrew D.,23,0,24,1
1708257099768,PHYS 2BL,A11,441796,Meyertholen; Andrew D.,22,0,24,2
1708257099768,PHYS 2BL,A12,441798,Meyertholen; Andrew D.,24,0,24,0
1708257099768,PHYS 2BL,A13,441800,Meyertholen; Andrew D.,24,0,24,0
1708257099768,PHYS 2BL,A14,441802,Meyertholen; Andrew D.,24,0,24,0
1708257099768,PHYS 2BL,A15,441804,Meyertholen; Andrew D.,23,0,24,1
1708257100300,PHYS 2C,A01,460540,Tan; Tzer Han,30,0,30,0
1708257100300,PHYS 2C,A02,460541,Tan; Tzer Han,28,0,30,2
1708257100300,PHYS 2C,A03,460542,Tan; Tzer Han,28,0,30,2
1708257100300,PHYS 2C,A04,460543,Tan; Tzer Han,28,0,30,2
1708257100300,PHYS 2C,A05,460544,Tan; Tzer Han,28,0,30,2
1708257100300,PHYS 2C,A06,460545,Tan; Tzer Han,29,0,30,1
1708257100300,PHYS 2C,A07,460553,Tan; Tzer Han,30,0,30,0
1708257100300,PHYS 2C,A08,460561,Tan; Tzer Han,30,0,30,0
1708257100300,PHYS 2C,A09,460562,Tan; Tzer Han,28,0,30,2
1708257100300,PHYS 2C,A10,460563,Tan; Tzer Han,29,0,30,1
1708257100300,PHYS 2C,A11,460567,Tan; Tzer Han,30,0,30,0
1708257100300,PHYS 2C,A12,460568,Tan; Tzer Han,28,0,30,2
1708257100827,PHYS 2CL,A01,441809,Ni; Kaixuan,25,0,28,3
1708257100827,PHYS 2CL,A02,441811,Ni; Kaixuan,27,0,28,1
1708257100827,PHYS 2CL,A03,441814,Ni; Kaixuan,23,0,28,5
1708257100827,PHYS 2CL,A04,441817,Ni; Kaixuan,28,0,28,0
1708257100827,PHYS 2CL,A05,441819,Ni; Kaixuan,26,0,28,2
1708257100827,PHYS 2CL,A06,441820,Ni; Kaixuan,27,0,28,1
1708257101354,PHYS 2D,A01,460569,Sharma; Vivek A.,24,0,25,1
1708257101354,PHYS 2D,A02,460574,Sharma; Vivek A.,24,0,25,1
1708257101354,PHYS 2D,A03,460575,Sharma; Vivek A.,25,0,25,0
1708257101886,PHYS 4B,A01,441829,Grinstein; Benjamin,34,0,38,4
1708257101886,PHYS 4B,A02,441831,Grinstein; Benjamin,30,0,32,2
1708257101886,PHYS 4B,A03,441832,Grinstein; Benjamin,30,0,30,0
1708257101886,PHYS 4B,A04,441833,Grinstein; Benjamin,30,0,30,0
1708257102413,PHYS 4E,A01,441907,Frano Pereira; Alex M,33,0,34,1
1708257102413,PHYS 4E,A02,441958,Frano Pereira; Alex M,34,0,34,0
1708257102939,PHYS 10,A01,441971,Burgasser; Adam Jonathan,118,0,120,2
1708257103463,PHYS 13,A01,441974,Wright; Shelley Adams,61,0,65,4
1708257103988,PHYS 87,A00,486898,Grinstein; Benjamin,19,0,20,1
1708257104583,PHYS 100C,A01,441978,Averitt; Richard Douglas,58,0,60,2
1708257105110,PHYS 105B,A01,441985,Green; Daniel Richard,37,0,40,3
1708257105635,PHYS 120,A01,441995,Arnold; Kam S,40,0,44,4
1708257105635,PHYS 120,A02,442011,Arnold; Kam S,41,0,44,3
1708257106160,PHYS 130A,A01,442032,Parker; Daniel E,74,0,75,1
1708257106691,PHYS 130B,A01,442056,Branson; James G,47,0,50,3
1708257107219,PHYS 139,A00,442057,Jun; Suckjoon,30,0,30,0
1708257107219,PHYS 139,B00,442059,Duarte; Javier Mauricio & Li; Aobo,42,0,50,8
1708257107744,PHYS 140A,A01,442065,Shotwell; Brian,49,0,50,1
1708257108275,PHYS 152B,A01,442067,Hirsch; Jorge Eduardo,16,0,20,4
1708257108801,PHYS 154,A01,442069,Jenkins; Elizabeth,29,0,30,1
1708257109331,PHYS 162,A01,442096,Keating; Brian,64,0,65,1
1708257109857,PHYS 170,A01,486870,Oh; Seungeun,39,0,40,1
1708257110382,PHYS 177,A00,442103,Dudko; Olga,20,0,20,0
1708257110912,PHYS 203B,A01,442132,Fogler; Michael M.,20,0,20,0
1708257111438,PHYS 210A,A01,442143,Hwa; Terence T.,20,0,20,0
1708257111963,PHYS 212C,A01,442200,Chivukula; Raja S,18,0,20,2
1708257112494,PHYS 215C,A00,442201,Intriligator; Kenneth Arthur,19,0,20,1
1708257113021,PHYS 225C,A01,442203,Flauger; Raphael M,19,0,20,1
1708257113551,PHYS 227,A00,442204,Tytler; David Robert,29,0,30,1
1708257114079,PHYS 230,A01,442206,McGreevy; John A.,20,0,20,0
1708257114604,PHYS 239,A00,442207,Goldenfeld; Nigel,20,0,20,0
1708257114604,PHYS 239,B00,442208,Duarte; Javier Mauricio & Li; Aobo,5,0,5,0
1708257115134,PHYS 244,A01,442280,Norman; Michael L,12,0,20,8
1708257115659,PHYS 250,A00,442300,Fogler; Michael M.,50,0,50,0
1708257116185,PHYS 251,A00,442307,Grinstein; Benjamin,20,0,20,0
1708257116712,PHYS 252,A00,442348,Diamond; Patrick H,10,0,10,0
1708257117238,PHYS 253,A00,442349,Theissen; Christopher Alexander,30,0,30,0
1708257117765,PHYS 254,A00,442352,Hwa; Terence T.,30,0,30,0
1708257118290,PHYS 255,A00,442423,Hwa; Terence T.,30,0,30,0
1708257118815,PHYS 258,A00,442426,Theissen; Christopher Alexander,30,0,30,0
1708257119340,PHYS 260,A00,442427,Frano Pereira; Alex M,50,0,50,0
1708257119871,PHYS 277,A00,442428,Dudko; Olga,20,0,20,0
1708257120413,POLI 5D,A01,419010,Dai; Yinlin,5,0,7,2
1708257120413,POLI 5D,A02,419020,Dai; Yinlin,7,0,7,0
1708257120413,POLI 5D,A03,419022,Dai; Yinlin,4,0,6,2
1708257120413,POLI 5D,A04,419040,Dai; Yinlin,5,0,5,0
1708257120413,POLI 5D,B01,419065,Dai; Yinlin,7,0,7,0
1708257120413,POLI 5D,B02,419068,Dai; Yinlin,7,0,7,0
1708257120413,POLI 5D,B03,419069,Dai; Yinlin,6,0,6,0
1708257120413,POLI 5D,B04,419070,Dai; Yinlin,5,0,5,0
1708257120413,POLI 5D,C01,487211,Staff,3,0,5,2
1708257120941,POLI 11D,A01,419072,Desposato; Scott,32,0,34,2
1708257120941,POLI 11D,A02,419073,Desposato; Scott,33,0,34,1
1708257120941,POLI 11D,A03,419082,Desposato; Scott,32,0,34,2
1708257120941,POLI 11D,A04,419123,Desposato; Scott,34,0,34,0
1708257120941,POLI 11D,A05,419124,Desposato; Scott,34,0,34,0
1708257120941,POLI 11D,A06,419125,Desposato; Scott,34,0,34,0
1708257121468,POLI 12D,A01,419127,Gartzke; Erik,29,0,34,5
1708257121468,POLI 12D,A02,419128,Gartzke; Erik,34,0,34,0
1708257121468,POLI 12D,A03,419129,Gartzke; Erik,34,0,34,0
1708257121468,POLI 12D,A04,419130,Gartzke; Erik,34,0,34,0
1708257121468,POLI 12D,A05,419131,Gartzke; Erik,32,0,34,2
1708257121468,POLI 12D,A06,419168,Gartzke; Erik,34,0,34,0
1708257121999,POLI 13DR,A01,477733,Draper; Matthew William,28,0,34,6
1708257121999,POLI 13DR,A02,477734,Draper; Matthew William,32,0,34,2
1708257121999,POLI 13DR,A03,477736,Draper; Matthew William,33,0,34,1
1708257121999,POLI 13DR,A04,477737,Draper; Matthew William,32,0,34,2
1708257121999,POLI 13DR,A05,477739,Draper; Matthew William,31,0,34,3
1708257121999,POLI 13DR,A06,477740,Draper; Matthew William,34,0,34,0
1708257122545,POLI 30D,A01,419179,Desposato; Scott,19,0,28,9
1708257122545,POLI 30D,A02,419180,Desposato; Scott,25,0,28,3
1708257122545,POLI 30D,A03,419181,Desposato; Scott,27,0,28,1
1708257122545,POLI 30D,A04,419182,Desposato; Scott,28,0,28,0
1708257122545,POLI 30D,A05,419187,Desposato; Scott,24,0,28,4
1708257122545,POLI 30D,A06,419189,Desposato; Scott,28,0,28,0
1708257123073,POLI 100E,A00,419191,Pitcher; Kennedy Anell,105,0,115,10
1708257123600,POLI 104P,A00,419192,Orfield; Michael Bennett,183,0,196,13
1708257124129,POLI 104U,A00,419193,Nichter; Maysa,88,0,115,27
1708257124670,POLI 108,A00,419194,Adida; Claire,293,0,295,2
1708257125195,POLI 110C,A00,419195,Soon; Valerie,47,0,50,3
1708257125724,POLI 120D,A00,419207,Hansen; Jan Eric,48,0,50,2
1708257126249,POLI 124A,A00,419209,Fortunato; David,48,0,50,2
1708257126780,POLI 131CR,A00,419211,Hoston; Germaine,41,0,50,9
1708257126780,POLI 131CR,B00,481592,Hoston; Germaine,10,0,10,0
1708257127307,POLI 136A,A00,419212,Roeder; Philip G,111,0,115,4
1708257127834,POLI 140D,A00,419213,Wong; Tak Kei,183,0,192,9
1708257128363,POLI 142D,A00,419214,Gartzke; Erik,227,0,230,3
1708257128889,POLI 145C,A00,419222,Fisk; David Lee,101,0,115,14
1708257129419,POLI 150A,A00,419225,Wong; Tak Kei,216,0,230,14
1708257129946,POLI 170A,A00,419226,Skillman; Rachel Diane,115,0,115,0
1708257130474,POLI 179,A00,419238,Staff,95,0,104,9
1708257130999,POLI 194,A00,455332,Hill; Seth J,0,0,0,0
1708257131527,POLI 194SD,A00,419248,Nichter; Maysa,999,0,999,0
1708257132052,POLI 197SD,001,419258,Nichter; Maysa,999,0,999,0
1708257132576,POLI 203B,A00,419265,Slantchev; Branislav,21,0,25,4
1708257133105,POLI 214R,A00,419275,Hoston; Germaine,23,0,25,2
1708257133629,POLI 219,A00,419289,Soon; Valerie,24,0,25,1
1708257134156,POLI 220A,A00,419299,Ferree; Karen E,21,0,25,4
1708257134681,POLI 233,A00,419333,Adida; Claire,23,0,25,2
1708257135205,POLI 243,A00,479118,Joseph; Michael F,23,0,25,2
1708257135732,POLI 251,A00,419334,Ban; Pamela M,23,0,25,2
1708257136257,POLI 257,A00,419335,Hill; Seth J,25,0,25,0
1708257136784,POLI 273,A00,419336,Mignozzetti; Umberto,16,0,25,9
1708257137313,POLI 280,A00,419337,Hafner-Burton; Emilie,18,0,25,7
1708257137839,POLI 281,A00,419338,Ban; Pamela M,21,0,25,4
1708257138364,POLI 282,A00,419339,Ferree; Karen E,19,0,25,6
1708257138894,POLI 283,A00,419340,Naoi; Megumi,23,0,25,2
1708257139421,POLI 285,A00,419341,Ingham; Sean,25,0,25,0
1708257139947,POLI 286,A00,419342,Mignozzetti; Umberto,23,0,25,2
1708257140475,POLI 288,A00,479174,Fowler; James,13,0,15,2
1708257141002,PSY 296,001,465760,Besterman; Aaron David,49,0,50,1
1708257141002,PSY 296,002,465765,Eyler; Lisa T.,49,0,50,1
1708257141002,PSY 296,003,465767,Patel; Ekta Himanshu,49,0,50,1
1708257141527,PSYC 3R,A00,419378,Pilegard; Celeste Cristine,314,0,325,11
1708257142126,PSYC 7,A00,419384,Powell; Lindsey Jane,288,0,295,7
1708257142670,PSYC 60,A01,460208,Lowe; Angela Beth,31,0,35,4
1708257142670,PSYC 60,A02,460209,Lowe; Angela Beth,28,0,35,7
1708257142670,PSYC 60,A03,460210,Lowe; Angela Beth,35,0,35,0
1708257142670,PSYC 60,A04,460211,Lowe; Angela Beth,33,0,35,2
1708257142670,PSYC 60,A05,460212,Lowe; Angela Beth,34,0,35,1
1708257142670,PSYC 60,A06,460213,Lowe; Angela Beth,35,0,35,0
1708257142670,PSYC 60,A07,460214,Lowe; Angela Beth,33,0,35,2
1708257142670,PSYC 60,B01,460215,Rose; Fred E.,35,0,35,0
1708257142670,PSYC 60,B02,460216,Rose; Fred E.,35,0,35,0
1708257142670,PSYC 60,B03,460218,Rose; Fred E.,35,0,35,0
1708257142670,PSYC 60,B04,460219,Rose; Fred E.,35,0,35,0
1708257142670,PSYC 60,B05,460220,Rose; Fred E.,32,0,35,3
1708257142670,PSYC 60,B06,460221,Rose; Fred E.,35,0,35,0
1708257142670,PSYC 60,B07,460222,Rose; Fred E.,35,0,35,0
1708257143197,PSYC 70,A01,460223,Pilegard; Celeste Cristine,29,0,35,6
1708257143197,PSYC 70,A02,460224,Pilegard; Celeste Cristine,32,0,35,3
1708257143197,PSYC 70,A03,460225,Pilegard; Celeste Cristine,34,0,35,1
1708257143197,PSYC 70,A04,460266,Pilegard; Celeste Cristine,33,0,35,2
1708257143197,PSYC 70,A05,460267,Pilegard; Celeste Cristine,35,0,35,0
1708257143197,PSYC 70,A06,460277,Pilegard; Celeste Cristine,34,0,35,1
1708257143726,PSYC 71,A01,419620,Staff,19,0,21,2
1708257143726,PSYC 71,A02,419662,Staff,20,0,21,1
1708257143726,PSYC 71,B01,419682,Geller; Emma Harlan,24,0,25,1
1708257143726,PSYC 71,B02,419732,Geller; Emma Harlan,26,0,26,0
1708257144251,PSYC 88,A00,419733,Dobkins; Karen R.,47,0,65,18
1708257144782,PSYC 100,A00,419734,Chapman; Eddie Nathaniel,388,0,410,22
1708257145308,PSYC 101,A00,419735,Walker; Caren Michelle,272,0,295,23
1708257145834,PSYC 102,A00,419779,Moranton; Nirelia Melbina-,292,0,295,3
1708257146360,PSYC 104,A00,419880,Fine; Rachel,267,0,295,28
1708257146887,PSYC 105,A00,419946,Lowe; Angela Beth,276,0,295,19
1708257147412,PSYC 111B,A01,419948,Geller; Emma Harlan,35,0,35,0
1708257147942,PSYC 116C,A01,420046,Lang; Ariel,25,0,25,0
1708257148479,PSYC 117,A01,420092,Bajic; Daniel Andrew,25,0,25,0
1708257149005,PSYC 118,A01,420095,Miller; Cory T.,37,0,45,8
1708257149533,PSYC 124,A00,420096,Chapman; Eddie Nathaniel,381,0,410,29
1708257150060,PSYC 127,A00,420097,Dickenson; Janna Alene,14,0,20,6
1708257150590,PSYC 132,A00,420121,Staff,114,0,120,6
1708257151116,PSYC 133R,A01,420172,Golden; Susan S. & Gorman; Michael R.,10,0,16,6
1708257151116,PSYC 133R,A02,420173,Golden; Susan S. & Gorman; Michael R.,16,0,16,0
1708257151116,PSYC 133R,A03,420175,Golden; Susan S. & Gorman; Michael R.,16,0,16,0
1708257151116,PSYC 133R,A04,420249,Golden; Susan S. & Gorman; Michael R.,13,0,16,3
1708257151641,PSYC 134,A00,420311,Kaye; Walter H.,296,0,300,4
1708257152170,PSYC 137,A00,420312,Lin; Chujun,292,0,295,3
1708257152701,PSYC 144,A00,420313,Wixted; John T,287,0,295,8
1708257153226,PSYC 147,A00,420315,Wong; Lauren Hitomi,120,0,146,26
1708257153751,PSYC 164,A00,420328,Kaplan; Paul,259,0,295,36
1708257154295,PSYC 172,A00,420336,Dickenson; Janna Alene,294,0,300,6
1708257154820,PSYC 178,A00,420337,Glaser; Dale,131,0,146,15
1708257155349,PSYC 179,A00,420338,Lacefield; Katharine I,256,0,328,72
1708257155875,PSYC 181,A00,420339,Anagnostaras; Stephan,333,0,350,17
1708257156403,PSYC 184,A00,420367,Wilson; Brent M,275,0,295,20
1708257156932,PSYC 188,A00,420368,Lacefield; Katharine I,234,0,300,66
1708257157458,PSYC 190,A00,420378,Barner; David A.,374,0,395,21
1708257158043,PSYC 193,B00,420626,Brashier; Nadia Marie,215,0,216,1
1708257158043,PSYC 193,C00,420643,Gremel; Christina M,33,0,35,2
1708257158570,PSYC 193L,A01,420817,Brown; Sandra A,65,0,65,0
1708257158570,PSYC 193L,B01,420830,Staff,26,0,30,4
1708257158570,PSYC 193L,C01,420832,Staff,49,0,49,0
1708257158570,PSYC 193L,D01,420834,Staff,27,0,30,3
1708257158570,PSYC 193L,E01,493996,Aron; Adam,24,0,24,0
1708257159095,PSYC 194C,A01,420905,Heyman; Gail D.,1,0,1,0
1708257159621,PSYC 205,A00,420906,Harris; Christine Renee,17,0,20,3
1708257160145,PSYC 218,A00,420907,Brady; Timothy Francis,11,0,20,9
1708257160673,PSYC 224,A00,420908,Gremel; Christina M,30,0,30,0
1708257161198,PSYC 242,A00,421469,Walker; Caren Michelle,27,0,30,3
1708257161724,PSYC 247,A00,421473,Walker; Caren Michelle,14,0,20,6
1708257162251,PSYC 270C,A00,421554,Dobkins; Karen R.,13,0,20,7
1708257162775,PSYC 272,A00,421561,Gentner; Tim,20,0,20,0
1708257163300,PSYC 274,A00,421564,McCullough; Michael E,29,0,30,1
1708257163824,PSYC 275,A00,421620,Staff,23,0,30,7
1708257164353,PSYC 276,A00,421622,McCullough; Michael E,14,0,20,6
1708257164877,PSYC 280,A00,421623,Serences; John Thomas,76,0,85,9
1708257165407,PSYC 296,001,421667,Anagnostaras; Stephan,9999,0,9999,0
1708257165407,PSYC 296,002,421773,Aron; Adam,9999,0,9999,0
1708257165407,PSYC 296,003,421794,Mukku; Dhananjaya,9999,0,9999,0
1708257165407,PSYC 296,004,421795,Barner; David A.,9998,0,9999,1
1708257165407,PSYC 296,005,421796,Schachner; Adena,9999,0,9999,0
1708257165407,PSYC 296,006,421797,Brown; Sandra A,9999,0,9999,0
1708257165407,PSYC 296,007,421798,Chapman; Eddie Nathaniel,9999,0,9999,0
1708257165407,PSYC 296,008,421799,Dickenson; Janna Alene,9999,0,9999,0
1708257165407,PSYC 296,009,421800,Dobkins; Karen R.,9998,0,9999,1
1708257165407,PSYC 296,010,421801,Fan; Judith Ellen,9999,0,9999,0
1708257165407,PSYC 296,011,421803,Ferreira; Victor,9999,0,9999,0
1708257165407,PSYC 296,012,421814,Geller; Emma Harlan,9998,0,9999,1
1708257165407,PSYC 296,013,422102,Gentner; Tim,9999,0,9999,0
1708257165407,PSYC 296,014,422103,Gorman; Michael R.,9999,0,9999,0
1708257165407,PSYC 296,015,422104,Gremel; Christina M,9999,0,9999,0
1708257165407,PSYC 296,016,422106,Harris; Christine Renee,9999,0,9999,0
1708257165407,PSYC 296,017,422107,Heyman; Gail D.,9999,0,9999,0
1708257165407,PSYC 296,018,422108,McCullough; Michael E,9999,0,9999,0
1708257165407,PSYC 296,019,422109,Mc Kenzie; Craig R.M.,9999,0,9999,0
1708257165407,PSYC 296,020,422122,Miller; Cory T.,9999,0,9999,0
1708257165407,PSYC 296,021,422123,Pashler; Harold E,9999,0,9999,0
1708257165407,PSYC 296,022,422124,Pilegard; Celeste Cristine,9999,0,9999,0
1708257165407,PSYC 296,023,422125,Powell; Lindsey Jane,9999,0,9999,0
1708257165407,PSYC 296,025,422127,Rickard; Timothy C.,9998,0,9999,1
1708257165407,PSYC 296,026,422128,Serences; John Thomas,9998,0,9999,1
1708257165407,PSYC 296,027,422130,Walker; Caren Michelle,9998,0,9999,1
1708257165407,PSYC 296,028,422132,Winkielman; Piotr,9999,0,9999,0
1708257165407,PSYC 296,029,422134,Wixted; John T,9996,0,9999,3
1708257165407,PSYC 296,030,422146,Brady; Timothy Francis,9998,0,9999,1
1708257165407,PSYC 296,031,422154,Carver; Leslie J.,9999,0,9999,0
1708257165407,PSYC 296,032,422161,Lin; Chujun,9999,0,9999,0
1708257165407,PSYC 296,033,422169,Brashier; Nadia Marie,9998,0,9999,1
1708257165407,PSYC 296,034,422177,Oesch; Nicholas W,9999,0,9999,0
1708257165936,RAD 296,001,465795,Staff,50,0,50,0
1708257165936,RAD 296,002,465796,Staff,50,0,50,0
1708257165936,RAD 296,003,465797,Staff,50,0,50,0
1708257166461,RELI 150,A00,419353,Rahimi; Babak,37,0,40,3
1708257166989,REV 87,A00,422721,Lyon; Antony J.,19,0,20,1
1708257167514,RMAS 296,001,465827,Murphy; James D,49,0,50,1
1708257167514,RMAS 296,002,465828,Staff,50,0,50,0
1708257167514,RMAS 296,003,465831,Staff,50,0,50,0
1708257168040,RMED 296,001,466791,Staff,50,0,50,0
1708257168040,RMED 296,002,466792,Staff,50,0,50,0
1708257168040,RMED 296,003,466793,Staff,50,0,50,0
1708257168570,SE 3,A01,446938,Van Den Einde; Yael Dahlia,50,0,52,2
1708257168570,SE 3,A02,446942,Van Den Einde; Yael Dahlia,49,0,52,3
1708257168570,SE 3,A03,446948,Van Den Einde; Yael Dahlia,52,0,53,1
1708257168570,SE 3,A04,446965,Van Den Einde; Yael Dahlia,53,0,53,0
1708257169095,SE 9,A01,447015,Kuester; Falko,30,0,34,4
1708257169095,SE 9,A02,447017,Kuester; Falko,33,0,33,0
1708257169095,SE 9,A03,447022,Kuester; Falko,31,0,33,2
1708257169625,SE 101B,A01,447040,Kosmatka; John B,55,0,56,1
1708257170150,SE 105,A01,447042,Qiao; Yu,118,0,120,2
1708257170679,SE 110A,A01,467467,Asaro; Robert J,56,0,56,0
1708257171205,SE 110B,A00,447045,Zhu; Qiang,122,0,125,3
1708257171731,SE 130B,A01,447049,Chadha; Mayank,92,0,100,8
1708257172259,SE 131A,A01,447059,Krysl; Petr,102,0,110,8
1708257172788,SE 132,A01,447078,Chen; Jiun-Shyan,48,0,50,2
1708257173313,SE 140B,A01,447086,Restrepo; Jose,29,0,34,5
1708257173313,SE 140B,A02,447123,Restrepo; Jose,21,0,33,12
1708257173313,SE 140B,A03,447124,Restrepo; Jose,30,0,33,3
1708257173840,SE 143B,A01,447133,Tehrani; Mehran,11,0,15,4
1708257173840,SE 143B,A02,447134,Tehrani; Mehran,12,0,15,3
1708257174370,SE 150A,A01,447136,Uang; Chia-Ming,94,0,100,6
1708257174896,SE 150B,A01,447214,Morrison; Machel Leigh,49,0,50,1
1708257175427,SE 151B,A00,447215,Shing; P. Benson,71,0,75,4
1708257175956,SE 160B,A01,467468,Kim; Hyunsun Alicia,91,0,100,9
1708257176482,SE 165,A00,447238,Farrar; Charles R.,9,0,10,1
1708257177010,SE 184,A00,447253,Hutchinson; Tara,20,0,20,0
1708257177536,SE 202,A00,447392,Kosmatka; John B,25,0,30,5
1708257178063,SE 204,A00,447482,Todd; Michael,12,0,20,8
1708257178591,SE 206,A00,447483,Conte; Joel P,30,0,30,0
1708257179117,SE 213,A00,447499,Palermo; Alessandro,17,0,30,13
1708257179646,SE 215,A00,447500,Zhu; Qiang,34,0,45,11
1708257180172,SE 222,A00,447507,Elgamal; Ahmed,30,0,30,0
1708257180699,SE 227,A00,447576,Hutchinson; Tara,20,0,25,5
1708257181228,SE 244,A00,447577,Elgamal; Ahmed,29,0,30,1
1708257181753,SE 247,A00,447580,Hutchinson; Tara,0,0,5,5
1708257182282,SE 251B,A00,447612,Qiao; Yu,15,0,25,10
1708257182808,SE 253B,A00,447613,Kim; Hyonny,28,0,30,2
1708257183334,SE 260B,A00,447614,Kim; Hyunsun Alicia,10,0,10,0
1708257183862,SE 265,A00,447615,Farrar; Charles R.,20,0,25,5
1708257184387,SE 266,A00,447616,Loh; Chin Hsiung,23,0,25,2
1708257185442,SE 280,A00,447650,Krysl; Petr,22,0,25,3
1708257185972,SE 281,A01,447658,Kuester; Falko,12,0,30,18
1708257186498,SE 290,A00,447659,Qiao; Yu,78,0,100,22
1708257187031,SE 296,001,447666,Asaro; Robert J,9999,0,9999,0
1708257187031,SE 296,002,447669,Chen; Jiun-Shyan,9999,0,9999,0
1708257187031,SE 296,003,447689,Conte; Joel P,9999,0,9999,0
1708257187031,SE 296,004,447690,Elgamal; Ahmed,9999,0,9999,0
1708257187031,SE 296,005,447728,Hutchinson; Tara,9999,0,9999,0
1708257187031,SE 296,006,447733,Jandaghi Semnani; Shabnam,9999,0,9999,0
1708257187031,SE 296,007,447734,Kim; Hyonny,9999,0,9999,0
1708257187031,SE 296,008,447737,Kim; Hyunsun Alicia,9999,0,9999,0
1708257187031,SE 296,009,447738,Kosmatka; John B,9999,0,9999,0
1708257187031,SE 296,010,447739,Krysl; Petr,9999,0,9999,0
1708257187031,SE 296,011,447740,Kuester; Falko,9999,0,9999,0
1708257187031,SE 296,012,447741,Lanza Di Scalea; Francesco,9999,0,9999,0
1708257187031,SE 296,013,447742,Loh; Kenneth J. H.,9999,0,9999,0
1708257187031,SE 296,014,447745,McCartney; John Scott,9999,0,9999,0
1708257187031,SE 296,015,447747,Morrison; Machel Leigh,9999,0,9999,0
1708257187031,SE 296,016,447749,Mosqueda; Gilberto,9999,0,9999,0
1708257187031,SE 296,017,447874,Qiao; Yu,9999,0,9999,0
1708257187031,SE 296,018,447875,Restrepo; Jose,9999,0,9999,0
1708257187031,SE 296,019,447886,Shing; P. Benson,9999,0,9999,0
1708257187031,SE 296,020,447887,Todd; Michael,9999,0,9999,0
1708257187031,SE 296,021,447888,Tomac; Ingrid,9999,0,9999,0
1708257187031,SE 296,022,447889,Tsampras; Georgios,9999,0,9999,0
1708257187031,SE 296,023,447890,Uang; Chia-Ming,9999,0,9999,0
1708257187031,SE 296,024,447931,Van Den Einde; Yael Dahlia,9999,0,9999,0
1708257187031,SE 296,025,447932,Zhu; Qiang,9999,0,9999,0
1708257187031,SE 296,026,448007,Tehrani; Mehran,9999,0,9999,0
1708257187031,SE 296,027,448008,Palermo; Alessandro,9999,0,9999,0
1708257187031,SE 296,028,492941,Farrar; Charles R.,9998,0,9999,1
1708257187560,SIO 10,A00,446025,Borsa; Adrian Antal,573,0,590,17
1708257188085,SIO 16,A00,446031,Gee; Jeffrey S,119,0,120,1
1708257188610,SIO 50,A01,446057,Cook; Geoffrey W,19,0,22,3
1708257188610,SIO 50,A02,446058,Cook; Geoffrey W,21,0,22,1
1708257189135,SIO 75,A00,446060,Norris; Richard D.,32,0,35,3
1708257189665,SIO 87,A00,479215,Feddersen; Falk & Morzfeld; Matthias,20,0,20,0
1708257189665,SIO 87,B00,489613,Cook; Geoffrey W,19,0,20,1
1708257189665,SIO 87,C00,489620,Cook; Geoffrey W,20,0,20,0
1708257190191,SIO 90,A00,446061,Staff,61,0,70,9
1708257190722,SIO 113,A01,446064,May; David Alexander,27,0,30,3
1708257191773,SIO 128,A00,446115,Bartlett; Douglas H,110,0,120,10
1708257192302,SIO 135,A01,446153,Fricker; Helen A.,16,0,17,1
1708257192302,SIO 135,A02,446156,Fricker; Helen A.,14,0,18,4
1708257192829,SIO 136,A01,446159,Kacev; David & Wegner; Nicholas Craig & Bartlett; Douglas H,31,0,33,2
1708257192829,SIO 136,A02,446160,Kacev; David & Wegner; Nicholas Craig & Bartlett; Douglas H,33,0,33,0
1708257193355,SIO 139,A00,446164,Kacev; David,66,0,70,4
1708257193886,SIO 141,A01,446173,Pomeroy; Robert S.,11,0,12,1
1708257194411,SIO 143,A01,446175,Andersson; Andreas Jerry,20,0,30,10
1708257194946,SIO 145,A01,446181,Choy; Carolyn Anela,6,0,18,12
1708257195471,SIO 152,A01,446184,Van Allen; Emily Joyce,8,0,10,2
1708257195471,SIO 152,A02,479204,Van Allen; Emily Joyce,10,0,10,0
1708257195997,SIO 153,A01,446188,Capaldi; Tomas,24,0,26,2
1708257196526,SIO 160,A00,446189,Stegman; David,21,0,25,4
1708257197052,SIO 164,A00,446193,Staff,27,0,35,8
1708257197577,SIO 173,A00,446194,Lutsko; Nicholas J.,28,0,30,2
1708257198103,SIO 174,A00,446197,Aluwihare; Lihini & Russell; Lynn M.,26,0,30,4
1708257198632,SIO 181,A01,446200,Tresguerres; Martin,18,0,25,7
1708257198632,SIO 181,A02,446201,Tresguerres; Martin,23,0,25,2
1708257198632,SIO 181,A03,446209,Tresguerres; Martin,24,0,25,1
1708257198632,SIO 181,A04,446211,Tresguerres; Martin,24,0,25,1
1708257198632,SIO 181,A05,446223,Tresguerres; Martin,24,0,25,1
1708257198632,SIO 181,A06,446236,Tresguerres; Martin,24,0,25,1
1708257199157,SIO 192,A00,479211,Gerwick; William Henry,20,0,20,0
1708257199685,SIO 194,A00,455340,Hill; Seth J,0,0,0,0
1708257200212,SIOB 262,A00,446243,Gerwick; William Henry,23,0,25,2
1708257200740,SIOB 269,A00,446244,Staff,19,0,20,1
1708257201266,SIOB 270,A01,446261,Allen; Andrew Ellis & Petrik; Colleen Mary,18,0,20,2
1708257201793,SIOB 278,A00,446273,Arcila; Dahiana K,13,0,15,2
1708257201793,SIOB 278,B00,481742,Aburto Oropeza; Marco Octavio,18,0,20,2
1708257202323,SIOB 279,A00,446286,Franks; Peter,31,0,35,4
1708257202850,SIOB 291,A00,446292,Hechinger; Ryan F.,20,0,20,0
1708257203379,SIOB 296,A00,446293,Mongiardino Koch; Nicolas,16,0,20,4
1708257203909,SIOB 297,A00,446294,Allen; Eric,66,0,70,4
1708257204436,SIOC 202B,A00,446312,Stramski; Dariusz & Gabriel; Anne Alice-Agnes,17,0,20,3
1708257204962,SIOC 203C,A01,446314,Young; William Roy,5,0,5,0
1708257205492,SIOC 207C,A00,492798,Vasconcelos; Manuela,5,0,5,0
1708257206018,SIOC 208,A00,446315,Merrifield; Mark A,16,0,20,4
1708257206544,SIOC 209,A00,478924,Werner; Bradley T.,11,0,15,4
1708257206544,SIOC 209,B00,479224,Watson-Parris; Duncan,15,0,25,10
1708257206544,SIOC 209,C00,480739,Ricke; Katharine L,24,0,24,0
1708257207069,SIOC 212B,A01,446324,Cessi; Paola,40,0,40,0
1708257207596,SIOC 217C,A00,446325,Lutsko; Nicholas J.,25,0,25,0
1708257208125,SIOC 220,A00,446326,Rudnick; Daniel Lars,13,0,15,2
1708257208649,SIOC 224,A00,446327,Eisenman; Ian,20,0,25,5
1708257209174,SIOC 228,A00,446328,Shi; Yuanyuan,1,0,10,9
1708257209702,SIOC 235,A00,446342,Xie; Shang-Ping,14,0,15,1
1708257210226,SIOC 251,A00,446343,Evan; Amato Tomas,19,0,20,1
1708257210752,SIOG 200B,A00,446344,Gabriel; Anne Alice-Agnes,9,0,10,1
1708257211330,SIOG 221,A00,446354,Parnell-Turner; Ross Ernes,29,0,30,1
1708257211862,SIOG 227B,A00,446355,Laske; Gabi & Shearer; Peter M,19,0,20,1
1708257212386,SIOG 228,A00,446356,Van Allen; Emily Joyce,7,0,20,13
1708257212912,SIOG 230,A00,446359,Constable; Catherine G,25,0,25,0
1708257213441,SIOG 232,A00,446360,Constable; Catherine G & Constable; Steven C,37,0,40,3
1708257213966,SIOG 234,A00,446361,Sandwell; David T,15,0,15,0
1708257214495,SIOG 236,A01,477658,Fricker; Helen A.,5,0,5,0
1708257214495,SIOG 236,A02,477685,Fricker; Helen A.,3,0,5,2
1708257215021,SIOG 239,A00,446362,Gabriel; Anne Alice-Agnes,19,0,20,1
1708257215021,SIOG 239,B00,481507,May; David Alexander,6,0,6,0
1708257215021,SIOG 239,C00,486863,Fialko; Yuri A.,15,0,15,0
1708257215546,SIOG 268,A00,446364,Barbeau; Katherine,12,0,15,3
1708257216072,SOCE 194,A00,455341,Hill; Seth J,0,0,0,0
1708257216598,SOCG 204,A00,446551,Ng; Kwai,0,0,8,8
1708257217127,SOCG 206,A00,446552,Alvarez; Camila Huerta,4,0,8,4
1708257217653,SOCG 214,A00,446553,Raudenbush; Danielle,3,0,8,5
1708257218183,SOCG 255B,A00,446602,Serlin; David,2,0,5,3
1708257218713,SOCG 255C,A00,446813,Gates; Kelly,3,0,5,2
1708257219239,SOCG 290,A00,446910,Thorpe; Charles Robert,0,0,10,10
1708257219239,SOCG 290,B00,446911,Goldman; Harvey Stern,1,0,10,9
1708257219239,SOCG 290,C00,446914,Lampland; Martha,5,0,10,5
1708257219765,SOCI 2,A01,446373,Rogers; Julia Ellen,28,0,30,2
1708257219765,SOCI 2,A02,446374,Rogers; Julia Ellen,29,0,30,1
1708257219765,SOCI 2,A03,446382,Rogers; Julia Ellen,29,0,30,1
1708257219765,SOCI 2,A04,446384,Rogers; Julia Ellen,30,0,30,0
1708257219765,SOCI 2,A05,446389,Rogers; Julia Ellen,30,0,30,0
1708257219765,SOCI 2,A06,446393,Rogers; Julia Ellen,29,0,30,1
1708257220296,SOCI 20,A01,446396,Calderon-Zaks; Michael Aar,33,0,34,1
1708257220296,SOCI 20,A02,446409,Calderon-Zaks; Michael Aar,34,0,34,0
1708257220825,SOCI 40,A01,446417,Raudenbush; Danielle,30,0,32,2
1708257220825,SOCI 40,A02,446419,Raudenbush; Danielle,31,0,32,1
1708257220825,SOCI 40,A03,446434,Raudenbush; Danielle,31,0,32,1
1708257220825,SOCI 40,A04,446436,Raudenbush; Danielle,28,0,32,4
1708257220825,SOCI 40,A05,446441,Raudenbush; Danielle,29,0,32,3
1708257220825,SOCI 40,A06,446445,Raudenbush; Danielle,32,0,32,0
1708257221356,SOCI 60,A01,446461,Sutton; April Marie,30,0,32,2
1708257221356,SOCI 60,A02,446468,Sutton; April Marie,30,0,32,2
1708257221356,SOCI 60,A03,446469,Sutton; April Marie,26,0,32,6
1708257221356,SOCI 60,A04,446471,Sutton; April Marie,31,0,32,1
1708257221883,SOCI 100,A01,446480,Payne; Christine Anna,28,0,30,2
1708257221883,SOCI 100,A02,446491,Payne; Christine Anna,29,0,30,1
1708257221883,SOCI 100,A03,446492,Payne; Christine Anna,28,0,30,2
1708257221883,SOCI 100,A04,446493,Payne; Christine Anna,27,0,30,3
1708257222409,SOCI 103M,A00,481672,Kilpatrick; Kevin,27,0,28,1
1708257222938,SOCI 104,A00,446494,Turner; Christena L.,28,0,30,2
1708257223464,SOCI 104Q,A00,446495,Rogers; Julia Ellen,27,0,30,3
1708257223993,SOCI 106,A00,446496,Payne; Christine Anna,25,0,30,5
1708257224518,SOCI 107,A00,446497,Staff,30,0,30,0
1708257225044,SOCI 109,A00,446498,Rona-Tas; Akos,20,0,25,5
1708257225570,SOCI 111,A00,446499,Ribas Norris; Janet Vanesa,54,0,56,2
1708257226099,SOCI 114,A00,446500,Lampland; Martha,73,0,75,2
1708257226625,SOCI 117,A01,446502,Jones; Gabrielle Anastasia,14,0,17,3
1708257226625,SOCI 117,A02,446516,Jones; Gabrielle Anastasia,17,0,17,0
1708257226625,SOCI 117,A03,458787,Jones; Gabrielle Anastasia,17,0,17,0
1708257226625,SOCI 117,A04,458835,Jones; Gabrielle Anastasia,19,0,19,0
1708257227152,SOCI 120T,A00,446518,Staff,56,0,56,0
1708257227681,SOCI 123,A00,446519,Staff,79,0,80,1
1708257228207,SOCI 125,A00,487186,Calderon-Zaks; Michael Aar,55,0,56,1
1708257228738,SOCI 126,A01,446532,Jones; Makeba,15,0,15,0
1708257228738,SOCI 126,A02,446533,Jones; Makeba,15,0,15,0
1708257228738,SOCI 126,A03,458839,Jones; Makeba,15,0,15,0
1708257228738,SOCI 126,A04,458840,Jones; Makeba,15,0,15,0
1708257229265,SOCI 133,A00,446534,Calderon-Zaks; Michael Aar,53,0,56,3
1708257229791,SOCI 135,A00,486886,Ruiz; Jonathan Joseph,55,0,56,1
1708257230321,SOCI 136,A00,486887,Ruiz; Jonathan Joseph,56,0,56,0
1708257230847,SOCI 139,A00,446535,Ribas Norris; Janet Vanesa,78,0,80,2
1708257231378,SOCI 140J,A00,446537,Estefan; Michel,75,0,100,25
1708257231905,SOCI 142,A00,477639,Crofts; Christine,43,0,50,7
1708257232431,SOCI 146,A00,446538,Summers; Valerie R.,113,0,120,7
1708257232958,SOCI 151,A00,446540,Goldman; Harvey Stern,56,0,56,0
1708257233484,SOCI 156,A00,446541,Ostovany; Khashayar,55,0,56,1
1708257234010,SOCI 157,A00,446542,Jules-Rosette; Bennetta W.,28,0,28,0
1708257234539,SOCI 159,A00,494493,Estefan; Michel,93,0,96,3
1708257235065,SOCI 161,A00,477638,Staff,45,0,45,0
1708257235637,SOCI 162,A00,477642,Staff,54,0,55,1
1708257236167,SOCI 165,A00,446543,Rona-Tas; Akos,49,0,56,7
1708257236693,SOCI 171,A00,446544,Thorpe; Charles Robert,56,0,56,0
1708257237221,SOCI 173,A00,482888,Crofts; Christine,92,0,100,8
1708257237748,SOCI 180,A00,446545,Ostovany; Khashayar,55,0,56,1
1708257238274,SOCI 183,A00,446546,Sutton; April Marie,43,0,45,2
1708257238804,SOCI 185,A00,494495,Staff,30,0,30,0
1708257239333,SOCI 188D,A00,446549,Kokinis; Troy Andreas,24,0,25,1
1708257239859,SOCI 198RA,001,446550,Ng; Kwai,30,0,30,0
1708257240385,SOMC 224C,A00,466928,Bhakta; Savita Ganapathi,160,0,160,0
1708257240916,SOMC 229,A00,466925,Hoang; Mai Phuong,160,0,160,0
1708257241443,SOMC 240,A00,466937,Coyne; Christopher John,150,0,150,0
1708257241972,SOMC 242,A00,466931,Kline; Ahnika Sarah,160,0,160,0
1708257242502,SOMC 244,A00,466939,Mandel; Jess,150,0,150,0
1708257243028,SOMC 245C,A01,466935,Noel; Geoffroy Pierre Jean,160,0,160,0
1708257243557,SOMC 246C,A00,487163,Eyler; Lisa T.,160,0,160,0
1708257244083,SOMC 247C,A50,466950,Calcutt; Nigel A,160,0,160,0
1708257244613,SOMC 248C,A00,466936,Joshi; Weena Erin,160,0,160,0
1708257245139,SOMC 255C,A00,466951,Allison; Matthew,160,0,160,0
1708257245664,SPPH 161R,A01,476600,Chambers; Christina D,99,0,100,1
1708257246190,SPPH 263B,A01,460901,Hook; Vivian Yuan-Ho,25,0,25,0
1708257246718,SPPS 200A,A00,460907,Luli; Alex J,99,0,99,0
1708257247246,SPPS 200B,A00,460928,Luli; Alex J,99,0,99,0
1708257247775,SPPS 200C,A00,460934,Luli; Alex J,95,0,99,4
1708257248301,SPPS 203,A00,460955,Painter; Nathan A.,83,0,99,16
1708257248826,SPPS 205,A01,460978,Bandeira; Nuno Filipe Cabrita,64,0,80,16
1708257249356,SPPS 209,A00,460979,Bounthavong; Mark,94,0,99,5
1708257249882,SPPS 210,001,460980,Gustafsson; Asa Birgitta,99,0,99,0
1708257250411,SPPS 211A,A00,460987,Ferguson; Fleur,85,0,99,14
1708257250936,SPPS 211B,A00,460991,Ferguson; Fleur,96,0,99,3
1708257251463,SPPS 211C,A00,460992,Ferguson; Fleur,95,0,99,4
1708257251994,SPPS 211D,A00,460993,Tsunoda; Shirley M.,99,0,99,0
1708257252521,SPPS 212C,A01,460995,Saunders; Ila Maewal,95,0,99,4
1708257253048,SPPS 213C,A00,460996,Awdishu; Linda,95,0,99,4
1708257253577,SPPS 218B,A00,460997,Mandyam; Chitra,95,0,99,4
1708257254104,SPPS 225,A01,460999,Reed; Chantal,83,0,99,16
1708257254632,SPPS 236,A00,461000,Reid; Erin G.,96,0,99,3
1708257255159,SPPS 237,A00,461002,Mimoto; Mizuho Stacy,96,0,99,3
1708257255684,SPPS 238,A00,461041,Beyhan; Sinem,96,0,99,3
1708257256211,SPPS 241,A01,461122,Tsunoda; Shirley M.,83,0,99,16
1708257256737,SPPS 249,A00,461123,Brandl; Katharina,96,0,99,3
1708257257266,SPPS 250,A00,461126,Tsunoda; Shirley M.,45,0,50,5
1708257257791,SPPS 251,A00,461127,Chen; Timothy,99,0,99,0
1708257258317,SPPS 252,A00,461128,Abdul-Mutakabbir; Jacinda,74,0,80,6
1708257258848,SPPS 254,A00,481670,Shapiro; Desiree Nicolette,77,0,80,3
1708257259373,SPPS 261,A00,461129,Chambers; Christina D,93,0,99,6
1708257259903,SPPS 278,A00,459983,Fricovsky; Eduardo Santiago,98,0,99,1
1708257260429,SPPS 280,A00,461259,Fricovsky; Eduardo Santiago,19,0,20,1
1708257260954,SPPS 283,A00,461283,Tsunoda; Shirley M.,96,0,99,3
1708257261480,SURG 261,A00,466973,Staff,50,0,50,0
1708257262012,SURG 296,001,467004,Agha Hosseini; Ava,49,0,50,1
1708257262012,SURG 296,002,467005,Hinchcliff; Katharine Moss,49,0,50,1
1708257262012,SURG 296,003,467006,Eliceiri; Brian,49,0,50,1
1708257262548,SYN 1,001,448577,Bishop; Graham,19,0,20,1
1708257262548,SYN 1,002,448578,Iatarola; Briana Marie,19,0,20,1
1708257262548,SYN 1,003,448579,Browne; Emily,20,0,20,0
1708257262548,SYN 1,004,448580,Vega; Adrian,20,0,20,0
1708257262548,SYN 1,005,448581,Browne; Emily,20,0,20,0
1708257262548,SYN 1,006,448582,Rock; Martin,20,0,20,0
1708257262548,SYN 1,007,448583,Rock; Martin,20,0,20,0
1708257262548,SYN 1,008,448584,Iatarola; Briana Marie,19,0,20,1
1708257262548,SYN 1,009,448585,Bishop; Graham,20,0,20,0
1708257262548,SYN 1,010,448586,Bishop; Graham,20,0,20,0
1708257262548,SYN 1,011,448587,Gladstein; Jill M,15,0,15,0
1708257262548,SYN 1,012,448588,Meyer; Leslie Rose,20,0,20,0
1708257262548,SYN 1,013,448589,Rosenberg; Ryan Glenn,20,0,20,0
1708257262548,SYN 1,014,448627,Rosenberg; Ryan Glenn,19,0,20,1
1708257262548,SYN 1,015,448630,Atkinson; Arthur Laird,20,0,20,0
1708257262548,SYN 1,016,448651,Hom; Kirstyn Courtney,20,0,20,0
1708257262548,SYN 1,017,448652,Difruscio; Mark,20,0,20,0
1708257262548,SYN 1,018,448669,Hom; Kirstyn Courtney,20,0,20,0
1708257262548,SYN 1,019,448674,Hom; Kirstyn Courtney,18,0,20,2
1708257262548,SYN 1,020,448675,Atkinson; Arthur Laird,20,0,20,0
1708257262548,SYN 1,021,448678,Gladstein; Jill M,15,0,15,0
1708257262548,SYN 1,022,448682,Iatarola; Briana Marie,20,0,20,0
1708257262548,SYN 1,023,448691,Birberick; Brittany Celest,20,0,20,0
1708257262548,SYN 1,024,448751,Birberick; Brittany Celest,20,0,20,0
1708257262548,SYN 1,027,448766,Deavenport; James Cary,19,0,20,1
1708257262548,SYN 1,028,448767,Meyer; Leslie Rose,20,0,20,0
1708257262548,SYN 1,029,448775,Tawater; Hanna Jean,20,0,20,0
1708257262548,SYN 1,030,448777,Tawater; Hanna Jean,20,0,20,0
1708257262548,SYN 1,031,448792,Deavenport; James Cary,20,0,20,0
1708257262548,SYN 1,032,480169,Tawater; Hanna Jean,18,0,20,2
1708257263074,SYN 1R,001,448793,Difruscio; Mark,20,0,20,0
1708257263074,SYN 1R,004,449146,Difruscio; Mark,20,0,20,0
1708257263614,SYN 100,A01,449148,Staff,11,0,15,4
1708257263614,SYN 100,A02,449149,Staff,15,0,15,0
1708257263614,SYN 100,B01,449164,Gladstein; Jill M,0,0,0,0
1708257263614,SYN 100,B02,449166,Gladstein; Jill M,0,0,0,1
1708257263614,SYN 100,C01,449244,Staff,7,0,15,8
1708257263614,SYN 100,C02,449274,Staff,13,0,15,2
1708257263614,SYN 100,D01,449278,Staff,20,0,20,0
1708257263614,SYN 100,D02,449279,Staff,20,0,20,0
1708257263614,SYN 100,E01,449281,Rock; Martin,9,0,15,6
1708257263614,SYN 100,E02,449282,Rock; Martin,14,0,15,1
1708257263614,SYN 100,F01,449304,Browne; Emily,12,0,15,3
1708257263614,SYN 100,F02,449306,Browne; Emily,14,0,15,1
1708257263614,SYN 100,I01,449390,Gormally; Brenna,0,0,0,0
1708257263614,SYN 100,I02,449391,Gormally; Brenna,0,0,0,0
1708257263614,SYN 100,J01,449401,Atkinson; Arthur Laird,11,0,15,4
1708257263614,SYN 100,J02,449402,Atkinson; Arthur Laird,14,0,15,1
1708257263614,SYN 100,K01,449404,Deavenport; James Cary,11,0,15,4
1708257263614,SYN 100,K02,449405,Deavenport; James Cary,14,0,15,1
1708257263614,SYN 100,L01,449408,Rosenberg; Ryan Glenn,10,0,15,5
1708257263614,SYN 100,L02,449420,Rosenberg; Ryan Glenn,15,0,15,0
1708257264140,SYN 150,001,450016,Vega; Adrian,19,0,19,0
1708257264140,SYN 150,003,450031,Birberick; Brittany Celest,20,0,20,0
1708257264735,SYN 150R,001,494950,Vega; Adrian,20,0,20,0
1708257265265,SYN 198,001,494388,Staff,9999,0,9999,0
1708257265793,TDAC 1,A00,450042,Walsh; Kim C.,14,0,20,6
1708257265793,TDAC 1,B00,450043,Walsh; Kim C.,11,0,20,9
1708257265793,TDAC 1,C00,450044,Walsh; Kim C.,15,0,20,5
1708257265793,TDAC 1,D00,486830,Basso; Beatrice,20,0,20,0
1708257265793,TDAC 1,E00,492912,Walsh; Kim C.,15,0,20,5
1708257265793,TDAC 1,F00,492936,Walsh; Kim C.,18,0,20,2
1708257266319,TDAC 101,A00,450895,Celik; Aysan Karagasli,18,0,20,2
1708257266846,TDAC 102,A00,450904,Walsh; Kim C.,20,0,20,0
1708257266846,TDAC 102,B00,450916,Harting; Carla Kelso,20,0,20,0
1708257267371,TDAC 108,A00,450917,Buescher; Stephen W.,18,0,20,2
1708257267898,TDAC 109,A00,450924,Blair; Kyle Adam,20,0,20,0
1708257268430,TDAC 122,A00,451025,Perry; Lamar,30,0,30,0
1708257268430,TDAC 122,B00,480845,Perry; Lamar,30,0,30,0
1708257268955,TDAC 123,A00,451026,Buescher; Stephen W.,30,0,30,0
1708257268955,TDAC 123,B00,451028,Celik; Aysan Karagasli,30,0,30,0
1708257268955,TDAC 123,C00,480851,Perry; Lamar,30,0,30,0
1708257269480,TDDE 101,A00,451030,Guirguis; Mark C,18,0,20,2
1708257270009,TDDE 112,A00,451032,Staff,20,0,20,0
1708257270533,TDDE 130,A00,451033,Guirguis; Mark C,19,0,20,1
1708257271064,TDDE 132,A00,451034,Guirguis; Mark C,20,0,20,0
1708257271589,TDDE 169A,A00,481304,Petrovich; Victoria A.,19,0,20,1
1708257272118,TDDM 1,A00,450045,Weinberg; Sadie,27,0,30,3
1708257272644,TDDM 101,A00,451067,Staff,29,0,30,1
1708257273176,TDDR 101,A00,451068,Powell; Lora,29,0,34,5
1708257273702,TDDR 102,A00,451069,Powell; Lora,19,0,20,1
1708257274230,TDDR 111,A00,451070,Castro; Robert Jess,15,0,16,1
1708257274230,TDDR 111,B00,451071,Castro; Robert Jess,15,0,16,1
1708257274756,TDDR 190,A00,451073,Perry; Lamar,1,0,1,0
1708257275284,TDGE 1,A01,450047,Salovey; Todd,20,0,20,0
1708257275284,TDGE 1,A02,450048,Salovey; Todd,20,0,20,0
1708257275284,TDGE 1,A03,450085,Salovey; Todd,18,0,20,2
1708257275284,TDGE 1,A04,450093,Salovey; Todd,20,0,20,0
1708257275284,TDGE 1,A05,450096,Salovey; Todd,19,0,20,1
1708257275284,TDGE 1,A06,450132,Salovey; Todd,16,0,20,4
1708257275808,TDGE 25,A00,450236,Harting; Carla Kelso,12,0,20,8
1708257275808,TDGE 25,B00,450240,Harting; Carla Kelso,16,0,20,4
1708257275808,TDGE 25,C00,450243,Harting; Carla Kelso,14,0,20,6
1708257275808,TDGE 25,D00,450388,Harting; Carla Kelso,16,0,20,4
1708257276337,TDGE 100,A01,451098,Salovey; Todd,24,0,25,1
1708257276337,TDGE 100,A02,451099,Salovey; Todd,24,0,25,1
1708257276862,TDGE 124,A00,451122,Fulton; Julia,168,0,200,32
1708257277392,TDGE 125,A00,480853,Havis; Allan,197,0,200,3
1708257277392,TDGE 125,B00,480886,Staff,216,0,220,4
1708257277921,TDGE 133,A00,481097,Brill; Robert L.,20,0,20,0
1708257278450,TDGE 196B,A00,493144,Barricelli; Marc Alexander,1,0,1,0
1708257278450,TDGE 196B,B00,493148,Buescher; Stephen W.,2,0,2,0
1708257278450,TDGE 196B,C00,493151,Burelle; Julie Sara Veronique,1,0,1,0
1708257278450,TDGE 196B,D00,493189,Castro; Robert Jess,2,0,2,0
1708257278450,TDGE 196B,E00,493190,Guirguis; Mark C,1,0,1,0
1708257278450,TDGE 196B,F00,493240,Iizuka; Naomi Hisako,1,0,1,0
1708257278450,TDGE 196B,G00,493241,Perry; Lamar,1,0,1,0
1708257278450,TDGE 196B,H00,493249,Powell; Lora,1,0,1,0
1708257278450,TDGE 196B,I00,493296,Stein; Deborah Isobel,6,0,6,0
1708257278977,TDGR 213C,A00,451385,Buescher; Stephen W.,10,0,10,0
1708257279506,TDGR 220A,A00,451386,Barricelli; Marc Alexander,10,0,10,0
1708257280032,TDGR 239,A00,451387,Blair; Kyle Adam,10,0,10,0
1708257280561,TDGR 240,A00,481306,Portes; Elizabeth Marie,5,0,5,0
1708257281087,TDGR 245,A00,451388,Perry; Lamar,7,0,7,0
1708257281612,TDGR 250,A00,451395,Iizuka; Naomi Hisako,8,0,10,2
1708257282138,TDGR 251,A00,451397,Iizuka; Naomi Hisako,9,0,10,1
1708257282138,TDGR 251,B00,451398,Stein; Deborah Isobel,9,0,10,1
1708257282668,TDGR 257B,A00,451399,Finch; Michael S,8,0,10,2
1708257283197,TDGR 278,A00,481307,Petrovich; Victoria A.,4,0,5,1
1708257283724,TDGR 279,A00,451400,Bokovikova; Alina V,9,0,10,1
1708257283724,TDGR 279,B00,451401,Brill; Robert L.,10,0,10,0
1708257283724,TDGR 279,C00,451402,Petrovich; Victoria A.,10,0,10,0
1708257283724,TDGR 279,D00,451403,McElver; Robert Harrison,10,0,10,0
1708257283724,TDGR 279,E00,451404,Kuhl; Christopher August,10,0,10,0
1708257284250,TDGR 286,A00,451405,Knox; Leila Elizabeth,9,0,10,1
1708257284780,TDGR 288,A00,451406,Powell; Lora,6,0,7,1
1708257285307,TDGR 292,A00,451407,Power; Jade Yukana,10,0,10,0
1708257285307,TDGR 292,B00,451408,Mehrishi; Rishika,10,0,10,0
1708257285839,TDGR 293,001,451417,Power; Jade Yukana,7,0,7,0
1708257285839,TDGR 293,002,451418,Burelle; Julie Sara Veronique,7,0,7,0
1708257285839,TDGR 293,003,451419,Yapp; Hentyle T,7,0,7,0
1708257285839,TDGR 293,005,451421,Anderson; Mysia Anyse,7,0,7,0
1708257286364,TDGR 294,001,451429,Burelle; Julie Sara Veronique,7,0,7,0
1708257286364,TDGR 294,002,451431,Power; Jade Yukana,7,0,7,0
1708257286364,TDGR 294,003,451432,Yapp; Hentyle T,7,0,7,0
1708257286890,TDGR 295,A00,451433,Barricelli; Marc Alexander,10,0,10,0
1708257287419,TDGR 296,A00,451489,Powell; Lora,6,0,7,1
1708257287419,TDGR 296,B00,451497,Porter; Lisa,6,0,7,1
1708257287945,TDHD 175,A00,451123,Jun; Grace Shin Hae,40,0,40,0
1708257288484,TDHD 176,A00,451124,Caligagan; Maria T.,40,0,40,0
1708257289013,TDHT 10,A00,450409,Power; Jade Yukana,20,0,20,0
1708257289013,TDHT 10,B00,450450,Power; Jade Yukana,19,0,20,1
1708257289543,TDHT 23,A01,450546,Salimi; Rana,24,0,24,0
1708257289543,TDHT 23,A02,450549,Salimi; Rana,22,0,24,2
1708257289543,TDHT 23,A03,450553,Salimi; Rana,24,0,24,0
1708257290068,TDHT 101,A00,451125,Anderson; Mysia Anyse,25,0,25,0
1708257290068,TDHT 101,B00,451126,Mehrishi; Rishika,23,0,25,2
1708257290595,TDHT 104,A00,451225,Basso; Beatrice,22,0,25,3
1708257291121,TDHT 109,A01,451227,Anderson; Mysia Anyse,25,0,25,0
1708257291651,TDHT 122,A00,451228,Power; Jade Yukana,21,0,25,4
1708257292180,TDMV 1,A00,450558,Caligagan; Maria T.,15,0,30,15
1708257292709,TDMV 2,A00,450627,Anabo; Cherry,24,0,30,6
1708257293240,TDMV 3,A00,450630,Arcidiacono; Kristin,37,0,40,3
1708257293766,TDMV 11,A00,481244,Fyall; DauntÉ Edward,30,0,30,0
1708257294289,TDMV 20,A00,450789,Smith; Alison D,38,0,40,2
1708257294818,TDMV 110,A00,451229,Caligagan; Maria T.,28,0,30,2
1708257295344,TDMV 111,A00,451234,Smith; Alison D,28,0,30,2
1708257295870,TDMV 120,A00,451260,Weinberg; Sadie,30,0,30,0
1708257295870,TDMV 120,B00,451261,Sammartano; Tonnie,30,0,30,0
1708257296400,TDMV 122,A00,451262,Staff,28,0,30,2
1708257296925,TDMV 123,A00,451263,Duran; Marcos Antonio,28,0,30,2
1708257297455,TDMV 130,A00,451272,Mack; Kara Shanai',30,0,30,0
1708257297981,TDMV 138,A00,451275,Jun; Grace Shin Hae,4,0,30,26
1708257298509,TDMV 140,A00,451276,Lima; Paulo Henrique,40,0,40,0
1708257298509,TDMV 140,B00,451308,Power; Jade Yukana,39,0,40,1
1708257298509,TDMV 140,C00,451371,Caligagan; Tony,40,0,40,0
1708257298509,TDMV 140,D00,451373,Corrales; Joseph Bernales,28,0,30,2
1708257299037,TDMV 141,A00,451374,Caligagan; Tony,26,0,30,4
1708257299563,TDMV 142,A00,451375,Blanco; Juan Carlos,25,0,40,15
1708257300091,TDMV 143,A00,451376,Fyall; DauntÉ Edward,39,0,40,1
1708257300617,TDMV 144,A00,451377,Anabo; Cherry,39,0,40,1
1708257301146,TDMV 149,A00,451378,Jun; Grace Shin Hae,36,0,40,4
1708257301672,TDPF 162,A00,451379,Alvarez; Ana Maria,40,0,40,0
1708257302196,TDPR 6,A01,450799,Guirguis; Mark C,50,0,50,0
1708257302196,TDPR 6,A02,450801,Guirguis; Mark C,50,0,50,0
1708257302724,TDPR 102,A00,451380,Guirguis; Mark C,20,0,20,0
1708257303248,TDPR 104,A00,451381,Powell; Lora,15,0,15,0
1708257303778,TDPW 1,A00,450808,Stein; Deborah Isobel,14,0,15,1
1708257303778,TDPW 1,B00,450864,Stein; Deborah Isobel,13,0,15,2
1708257303778,TDPW 1,C00,450865,Stein; Deborah Isobel,15,0,15,0
1708257303778,TDPW 1,D00,450868,Stein; Deborah Isobel,13,0,15,2
1708257303778,TDPW 1,E00,450874,Stein; Deborah Isobel,14,0,15,1
1708257304306,TDPW 102,A00,451382,Staff,18,0,20,2
1708257304831,TDPW 104,A00,481182,Staff,17,0,20,3
1708257305357,TDTR 10,A00,450881,Wilson; Terry A.,28,0,30,2
1708257305887,TDTR 15,A00,450882,Smith; Alison D,30,0,30,0
1708257306414,TMC 15,A00,479039,Hemans; Patricia Ann Benitez,25,0,25,0
1708257306943,TMC 87,A00,479049,Solomon; Amanda Lee Albaniel,20,0,20,0
1708257307474,UROL 296,001,467060,Anger; Jennifer Tash,49,0,50,1
1708257307474,UROL 296,002,467061,Staff,50,0,50,0
1708257308008,USP 3,A01,458852,Martin; Isaac,34,0,35,1
1708257308008,USP 3,A02,458853,Martin; Isaac,35,0,35,0
1708257308008,USP 3,A03,458861,Martin; Isaac,34,0,35,1
1708257308008,USP 3,A04,458862,Martin; Isaac,32,0,35,3
1708257308537,USP 4,A00,451772,Schwaller; Nora Louise,19,0,25,6
1708257309063,USP 5,A01,458863,Shenkman; Michael Thomas,33,0,35,2
1708257309063,USP 5,A02,458864,Shenkman; Michael Thomas,31,0,35,4
1708257309594,USP 15,A01,458931,Staff,33,0,35,2
1708257309594,USP 15,A02,459024,Staff,31,0,35,4
1708257310120,USP 25,A00,451786,Sun; Feiyang,57,0,60,3
1708257310649,USP 100,A00,451787,Moses; Kelema Lee,55,0,60,5
1708257311178,USP 108,A00,477594,Martin; Isaac,25,0,25,0
1708257311703,USP 119,A00,477595,Schwaller; Nora Louise,23,0,25,2
1708257312228,USP 124,A00,451790,Hinds; Juli Beth,62,0,70,8
1708257312753,USP 128B,A01,451910,Lewis; Leslie R,12,0,13,1
1708257313281,USP 142B,A01,451954,Lewis; Leslie R,24,0,25,1
1708257313811,USP 142C,A00,451977,Lerner; Amy M,0,0,0,0
1708257314338,USP 145,A00,451999,Yaghmaee; Saman,140,0,146,6
1708257314868,USP 150,A00,452165,Staff,44,0,50,6
1708257315393,USP 151,A00,452166,Staff,49,0,50,1
1708257315920,USP 152A,A01,459025,Weaver; Todd D,25,0,25,0
1708257315920,USP 152A,A02,459074,Weaver; Todd D,24,0,25,1
1708257316450,USP 152B,A00,452224,Moeder; Nathan L,21,0,25,4
1708257316981,USP 153,A00,452339,Shenkman; Michael Thomas,50,0,50,0
1708257317509,USP 158A,A00,452410,Sun; Feiyang,25,0,25,0
1708257318091,USP 159B,A00,452411,Gherini; Paul Pier-Carlo,6,0,8,2
1708257318620,USP 160,A00,452412,Wartell; Julie Dara,25,0,25,0
1708257319145,USP 164,A00,452413,Moses; Kelema Lee,22,0,25,3
1708257319670,USP 165C,A00,452442,Frank; Lawrence Douglas,20,0,20,0
1708257320197,USP 169,A00,452598,Bajaj; Ravi Siddharth,32,0,35,3
1708257320727,USP 170,A00,477593,Entezam; Maryam,60,0,60,0
1708257321252,USP 172,A00,452676,Peerson; Susan,19,0,25,6
1708257321777,USP 175,A00,452848,Velasco; Diego,18,0,20,2
1708257322306,USP 177A,A00,453084,Velasco; Diego,21,0,25,4
1708257322847,USP 177B,A00,453127,Peerson; Susan,22,0,25,3
1708257323378,USP 183,A00,453128,Sutton; April Marie,19,0,20,1
1708257323904,USP 188B,A00,453187,Pezzoli; Keith,30,0,30,0
1708257324429,USP 190,A00,453234,Pezzoli; Keith,0,0,0,1
1708257324955,USP 191B,A00,453240,Polat; Soydan Alihan,18,0,20,2
1708257325481,USP 193,A00,453251,Bussell; Mirle Rabinowitz,24,0,25,1
1708257326006,USP 194,A00,455342,Hill; Seth J,0,0,0,0
1708257326532,USP 265C,A00,453264,Frank; Lawrence Douglas,10,0,10,0
1708257327063,VIS 3,A01,453427,Staff,25,0,25,0
1708257327063,VIS 3,A02,453428,Staff,15,0,25,10
1708257327063,VIS 3,A03,453429,Staff,25,0,25,0
1708257327063,VIS 3,A04,453430,Staff,21,0,25,4
1708257327063,VIS 3,A05,453431,Staff,25,0,25,0
1708257327063,VIS 3,A06,453432,Staff,23,0,25,2
1708257327063,VIS 3,A07,453433,Staff,17,0,25,8
1708257327063,VIS 3,A08,453434,Staff,23,0,25,2
1708257327063,VIS 3,A09,453435,Staff,21,0,25,4
1708257327063,VIS 3,A10,453436,Staff,23,0,25,2
1708257327590,VIS 9,A00,453437,Camargo; William,116,0,146,30
1708257328118,VIS 10,A00,453438,Kiratli; Solen,189,0,200,11
1708257328645,VIS 21B,A01,453440,Shen; Kuiyi,31,0,32,1
1708257328645,VIS 21B,A02,453441,Shen; Kuiyi,31,0,32,1
1708257328645,VIS 21B,A03,453442,Shen; Kuiyi,31,0,32,1
1708257328645,VIS 21B,A04,453443,Shen; Kuiyi,32,0,32,0
1708257328645,VIS 21B,A05,453444,Shen; Kuiyi,32,0,32,0
1708257328645,VIS 21B,A06,453452,Shen; Kuiyi,32,0,32,0
1708257328645,VIS 21B,A07,453468,Shen; Kuiyi,30,0,32,2
1708257328645,VIS 21B,A08,453587,Shen; Kuiyi,32,0,32,0
1708257329179,VIS 22,A01,453589,Rose; Jordan M,32,0,32,0
1708257329179,VIS 22,A02,453590,Rose; Jordan M,32,0,32,0
1708257329179,VIS 22,A03,453615,Rose; Jordan M,31,0,32,1
1708257329179,VIS 22,A04,453616,Rose; Jordan M,32,0,32,0
1708257329179,VIS 22,A05,453617,Rose; Jordan M,30,0,32,2
1708257329179,VIS 22,A06,453618,Rose; Jordan M,30,0,32,2
1708257329179,VIS 22,A07,453620,Rose; Jordan M,32,0,32,0
1708257329179,VIS 22,A08,453621,Rose; Jordan M,32,0,32,0
1708257329179,VIS 22,A09,453635,Rose; Jordan M,32,0,32,0
1708257329179,VIS 22,A10,453636,Rose; Jordan M,32,0,32,0
1708257330172,VIS 31,A00,453637,Dominguez; Ricardo,133,0,146,13
1708257330701,VIS 41,A01,453644,D'Elena-Tweed; Jessica Erin,23,0,25,2
1708257330701,VIS 41,A02,453645,D'Elena-Tweed; Jessica Erin,22,0,25,3
1708257330701,VIS 41,A03,453646,D'Elena-Tweed; Jessica Erin,25,0,25,0
1708257330701,VIS 41,A04,453647,D'Elena-Tweed; Jessica Erin,18,0,25,7
1708257330701,VIS 41,A05,453648,D'Elena-Tweed; Jessica Erin,25,0,25,0
1708257330701,VIS 41,A06,453650,D'Elena-Tweed; Jessica Erin,24,0,25,1
1708257331231,VIS 70N,A01,453652,Garnett; Mariah J,21,0,22,1
1708257331231,VIS 70N,A02,453653,Garnett; Mariah J,21,0,22,1
1708257331231,VIS 70N,A03,453654,Garnett; Mariah J,22,0,22,0
1708257331231,VIS 70N,A04,453657,Garnett; Mariah J,22,0,22,0
1708257331231,VIS 70N,A05,453662,Garnett; Mariah J,20,0,22,2
1708257331231,VIS 70N,A06,453663,Garnett; Mariah J,22,0,22,0
1708257331757,VIS 83,A00,453664,Kester; Grant,137,0,146,9
1708257332283,VIS 101A,A00,453666,Cruz; Edwin Teddy,10,0,15,5
1708257332812,VIS 102,A00,453668,Cruz; Edwin Teddy,81,0,85,4
1708257333340,VIS 105A,A00,453669,Adler; Amy,29,0,30,1
1708257333887,VIS 105B,A00,453738,Herc-Balaszek; Malgorzata,25,0,30,5
1708257333887,VIS 105B,B00,453739,Staff,27,0,30,3
1708257334414,VIS 106A,A00,453740,Staff,22,0,25,3
1708257334943,VIS 106B,A00,453741,De Luca; Mara Julia,20,0,25,5
1708257335471,VIS 106C,A00,453746,Vangenderen; Monique Luise,11,0,15,4
1708257336000,VIS 107A,A00,453747,Gregoire; Mathieu,19,0,25,6
1708257336529,VIS 107B,A00,453748,Dean; Danielle Adobi,23,0,25,2
1708257337056,VIS 110A,A00,453749,Adler; Amy,13,0,15,2
1708257337582,VIS 110E,A00,453798,Gregoire; Mathieu,14,0,15,1
1708257338111,VIS 110F,A00,453799,Staff,15,0,15,0
1708257338636,VIS 110N,A00,453803,Dean; Danielle Adobi,15,0,15,0
1708257339163,VIS 123B,A00,453804,Gaines; Malik Julian,75,0,75,0
1708257339691,VIS 125BN,A00,453813,Welchman; John C.,75,0,75,0
1708257340216,VIS 126P,A00,453814,Wardwell; Mariana Razo,74,0,75,1
1708257340744,VIS 128E,A00,453815,Staff,75,0,75,0
1708257341270,VIS 129E,A00,453855,Shen; Kuiyi,12,0,15,3
1708257341800,VIS 131,A00,453859,Trigilio; Michael,12,0,15,3
1708257341800,VIS 131,B00,479342,Mangolte; Babette,15,0,15,0
1708257342325,VIS 133A,A00,454231,Barbosa; Erika Katrina,13,0,15,2
1708257342851,VIS 134,A00,454232,Yoldas; Pinar,59,0,75,16
1708257343381,VIS 141B,A00,454233,Stalbaum; Brett,12,0,15,3
1708257343908,VIS 145B,A00,454234,Alexander; Amy J,14,0,15,1
1708257343908,VIS 145B,B00,454235,Kiratli; Solen,8,0,15,7
1708257344453,VIS 147A,A01,454237,Stalbaum; Brett,20,0,22,2
1708257344453,VIS 147A,A02,454238,Stalbaum; Brett,18,0,22,4
1708257344978,VIS 157,A01,454240,Cartwright; Lisa,32,0,34,2
1708257344978,VIS 157,A02,454241,Cartwright; Lisa,32,0,34,2
1708257345521,VIS 159,A01,454243,Akten; Mehmet,34,0,34,0
1708257345521,VIS 159,A02,454244,Akten; Mehmet,32,0,34,2
1708257345521,VIS 159,A03,454300,Akten; Mehmet,30,0,34,4
1708257345521,VIS 159,A04,454301,Akten; Mehmet,33,0,34,1
1708257345521,VIS 159,A05,454302,Akten; Mehmet,30,0,34,4
1708257345521,VIS 159,A06,454307,Akten; Mehmet,33,0,34,1
1708257345521,VIS 159,A07,454308,Akten; Mehmet,34,0,34,0
1708257345521,VIS 159,A08,454309,Akten; Mehmet,33,0,34,1
1708257346045,VIS 160B,A00,454310,Alexander; Amy J,13,0,15,2
1708257346045,VIS 160B,B00,454311,Akten; Mehmet,14,0,15,1
1708257346045,VIS 160B,C00,454312,Stone; Patricia,12,0,15,3
1708257346570,VIS 164,A00,454313,Cross; Brian R,19,0,22,3
1708257346570,VIS 164,B00,454314,Camargo; William,22,0,22,0
1708257347100,VIS 165,A00,454315,Erdmann; Dean,22,0,22,0
1708257347630,VIS 167,A00,454316,Staff,18,0,22,4
1708257348155,VIS 169A,A00,454317,Mostajo; Lorena,21,0,22,1
1708257348681,VIS 171,A00,454318,Nakayama; Yue,21,0,22,1
1708257349207,VIS 174,A00,454319,Staff,19,0,22,3
1708257349733,VIS 177,A00,454320,Cho; Erica,21,0,22,1
1708257350261,VIS 178,A00,454321,Staff,0,0,0,0
1708257350787,VIS 179,A00,454322,Erdmann; Dean,22,0,22,0
1708257351313,VIS 180A,A00,454323,Nakayama; Yue,21,0,22,1
1708257351838,VIS 180B,A00,454341,Cross; Brian R,20,0,22,2
1708257352363,VIS 183A,A00,454342,Cho; Erica,17,0,22,5
1708257352892,VIS 185,A00,454343,Miller; Nicole L,18,0,22,4
1708257353422,VIS 190,A00,454360,Crandall; Jordan,15,0,15,0
1708257353422,VIS 190,B00,454361,D'Elena-Tweed; Jessica Erin,10,0,15,5
1708257353947,VIS 202,A00,454369,Miller; Nicole L,12,0,15,3
1708257354472,VIS 203,A00,454370,Garnett; Mariah J,8,0,15,7
1708257354997,VIS 206,A00,454376,Kester; Grant,10,0,15,5
1708257355526,VIS 208,A00,454377,Moss; Ceci,15,0,15,0
1708257356051,VIS 211,A00,454413,Segade; Alexandro Abraham,0,0,0,2
1708257356578,VIS 243,A00,454429,Rose; Jordan M,5,0,15,10
1708257357104,VIS 255,A00,454430,Welchman; John C.,8,0,15,7
1708257357632,VIS 262,A00,454431,Yoldas; Pinar,11,0,15,4
1708257358160,WCWP 10A,001,454442,Uriarte; Emma,17,0,20,3
1708257358160,WCWP 10A,002,454443,Uriarte; Emma,14,0,20,6
1708257358160,WCWP 10A,003,454479,Uriarte; Emma,19,0,20,1
1708257358160,WCWP 10A,004,454480,Staff,0,0,0,0
1708257358160,WCWP 10A,005,454484,Staff,0,0,0,0
1708257358160,WCWP 10A,006,454485,Staff,0,0,0,0
1708257358160,WCWP 10A,007,454487,Staff,0,0,0,0
1708257358160,WCWP 10A,008,454488,Susi; Natalie,14,0,20,6
1708257358160,WCWP 10A,009,454489,Staff,0,0,0,0
1708257358160,WCWP 10A,010,454490,Staff,0,0,0,0
1708257358721,WCWP 10B,001,454492,Ornelas; Tricia,20,0,20,0
1708257358721,WCWP 10B,002,454501,Ornelas; Tricia,20,0,20,0
1708257358721,WCWP 10B,003,454565,Gagnon; Jeffrey C,2,0,20,18
1708257358721,WCWP 10B,004,454604,Ornelas; Tricia,16,0,20,4
1708257358721,WCWP 10B,005,454668,Staff,16,0,16,0
1708257358721,WCWP 10B,006,454724,Staff,16,0,16,0
1708257358721,WCWP 10B,007,454725,Staff,14,0,16,2
1708257358721,WCWP 10B,008,454768,Staff,0,0,0,0
1708257358721,WCWP 10B,009,454769,Staff,0,0,0,0
1708257358721,WCWP 10B,010,454770,Staff,0,0,0,0
1708257358721,WCWP 10B,011,454771,Dhir; Simrita,16,0,20,4
1708257358721,WCWP 10B,012,454772,Dhir; Simrita,16,0,20,4
1708257358721,WCWP 10B,013,454773,Merryman; Walter,17,0,20,3
1708257358721,WCWP 10B,014,454774,Dhir; Simrita,18,0,20,2
1708257358721,WCWP 10B,015,454775,Merryman; Walter,17,0,20,3
1708257358721,WCWP 10B,016,454776,Merryman; Walter,18,0,20,2
1708257358721,WCWP 10B,017,454777,Welji; Haleema Nazir,14,0,16,2
1708257358721,WCWP 10B,018,478868,Staff,16,0,16,0
1708257358721,WCWP 10B,019,478869,Staff,0,0,0,0
1708257358721,WCWP 10B,020,478876,Staff,0,0,0,0
1708257358721,WCWP 10B,021,478877,Staff,0,0,0,0
1708257358721,WCWP 10B,022,478887,Staff,0,0,0,0
1708257358721,WCWP 10B,023,478889,Staff,16,0,16,0
1708257358721,WCWP 10B,024,478892,Staff,0,0,0,0
1708257358721,WCWP 10B,025,478907,Staff,0,0,0,0
1708257359250,WCWP 100,A00,454800,McCleary; Keith Long,20,0,20,0
1708257359250,WCWP 100,B00,454804,McCleary; Keith Long,20,0,20,0
1708257359250,WCWP 100,C00,454822,Twohig; Niall Ivan,19,0,20,1
1708257359250,WCWP 100,D00,454855,Young; Mark T,20,0,20,0
1708257359250,WCWP 100,E00,454860,Twohig; Niall Ivan,19,0,20,1
1708257359250,WCWP 100,F00,454932,Young; Mark T,20,0,20,0
1708257359250,WCWP 100,G00,454933,Young; Mark T,20,0,20,0
1708257359776,WES 207,A00,454941,Kastner; Ryan Charles,20,0,20,0
1708257360304,WES 265,A00,454942,Staff,19,0,20,1
1708257362489,AAS 10,A01,392963,Butler; Elizabeth Annette,34,0,34,0
1708257362489,AAS 10,A02,392965,Butler; Elizabeth Annette,33,0,34,1
1708257363015,AAS 170,A00,392977,Butler; Elizabeth Annette,31,0,32,1
1708257363547,AAS 198,001,479182,Childs; Dennis R.,20,0,20,0
1708257364075,AESE 261,A00,387945,Staff,33,0,33,0
1708257364604,AESE 278D,A00,387953,Staff,33,0,33,0
1708257365129,AESE 278E,A00,387954,Staff,33,0,33,0
1708257365657,AESE 279A,A00,387956,Staff,33,0,33,0
1708257366183,AIP 197P,001,494494,Goldfarb; Brian,9999,0,9999,0
1708257366709,ANAR 100,A00,387884,Shtienberg; Gilad,15,0,16,1
1708257367239,ANAR 104,A01,387886,Tamberino; Anthony Thomas,21,0,25,4
1708257367764,ANAR 111,A00,387888,Staff,36,0,36,0
1708257368289,ANAR 115,A00,387889,Shtienberg; Gilad,36,0,36,0
1708257368820,ANAR 120,A00,387890,Staff,36,0,36,0
1708257369347,ANAR 155,A00,387891,Braswell; Geoffrey E.,15,0,25,10
1708257369877,ANAR 164,A00,387892,Staff,32,0,35,3
1708257370403,ANBI 100,A00,489626,Fox; Patrick Keolu Ozer,39,0,40,1
1708257370928,ANBI 111,A00,387893,Hrvoj Mihic; Branka,37,0,40,3
1708257371983,ANBI 144,A00,387896,Wilder; Linnea Lorene,72,0,75,3
1708257372514,ANBI 149,A00,489628,Non; Amy L,0,0,0,0
1708257373098,ANBI 173,A00,387897,Wilder; Linnea Lorene,74,0,75,1
1708257373623,ANBI 174,A00,489627,Strum; Shirley C.,13,0,15,2
1708257374149,ANES 296,001,463968,Gabriel; Rodney A,49,0,50,1
1708257374149,ANES 296,002,463969,Staff,50,0,50,0
1708257374149,ANES 296,003,463970,Staff,50,0,50,0
1708257374679,ANSC 100,A00,387898,Bialecki; Jon Anthony,40,0,40,0
1708257375207,ANSC 101,A00,387900,Sloane; Julia Kathryn,34,0,40,6
1708257375733,ANSC 117,A00,387901,Martin Sandino; Amanda Maria Yoland,13,0,15,2
1708257376258,ANSC 134,A00,387902,Staff,38,0,40,2
1708257376786,ANSC 137,A00,387903,Stewart; Alexander B,80,0,80,0
1708257377316,ANSC 138,A00,387904,Parish; Steven Martin,14,0,15,1
1708257377842,ANSC 142,A00,387905,Stone; Annika Britt,34,0,40,6
1708257378367,ANSC 147,A00,387906,Stewart; Alexander B,40,0,40,0
1708257378893,ANSC 148,A00,387907,Olivas Hernandez; Olga Lid,92,0,92,0
1708257379419,ANSC 186,A00,387910,Hankins; Joseph D.,28,0,30,2
1708257379950,ANTH 2,A01,387863,Marchetto; Maria Carolina,37,0,40,3
1708257379950,ANTH 2,A02,387864,Marchetto; Maria Carolina,40,0,40,0
1708257379950,ANTH 2,A03,387865,Marchetto; Maria Carolina,36,0,40,4
1708257379950,ANTH 2,A04,387866,Marchetto; Maria Carolina,39,0,40,1
1708257380479,ANTH 3,A01,387868,Stroth; Luke Reyneri,28,0,30,2
1708257380479,ANTH 3,A02,387869,Stroth; Luke Reyneri,29,0,30,1
1708257380479,ANTH 3,A03,387870,Stroth; Luke Reyneri,30,0,30,0
1708257380479,ANTH 3,A04,387871,Stroth; Luke Reyneri,29,0,30,1
1708257381003,ANTH 10,A00,387872,Stewart; Alexander B,80,0,80,0
1708257381532,ANTH 21,A01,387874,Stone; Annika Britt,40,0,40,0
1708257381532,ANTH 21,A02,387875,Stone; Annika Britt,40,0,40,0
1708257381532,ANTH 21,A03,387876,Stone; Annika Britt,40,0,40,0
1708257381532,ANTH 21,A04,387877,Stone; Annika Britt,39,0,40,1
1708257382060,ANTH 23,A01,387879,Staff,40,0,40,0
1708257382060,ANTH 23,A02,387880,Staff,40,0,40,0
1708257382060,ANTH 23,A03,387881,Staff,40,0,40,0
1708257382060,ANTH 23,A04,387882,Staff,40,0,40,0
1708257382586,ANTH 24,A00,387883,Pedersen; David,40,0,40,0
1708257383114,ANTH 103,A00,387911,Staff,343,0,350,7
1708257383642,ANTH 105,A00,387912,Staff,73,0,75,2
1708257384168,ANTH 112,A00,387913,Staff,23,0,25,2
1708257384697,ANTH 120,A00,479486,Parish; Steven Martin,28,0,30,2
1708257385224,ANTH 128B,A01,387923,Lewis; Leslie R,12,0,12,0
1708257385750,ANTH 192,A00,387925,Varma; Saiba,20,0,20,0
1708257386275,ANTH 196C,A00,387927,Varma; Saiba,15,0,15,0
1708257386804,ANTH 212,A00,387931,Marchetto; Maria Carolina,25,0,25,0
1708257386804,ANTH 212,B00,479487,Semendeferi; Ekaterini,25,0,25,0
1708257387331,ANTH 220,A00,387932,Csordas; Thomas J.,9,0,12,3
1708257387860,ANTH 230,001,493297,Goldstein; Paul S,18,0,20,2
1708257388385,ANTH 260,A00,479223,Jenkins; Janis A.,25,0,25,0
1708257388913,ANTH 272,A00,387936,Serlin; David,5,0,5,0
1708257389441,ANTH 273,A00,387938,Gates; Kelly,5,0,5,0
1708257389966,ANTH 288,A00,387940,Braswell; Geoffrey E.,25,0,25,0
1708257390493,ANTH 295,001,493298,Algaze; Guillermo,3,0,3,0
1708257390493,ANTH 295,002,493299,Brenner; Suzanne A,3,0,3,0
1708257390493,ANTH 295,003,493300,Csordas; Thomas J.,3,0,3,0
1708257390493,ANTH 295,004,493422,Fox; Patrick Keolu Ozer,3,0,3,0
1708257390493,ANTH 295,005,493472,Gagneux; Pascal,3,0,3,0
1708257390493,ANTH 295,006,493515,Goldstein; Paul S,3,0,3,0
1708257390493,ANTH 295,007,493592,Hankins; Joseph D.,3,0,3,0
1708257390493,ANTH 295,008,493631,Jassal; Aftab,3,0,3,0
1708257390493,ANTH 295,009,493639,Jenkins; Janis A.,3,0,3,0
1708257390493,ANTH 295,010,493657,Kaiser; Bronwyn Nicole,3,0,3,0
1708257390493,ANTH 295,011,493692,Kang; Byung Chu,3,0,3,0
1708257390493,ANTH 295,012,493758,Marchetto; Maria Carolina,3,0,3,0
1708257390493,ANTH 295,013,493761,Non; Amy L,3,0,3,0
1708257390493,ANTH 295,014,493762,Pedersen; David,3,0,3,0
1708257390493,ANTH 295,015,493825,Rivera-Collazo; Isabel C,3,0,3,0
1708257390493,ANTH 295,016,493826,Varma; Saiba,3,0,3,0
1708257390493,ANTH 295,017,493828,Yeh; Rihan Wen Xin,3,0,3,0
1708257391025,ANTH 296,001,493830,Braswell; Geoffrey E.,3,0,3,0
1708257391025,ANTH 296,002,493836,Marchetto; Maria Carolina,3,0,3,0
1708257391025,ANTH 296,003,493838,Rivera-Collazo; Isabel C,3,0,3,0
1708257391025,ANTH 296,004,493840,Varma; Saiba,3,0,3,0
1708257391025,ANTH 296,005,493842,Algaze; Guillermo,3,0,3,0
1708257391025,ANTH 296,006,493845,Brenner; Suzanne A,3,0,3,0
1708257391025,ANTH 296,007,493846,Csordas; Thomas J.,3,0,3,0
1708257391025,ANTH 296,008,493907,Fox; Patrick Keolu Ozer,3,0,3,0
1708257391025,ANTH 296,009,493949,Gagneux; Pascal,3,0,3,0
1708257391025,ANTH 296,010,493960,Goldstein; Paul S,3,0,3,0
1708257391025,ANTH 296,011,493961,Hankins; Joseph D.,3,0,3,0
1708257391025,ANTH 296,012,493962,Jassal; Aftab,3,0,3,0
1708257391025,ANTH 296,013,493963,Jenkins; Janis A.,3,0,3,0
1708257391025,ANTH 296,014,493964,Kaiser; Bronwyn Nicole,3,0,3,0
1708257391025,ANTH 296,015,493965,Kang; Byung Chu,3,0,3,0
1708257391025,ANTH 296,016,493966,Levy; Thomas E,3,0,3,0
1708257391025,ANTH 296,017,493967,Non; Amy L,3,0,3,0
1708257391025,ANTH 296,018,493968,Pedersen; David,3,0,3,0
1708257391025,ANTH 296,019,493969,Postero; Nancy Grey,3,0,3,0
1708257391025,ANTH 296,020,493970,Semendeferi; Ekaterini,3,0,3,0
1708257391025,ANTH 296,021,493971,Yeh; Rihan Wen Xin,3,0,3,0
1708257391550,AUD 236,A00,480192,Harris; Jeffrey Paul,12,0,12,0
1708257392082,AUD 260,A00,480227,Spriggs; Meghan K,12,0,12,0
1708257392608,AUD 272,A00,480367,Zettner; Erika,12,0,12,0
1708257393134,AUD 275,A00,480369,Zettner; Erika,12,0,12,0
1708257393659,AUD 284,A00,480370,Zettner; Erika,12,0,12,0
1708257393659,AUD 284,B00,480372,Spriggs; Meghan K,12,0,12,0
1708257394185,AUD 291,A00,480374,Zettner; Erika,12,0,12,0
1708257394710,AUD 296,A00,480375,Zettner; Erika,12,0,12,0
1708257394710,AUD 296,B00,480376,Harris; Jeffrey Paul,12,0,12,0
1708257394710,AUD 296,C00,480377,Ryan; Allen F.,12,0,12,0
1708257395246,AWP 3,002,387672,Given; William Allan,9,0,9,0
1708257395246,AWP 3,003,387678,Staff,5,0,5,0
1708257395246,AWP 3,004,387681,Staff,0,0,0,0
1708257395246,AWP 3,007,387784,West; Geoffrey Scott,4,0,5,1
1708257395246,AWP 3,009,387786,Kolodezh; Samuel,5,0,5,0
1708257395246,AWP 3,010,387787,Gilbert; Peter W,5,0,5,0
1708257395771,AWP 4A,001,387791,Staff,12,0,12,0
1708257395771,AWP 4A,002,387792,Staff,0,0,0,0
1708257396325,AWP 4B,001,387793,Bolin; Jillian,0,0,0,0
1708257396325,AWP 4B,002,387794,Bolin; Jillian,0,0,0,0
1708257396325,AWP 4B,003,387795,Bauer; Holly Jean,0,0,0,0
1708257396325,AWP 4B,004,387796,Vaughn; Kelsey Sara,0,0,0,0
1708257396325,AWP 4B,005,387797,Vaughn; Kelsey Sara,0,0,0,0
1708257396325,AWP 4B,007,387799,Ajo; Frances Margaret,0,0,0,0
1708257396325,AWP 4B,008,387800,Ajo; Frances Margaret,0,0,0,0
1708257396325,AWP 4B,009,387801,Hall; Graham T,0,0,0,0
1708257396325,AWP 4B,010,387802,Hall; Graham T,0,0,0,0
1708257396325,AWP 4B,011,387803,Heiser; Jerrod A,0,0,0,0
1708257396325,AWP 4B,012,387804,Heiser; Jerrod A,0,0,0,0
1708257396325,AWP 4B,013,387805,Jones; William Jadie,0,0,0,0
1708257396325,AWP 4B,014,387806,Jones; William Jadie,0,0,0,0
1708257396325,AWP 4B,015,387807,Christie; Veronica Ann,0,0,0,0
1708257396325,AWP 4B,016,387808,Christie; Veronica Ann,0,0,0,0
1708257396325,AWP 4B,019,387820,Falcon; Jennifer A,0,0,0,0
1708257396325,AWP 4B,020,387821,Falcon; Jennifer A,0,0,0,0
1708257396325,AWP 4B,021,387822,Eastin; Schuyler E.,0,0,0,0
1708257396325,AWP 4B,023,387824,Coulter; Jane Elisabeth,0,0,0,0
1708257396325,AWP 4B,025,387826,O'Neil; Courtney L,0,0,0,0
1708257396325,AWP 4B,026,387827,O'Neil; Courtney L,0,0,0,0
1708257396325,AWP 4B,027,387828,Tsurska Svetina; Olena,0,0,0,0
1708257396325,AWP 4B,028,387829,Tsurska Svetina; Olena,0,0,0,0
1708257396325,AWP 4B,029,387830,Spicer; Jacqueline,0,0,0,0
1708257396325,AWP 4B,030,387831,Spicer; Jacqueline,0,0,0,0
1708257396325,AWP 4B,031,387832,Steinberg; Stacy A,0,0,0,0
1708257396325,AWP 4B,032,387833,Steinberg; Stacy A,0,0,0,0
1708257396325,AWP 4B,033,387834,Chandler; Bailee Daniele,0,0,0,0
1708257396325,AWP 4B,034,387835,Chandler; Bailee Daniele,0,0,0,0
1708257396325,AWP 4B,035,387836,Tiernan; Christa Michelle,0,0,0,0
1708257396325,AWP 4B,036,387837,Tiernan; Christa Michelle,0,0,0,0
1708257396325,AWP 4B,037,387840,Gardella; Alexander Drew,0,0,0,0
1708257396325,AWP 4B,038,387841,Gardella; Alexander Drew,0,0,0,0
1708257396325,AWP 4B,039,387857,Zimmerman; Guy,0,0,0,0
1708257396325,AWP 4B,040,387858,Zimmerman; Guy,0,0,0,0
1708257396325,AWP 4B,041,387859,Zroka; Amy Liane,0,0,0,0
1708257396325,AWP 4B,042,387860,Zroka; Amy Liane,0,0,0,0
1708257396855,BENG 87,A00,489656,Sah; Robert Lie-Yuan,20,0,20,0
1708257396855,BENG 87,B00,489657,Sah; Robert Lie-Yuan,20,0,20,0
1708257396855,BENG 87,C00,494754,Omens; Jeffrey Howard,20,0,20,0
1708257397380,BENG 100,A01,387959,Alexandrov; Ludmil B,26,0,28,2
1708257397380,BENG 100,A02,387960,Alexandrov; Ludmil B,26,0,28,2
1708257397380,BENG 100,A03,387984,Alexandrov; Ludmil B,26,0,28,2
1708257397380,BENG 100,A04,387985,Alexandrov; Ludmil B,25,0,28,3
1708257397380,BENG 100,A05,387986,Alexandrov; Ludmil B,27,0,28,1
1708257397905,BENG 102,A00,387987,Chapelin; Fanny,55,0,56,1
1708257398434,BENG 103B,A00,387993,Fraley; Stephanie I.,116,0,120,4
1708257398962,BENG 112B,A01,388053,Shi; Lingyan,26,0,30,4
1708257398962,BENG 112B,A02,388054,Shi; Lingyan,29,0,30,1
1708257399489,BENG 125,A00,388055,Hasty; Jeff M,120,0,160,40
1708257400015,BENG 133,A01,388866,Mali; Prashant Gulab Ram,36,0,40,4
1708257400546,BENG 140B,A01,388884,Cabrales; Pedro,28,0,30,2
1708257400546,BENG 140B,A02,388885,Cabrales; Pedro,30,0,30,0
1708257400546,BENG 140B,A03,388886,Cabrales; Pedro,26,0,30,4
1708257401073,BENG 160,A50,388889,Aguado; Brian Alberto,23,0,25,2
1708257401073,BENG 160,A51,388919,Aguado; Brian Alberto,25,0,25,0
1708257401073,BENG 160,A52,388920,Aguado; Brian Alberto,25,0,25,0
1708257401601,BENG 168,A01,388961,Khojah; Reem I,30,0,30,0
1708257402127,BENG 172,A50,389087,Omens; Jeffrey Howard & Cabrales; Pedro,15,0,20,5
1708257402127,BENG 172,A51,389088,Omens; Jeffrey Howard & Cabrales; Pedro,14,0,20,6
1708257402653,BENG 182,A01,389128,Bafna; Vineet,28,0,30,2
1708257403183,BENG 186A,A00,389130,Kwon; Ester Jihae,105,0,120,15
1708257403709,BENG 187A,A00,389289,Taylor Amos; Alyssa C,157,0,170,13
1708257404240,BENG 187D,A00,389290,Taylor Amos; Alyssa C,33,0,60,27
1708257404240,BENG 187D,B00,389300,Taylor Amos; Alyssa C,51,0,60,9
1708257404240,BENG 187D,C00,389302,Taylor Amos; Alyssa C,35,0,60,25
1708257404765,BENG 189,A00,389303,Contijoch; Francisco,26,0,30,4
1708257405295,BENG 193,A00,389328,Engler; Adam J.,0,0,0,0
1708257405823,BENG 196,A00,436038,Engler; Adam J.,9999,0,9999,0
1708257406348,BENG 197,A00,436081,Engler; Adam J.,9999,0,9999,0
1708257406877,BENG 203,A00,389385,Bafna; Vineet & Zhong; Sheng,20,0,20,0
1708257407404,BENG 207,A00,389386,Kwon; Ester Jihae,10,0,40,30
1708257407404,BENG 207,B00,389400,Taylor Amos; Alyssa C,8,0,30,22
1708257407404,BENG 207,C00,389432,Khojah; Reem I,20,0,40,20
1708257407933,BENG 209,A00,389456,Scholtes Acevedo; Claire,30,0,30,0
1708257408472,BENG 213,A00,389496,Palsson; Bernhard O.,16,0,20,4
1708257409525,BENG 224,A00,389515,Staff,0,0,0,0
1708257410057,BENG 226,A01,479043,Schmid-Schoenbein; Geert W,7,0,30,23
1708257410583,BENG 227,A00,389591,Fraley; Stephanie I.,55,0,120,65
1708257411108,BENG 230C,A00,389810,Mc Culloch; Andrew Douglas,43,0,90,47
1708257411636,BENG 232,A01,390161,Sah; Robert Lie-Yuan,6,0,50,44
1708257412162,BENG 233,A00,390290,Shah; Sameer B,33,0,50,17
1708257412688,BENG 234,A00,390291,Silva; Gabriel,20,0,56,36
1708257413217,BENG 235,A00,390318,Bintu; Bogdan,16,0,40,24
1708257413746,BENG 276,A00,390357,Mc Culloch; Andrew Douglas & Amaro; Rommie E,0,0,0,0
1708257414271,BENG 280C,A01,390443,McVeigh; Elliot R.,45,0,56,11
1708257414796,BENG 281,A00,390444,Kravets; Vira V.,50,0,110,60
1708257415325,BENG 283,A00,390445,Komives; Elizabeth A,4,0,4,0
1708257415854,BENG 292,A01,390623,Ross; Camille,20,0,20,0
1708257416379,BENG 294C,A00,390709,Engler; Adam J.,17,0,20,3
1708257416904,BENG 295,A00,436300,Watson; John Thomas,9999,0,9999,0
1708257417432,BGGN 205,A00,423656,Daugherty; Matthew Dorton,47,0,60,13
1708257417960,BGGN 207,A01,423703,Ross; Camille,0,0,0,0
1708257418485,BGGN 215,A00,423704,Petrie; Katherine Lynn,22,0,30,8
1708257419011,BGGN 216,A01,423855,Mueller; Liam O'Connor,37,0,50,13
1708257419537,BGGN 218,A00,423861,David; Michael,19,0,30,11
1708257420065,BGGN 223,A00,423862,Bier; Ethan,17,0,35,18
1708257420590,BGGN 230,A00,423863,Taylor; Susan S.,8,0,15,7
1708257421118,BGGN 232,A00,423864,Briggs; Steven & Troemel; Emily Ruth,25,0,30,5
1708257421645,BGGN 239,A01,424014,Kronenberg; Mitchell E.,30,0,30,0
1708257422171,BGGN 240,A01,424016,Juavinett; Ashley Lauren,0,0,6,6
1708257422699,BGGN 248,A00,424017,Halpain; Shelley,26,0,30,4
1708257423224,BGGN 249C,A00,424052,Staff,33,0,33,0
1708257423749,BGGN 250,A01,424091,Zou; Yimin,7,0,8,1
1708257424274,BGGN 252,A01,424093,Sejnowski; Terrence J,5,0,6,1
1708257424798,BGGN 255,A00,424094,Root; Cory Matthew,29,0,30,1
1708257425329,BGGN 262,A01,424096,Villa Rodriguez; Elizabeth,30,0,30,0
1708257425861,BGGN 267,A01,424099,Benna; Marcus K & Aljadeff; Johnatan,5,0,6,1
1708257426441,BGGN 270,A00,477483,Juavinett; Ashley Lauren,67,0,75,8
1708257427045,BGGN 271,001,481745,Ackerman; Susan,9998,0,9999,1
1708257427045,BGGN 271,002,481746,Akbari; Omar Sultan,9999,0,9999,0
1708257427045,BGGN 271,003,481747,Allen; Nicola J,9999,0,9999,0
1708257427045,BGGN 271,004,481748,Banegas; Matthew Patrick,9999,0,9999,0
1708257427045,BGGN 271,005,481749,Breen; Ellen C.,9998,0,9999,1
1708257427045,BGGN 271,006,481750,Briggs; Steven,9998,0,9999,1
1708257427045,BGGN 271,007,481751,Bui; Jack D,9999,0,9999,0
1708257427045,BGGN 271,008,481762,Busch; Wolfgang,9999,0,9999,0
1708257427045,BGGN 271,009,481763,Castle; Michael James,9999,0,9999,0
1708257427045,BGGN 271,010,481764,Chang; John Tzu-yu,9999,0,9999,0
1708257427045,BGGN 271,011,481765,Chen; Ju,9998,0,9999,1
1708257427045,BGGN 271,012,481766,Chen; Xu,9999,0,9999,0
1708257427045,BGGN 271,013,481767,Cheng; Christine Shiang-Ling,9999,0,9999,0
1708257427045,BGGN 271,014,481768,Cherqui; Stephanie,9999,0,9999,0
1708257427045,BGGN 271,015,481769,Cho; Yoshitake,9999,0,9999,0
1708257427045,BGGN 271,016,481770,Church; Kellie Breen,9998,0,9999,1
1708257427045,BGGN 271,017,481771,Cleland; Elsa Eleanor,9999,0,9999,0
1708257427045,BGGN 271,018,481779,Cohen; Shiran,9998,0,9999,1
1708257427045,BGGN 271,019,481814,Cook-Andersen; Heidi Leigh,9999,0,9999,0
1708257427045,BGGN 271,020,481815,Cooke; James Edward,9999,0,9999,0
1708257427045,BGGN 271,021,481816,Coufal; Nicole Gabriele,9998,0,9999,1
1708257427045,BGGN 271,022,481818,Crotty Alexander; Laura E,9999,0,9999,0
1708257427045,BGGN 271,023,481819,Daugherty; Matthew Dorton,9998,0,9999,1
1708257427045,BGGN 271,024,481820,De Guglielmo; Giordano,9998,0,9999,1
1708257427045,BGGN 271,025,481821,Doherty; Taylor Alan,9998,0,9999,1
1708257427045,BGGN 271,026,481822,Dulawa; Stephanie Carole,9999,0,9999,0
1708257427045,BGGN 271,027,481823,Esko; Jeffrey D.,9998,0,9999,1
1708257427045,BGGN 271,028,481824,Feldstein; Ariel E,9998,0,9999,1
1708257427045,BGGN 271,029,481825,Friedman; Rick Adam,9999,0,9999,0
1708257427045,BGGN 271,030,481826,Furnari; Frank,9999,0,9999,0
1708257427045,BGGN 271,031,481829,Ghosh; Pradipta,9998,0,9999,1
1708257427045,BGGN 271,032,481830,Gleeson; Joseph Gerard,9999,0,9999,0
1708257427045,BGGN 271,033,481831,Golden; Susan S.,9998,0,9999,1
1708257427045,BGGN 271,034,481832,Goren; Alon M,9998,0,9999,1
1708257427045,BGGN 271,035,481834,Gustafsson; Asa Birgitta,9999,0,9999,0
1708257427045,BGGN 271,036,481836,Hamdoun; Amr,9999,0,9999,0
1708257427045,BGGN 271,037,481837,Hao; Nan,9999,0,9999,0
1708257427045,BGGN 271,038,481840,Holway; David A.,9998,0,9999,1
1708257427045,BGGN 271,039,481841,Huffaker; Alisa,9998,0,9999,1
1708257427045,BGGN 271,040,481843,Sebat; Lilia Mikhailovna,9998,0,9999,1
1708257427045,BGGN 271,041,481889,Ideker; Trey,9999,0,9999,0
1708257427045,BGGN 271,042,481890,Jiang; Qingfei,9998,0,9999,1
1708257427045,BGGN 271,043,482311,Jin; Yishi,9999,0,9999,0
1708257427045,BGGN 271,044,482334,Joiner; William J.,9999,0,9999,0
1708257427045,BGGN 271,045,482353,Kaech; Susan Michelle,9998,0,9999,1
1708257427045,BGGN 271,046,482378,Karin; Michael,9999,0,9999,0
1708257427045,BGGN 271,047,482379,Kleinfeld; David,9999,0,9999,0
1708257427045,BGGN 271,048,482413,Koffler; Yacov,9999,0,9999,0
1708257427045,BGGN 271,049,482414,Komiyama; Takaki,9999,0,9999,0
1708257427045,BGGN 271,050,482415,Kryazhimskiy; Sergey A,9999,0,9999,0
1708257427045,BGGN 271,051,482416,Lawson; Mark Andrew,9999,0,9999,0
1708257427045,BGGN 271,052,482417,Lee; Yun Sok,9999,0,9999,0
1708257427045,BGGN 271,053,482451,Leutgeb; Stefan,9998,0,9999,1
1708257427045,BGGN 271,054,482452,Lo; Stanley M.,9999,0,9999,0
1708257427045,BGGN 271,055,482453,Lu; Pengzhe,9998,0,9999,1
1708257427045,BGGN 271,056,482454,Lykke-Andersen; Jens,9998,0,9999,1
1708257427045,BGGN 271,057,482456,McDonnell; Lisa Marie,9999,0,9999,0
1708257427045,BGGN 271,058,482461,McHugh; Colleen A,9998,0,9999,1
1708257427045,BGGN 271,059,482478,Meharena; Hiruy Sibhatu,9999,0,9999,0
1708257427045,BGGN 271,060,482497,Morris; Gerald P,9999,0,9999,0
1708257427045,BGGN 271,061,482499,Mukamel; Eran A,9998,0,9999,1
1708257427045,BGGN 271,062,482535,Muotri; Alysson,9999,0,9999,0
1708257427045,BGGN 271,063,482551,Muroyama; Andrew David,9999,0,9999,0
1708257427045,BGGN 271,064,482552,Neal; Sonya E,9999,0,9999,0
1708257427045,BGGN 271,065,482618,Nieh; James Charles,9999,0,9999,0
1708257427045,BGGN 271,066,482619,O'Donoghue; Anthony John,9999,0,9999,0
1708257427045,BGGN 271,067,482626,Pantham; Priyadarshini,9999,0,9999,0
1708257427045,BGGN 271,068,482633,Parast; Mana,9999,0,9999,0
1708257427045,BGGN 271,069,482634,Perry; Michael William,9999,0,9999,0
1708257427045,BGGN 271,070,482639,Pride; David Tevis,9999,0,9999,0
1708257427045,BGGN 271,071,482645,Pruneda-Paz; Jose L.,9999,0,9999,0
1708257427045,BGGN 271,072,482648,Rana; Tariq,9999,0,9999,0
1708257427045,BGGN 271,073,482650,Risbrough; Victoria Blythe,9999,0,9999,0
1708257427045,BGGN 271,074,482655,Rissman; Robert Andrew,9999,0,9999,0
1708257427045,BGGN 271,075,482656,Rosenfeld; Michael G,9999,0,9999,0
1708257427045,BGGN 271,076,482657,Saier; Milton H.,9999,0,9999,0
1708257427045,BGGN 271,077,482663,Sander; Maike,9999,0,9999,0
1708257427045,BGGN 271,078,482664,Schenk; Simon,9999,0,9999,0
1708257427045,BGGN 271,079,482665,Schoeneberg; Johannes,9998,0,9999,1
1708257427045,BGGN 271,080,482666,Schroeder; Julian I,9998,0,9999,1
1708257427045,BGGN 271,081,482667,Shaner; Nathan C.,9999,0,9999,0
1708257427045,BGGN 271,082,482668,Sheikh; Farah,9999,0,9999,0
1708257427045,BGGN 271,083,482669,Shurin; Jonathan,9999,0,9999,0
1708257427045,BGGN 271,084,482675,Sigurdson; Christina,9999,0,9999,0
1708257427045,BGGN 271,085,482676,Smith; David M.,9999,0,9999,0
1708257427045,BGGN 271,086,482677,Steinmetz; Nicole F,9999,0,9999,0
1708257427045,BGGN 271,087,482692,Su; Chih-Ying,9999,0,9999,0
1708257427045,BGGN 271,088,482694,Suel; Gurol Mehmet,9999,0,9999,0
1708257427045,BGGN 271,089,482695,Telese; Francesca,9999,0,9999,0
1708257427045,BGGN 271,090,482745,Thackray; Varykina G.,9999,0,9999,0
1708257427045,BGGN 271,091,482746,Towers; Christina Garlingt,9999,0,9999,0
1708257427045,BGGN 271,092,482747,Troemel; Emily Ruth,9997,0,9999,2
1708257427045,BGGN 271,093,482748,Tye; Kay M,9999,0,9999,0
1708257427045,BGGN 271,094,482749,Valdez-Jasso; Daniela,9998,0,9999,1
1708257427045,BGGN 271,095,482750,Wahlin; Karl Jonas,9997,0,9999,2
1708257427045,BGGN 271,096,482751,Welsbie; Derek,9999,0,9999,0
1708257427045,BGGN 271,097,482752,Wilkinson; Miles Frome,9999,0,9999,0
1708257427045,BGGN 271,098,482754,Yaksh; Tony L.,9999,0,9999,0
1708257427045,BGGN 271,099,482760,Yang; Jing,9999,0,9999,0
1708257427045,BGGN 271,100,482761,Yeo; Eugene Wei-Ming,9998,0,9999,1
1708257427045,BGGN 271,101,482763,Ying; Wei,9999,0,9999,0
1708257427045,BGGN 271,102,482764,Zarrinpar; Amir,9999,0,9999,0
1708257427045,BGGN 271,103,482765,Zengler; Karsten B,9999,0,9999,0
1708257427045,BGGN 271,104,482766,Zhang; Dong-Er,9999,0,9999,0
1708257427045,BGGN 271,105,482768,Zhao; Yunde,9999,0,9999,0
1708257427045,BGGN 271,106,482776,Zheng; Binhai,9999,0,9999,0
1708257427045,BGGN 271,107,482777,Zheng; Ye,9998,0,9999,1
1708257427045,BGGN 271,108,482806,Zuniga; Elina I,9999,0,9999,0
1708257427573,BGGN 273,A01,424101,Mueller; Liam O'Connor,43,0,50,7
1708257428097,BGGN 280,A00,424102,Ernst; Andreas,3,0,5,2
1708257428097,BGGN 280,C00,481361,Amaro; Rommie E,2,0,5,3
1708257428626,BGGN 281,A00,424103,Desai; Arshad & Oegema; Karen,0,0,5,5
1708257429152,BGGN 283,A00,424104,Rivera; Fabian Chavez,0,0,5,5
1708257429152,BGGN 283,B00,424105,Russell; Alistair B,4,0,5,1
1708257429152,BGGN 283,D00,424107,Wildonger; Jill Cathleen,1,0,5,4
1708257429678,BGGN 284,A00,424108,Glasgow; Stacey Marie,2,0,5,3
1708257430207,BGGN 285,A00,424109,Chisholm; Andrew D.,1,0,5,4
1708257430207,BGGN 285,B00,424110,Farley; Emma Kristen,2,0,5,3
1708257430733,BGGN 295,A00,424120,Tour; Ella,9,0,30,21
1708257431259,BGJC 204,A00,424138,Lu; Li-Fan & Chang; John Tzu-yu,9998,0,9999,1
1708257431789,BGJC 215,A00,424139,Cooke; James Edward & Lo; Stanley M.,10,0,10,0
1708257432345,BGRD 200,001,485528,Ackerman; Susan,9998,0,9999,1
1708257432345,BGRD 200,002,485529,Akbari; Omar Sultan,9999,0,9999,0
1708257432345,BGRD 200,003,485530,Allen; Eric,9999,0,9999,0
1708257432345,BGRD 200,004,485531,Allen; Nicola J,9999,0,9999,0
1708257432345,BGRD 200,005,485533,Amaro; Rommie E,9999,0,9999,0
1708257432345,BGRD 200,006,485535,Augustine; Vineet,9999,0,9999,0
1708257432345,BGRD 200,007,485536,Ayres; Janelle Samantha,9999,0,9999,0
1708257432345,BGRD 200,008,485538,Banegas; Matthew Patrick,9999,0,9999,0
1708257432345,BGRD 200,009,485539,Banghart; Matthew Ryan,9999,0,9999,0
1708257432345,BGRD 200,010,485542,Benna; Marcus K,9999,0,9999,0
1708257432345,BGRD 200,011,485543,Bennett; Eric J,9999,0,9999,0
1708257432345,BGRD 200,012,485545,Bloodgood; Brenda Laurie,9999,0,9999,0
1708257432345,BGRD 200,013,485546,Breen; Ellen C.,9998,0,9999,1
1708257432345,BGRD 200,014,485548,Briggs; Steven,9998,0,9999,1
1708257432345,BGRD 200,015,485549,Bui; Jack D,9999,0,9999,0
1708257432345,BGRD 200,016,485552,Busch; Wolfgang,9999,0,9999,0
1708257432345,BGRD 200,017,485621,Callaway; Edward M,9999,0,9999,0
1708257432345,BGRD 200,018,485622,Castle; Michael James,9999,0,9999,0
1708257432345,BGRD 200,019,485623,Chaim; Isaac,9999,0,9999,0
1708257432345,BGRD 200,020,485624,Chang; John Tzu-yu,9999,0,9999,0
1708257432345,BGRD 200,021,485625,Chen; Ju,9999,0,9999,0
1708257432345,BGRD 200,022,485626,Chen; Xu,9999,0,9999,0
1708257432345,BGRD 200,023,485627,Cheng; Christine Shiang-Ling,9999,0,9999,0
1708257432345,BGRD 200,024,485632,Cherqui; Stephanie,9999,0,9999,0
1708257432345,BGRD 200,025,485633,Cho; Yoshitake,9999,0,9999,0
1708257432345,BGRD 200,026,485634,Church; Kellie Breen,9999,0,9999,0
1708257432345,BGRD 200,027,485635,Cleland; Elsa Eleanor,9999,0,9999,0
1708257432345,BGRD 200,028,485636,Cohen; Shiran,9998,0,9999,1
1708257432345,BGRD 200,029,485639,Cook-Andersen; Heidi Leigh,9999,0,9999,0
1708257432345,BGRD 200,030,485686,Cooke; James Edward,9999,0,9999,0
1708257432345,BGRD 200,031,485688,Cooper; Kimberly Lynn,9999,0,9999,0
1708257432345,BGRD 200,032,485689,Coufal; Nicole Gabriele,9998,0,9999,1
1708257432345,BGRD 200,033,485690,Crotty Alexander; Laura E,9999,0,9999,0
1708257432345,BGRD 200,034,485691,Staff,9999,0,9999,0
1708257432345,BGRD 200,035,485692,De Guglielmo; Giordano,9999,0,9999,0
1708257432345,BGRD 200,036,485693,De Silva; Shermin,9999,0,9999,0
1708257432345,BGRD 200,037,485694,Desai; Arshad,9999,0,9999,0
1708257432345,BGRD 200,038,485695,Dickinson; Alexandra Jazz,9999,0,9999,0
1708257432345,BGRD 200,039,485717,Doherty; Taylor Alan,9998,0,9999,1
1708257432345,BGRD 200,040,485720,Dulawa; Stephanie Carole,9999,0,9999,0
1708257432345,BGRD 200,041,485721,Ecker; Joseph R,9999,0,9999,0
1708257432345,BGRD 200,042,485760,Engle; Dannielle D,9999,0,9999,0
1708257432345,BGRD 200,043,485761,Ernst; Andreas,9998,0,9999,1
1708257432345,BGRD 200,044,485766,Esko; Jeffrey D.,9998,0,9999,1
1708257432345,BGRD 200,045,485905,Evans; Ronald M,9999,0,9999,0
1708257432345,BGRD 200,046,485907,Staff,9999,0,9999,0
1708257432345,BGRD 200,047,485918,Feldstein; Ariel E,9998,0,9999,1
1708257432345,BGRD 200,048,485938,Friedman; Rick Adam,9999,0,9999,0
1708257432345,BGRD 200,049,485986,Furnari; Frank,9999,0,9999,0
1708257432345,BGRD 200,050,486018,Gage; Fred H,9999,0,9999,0
1708257432345,BGRD 200,051,486139,George; Monique Leana,9999,0,9999,0
1708257432345,BGRD 200,052,486140,Ghosh; Pradipta,9998,0,9999,1
1708257432345,BGRD 200,053,486141,Glass; Christopher,9998,0,9999,1
1708257432345,BGRD 200,054,486142,Gleeson; Joseph Gerard,9999,0,9999,0
1708257432345,BGRD 200,055,486143,Golden; Susan S.,9999,0,9999,0
1708257432345,BGRD 200,056,486144,Goldrath; Ananda,9999,0,9999,0
1708257432345,BGRD 200,057,486145,Goren; Alon M,9998,0,9999,1
1708257432345,BGRD 200,058,486146,Gustafsson; Asa Birgitta,9999,0,9999,0
1708257432345,BGRD 200,059,486164,Gutkind; Jorge Silvio,9999,0,9999,0
1708257432345,BGRD 200,060,486203,Hamdoun; Amr,9999,0,9999,0
1708257432345,BGRD 200,061,486204,Hampton; Randolph Y.,9999,0,9999,0
1708257432345,BGRD 200,062,486205,Hao; Nan,9999,0,9999,0
1708257432345,BGRD 200,063,486206,Staff,9999,0,9999,0
1708257432345,BGRD 200,064,486207,Hasty; Jeff M,9999,0,9999,0
1708257432345,BGRD 200,065,486208,Hollern; Daniel Patrick,9999,0,9999,0
1708257432345,BGRD 200,066,486209,Holway; David A.,9997,0,9999,2
1708257432345,BGRD 200,067,486214,Huffaker; Alisa,9998,0,9999,1
1708257432345,BGRD 200,068,486215,Hui; Enfu,9999,0,9999,0
1708257432345,BGRD 200,069,486216,Hwa; Terence T.,9999,0,9999,0
1708257432345,BGRD 200,070,486217,Sebat; Lilia Mikhailovna,9998,0,9999,1
1708257432345,BGRD 200,071,486218,Ideker; Trey,9999,0,9999,0
1708257432345,BGRD 200,072,486219,Jackrel; Sara,9998,0,9999,1
1708257432345,BGRD 200,073,486224,Jiang; Qingfei,9998,0,9999,1
1708257432345,BGRD 200,074,486225,Jin; Yishi,9999,0,9999,0
1708257432345,BGRD 200,075,486226,Joiner; William J.,9999,0,9999,0
1708257432345,BGRD 200,076,486227,Jun; Suckjoon,9999,0,9999,0
1708257432345,BGRD 200,077,486228,Kadonaga; James T,9998,0,9999,1
1708257432345,BGRD 200,078,486229,Kaech; Susan Michelle,9997,0,9999,2
1708257432345,BGRD 200,079,486237,Karin; Michael,9999,0,9999,0
1708257432345,BGRD 200,080,486238,Kleinfeld; David,9999,0,9999,0
1708257432345,BGRD 200,081,486239,Knight; Robin,9999,0,9999,0
1708257432345,BGRD 200,082,486335,Koffler; Yacov,9999,0,9999,0
1708257432345,BGRD 200,083,486336,Komiyama; Takaki,9999,0,9999,0
1708257432345,BGRD 200,084,486337,Kosuri; Pallav,9999,0,9999,0
1708257432345,BGRD 200,085,486353,Kryazhimskiy; Sergey A,9999,0,9999,0
1708257432345,BGRD 200,086,486354,Kurle; Carolyn M.,9999,0,9999,0
1708257432345,BGRD 200,087,486355,Law; Julie A,9999,0,9999,0
1708257432345,BGRD 200,088,486356,Lawson; Mark Andrew,9999,0,9999,0
1708257432345,BGRD 200,089,486357,Lee; Kuo Fen,9999,0,9999,0
1708257432345,BGRD 200,090,486376,Lee; Yun Sok,9999,0,9999,0
1708257432345,BGRD 200,091,486413,Leutgeb; Jill K.,9999,0,9999,0
1708257432345,BGRD 200,092,486414,Leutgeb; Stefan,9998,0,9999,1
1708257432345,BGRD 200,093,486415,Lim; Byungkook,9999,0,9999,0
1708257432345,BGRD 200,094,486419,Lo; Stanley M.,9999,0,9999,0
1708257432345,BGRD 200,095,486420,Looger; Loren Lee,9999,0,9999,0
1708257432345,BGRD 200,096,486422,Lovett-Barron; Matthew Rod,9999,0,9999,0
1708257432345,BGRD 200,097,486423,Lu; Li-Fan,9998,0,9999,1
1708257432345,BGRD 200,098,486424,Lu; Pengzhe,9998,0,9999,1
1708257432345,BGRD 200,099,486425,Lykke-Andersen; Jens,9998,0,9999,1
1708257432345,BGRD 200,100,486426,Lyumkis; Dmitry Evgenievich,9999,0,9999,0
1708257432345,BGRD 200,101,486427,Madigan; Cressida Ariana,9999,0,9999,0
1708257432345,BGRD 200,102,486428,Staff,9999,0,9999,0
1708257432345,BGRD 200,103,486429,Mayfield; Stephen P.,9998,0,9999,1
1708257432345,BGRD 200,104,486430,McDonnell; Lisa Marie,9999,0,9999,0
1708257432345,BGRD 200,105,486620,McHugh; Colleen A,9998,0,9999,1
1708257432345,BGRD 200,106,486621,Meharena; Hiruy Sibhatu,9999,0,9999,0
1708257432345,BGRD 200,107,486622,Staff,9999,0,9999,0
1708257432345,BGRD 200,108,486681,Morris; Gerald P,9999,0,9999,0
1708257432345,BGRD 200,109,486682,Mukamel; Eran A,9998,0,9999,1
1708257432345,BGRD 200,110,486683,Muotri; Alysson,9999,0,9999,0
1708257432345,BGRD 200,111,486684,Muroyama; Andrew David,9999,0,9999,0
1708257432345,BGRD 200,112,486687,Murre; Cornelis,9999,0,9999,0
1708257432345,BGRD 200,113,486691,Neal; Sonya E,9999,0,9999,0
1708257432345,BGRD 200,114,486692,Nieh; James Charles,9998,0,9999,1
1708257432345,BGRD 200,115,486693,Nimmerjahn; Axel,9999,0,9999,0
1708257432345,BGRD 200,116,486694,Nizet; Victor F.,9999,0,9999,0
1708257432345,BGRD 200,117,486695,O'Donoghue; Anthony John,9999,0,9999,0
1708257432345,BGRD 200,118,486706,Oegema; Karen,9999,0,9999,0
1708257432345,BGRD 200,119,486708,O'Shea; Clodagh,9999,0,9999,0
1708257432345,BGRD 200,120,486709,Pantham; Priyadarshini,9999,0,9999,0
1708257432345,BGRD 200,121,486715,Parast; Mana,9999,0,9999,0
1708257432345,BGRD 200,122,486716,Pasquinelli; Amy,9998,0,9999,1
1708257432345,BGRD 200,123,486718,Pekkurnaz Banghart; Gulcin,9999,0,9999,0
1708257432345,BGRD 200,124,486720,Perry; Michael William,9999,0,9999,0
1708257432345,BGRD 200,125,486721,Pfaff; Samuel,9999,0,9999,0
1708257432345,BGRD 200,126,486723,Pogliano; Joseph,9999,0,9999,0
1708257432345,BGRD 200,127,486724,Pogliano; Kit J.,9999,0,9999,0
1708257432345,BGRD 200,128,486727,Pride; David Tevis,9999,0,9999,0
1708257432345,BGRD 200,129,486728,Pruneda-Paz; Jose L.,9999,0,9999,0
1708257432345,BGRD 200,130,486733,Staff,9999,0,9999,0
1708257432345,BGRD 200,131,486734,Rana; Tariq,9999,0,9999,0
1708257432345,BGRD 200,132,486736,Reck-Peterson; Samara L,9999,0,9999,0
1708257432345,BGRD 200,133,486738,Rennison; Diana,9999,0,9999,0
1708257432345,BGRD 200,134,486741,Rifkin; Scott,9999,0,9999,0
1708257432345,BGRD 200,135,486743,Risbrough; Victoria Blythe,9999,0,9999,0
1708257432345,BGRD 200,136,486749,Rissman; Robert Andrew,9999,0,9999,0
1708257432345,BGRD 200,137,486750,Rivera; Fabian Chavez,9999,0,9999,0
1708257432345,BGRD 200,138,486753,Root; Cory Matthew,9999,0,9999,0
1708257432345,BGRD 200,139,486760,Rosenfeld; Michael G,9998,0,9999,1
1708257432345,BGRD 200,140,486763,Russell; Alistair B,9999,0,9999,0
1708257432345,BGRD 200,141,486766,Saier; Milton H.,9999,0,9999,0
1708257432345,BGRD 200,142,486768,Sander; Maike,9999,0,9999,0
1708257432345,BGRD 200,143,486770,Saphire; Erica Ollmann,9999,0,9999,0
1708257432345,BGRD 200,144,486771,Schenk; Simon,9999,0,9999,0
1708257432345,BGRD 200,145,486774,Schoeneberg; Johannes,9999,0,9999,0
1708257432345,BGRD 200,146,486777,Schroeder; Julian I,9998,0,9999,1
1708257432345,BGRD 200,147,486783,Shah; Sameer B,9999,0,9999,0
1708257432345,BGRD 200,148,486784,Shaner; Nathan C.,9999,0,9999,0
1708257432345,BGRD 200,149,486785,Shaw; Reuben,9999,0,9999,0
1708257432345,BGRD 200,150,486786,Sheikh; Farah,9999,0,9999,0
1708257432345,BGRD 200,151,486787,Staff,9999,0,9999,0
1708257432345,BGRD 200,152,486788,Signer; Robert,9999,0,9999,0
1708257432345,BGRD 200,153,486789,Sigurdson; Christina,9999,0,9999,0
1708257432345,BGRD 200,154,486790,Smith; David M.,9999,0,9999,0
1708257432345,BGRD 200,155,486791,Soncin; Francesca,9999,0,9999,0
1708257432345,BGRD 200,156,486792,Steinmetz; Nicole F,9999,0,9999,0
1708257432345,BGRD 200,157,486793,Su; Chih-Ying,9999,0,9999,0
1708257432345,BGRD 200,158,486794,Suel; Gurol Mehmet,9999,0,9999,0
1708257432345,BGRD 200,159,486795,Sun; Xin,9999,0,9999,0
1708257432345,BGRD 200,160,486796,Telese; Francesca,9999,0,9999,0
1708257432345,BGRD 200,161,486797,Thackray; Varykina G.,9999,0,9999,0
1708257432345,BGRD 200,162,486798,Towers; Christina Garlingt,9999,0,9999,0
1708257432345,BGRD 200,163,486799,Traver; David,9999,0,9999,0
1708257432345,BGRD 200,164,486800,Troemel; Emily Ruth,9998,0,9999,1
1708257432345,BGRD 200,165,486801,Tye; Kay M,9999,0,9999,0
1708257432345,BGRD 200,166,486802,Valdez-Jasso; Daniela,9998,0,9999,1
1708257432345,BGRD 200,167,486803,Vijayanand; Pandurangan,9999,0,9999,0
1708257432345,BGRD 200,168,486804,Villa Rodriguez; Elizabeth,9999,0,9999,0
1708257432345,BGRD 200,169,486805,Wahlin; Karl Jonas,9997,0,9999,2
1708257432345,BGRD 200,170,486806,Wang; Jean Yin Jen,9999,0,9999,0
1708257432345,BGRD 200,171,486807,Welsbie; Derek,9999,0,9999,0
1708257432345,BGRD 200,172,486808,Wildonger; Jill Cathleen,9998,0,9999,1
1708257432345,BGRD 200,173,486809,Wilkinson; Miles Frome,9999,0,9999,0
1708257432345,BGRD 200,174,486810,Winzeler; Elizabeth A,9999,0,9999,0
1708257432345,BGRD 200,175,486811,Yaksh; Tony L.,9999,0,9999,0
1708257432345,BGRD 200,176,486812,Yang; Jing,9999,0,9999,0
1708257432345,BGRD 200,177,486813,Staff,9999,0,9999,0
1708257432345,BGRD 200,178,486814,Yeo; Eugene Wei-Ming,9998,0,9999,1
1708257432345,BGRD 200,179,486815,Ying; Wei,9999,0,9999,0
1708257432345,BGRD 200,180,486816,Zarrinpar; Amir,9999,0,9999,0
1708257432345,BGRD 200,181,486817,Zengler; Karsten B,9999,0,9999,0
1708257432345,BGRD 200,182,486818,Zhang; Dong-Er,9999,0,9999,0
1708257432345,BGRD 200,183,486819,Zhao; Yunde,9999,0,9999,0
1708257432345,BGRD 200,184,486820,Zheng; Binhai,9999,0,9999,0
1708257432345,BGRD 200,185,486821,Zheng; Ye,9998,0,9999,1
1708257432345,BGRD 200,186,486822,Zuniga; Elina I,9999,0,9999,0
1708257432873,BGSE 200,A00,424140,Tour; Ella & Petrie; Katherine Lynn,9995,0,9999,4
1708257433398,BGSE 205,A00,424177,Bennett; Eric J,49,0,50,1
1708257433398,BGSE 205,B00,424179,Bennett; Eric J,48,0,50,2
1708257433398,BGSE 205,C00,424182,Bennett; Eric J,47,0,50,3
1708257433398,BGSE 205,D00,424184,Bennett; Eric J,46,0,50,4
1708257433398,BGSE 205,E00,424185,Bennett; Eric J,50,0,50,0
1708257433922,BIBC 100,A01,425401,Corbett; Kevin Daniel,150,0,158,8
1708257433922,BIBC 100,B01,477769,Amaro; Rommie E,156,0,158,2
1708257434449,BIBC 102,A01,425425,Bozinovic; Goran,255,0,256,1
1708257434449,BIBC 102,B01,425440,Hampton; Randolph Y.,250,0,256,6
1708257434449,BIBC 102,C01,486849,Flagg; Matthew Paul,61,0,120,59
1708257434980,BIBC 103,A01,425476,Grossman; Emily N,17,0,24,7
1708257434980,BIBC 103,A02,425509,Grossman; Emily N,21,0,24,3
1708257434980,BIBC 103,A03,425530,Grossman; Emily N,18,0,24,6
1708257434980,BIBC 103,A04,425536,Grossman; Emily N,22,0,24,2
1708257434980,BIBC 103,B01,425538,Boumechache; Miyyada,20,0,24,4
1708257434980,BIBC 103,B02,425539,Boumechache; Miyyada,24,0,24,0
1708257434980,BIBC 103,B03,425548,Boumechache; Miyyada,24,0,24,0
1708257434980,BIBC 103,B04,425549,Boumechache; Miyyada,24,0,24,0
1708257435507,BIBC 120,A01,425592,Coleman; Aaron B.,242,0,256,14
1708257436037,BIBC 194,A00,425609,Ernst; Andreas,21,0,27,6
1708257436037,BIBC 194,B00,477632,Saier; Milton H.,26,0,27,1
1708257436037,BIBC 194,C00,481360,Amaro; Rommie E,23,0,27,4
1708257436037,BIBC 194,D00,486852,Flagg; Matthew Paul,21,0,32,11
1708257436565,BICD 100,A01,470377,Troemel; Emily Ruth,127,0,128,1
1708257436565,BICD 100,A02,470378,Troemel; Emily Ruth,126,0,128,2
1708257436565,BICD 100,B01,470409,Reinagel; Pam,59,0,64,5
1708257436565,BICD 100,B02,470413,Reinagel; Pam,62,0,64,2
1708257436565,BICD 100,B03,470464,Reinagel; Pam,64,0,64,0
1708257436565,BICD 100,B04,470468,Reinagel; Pam,63,0,64,1
1708257436565,BICD 100,C01,470469,Beyhan; Sinem,51,0,64,13
1708257436565,BICD 100,C02,470605,Beyhan; Sinem,58,0,64,6
1708257436565,BICD 100,C03,470606,Beyhan; Sinem,60,0,64,4
1708257436565,BICD 100,C04,470607,Beyhan; Sinem,63,0,64,1
1708257436565,BICD 100,D01,477465,Nguyen; Vu Quang,158,0,160,2
1708257437095,BICD 100R,A01,425674,Smith; Laurie,29,0,34,5
1708257437095,BICD 100R,A02,425675,Smith; Laurie,30,0,34,4
1708257437095,BICD 100R,A03,425676,Smith; Laurie,30,0,34,4
1708257437620,BICD 104,A01,425696,Greenspan; Ralph J.,60,0,64,4
1708257438146,BICD 110,A01,470608,Muroyama; Andrew David,264,0,275,11
1708257438146,BICD 110,B01,425721,Ernst; Andreas,244,0,275,31
1708257438676,BICD 112,A01,458177,Cooper; Kimberly Lynn & Traver; David,10,0,32,22
1708257438676,BICD 112,A02,458180,Cooper; Kimberly Lynn & Traver; David,28,0,32,4
1708257439202,BICD 123,A01,425725,Zhao; Yunde,23,0,32,9
1708257439728,BICD 140,A01,425728,Lu; Li-Fan,227,0,240,13
1708257440257,BICD 158,A01,425730,Bier; Ethan,136,0,145,9
1708257440784,BICD 194,A00,425731,Desai; Arshad & Oegema; Karen,17,0,27,10
1708257440784,BICD 194,B00,481735,Wilhelm; James E.,29,0,32,3
1708257441312,BIEB 121,A00,425732,Butler; Shannon Rhey,21,0,32,11
1708257441312,BIEB 121,B00,425733,Butler; Shannon Rhey,24,0,32,8
1708257441839,BIEB 130,A01,425735,Kurle; Carolyn M.,243,0,295,52
1708257442368,BIEB 146,A01,425737,Petrie; Katherine Lynn,365,0,395,30
1708257442893,BIEB 148,A01,470637,Rose; Noah Hartmann,59,0,63,4
1708257442893,BIEB 148,A02,470638,Rose; Noah Hartmann,61,0,63,2
1708257443424,BIEB 154,A01,458184,Stockwell; Sarah R,29,0,30,1
1708257443424,BIEB 154,A02,458186,Stockwell; Sarah R,29,0,30,1
1708257443950,BIEB 176,A01,425741,De Silva; Shermin,56,0,64,8
1708257444479,BIEB 182,A01,458194,Roy; Kaustuv,25,0,32,7
1708257444479,BIEB 182,A02,458215,Roy; Kaustuv,31,0,32,1
1708257445007,BILD 1,A01,424267,Patrick; Gentry,249,0,250,1
1708257445007,BILD 1,B01,424272,Burg; Michael,231,0,250,19
1708257445007,BILD 1,C01,424293,Pickett; Brooke Elizabeth,245,0,250,5
1708257445007,BILD 1,D01,458292,Gonzalez Gamboa; Ivonne,48,0,50,2
1708257445007,BILD 1,D02,458295,Gonzalez Gamboa; Ivonne,50,0,50,0
1708257445007,BILD 1,D03,458296,Gonzalez Gamboa; Ivonne,50,0,50,0
1708257445007,BILD 1,D04,458297,Gonzalez Gamboa; Ivonne,49,0,50,1
1708257445007,BILD 1,D05,458303,Gonzalez Gamboa; Ivonne,50,0,50,0
1708257445536,BILD 2,A01,458304,Reyes Gonzalez; Catalina,53,0,56,3
1708257445536,BILD 2,A02,458307,Reyes Gonzalez; Catalina,55,0,56,1
1708257445536,BILD 2,A03,458313,Reyes Gonzalez; Catalina,55,0,56,1
1708257445536,BILD 2,A04,458320,Reyes Gonzalez; Catalina,56,0,56,0
1708257445536,BILD 2,B01,458324,Reyes Gonzalez; Catalina,47,0,56,9
1708257445536,BILD 2,B02,458327,Reyes Gonzalez; Catalina,54,0,56,2
1708257445536,BILD 2,B03,458339,Reyes Gonzalez; Catalina,56,0,56,0
1708257445536,BILD 2,B04,458340,Reyes Gonzalez; Catalina,56,0,56,0
1708257445536,BILD 2,C01,458387,Park; Ji Young,44,0,49,5
1708257445536,BILD 2,C02,458544,Park; Ji Young,46,0,49,3
1708257445536,BILD 2,C03,458557,Park; Ji Young,47,0,49,2
1708257445536,BILD 2,C04,458563,Park; Ji Young,46,0,49,3
1708257446062,BILD 3,A01,424312,Hammond; LaTisha Marie,331,0,350,19
1708257446062,BILD 3,B01,470107,Stockwell; Sarah R,66,0,70,4
1708257446062,BILD 3,B02,470110,Stockwell; Sarah R,70,0,70,0
1708257446062,BILD 3,B03,470116,Stockwell; Sarah R,70,0,70,0
1708257446062,BILD 3,B04,470123,Stockwell; Sarah R,67,0,70,3
1708257446062,BILD 3,B05,470150,Stockwell; Sarah R,70,0,70,0
1708257446062,BILD 3,C01,470159,Cooper; Kimberly Lynn,67,0,70,3
1708257446062,BILD 3,C02,470160,Cooper; Kimberly Lynn,69,0,70,1
1708257446062,BILD 3,C03,470164,Cooper; Kimberly Lynn,70,0,70,0
1708257446062,BILD 3,C04,470165,Cooper; Kimberly Lynn,69,0,70,1
1708257446062,BILD 3,C05,470374,Cooper; Kimberly Lynn,68,0,70,2
1708257446597,BILD 4,A01,424318,Staff,22,0,24,2
1708257446597,BILD 4,A02,424324,Staff,24,0,24,0
1708257446597,BILD 4,A03,424325,Staff,24,0,24,0
1708257446597,BILD 4,A04,424326,Staff,22,0,24,2
1708257446597,BILD 4,A05,424327,Staff,24,0,24,0
1708257446597,BILD 4,A06,424330,Staff,24,0,24,0
1708257446597,BILD 4,A07,424331,Staff,24,0,24,0
1708257446597,BILD 4,A08,424342,Staff,24,0,24,0
1708257446597,BILD 4,B01,424462,Pickett; Brooke Elizabeth,23,0,24,1
1708257446597,BILD 4,B02,424466,Pickett; Brooke Elizabeth,24,0,24,0
1708257446597,BILD 4,B03,424469,Pickett; Brooke Elizabeth,23,0,24,1
1708257446597,BILD 4,B04,424470,Pickett; Brooke Elizabeth,22,0,24,2
1708257446597,BILD 4,B05,424700,Pickett; Brooke Elizabeth,23,0,24,1
1708257446597,BILD 4,B06,424723,Pickett; Brooke Elizabeth,24,0,24,0
1708257446597,BILD 4,B07,424730,Pickett; Brooke Elizabeth,24,0,24,0
1708257446597,BILD 4,B08,424929,Pickett; Brooke Elizabeth,22,0,24,2
1708257446597,BILD 4,C01,424947,Gonzalez Gamboa; Ivonne,22,0,24,2
1708257446597,BILD 4,C02,424951,Gonzalez Gamboa; Ivonne,23,0,24,1
1708257446597,BILD 4,C03,424991,Gonzalez Gamboa; Ivonne,23,0,24,1
1708257446597,BILD 4,C04,424993,Gonzalez Gamboa; Ivonne,24,0,24,0
1708257446597,BILD 4,C05,424994,Gonzalez Gamboa; Ivonne,24,0,24,0
1708257446597,BILD 4,C06,425209,Gonzalez Gamboa; Ivonne,24,0,24,0
1708257446597,BILD 4,C07,425233,Gonzalez Gamboa; Ivonne,24,0,24,0
1708257446597,BILD 4,C08,425247,Gonzalez Gamboa; Ivonne,24,0,24,0
1708257447122,BILD 60,A01,425326,Hammond; LaTisha Marie,62,0,64,2
1708257447648,BILD 83,A00,425347,Pogliano; Joseph,25,0,30,5
1708257448173,BILD 87,A00,425368,Saier; Milton H.,20,0,20,0
1708257448705,BIMM 100,A01,425744,Cooper; Andrew Michael,303,0,320,17
1708257448705,BIMM 100,B01,425746,Cooper; Andrew Michael,315,0,320,5
1708257449234,BIMM 101,A01,425748,McDonnell; Lisa Marie,8,0,24,16
1708257449234,BIMM 101,A02,425749,McDonnell; Lisa Marie,23,0,24,1
1708257449234,BIMM 101,B01,425751,Day; Christopher D,22,0,24,2
1708257449234,BIMM 101,B02,425752,Day; Christopher D,24,0,24,0
1708257449234,BIMM 101,B03,425753,Day; Christopher D,22,0,24,2
1708257449234,BIMM 101,B04,425754,Day; Christopher D,24,0,24,0
1708257449234,BIMM 101,C01,425756,Rusert; Jessica Marie,16,0,24,8
1708257449234,BIMM 101,C02,425757,Rusert; Jessica Marie,23,0,24,1
1708257449234,BIMM 101,C03,425758,Rusert; Jessica Marie,23,0,24,1
1708257449234,BIMM 101,C04,425759,Rusert; Jessica Marie,23,0,24,1
1708257449760,BIMM 110,A01,425764,Niwa; Maho,55,0,56,1
1708257449760,BIMM 110,A02,425765,Niwa; Maho,56,0,56,0
1708257449760,BIMM 110,A03,425766,Niwa; Maho,56,0,56,0
1708257449760,BIMM 110,A04,425767,Niwa; Maho,55,0,56,1
1708257450292,BIMM 116R,A01,425771,Golden; Susan S. & Gorman; Michael R.,55,0,72,17
1708257450292,BIMM 116R,A02,425772,Golden; Susan S. & Gorman; Michael R.,53,0,72,19
1708257450292,BIMM 116R,A03,425773,Golden; Susan S. & Gorman; Michael R.,66,0,72,6
1708257450292,BIMM 116R,A04,425774,Golden; Susan S. & Gorman; Michael R.,70,0,72,2
1708257450818,BIMM 118,A01,425779,David; Michael,83,0,96,13
1708257451348,BIMM 120,A01,425792,Pirino; Giorgia,203,0,216,13
1708257451348,BIMM 120,B01,470639,Saier; Milton H.,201,0,216,15
1708257451882,BIMM 121,A01,425830,Gustafson-Brown; Cindy,18,0,24,6
1708257451882,BIMM 121,A02,425831,Gustafson-Brown; Cindy,21,0,24,3
1708257451882,BIMM 121,A03,425832,Gustafson-Brown; Cindy,24,0,24,0
1708257451882,BIMM 121,A04,425833,Gustafson-Brown; Cindy,23,0,24,1
1708257451882,BIMM 121,B01,425835,Pirino; Giorgia,17,0,24,7
1708257451882,BIMM 121,B02,425836,Pirino; Giorgia,24,0,24,0
1708257451882,BIMM 121,C01,425838,Park; Ji Young,6,0,24,18
1708257451882,BIMM 121,C02,425839,Park; Ji Young,20,0,24,4
1708257452408,BIMM 134,A01,425841,Burg; Michael,393,0,416,23
1708257452939,BIMM 143,A01,425843,Grant; Barry J,17,0,40,23
1708257452939,BIMM 143,B01,425845,Bozinovic; Goran,33,0,40,7
1708257453464,BIMM 182,A01,455012,Bafna; Vineet,28,0,50,22
1708257453990,BIMM 194,A00,425847,Rivera; Fabian Chavez,24,0,27,3
1708257453990,BIMM 194,B00,425868,Russell; Alistair B,16,0,27,11
1708257453990,BIMM 194,D00,425870,Wildonger; Jill Cathleen,14,0,27,13
1708257454519,BIOM 202,A00,390710,Corbett; Kevin Daniel,93,0,100,7
1708257455049,BIOM 219,A00,390713,Ross; Camille,0,0,0,7
1708257455576,BIOM 231,A00,455099,Furnari; Frank,0,0,0,0
1708257455576,BIOM 231,B00,455100,Lopez Ramirez; Miguel Alej,0,0,0,0
1708257456103,BIOM 242,A00,390714,Hamilton; Bruce Alan,20,0,20,0
1708257456641,BIOM 246,A00,492784,Gordts; Philip & Varki; Ajit P & Lewis; Amanda Lark & Godula; Kamil & Gagneux; Pascal & Esko; Jeffrey D. & Bode; Lars,0,0,0,0
1708257457169,BIOM 252,A00,390715,Ayyagari; Radha,27,0,28,1
1708257457696,BIOM 254,A00,390718,Corbett; Kevin Daniel,14,0,20,6
1708257458222,BIOM 272,A00,390722,Hangauer; Matthew John,16,0,20,4
1708257458753,BIOM 274,A00,390725,Sun; Bryan Kee-Hong,7,0,15,8
1708257459279,BIOM 283,A00,390728,Komives; Elizabeth A,2,0,2,0
1708257459805,BIOM 285,A00,390730,Gaulton; Kyle J,10,0,20,10
1708257460333,BIOM 295,A00,455083,Brown; Joan Heller,0,0,0,0
1708257460862,BIPN 100,A01,425872,Augustine; Vineet,240,0,245,5
1708257460862,BIPN 100,B01,425874,George; Monique Leana,240,0,245,5
1708257460862,BIPN 100,C01,458640,Maita; Isabella Vincenza,44,0,49,5
1708257460862,BIPN 100,C02,458646,Maita; Isabella Vincenza,48,0,49,1
1708257460862,BIPN 100,C03,458714,Maita; Isabella Vincenza,48,0,49,1
1708257460862,BIPN 100,C04,458716,Maita; Isabella Vincenza,48,0,49,1
1708257460862,BIPN 100,C05,458717,Maita; Isabella Vincenza,46,0,49,3
1708257461388,BIPN 105,A01,425877,Armour; Jon Christopher,12,0,21,9
1708257461388,BIPN 105,A02,425878,Armour; Jon Christopher,21,0,21,0
1708257461388,BIPN 105,A03,425879,Armour; Jon Christopher,10,0,21,11
1708257461388,BIPN 105,A04,425880,Armour; Jon Christopher,20,0,21,1
1708257461915,BIPN 120,A01,425882,Cooke; James Edward,370,0,395,25
1708257462445,BIPN 140,A01,425884,Hibbs; Ryan E.,183,0,192,9
1708257462969,BIPN 144,A01,425886,Zou; Yimin,153,0,158,5
1708257463495,BIPN 145,A01,425888,Maita; Isabella Vincenza,41,0,42,1
1708257463495,BIPN 145,B01,425918,Marino; Marc J,37,0,42,5
1708257463495,BIPN 145,B02,425954,Marino; Marc J,40,0,42,2
1708257464024,BIPN 147,A01,426086,Sejnowski; Terrence J,53,0,64,11
1708257464550,BIPN 152,A01,426112,Halpain; Shelley,97,0,128,31
1708257465077,BIPN 162,A01,426120,Juavinett; Ashley Lauren,17,0,30,13
1708257465641,BIPN 164,A01,455010,Benna; Marcus K & Aljadeff; Johnatan,120,0,120,0
1708257466169,BIPN 194,A00,426122,Glasgow; Stacey Marie,20,0,27,7
1708257466694,BISP 170,A00,426158,French; Kathleen Ann,26,0,30,4
1708257467219,BISP 182,A00,426168,Pogliano; Joseph,9999,0,9999,0
1708257467749,BISP 194,A00,426240,Chisholm; Andrew D.,11,0,27,16
1708257467749,BISP 194,B00,426241,Farley; Emma Kristen,25,0,27,2
1708257468274,BNFO 281,A00,427175,Gaasterland; Theresa,85,0,100,15
1708257468804,BNFO 283,A00,427211,Carter; Hannah Kathryn & Chavez; Alejandro,39,0,50,11
1708257468804,BNFO 283,B00,480483,Amariuta-Bartell; Tiffany & Dorrestein; Pieter,21,0,30,9
1708257469329,BNFO 294,B01,427269,Ross; Camille,47,0,50,3
1708257469878,CAT 3,A01,396994,Glaser; Amelia,15,0,15,0
1708257469878,CAT 3,A02,396995,Glaser; Amelia,15,0,15,0
1708257469878,CAT 3,A03,396996,Glaser; Amelia,7,0,15,8
1708257469878,CAT 3,A04,396997,Glaser; Amelia,12,0,15,3
1708257469878,CAT 3,A05,397004,Glaser; Amelia,15,0,15,0
1708257469878,CAT 3,A06,397039,Glaser; Amelia,11,0,15,4
1708257469878,CAT 3,A07,397040,Glaser; Amelia,13,0,15,2
1708257469878,CAT 3,A08,397084,Glaser; Amelia,15,0,15,0
1708257469878,CAT 3,A09,397269,Glaser; Amelia,13,0,15,2
1708257469878,CAT 3,A10,397270,Glaser; Amelia,0,0,15,15
1708257469878,CAT 3,A11,397271,Glaser; Amelia,9,0,15,6
1708257469878,CAT 3,A12,397272,Glaser; Amelia,12,0,15,3
1708257469878,CAT 3,A13,397273,Glaser; Amelia,15,0,15,0
1708257469878,CAT 3,A14,397274,Glaser; Amelia,14,0,15,1
1708257469878,CAT 3,B01,397276,Porter; Lisa,15,0,15,0
1708257469878,CAT 3,B02,397277,Porter; Lisa,15,0,15,0
1708257469878,CAT 3,B03,397278,Porter; Lisa,14,0,15,1
1708257469878,CAT 3,B04,397279,Porter; Lisa,15,0,15,0
1708257469878,CAT 3,B06,397281,Porter; Lisa,15,0,15,0
1708257469878,CAT 3,B07,397291,Porter; Lisa,15,0,15,0
1708257469878,CAT 3,B09,397293,Porter; Lisa,15,0,15,0
1708257469878,CAT 3,B10,397294,Porter; Lisa,15,0,15,0
1708257469878,CAT 3,B11,397295,Porter; Lisa,12,0,15,3
1708257469878,CAT 3,B12,397296,Porter; Lisa,14,0,15,1
1708257469878,CAT 3,B13,397297,Porter; Lisa,11,0,15,4
1708257469878,CAT 3,B14,397298,Porter; Lisa,15,0,15,0
1708257469878,CAT 3,B15,397299,Porter; Lisa,15,0,15,0
1708257469878,CAT 3,B16,397300,Porter; Lisa,15,0,15,0
1708257469878,CAT 3,C01,397302,Marchisotto; Jennifer Anne,13,0,15,2
1708257469878,CAT 3,C02,397308,Marchisotto; Jennifer Anne,9,0,15,6
1708257469878,CAT 3,C03,397309,Marchisotto; Jennifer Anne,9,0,15,6
1708257469878,CAT 3,C04,397315,Marchisotto; Jennifer Anne,11,0,15,4
1708257469878,CAT 3,C05,397316,Marchisotto; Jennifer Anne,14,0,15,1
1708257469878,CAT 3,C06,397322,Marchisotto; Jennifer Anne,15,0,15,0
1708257469878,CAT 3,C07,397323,Marchisotto; Jennifer Anne,15,0,15,0
1708257469878,CAT 3,C08,397329,Marchisotto; Jennifer Anne,15,0,15,0
1708257469878,CAT 3,C09,397333,Marchisotto; Jennifer Anne,15,0,15,0
1708257469878,CAT 3,C10,397336,Marchisotto; Jennifer Anne,15,0,15,0
1708257469878,CAT 3,C11,397354,Marchisotto; Jennifer Anne,13,0,15,2
1708257469878,CAT 3,C12,397357,Marchisotto; Jennifer Anne,15,0,15,0
1708257469878,CAT 3,C13,397364,Marchisotto; Jennifer Anne,14,0,15,1
1708257469878,CAT 3,C14,397367,Marchisotto; Jennifer Anne,14,0,15,1
1708257469878,CAT 3,C15,397369,Marchisotto; Jennifer Anne,15,0,15,0
1708257469878,CAT 3,C16,397373,Marchisotto; Jennifer Anne,15,0,15,0
1708257469878,CAT 3,C17,397374,Marchisotto; Jennifer Anne,15,0,15,0
1708257469878,CAT 3,C18,397380,Marchisotto; Jennifer Anne,14,0,15,1
1708257469878,CAT 3,D02,397405,Rahimi; Babak,13,0,15,2
1708257469878,CAT 3,D03,397408,Rahimi; Babak,14,0,15,1
1708257469878,CAT 3,D04,397415,Rahimi; Babak,15,0,15,0
1708257469878,CAT 3,D05,397416,Rahimi; Babak,15,0,15,0
1708257469878,CAT 3,D06,397422,Rahimi; Babak,15,0,15,0
1708257469878,CAT 3,D07,397426,Rahimi; Babak,14,0,15,1
1708257469878,CAT 3,D09,397447,Rahimi; Babak,11,0,15,4
1708257469878,CAT 3,D10,397450,Rahimi; Babak,13,0,15,2
1708257469878,CAT 3,D11,397625,Rahimi; Babak,13,0,15,2
1708257469878,CAT 3,D12,397630,Rahimi; Babak,15,0,15,0
1708257469878,CAT 3,D13,397631,Rahimi; Babak,14,0,15,1
1708257469878,CAT 3,D14,397635,Rahimi; Babak,14,0,15,1
1708257470403,CAT 3CE,A01,397642,Bronstein; Phoebe Malan,25,0,25,0
1708257470931,CAT 87,A00,397645,Bronstein; Phoebe Malan,19,0,20,1
1708257471457,CAT 90,A00,480731,Bronstein; Phoebe Malan,20,0,20,0
1708257471984,CAT 124,A01,397662,Knight; Amy,5,0,5,0
1708257471984,CAT 124,A02,397722,Knight; Amy,5,0,5,0
1708257471984,CAT 124,A03,397726,Knight; Amy,5,0,5,0
1708257471984,CAT 124,A04,397829,Knight; Amy,4,0,5,1
1708257472520,CAT 125,001,397832,Popko; Elizabeth Ashley,20,0,20,0
1708257472520,CAT 125,002,397833,Delaville; Romain,20,0,20,0
1708257472520,CAT 125,003,397834,Marchisotto; Jennifer Anne,18,0,20,2
1708257472520,CAT 125,004,397835,Bigham; David Joseph,20,0,20,0
1708257472520,CAT 125,005,397836,Bigham; David Joseph,19,0,20,1
1708257472520,CAT 125,006,397837,Bigham; David Joseph,16,0,20,4
1708257472520,CAT 125,007,397838,Vanderschuit; Maya Alysia,20,0,20,0
1708257472520,CAT 125,008,397839,Vanderschuit; Maya Alysia,20,0,20,0
1708257472520,CAT 125,009,397840,Vanderschuit; Maya Alysia,20,0,20,0
1708257472520,CAT 125,010,397841,Morales; Celeste Georgianna,15,0,16,1
1708257472520,CAT 125,011,397842,Morales; Celeste Georgianna,16,0,16,0
1708257472520,CAT 125,012,397881,Morales; Celeste Georgianna,19,0,20,1
1708257472520,CAT 125,013,397954,Rose; Becca Rae,18,0,20,2
1708257472520,CAT 125,014,397956,Rose; Becca Rae,20,0,20,0
1708257472520,CAT 125,015,397998,Rose; Becca Rae,19,0,20,1
1708257472520,CAT 125,016,397999,Tosun; Adriana,20,0,20,0
1708257472520,CAT 125,017,398001,Tosun; Adriana,20,0,20,0
1708257472520,CAT 125,018,398009,Irwin; Matthew Joseph,19,0,20,1
1708257472520,CAT 125,019,398010,Irwin; Matthew Joseph,18,0,20,2
1708257472520,CAT 125,020,398014,Irwin; Matthew Joseph,20,0,20,0
1708257473052,CAT 125R,A00,398015,Smith; Lauryn Alissa,19,0,20,1
1708257473052,CAT 125R,B00,398016,Smith; Lauryn Alissa,17,0,20,3
1708257473052,CAT 125R,C00,398017,Smith; Lauryn Alissa,19,0,20,1
1708257473052,CAT 125R,D00,398019,Tosun; Adriana,19,0,20,1
1708257473052,CAT 125R,E00,398020,Hyland; Tina Mae,12,0,20,8
1708257473052,CAT 125R,F00,398027,Hyland; Tina Mae,18,0,20,2
1708257473052,CAT 125R,G00,398028,Hyland; Tina Mae,18,0,20,2
1708257473580,CCE 1,A01,396087,Kenley Grounds; Nicole,40,0,40,0
1708257473580,CCE 1,B01,396142,Quijada; David,39,0,40,1
1708257473580,CCE 1,C01,396159,Bigley; Michele Heather,39,0,40,1
1708257473580,CCE 1,D01,396164,Bigley; Michele Heather,40,0,40,0
1708257473580,CCE 1,E01,396166,Lee; Kassandra,40,0,40,0
1708257473580,CCE 1,F01,396168,Lee; Kassandra,40,0,40,0
1708257473580,CCE 1,G01,396170,Staff,40,0,40,0
1708257473580,CCE 1,H01,396172,Staff,40,0,40,0
1708257474108,CENG 101B,A00,392993,Chen; Shaochen,44,0,45,1
1708257474638,CENG 101C,A00,392997,Li; Yanran,148,0,150,2
1708257475165,CENG 113,A00,393000,Chen; Zheng,69,0,70,1
1708257475165,CENG 113,B00,393001,Li; Wan-Lu,69,0,70,1
1708257475691,CENG 124B,A00,393036,Powell; Alyssa & Russ; Benjamin Edward,113,0,120,7
1708257476218,CENG 157,A00,393220,Opatkiewicz; Justin Paul,50,0,57,7
1708257476747,CENG 160,A00,393231,Powell; Alyssa,70,0,80,10
1708257477272,CENG 170,A01,393238,Drews; Aaron,27,0,30,3
1708257477798,CENG 175,A00,393239,Steinmetz; Nicole F,34,0,35,1
1708257478328,CENG 176B,A01,393285,Opatkiewicz; Justin Paul,46,0,52,6
1708257478328,CENG 176B,B01,393629,Zhang; Liangfang,40,0,49,9
1708257478853,CENG 205,A00,393681,Jahed Motlagh; Zeinab,53,0,60,7
1708257479378,CENG 257,A00,393682,Opatkiewicz; Justin Paul,10,0,13,3
1708257479962,CGS 87,A00,489609,Wesling; Megan E.,20,0,20,0
1708257480489,CGS 100B,A00,396181,Whitley; Leila Marie,28,0,30,2
1708257481017,CGS 109,A00,396194,Whitley; Leila Marie,19,0,20,1
1708257481546,CGS 112,A00,396220,Martin Sandino; Amanda Maria Yoland,22,0,25,3
1708257482073,CGS 114,A00,396223,Steelman; Katherine Wallis,14,0,16,2
1708257482598,CGS 116,A00,396295,Staff,19,0,20,1
1708257483124,CGS 117,A00,396306,Martin Sandino; Amanda Maria Yoland,14,0,15,1
1708257483649,CGS 118,A00,396314,Hankins; Joseph D.,28,0,29,1
1708257484179,CGS 128,A00,396366,Whitley; Leila Marie,14,0,15,1
1708257484707,CGS 137,A00,396865,Martin Sandino; Amanda Maria Yoland,16,0,19,3
1708257485234,CGS 150,A00,396901,Taylor-Garcia; Daphne,18,0,18,0
1708257485761,CGS 196B,A00,396904,Lo; Stanley M.,7,0,7,0
1708257485761,CGS 196B,B00,396973,Brenner; Suzanne A,7,0,7,0
1708257485761,CGS 196B,C00,396985,Jones; Makeba,7,0,7,0
1708257486288,CGS 198,001,396987,Anderson; Patrick W.,0,0,0,0
1708257486288,CGS 198,002,396988,Anderson; Patrick W.,0,0,0,0
1708257486288,CGS 198,003,396989,Anderson; Patrick W.,0,0,0,0
1708257486288,CGS 198,004,396990,Anderson; Patrick W.,0,0,0,0
1708257486812,CGS 200,A00,396991,Perez; Roy,0,0,0,3
1708257487339,CHEM 6A,A01,459563,Deshmukh; Lalit,40,0,40,0
1708257487339,CHEM 6A,A02,459564,Deshmukh; Lalit,35,0,40,5
1708257487339,CHEM 6A,A03,459565,Deshmukh; Lalit,31,0,40,9
1708257487339,CHEM 6A,A04,459566,Deshmukh; Lalit,30,0,38,8
1708257487339,CHEM 6A,A05,459567,Deshmukh; Lalit,40,0,40,0
1708257487339,CHEM 6A,A06,459568,Deshmukh; Lalit,37,0,40,3
1708257487339,CHEM 6A,A07,459569,Deshmukh; Lalit,37,0,40,3
1708257487339,CHEM 6A,A08,459570,Deshmukh; Lalit,0,0,0,0
1708257487871,CHEM 6B,A01,467314,Ortony; Julia Helen,39,0,40,1
1708257487871,CHEM 6B,A02,467322,Ortony; Julia Helen,32,0,40,8
1708257487871,CHEM 6B,A03,467323,Ortony; Julia Helen,40,0,40,0
1708257487871,CHEM 6B,A04,467325,Ortony; Julia Helen,31,0,40,9
1708257487871,CHEM 6B,A05,467326,Ortony; Julia Helen,39,0,40,1
1708257487871,CHEM 6B,A06,467346,Ortony; Julia Helen,40,0,40,0
1708257487871,CHEM 6B,B01,467360,Hopkins; Patrycja Anna,35,0,40,5
1708257487871,CHEM 6B,B02,467363,Hopkins; Patrycja Anna,38,0,40,2
1708257487871,CHEM 6B,B03,467364,Hopkins; Patrycja Anna,35,0,40,5
1708257487871,CHEM 6B,B04,467380,Hopkins; Patrycja Anna,40,0,40,0
1708257487871,CHEM 6B,B05,467381,Hopkins; Patrycja Anna,40,0,40,0
1708257487871,CHEM 6B,B06,467382,Hopkins; Patrycja Anna,39,0,40,1
1708257488402,CHEM 6C,A01,468994,Ternansky; Robert J.,39,0,40,1
1708257488402,CHEM 6C,A02,469054,Ternansky; Robert J.,38,0,40,2
1708257488402,CHEM 6C,A03,469065,Ternansky; Robert J.,39,0,40,1
1708257488402,CHEM 6C,A04,469069,Ternansky; Robert J.,40,0,40,0
1708257488402,CHEM 6C,A05,469080,Ternansky; Robert J.,40,0,40,0
1708257488402,CHEM 6C,B01,469318,Ternansky; Robert J.,39,0,40,1
1708257488402,CHEM 6C,B02,469319,Ternansky; Robert J.,40,0,40,0
1708257488402,CHEM 6C,B03,469320,Ternansky; Robert J.,39,0,40,1
1708257488402,CHEM 6C,B04,469321,Ternansky; Robert J.,40,0,40,0
1708257488402,CHEM 6C,B05,469322,Ternansky; Robert J.,40,0,40,0
1708257488402,CHEM 6C,C01,469323,Schurmeier; Kimberly,38,0,40,2
1708257488402,CHEM 6C,C02,469324,Schurmeier; Kimberly,36,0,40,4
1708257488402,CHEM 6C,C03,469325,Schurmeier; Kimberly,38,0,40,2
1708257488402,CHEM 6C,C04,469326,Schurmeier; Kimberly,36,0,40,4
1708257488402,CHEM 6C,C05,469327,Schurmeier; Kimberly,40,0,40,0
1708257488402,CHEM 6C,D01,460183,Schurmeier; Kimberly,39,0,40,1
1708257488402,CHEM 6C,D02,460184,Schurmeier; Kimberly,32,0,40,8
1708257488402,CHEM 6C,D03,460185,Schurmeier; Kimberly,26,0,40,14
1708257488402,CHEM 6C,D04,460186,Schurmeier; Kimberly,38,0,40,2
1708257488402,CHEM 6C,D05,460187,Schurmeier; Kimberly,40,0,40,0
1708257488402,CHEM 6C,E01,460188,Stallings; Dontarie M,24,0,40,16
1708257488402,CHEM 6C,E02,460190,Stallings; Dontarie M,25,0,40,15
1708257488402,CHEM 6C,E03,460191,Stallings; Dontarie M,3,0,20,17
1708257488402,CHEM 6C,E04,460192,Stallings; Dontarie M,36,0,40,4
1708257488402,CHEM 6C,E05,460193,Stallings; Dontarie M,37,0,40,3
1708257488931,CHEM 6CH,A01,459630,Tezcan; Faik,40,0,40,0
1708257489461,CHEM 7L,A01,393998,Jazzar; Rodolphe,0,0,0,3
1708257489461,CHEM 7L,A02,393999,Jazzar; Rodolphe,10,0,24,14
1708257489461,CHEM 7L,A03,394000,Jazzar; Rodolphe,21,0,24,3
1708257489461,CHEM 7L,A04,394001,Jazzar; Rodolphe,22,0,24,2
1708257489461,CHEM 7L,A05,394002,Jazzar; Rodolphe,18,0,24,6
1708257489461,CHEM 7L,A06,394003,Jazzar; Rodolphe,22,0,24,2
1708257489461,CHEM 7L,A07,394004,Jazzar; Rodolphe,18,0,21,3
1708257489461,CHEM 7L,A08,394005,Jazzar; Rodolphe,0,0,0,0
1708257489461,CHEM 7L,A09,394006,Jazzar; Rodolphe,20,0,24,4
1708257489461,CHEM 7L,A10,394007,Jazzar; Rodolphe,24,0,24,0
1708257489461,CHEM 7L,B01,394009,Jazzar; Rodolphe,0,0,0,1
1708257489461,CHEM 7L,B02,394010,Jazzar; Rodolphe,1,0,6,5
1708257489461,CHEM 7L,B03,394011,Jazzar; Rodolphe,15,0,24,9
1708257489461,CHEM 7L,B04,394012,Jazzar; Rodolphe,18,0,21,3
1708257489461,CHEM 7L,B05,394013,Jazzar; Rodolphe,0,0,0,0
1708257489461,CHEM 7L,B06,394014,Jazzar; Rodolphe,15,0,24,9
1708257489461,CHEM 7L,B07,394015,Jazzar; Rodolphe,18,0,24,6
1708257489461,CHEM 7L,B08,394016,Jazzar; Rodolphe,23,0,24,1
1708257489461,CHEM 7L,B09,394017,Jazzar; Rodolphe,24,0,24,0
1708257489461,CHEM 7L,B10,394018,Jazzar; Rodolphe,24,0,24,0
1708257489461,CHEM 7L,C01,394020,Staff,0,0,0,0
1708257489461,CHEM 7L,C02,394021,Staff,21,0,24,3
1708257489461,CHEM 7L,C03,394022,Staff,23,0,24,1
1708257489461,CHEM 7L,C04,394023,Staff,24,0,24,0
1708257489461,CHEM 7L,C05,394024,Staff,0,0,0,0
1708257489461,CHEM 7L,C06,394025,Staff,20,0,24,4
1708257489461,CHEM 7L,C07,394026,Staff,22,0,24,2
1708257489461,CHEM 7L,C08,394027,Staff,23,0,24,1
1708257489461,CHEM 7L,C09,394028,Staff,24,0,24,0
1708257489461,CHEM 7L,C10,394029,Staff,23,0,24,1
1708257489987,CHEM 11,A01,459661,Staff,42,0,44,2
1708257489987,CHEM 11,A02,459664,Staff,44,0,44,0
1708257489987,CHEM 11,A03,459702,Staff,42,0,44,2
1708257489987,CHEM 11,A04,459707,Staff,44,0,44,0
1708257489987,CHEM 11,A05,459708,Staff,43,0,44,1
1708257489987,CHEM 11,A06,459711,Staff,41,0,44,3
1708257490514,CHEM 40A,A01,459576,Albizati; Kim F.,36,0,40,4
1708257490514,CHEM 40A,A02,459577,Albizati; Kim F.,33,0,40,7
1708257490514,CHEM 40A,A03,459578,Albizati; Kim F.,37,0,40,3
1708257490514,CHEM 40A,A04,459579,Albizati; Kim F.,38,0,40,2
1708257490514,CHEM 40A,A05,459580,Albizati; Kim F.,40,0,40,0
1708257490514,CHEM 40A,A06,459581,Albizati; Kim F.,37,0,40,3
1708257490514,CHEM 40A,A07,459582,Albizati; Kim F.,38,0,40,2
1708257490514,CHEM 40A,A08,459588,Albizati; Kim F.,39,0,40,1
1708257491049,CHEM 40B,A01,467442,Weizman; Haim,29,0,40,11
1708257491049,CHEM 40B,A02,467443,Weizman; Haim,33,0,40,7
1708257491049,CHEM 40B,A03,467444,Weizman; Haim,39,0,40,1
1708257491049,CHEM 40B,A04,467445,Weizman; Haim,38,0,40,2
1708257491049,CHEM 40B,A05,467446,Weizman; Haim,39,0,40,1
1708257491049,CHEM 40B,A06,467447,Weizman; Haim,37,0,40,3
1708257491049,CHEM 40B,A07,467448,Weizman; Haim,31,0,40,9
1708257491049,CHEM 40B,A08,467449,Weizman; Haim,40,0,40,0
1708257491049,CHEM 40B,B01,467383,Molinski; Tadeusz,40,0,40,0
1708257491049,CHEM 40B,B02,467384,Molinski; Tadeusz,40,0,40,0
1708257491049,CHEM 40B,B03,467385,Molinski; Tadeusz,40,0,40,0
1708257491049,CHEM 40B,B04,467399,Molinski; Tadeusz,40,0,40,0
1708257491049,CHEM 40B,B05,467400,Molinski; Tadeusz,40,0,40,0
1708257491049,CHEM 40B,B06,467401,Molinski; Tadeusz,40,0,40,0
1708257491049,CHEM 40B,B07,467402,Molinski; Tadeusz,40,0,40,0
1708257491049,CHEM 40B,B08,467404,Molinski; Tadeusz,39,0,40,1
1708257491576,CHEM 41B,A01,459571,Klosterman; Jeremy K,40,0,40,0
1708257491576,CHEM 41B,A02,459572,Klosterman; Jeremy K,36,0,37,1
1708257491576,CHEM 41B,A03,459573,Klosterman; Jeremy K,40,0,40,0
1708257492102,CHEM 41C,A01,459589,Tor; Yitzhak,40,0,40,0
1708257492102,CHEM 41C,A02,459624,Tor; Yitzhak,38,0,40,2
1708257492102,CHEM 41C,A03,459625,Tor; Yitzhak,40,0,40,0
1708257492102,CHEM 41C,A04,459626,Tor; Yitzhak,40,0,40,0
1708257492102,CHEM 41C,A05,459627,Tor; Yitzhak,29,0,29,0
1708257492102,CHEM 41C,A06,459628,Tor; Yitzhak,38,0,40,2
1708257492102,CHEM 41C,A07,459629,Tor; Yitzhak,40,0,40,0
1708257492642,CHEM 43A,A01,394068,Lam; Tin Yiu,12,0,24,12
1708257492642,CHEM 43A,A02,394088,Lam; Tin Yiu,23,0,24,1
1708257492642,CHEM 43A,A03,394092,Lam; Tin Yiu,23,0,24,1
1708257492642,CHEM 43A,A04,394093,Lam; Tin Yiu,21,0,24,3
1708257492642,CHEM 43A,A05,394094,Lam; Tin Yiu,23,0,24,1
1708257492642,CHEM 43A,A06,394096,Lam; Tin Yiu,15,0,24,9
1708257492642,CHEM 43A,A07,394115,Lam; Tin Yiu,20,0,24,4
1708257492642,CHEM 43A,A08,394116,Lam; Tin Yiu,22,0,24,2
1708257492642,CHEM 43A,A09,394117,Lam; Tin Yiu,22,0,24,2
1708257492642,CHEM 43A,A10,394118,Lam; Tin Yiu,20,0,24,4
1708257492642,CHEM 43A,A11,394119,Lam; Tin Yiu,8,0,13,5
1708257492642,CHEM 43A,A12,394120,Lam; Tin Yiu,24,0,24,0
1708257492642,CHEM 43A,A13,394132,Lam; Tin Yiu,24,0,24,0
1708257492642,CHEM 43A,B01,394134,Lam; Tin Yiu,24,0,24,0
1708257492642,CHEM 43A,B02,394135,Lam; Tin Yiu,16,0,24,8
1708257492642,CHEM 43A,B03,394136,Lam; Tin Yiu,13,0,24,11
1708257492642,CHEM 43A,B04,394137,Lam; Tin Yiu,17,0,24,7
1708257492642,CHEM 43A,B05,394138,Lam; Tin Yiu,20,0,24,4
1708257492642,CHEM 43A,B06,394139,Lam; Tin Yiu,19,0,24,5
1708257492642,CHEM 43A,B07,394140,Lam; Tin Yiu,19,0,24,5
1708257492642,CHEM 43A,B08,394141,Lam; Tin Yiu,24,0,24,0
1708257492642,CHEM 43A,B09,394142,Lam; Tin Yiu,20,0,24,4
1708257492642,CHEM 43A,B10,394143,Lam; Tin Yiu,24,0,24,0
1708257492642,CHEM 43A,B11,394145,Lam; Tin Yiu,22,0,24,2
1708257492642,CHEM 43A,B12,394146,Lam; Tin Yiu,23,0,24,1
1708257493167,CHEM 96,A00,394159,Bussey; Thomas J,24,0,25,1
1708257493697,CHEM 100A,A01,394161,Li; Shaowei,16,0,22,6
1708257493697,CHEM 100A,A02,394162,Li; Shaowei,20,0,24,4
1708257493697,CHEM 100A,A03,394163,Li; Shaowei,22,0,24,2
1708257493697,CHEM 100A,A04,394164,Li; Shaowei,24,0,24,0
1708257493697,CHEM 100A,A05,394165,Li; Shaowei,24,0,24,0
1708257493697,CHEM 100A,A06,394166,Li; Shaowei,20,0,22,2
1708257494225,CHEM 100B,A01,394175,Pomeroy; Robert S.,19,0,25,6
1708257494750,CHEM 105A,A01,394177,Young; Mark,31,0,39,8
1708257494750,CHEM 105A,B01,394179,Young; Mark,0,0,0,0
1708257495279,CHEM 108,A01,394181,Staff,14,0,20,6
1708257495279,CHEM 108,A02,394182,Staff,23,0,24,1
1708257495279,CHEM 108,B01,394184,Staff,4,0,20,16
1708257495279,CHEM 108,B02,394185,Staff,23,0,24,1
1708257495808,CHEM 109,A01,394187,Piercy; Marc Anthony,17,0,20,3
1708257495808,CHEM 109,A02,394188,Piercy; Marc Anthony,22,0,24,2
1708257495808,CHEM 109,B01,394193,Piercy; Marc Anthony,12,0,20,8
1708257495808,CHEM 109,B02,394194,Piercy; Marc Anthony,23,0,24,1
1708257496334,CHEM 111,A00,394195,Thiemens; Mark H,97,0,100,3
1708257496862,CHEM 114B,A01,459574,Piercy; Marc Anthony,39,0,45,6
1708257496862,CHEM 114B,A02,459575,Piercy; Marc Anthony,40,0,45,5
1708257497389,CHEM 114C,A01,467286,Komives; Elizabeth A,32,0,44,12
1708257497389,CHEM 114C,A02,467287,Komives; Elizabeth A,42,0,44,2
1708257497389,CHEM 114C,A03,467290,Komives; Elizabeth A,42,0,44,2
1708257497389,CHEM 114C,A04,467295,Komives; Elizabeth A,43,0,44,1
1708257497920,CHEM 114D,A00,394198,Ghosh; Gourisankar,29,0,30,1
1708257498446,CHEM 118,A01,459788,Donoghue; Daniel J.,37,0,40,3
1708257498446,CHEM 118,A02,459800,Donoghue; Daniel J.,37,0,40,3
1708257498446,CHEM 118,A03,459807,Donoghue; Daniel J.,36,0,40,4
1708257498446,CHEM 118,A04,459809,Donoghue; Daniel J.,38,0,40,2
1708257498446,CHEM 118,A05,459811,Donoghue; Daniel J.,37,0,40,3
1708257498446,CHEM 118,A06,459826,Donoghue; Daniel J.,39,0,40,1
1708257498973,CHEM 119,A01,467427,Joseph; Simpson,35,0,40,5
1708257498973,CHEM 119,A02,467441,Joseph; Simpson,0,0,0,0
1708257499503,CHEM 120B,A01,467450,Griffith; Kent,37,0,40,3
1708257499503,CHEM 120B,A02,467451,Griffith; Kent,34,0,40,6
1708257499503,CHEM 120B,A03,467452,Griffith; Kent,35,0,40,5
1708257500029,CHEM 123,A00,394211,Schimpf; Alina M,0,0,0,1
1708257500559,CHEM 125,A00,394217,Tezcan; Faik,18,0,20,2
1708257501085,CHEM 126A,A01,459715,Yong; Haiwang,39,0,40,1
1708257501085,CHEM 126A,A02,459725,Yong; Haiwang,36,0,40,4
1708257501611,CHEM 126B,A01,467405,Tauber; Michael,36,0,40,4
1708257501611,CHEM 126B,A02,467406,Tauber; Michael,39,0,40,1
1708257501611,CHEM 126B,A03,467426,Tauber; Michael,39,0,40,1
1708257502142,CHEM 132,A01,460181,Galperin; Michael,42,0,45,3
1708257502142,CHEM 132,A02,460182,Galperin; Michael,37,0,45,8
1708257502669,CHEM 135,A01,394222,Tauber; Michael,15,0,15,0
1708257503199,CHEM 143B,A01,394229,Klosterman; Jeremy K,16,0,24,8
1708257503199,CHEM 143B,A02,394230,Klosterman; Jeremy K,21,0,24,3
1708257503725,CHEM 156,A00,394231,Romero; Erik Anthony,30,0,30,0
1708257504255,CHEM 157,A00,394232,Tor; Yitzhak,74,0,80,6
1708257504780,CHEM 165,A01,460194,Herzik; Mark Anthony,21,0,25,4
1708257505307,CHEM 167,A01,467296,Deshmukh; Lalit,39,0,40,1
1708257505307,CHEM 167,A02,467297,Deshmukh; Lalit,33,0,40,7
1708257505307,CHEM 167,A03,467298,Deshmukh; Lalit,37,0,40,3
1708257505307,CHEM 167,A04,467312,Deshmukh; Lalit,37,0,40,3
1708257505835,CHEM 173,A00,394284,Young; Mark,48,0,50,2
1708257506367,CHEM 174,A01,455015,Pomeroy; Robert S.,45,0,50,5
1708257506895,CHEM 186,A00,477716,Paesani; Francesco & Gilson; Michael K.,6,0,12,6
1708257507421,CHEM 188,A00,394294,Bussey; Thomas J,19,0,20,1
1708257507946,CHEM 214,A00,394336,Ghosh; Gourisankar,12,0,20,8
1708257508477,CHEM 217,A00,394341,Joseph; Simpson,25,0,30,5
1708257509005,CHEM 221,A00,394425,Taylor; Susan S.,10,0,20,10
1708257509534,CHEM 225,A00,394429,Tezcan; Faik,4,0,10,6
1708257510060,CHEM 227,A00,394430,Schimpf; Alina M,26,0,30,4
1708257510592,CHEM 229,A00,394431,Stauber; Julia Megan,13,0,20,7
1708257511118,CHEM 235,A01,394433,Tauber; Michael,20,0,20,0
1708257511643,CHEM 236,A00,394434,Kummel; Andrew C,14,0,15,1
1708257512170,CHEM 241,A00,394435,Pokorski; Jonathan Kyle,14,0,15,1
1708257512695,CHEM 250,A00,394436,Weizman; Haim,0,0,0,16
1708257513224,CHEM 256,A00,394437,Romero; Erik Anthony,15,0,20,5
1708257513750,CHEM 257,A00,394438,Tor; Yitzhak,23,0,30,7
1708257514276,CHEM 265,A01,460195,Herzik; Mark Anthony,13,0,20,7
1708257514805,CHEM 273,A00,394440,Young; Mark,13,0,20,7
1708257515337,CHEM 276,A00,394441,Mc Culloch; Andrew Douglas & Amaro; Rommie E,0,0,0,0
1708257515868,CHEM 283,A00,394443,Komives; Elizabeth A,2,0,4,2
1708257516398,CHEM 286,A00,477693,Paesani; Francesco & Gilson; Michael K.,26,0,34,8
1708257516926,CHEM 291,A00,394446,Komives; Elizabeth A,20,0,20,0
1708257517453,CHEM 294,A00,394447,Romero; Erik Anthony,50,0,50,0
1708257517984,CHIN 10CD,A01,394453,Liu; Mingming,17,0,17,0
1708257517984,CHIN 10CD,A02,394457,Liu; Mingming,18,0,18,0
1708257518515,CHIN 10CM,A01,394465,Chen; Pei-Chia,11,0,12,1
1708257518515,CHIN 10CM,A02,394466,Chen; Pei-Chia,12,0,12,0
1708257518515,CHIN 10CM,B01,394468,Liu; Mingming,11,0,13,2
1708257518515,CHIN 10CM,B02,394469,Liu; Mingming,13,0,13,0
1708257519044,CHIN 10CN,A01,394581,Xu; Li,14,0,14,0
1708257519044,CHIN 10CN,A02,394582,Xu; Li,14,0,14,0
1708257519044,CHIN 10CN,B01,394585,Xu; Li,14,0,14,0
1708257519044,CHIN 10CN,B02,394586,Xu; Li,13,0,14,1
1708257519570,CHIN 20CD,A01,394591,Wang; Xiao,11,0,12,1
1708257519570,CHIN 20CD,A02,394592,Wang; Xiao,11,0,12,1
1708257520096,CHIN 20CN,A01,394597,Anderson; Qin-Hong,7,0,8,1
1708257520096,CHIN 20CN,A02,394599,Anderson; Qin-Hong,8,0,8,0
1708257520096,CHIN 20CN,B01,394601,Anderson; Qin-Hong,14,0,15,1
1708257520622,CHIN 100CM,A00,394602,Anderson; Qin-Hong,19,0,20,1
1708257521152,CHIN 100CN,A00,394603,Chen; Pei-Chia,24,0,24,0
1708257521680,CHIN 169B,A00,394623,Wang; Xiao,19,0,20,1
1708257522205,CLAS 87,A00,394669,Herbst; Matthew,19,0,20,1
1708257522733,CLAS 121R,A01,394671,Herbst; Matthew,11,0,12,1
1708257522733,CLAS 121R,B01,486854,Herbst; Matthew,8,0,8,0
1708257523264,CLIN 294C,A00,476856,Wierenga; Christina E & Banks; Sarah Jane,20,0,20,0
1708257523791,CLIN 296,001,476768,Brookman; Lauren Irene,94,0,100,6
1708257523791,CLIN 296,002,476855,Brookman; Lauren Irene,10,0,10,0
1708257524316,CLRE 238R,A00,394675,Mehta; Ravindra L.,9998,0,9999,1
1708257524841,CLRE 254,A00,394678,Vaida; Florin,9999,0,9999,0
1708257525367,CLRE 256,A00,394685,Morris; Sheldon,9999,0,9999,0
1708257525892,CLRE 258,A00,394692,Mehta; Ravindra L.,9999,0,9999,0
1708257526418,CLRE 260,A00,394693,Cuomo; Raphael Eduardo,9999,0,9999,0
1708257526948,CLRE 264,A00,394696,Mehta; Ravindra L.,9999,0,9999,0
1708257527474,CLRE 267,A00,394703,Vaida; Florin,9999,0,9999,0
1708257528000,CLRE 297,001,394705,Cuomo; Raphael Eduardo,9999,0,9999,0
1708257528528,CMM 246,A00,492783,Gordts; Philip & Varki; Ajit P & Lewis; Amanda Lark & Godula; Kamil & Gagneux; Pascal & Esko; Jeffrey D. & Bode; Lars,9,0,10,1
1708257529059,CMM 250,A00,492943,Willert; Karl Heinrich,31,0,40,9
1708257529585,COGR 200B,A00,395746,Jack; Caroline Sarah,2,0,5,3
1708257530115,COGR 225B,A00,395750,Serlin; David,1,0,5,4
1708257530642,COGR 225C,A00,395753,Gates; Kelly,1,0,5,4
1708257531168,COGR 275,A00,395943,Goldfarb; Brian,6,0,10,4
1708257531168,COGR 275,B00,396046,Fattal; Alexander Leor,4,0,10,6
1708257531168,COGR 275,C00,396047,Kidman; Shawna F,4,0,10,6
1708257531696,COGR 280,A00,396048,Ahn; Patricia Jeehyun,6,0,10,4
1708257532227,COGS 1,A01,407484,Boyle; Mary E. T.,52,0,60,8
1708257532227,COGS 1,A02,407498,Boyle; Mary E. T.,54,0,60,6
1708257532227,COGS 1,A03,407504,Boyle; Mary E. T.,59,0,60,1
1708257532227,COGS 1,A04,407512,Boyle; Mary E. T.,57,0,60,3
1708257532227,COGS 1,A05,407513,Boyle; Mary E. T.,60,0,60,0
1708257532227,COGS 1,A06,407514,Boyle; Mary E. T.,58,0,60,2
1708257532227,COGS 1,A07,407515,Boyle; Mary E. T.,57,0,57,0
1708257532755,COGS 9,A01,407520,Shannon; Kyle Michael,54,0,60,6
1708257532755,COGS 9,A02,407521,Shannon; Kyle Michael,60,0,60,0
1708257532755,COGS 9,A03,407522,Shannon; Kyle Michael,59,0,60,1
1708257532755,COGS 9,A04,407524,Shannon; Kyle Michael,57,0,60,3
1708257532755,COGS 9,A05,407525,Shannon; Kyle Michael,59,0,60,1
1708257533342,COGS 10,A01,407527,Morgan; Eric,45,0,50,5
1708257533342,COGS 10,A02,407530,Morgan; Eric,46,0,50,4
1708257533342,COGS 10,A03,407531,Morgan; Eric,46,0,50,4
1708257533342,COGS 10,A04,407532,Morgan; Eric,47,0,50,3
1708257533342,COGS 10,A05,407534,Morgan; Eric,47,0,50,3
1708257533342,COGS 10,A06,407539,Morgan; Eric,50,0,50,0
1708257533342,COGS 10,A07,407628,Morgan; Eric,50,0,50,0
1708257533867,COGS 11,A01,407699,Boroditsky; Lera,179,0,180,1
1708257534397,COGS 12,A00,407702,Boroditsky; Lera,75,0,75,0
1708257534929,COGS 14A,A01,407706,Barrera; Steven James,51,0,57,6
1708257534929,COGS 14A,A02,407707,Barrera; Steven James,54,0,57,3
1708257534929,COGS 14A,A03,407712,Barrera; Steven James,0,0,0,1
1708257534929,COGS 14A,A04,407715,Barrera; Steven James,57,0,57,0
1708257534929,COGS 14A,A05,407717,Barrera; Steven James,55,0,56,1
1708257534929,COGS 14A,A06,407718,Barrera; Steven James,52,0,55,3
1708257534929,COGS 14A,A07,407720,Barrera; Steven James,49,0,55,6
1708257535455,COGS 14B,A01,407723,Hoffman; Drew Ellen,52,0,57,5
1708257535455,COGS 14B,A02,407726,Hoffman; Drew Ellen,48,0,55,7
1708257535455,COGS 14B,A03,407727,Hoffman; Drew Ellen,52,0,55,3
1708257535455,COGS 14B,A04,407729,Hoffman; Drew Ellen,52,0,55,3
1708257535455,COGS 14B,A05,407730,Hoffman; Drew Ellen,50,0,55,5
1708257535982,COGS 17,A01,407733,Johnson; Christine M.,50,0,50,0
1708257535982,COGS 17,A02,407734,Johnson; Christine M.,48,0,50,2
1708257535982,COGS 17,A03,407735,Johnson; Christine M.,46,0,50,4
1708257535982,COGS 17,A04,407740,Johnson; Christine M.,47,0,50,3
1708257535982,COGS 17,A05,407745,Johnson; Christine M.,48,0,50,2
1708257535982,COGS 17,A06,407824,Johnson; Christine M.,48,0,50,2
1708257535982,COGS 17,A07,407878,Johnson; Christine M.,50,0,55,5
1708257535982,COGS 17,A08,408015,Johnson; Christine M.,52,0,55,3
1708257536521,COGS 18,A01,408118,Ellis; Shannon Elizabeth,27,0,35,8
1708257536521,COGS 18,A02,408119,Ellis; Shannon Elizabeth,31,0,35,4
1708257536521,COGS 18,A03,408120,Ellis; Shannon Elizabeth,23,0,35,12
1708257536521,COGS 18,A04,408136,Ellis; Shannon Elizabeth,33,0,35,2
1708257536521,COGS 18,A05,408141,Ellis; Shannon Elizabeth,35,0,35,0
1708257536521,COGS 18,A06,408143,Ellis; Shannon Elizabeth,34,0,35,1
1708257536521,COGS 18,A07,408144,Ellis; Shannon Elizabeth,35,0,35,0
1708257536521,COGS 18,A08,408145,Ellis; Shannon Elizabeth,34,0,35,1
1708257536521,COGS 18,A09,408146,Ellis; Shannon Elizabeth,35,0,35,0
1708257536521,COGS 18,B01,408148,Ellis; Shannon Elizabeth,30,0,32,2
1708257536521,COGS 18,B02,408149,Ellis; Shannon Elizabeth,26,0,32,6
1708257536521,COGS 18,B03,408151,Ellis; Shannon Elizabeth,27,0,33,6
1708257536521,COGS 18,B04,408154,Ellis; Shannon Elizabeth,32,0,33,1
1708257536521,COGS 18,B05,408163,Ellis; Shannon Elizabeth,29,0,33,4
1708257536521,COGS 18,B06,408176,Ellis; Shannon Elizabeth,33,0,33,0
1708257536521,COGS 18,B07,408177,Ellis; Shannon Elizabeth,31,0,33,2
1708257536521,COGS 18,B08,408178,Ellis; Shannon Elizabeth,32,0,33,1
1708257536521,COGS 18,B09,408195,Ellis; Shannon Elizabeth,31,0,33,2
1708257537047,COGS 87,A00,408196,Deak; Gedeon O.,20,0,20,0
1708257537047,COGS 87,B00,479478,Fleischer; Jason G,20,0,20,0
1708257537577,COGS 100,A01,408262,Allen; Michael Gordon,54,0,56,2
1708257537577,COGS 100,A02,408263,Allen; Michael Gordon,52,0,56,4
1708257537577,COGS 100,A03,408264,Allen; Michael Gordon,55,0,56,1
1708257537577,COGS 100,A04,408265,Allen; Michael Gordon,56,0,56,0
1708257537577,COGS 100,A05,408266,Allen; Michael Gordon,56,0,56,0
1708257537577,COGS 100,A06,408349,Allen; Michael Gordon,55,0,56,1
1708257538103,COGS 101A,A01,408352,Morgan; Eric,60,0,60,0
1708257538103,COGS 101A,A02,408353,Morgan; Eric,58,0,60,2
1708257538103,COGS 101A,A03,408354,Morgan; Eric,57,0,60,3
1708257538103,COGS 101A,A04,408355,Morgan; Eric,59,0,60,1
1708257538628,COGS 101B,A01,408373,Barrera; Steven James,47,0,50,3
1708257538628,COGS 101B,A02,408380,Barrera; Steven James,46,0,50,4
1708257538628,COGS 101B,A03,408384,Barrera; Steven James,38,0,50,12
1708257538628,COGS 101B,A04,408385,Barrera; Steven James,37,0,50,13
1708257539161,COGS 101C,A01,408387,Trott; Sean Thomas,48,0,50,2
1708257539161,COGS 101C,A02,408388,Trott; Sean Thomas,43,0,50,7
1708257539161,COGS 101C,A03,408389,Trott; Sean Thomas,45,0,50,5
1708257539688,COGS 107A,A01,408396,Boyle; Mary E. T.,54,0,56,2
1708257539688,COGS 107A,A02,408397,Boyle; Mary E. T.,54,0,56,2
1708257539688,COGS 107A,A03,408399,Boyle; Mary E. T.,51,0,56,5
1708257539688,COGS 107A,A04,408409,Boyle; Mary E. T.,50,0,56,6
1708257539688,COGS 107A,A05,408410,Boyle; Mary E. T.,51,0,56,5
1708257539688,COGS 107A,A06,408411,Boyle; Mary E. T.,55,0,56,1
1708257540217,COGS 107B,A01,408413,Mooshagian; Eric Frederick,46,0,50,4
1708257540217,COGS 107B,A02,408414,Mooshagian; Eric Frederick,43,0,50,7
1708257540217,COGS 107B,A03,408428,Mooshagian; Eric Frederick,43,0,50,7
1708257540217,COGS 107B,A04,408434,Mooshagian; Eric Frederick,46,0,50,4
1708257540217,COGS 107B,A05,408435,Mooshagian; Eric Frederick,50,0,50,0
1708257540217,COGS 107B,A06,408446,Mooshagian; Eric Frederick,49,0,50,1
1708257540743,COGS 107C,A01,408500,Chiba; Andrea,51,0,60,9
1708257540743,COGS 107C,A02,408519,Chiba; Andrea,55,0,60,5
1708257540743,COGS 107C,A03,408524,Chiba; Andrea,56,0,60,4
1708257541269,COGS 108,A01,408532,Fleischer; Jason G,45,0,60,15
1708257541269,COGS 108,A02,408543,Fleischer; Jason G,58,0,60,2
1708257541269,COGS 108,A03,408544,Fleischer; Jason G,59,0,60,1
1708257541269,COGS 108,A04,408552,Fleischer; Jason G,32,0,60,28
1708257541269,COGS 108,A05,408554,Fleischer; Jason G,47,0,60,13
1708257541269,COGS 108,A06,408574,Fleischer; Jason G,43,0,60,17
1708257541269,COGS 108,A07,408576,Fleischer; Jason G,56,0,60,4
1708257541798,COGS 112,A01,408682,Hoffman; Drew Ellen,32,0,50,18
1708257541798,COGS 112,A02,408683,Hoffman; Drew Ellen,38,0,50,12
1708257541798,COGS 112,A03,408684,Hoffman; Drew Ellen,48,0,60,12
1708257542325,COGS 122,A01,408695,Dow; Steven P,21,0,50,29
1708257542855,COGS 125,A00,408697,Klemmer; Scott R,35,0,50,15
1708257543382,COGS 126,A01,408787,Hollan; James D.,44,0,50,6
1708257543912,COGS 138,A01,408866,Khosla; Meenakshi,71,0,75,4
1708257544438,COGS 142,A01,408868,Rossano; Federico,49,0,50,1
1708257544963,COGS 144,A01,408950,Rossano; Federico,48,0,50,2
1708257545491,COGS 155,A01,408993,Staff,49,0,50,1
1708257546017,COGS 157,A00,408994,Creel; Sarah,0,0,0,0
1708257546544,COGS 160,A00,409031,Deak; Gedeon O.,20,0,20,0
1708257547075,COGS 175,A01,409035,Rill; Bryan,67,0,75,8
1708257547602,COGS 178,A00,409274,Jernigan; Terry Lynne,67,0,70,3
1708257548131,COGS 179,A00,409278,Staff,40,0,40,0
1708257548657,COGS 184,A01,409317,Johnson; Christine M.,42,0,50,8
1708257549181,COGS 185,A01,409476,Tu; Zhuowen,33,0,50,17
1708257549181,COGS 185,A02,409525,Tu; Zhuowen,45,0,50,5
1708257549710,COGS 188,A01,409527,Fleischer; Jason G,44,0,75,31
1708257550239,COGS 190C,001,409528,Chiba; Andrea,9999,0,9999,0
1708257550239,COGS 190C,002,409530,Fleischer; Jason G,9999,0,9999,0
1708257550239,COGS 190C,003,409531,Boyle; Mary E. T.,9999,0,9999,0
1708257550239,COGS 190C,004,409532,Nitz; Douglas A.,9999,0,9999,0
1708257550239,COGS 190C,005,409535,Rangel; Lara M,9999,0,9999,0
1708257550239,COGS 190C,006,409536,Rossano; Federico,9999,0,9999,0
1708257550239,COGS 190C,007,409537,Deak; Gedeon O.,9999,0,9999,0
1708257550239,COGS 190C,008,409538,Trott; Sean Thomas,9999,0,9999,0
1708257550239,COGS 190C,009,409540,Creel; Sarah,9999,0,9999,0
1708257550239,COGS 190C,010,409541,Voytek; Bradley Thomas,9999,0,9999,0
1708257550239,COGS 190C,011,409542,Greene; Deanna Jacquelyn,9999,0,9999,0
1708257550239,COGS 190C,012,409543,Ellis; Shannon Elizabeth,9999,0,9999,0
1708257550239,COGS 190C,013,409546,Kirsh; David Joel,9999,0,9999,0
1708257550769,COGS 190D,A00,409547,Voytek; Bradley Thomas,20,0,20,0
1708257551296,COGS 194,A00,409548,Hill; Seth J,9999,0,9999,0
1708257551822,COGS 200,A01,406697,Creel; Sarah,0,0,0,0
1708257552350,COGS 205,A00,406698,Chiba; Andrea,20,0,20,0
1708257552875,COGS 209,A00,406699,Mukamel; Eran A,41,0,68,27
1708257553407,COGS 210C,001,406700,Kirsh; David Joel,9999,0,9999,0
1708257553407,COGS 210C,002,406701,Greene; Deanna Jacquelyn,9998,0,9999,1
1708257553407,COGS 210C,003,406702,Xia; Haijun,9999,0,9999,0
1708257553407,COGS 210C,004,406703,Nitz; Douglas A.,9998,0,9999,1
1708257553407,COGS 210C,005,406710,Hollan; James D.,9999,0,9999,0
1708257553407,COGS 210C,006,406713,De Sa; Virginia,9999,0,9999,0
1708257553407,COGS 210C,007,406714,Rossano; Federico,9999,0,9999,0
1708257553407,COGS 210C,008,406740,Kiyonaga; Anastasia,9999,0,9999,0
1708257553407,COGS 210C,009,406745,Guo; Philip J,9998,0,9999,1
1708257553407,COGS 210C,010,406746,Dow; Steven P,9999,0,9999,0
1708257553407,COGS 210C,011,406747,Bergen; Benjamin,9999,0,9999,0
1708257553407,COGS 210C,012,406758,Coulson; Seana M,9999,0,9999,0
1708257553932,COGS 211C,A00,406763,Coulson; Seana M,17,0,20,3
1708257554461,COGS 229,A00,406788,Hollan; James D. & Xia; Haijun,4,0,10,6
1708257554990,COGS 238,A00,406789,Bergen; Benjamin,17,0,20,3
1708257555517,COGS 278,A00,406794,Jernigan; Terry Lynne,18,0,20,2
1708257556053,COMM 10,A01,394711,Schmidt; Thomas Rainer,20,0,24,4
1708257556053,COMM 10,A02,394714,Schmidt; Thomas Rainer,24,0,24,0
1708257556053,COMM 10,A03,394716,Schmidt; Thomas Rainer,24,0,24,0
1708257556053,COMM 10,A04,394717,Schmidt; Thomas Rainer,22,0,24,2
1708257556053,COMM 10,A05,394731,Schmidt; Thomas Rainer,24,0,24,0
1708257556053,COMM 10,A06,394733,Schmidt; Thomas Rainer,24,0,24,0
1708257556053,COMM 10,A07,394740,Schmidt; Thomas Rainer,24,0,24,0
1708257556053,COMM 10,A08,394741,Schmidt; Thomas Rainer,24,0,24,0
1708257556053,COMM 10,A09,394751,Schmidt; Thomas Rainer,23,0,24,1
1708257556053,COMM 10,A10,394779,Schmidt; Thomas Rainer,24,0,24,0
1708257556053,COMM 10,A11,394809,Schmidt; Thomas Rainer,24,0,24,0
1708257556053,COMM 10,A12,394811,Schmidt; Thomas Rainer,24,0,24,0
1708257556053,COMM 10,A13,394818,Schmidt; Thomas Rainer,24,0,24,0
1708257556053,COMM 10,A14,394825,Schmidt; Thomas Rainer,23,0,24,1
1708257556053,COMM 10,A15,394828,Schmidt; Thomas Rainer,24,0,24,0
1708257556053,COMM 10,A16,394829,Schmidt; Thomas Rainer,0,0,0,0
1708257556053,COMM 10,A17,486828,Schmidt; Thomas Rainer,20,0,21,1
1708257556582,COMM 20,A01,394834,McKenna; Denise,69,0,70,1
1708257557109,COMM 80,A01,394849,Campbell; Robert Harold,120,0,120,0
1708257557641,COMM 100C,A01,394957,Kidman; Shawna F,24,0,25,1
1708257557641,COMM 100C,A02,394972,Kidman; Shawna F,25,0,25,0
1708257557641,COMM 100C,A03,394977,Kidman; Shawna F,22,0,25,3
1708257557641,COMM 100C,A04,394981,Kidman; Shawna F,25,0,25,0
1708257557641,COMM 100C,A05,394985,Kidman; Shawna F,24,0,25,1
1708257557641,COMM 100C,A06,394989,Kidman; Shawna F,23,0,25,2
1708257557641,COMM 100C,A07,394993,Kidman; Shawna F,24,0,25,1
1708257557641,COMM 100C,A08,394997,Kidman; Shawna F,23,0,25,2
1708257557641,COMM 100C,A09,394999,Kidman; Shawna F,25,0,25,0
1708257557641,COMM 100C,A10,395018,Kidman; Shawna F,25,0,25,0
1708257557641,COMM 100C,A11,395041,Kidman; Shawna F,24,0,25,1
1708257557641,COMM 100C,A12,395080,Kidman; Shawna F,24,0,25,1
1708257558168,COMM 101,A01,395135,Halm; Gavin Patrick,15,0,15,0
1708257558168,COMM 101,A02,395252,Halm; Gavin Patrick,15,0,15,0
1708257558168,COMM 101,A03,395253,Halm; Gavin Patrick,15,0,15,0
1708257558168,COMM 101,A04,395263,Halm; Gavin Patrick,15,0,15,0
1708257558694,COMM 101D,A00,395264,Martinico; Daniel J,13,0,16,3
1708257559224,COMM 101K,A00,395266,Ahn; Patricia Jeehyun,16,0,18,2
1708257559753,COMM 101N,A00,395267,Martinico; Daniel J,16,0,16,0
1708257560279,COMM 102C,A01,395270,Campion; Camille E,5,0,6,1
1708257560279,COMM 102C,A02,395271,Campion; Camille E,6,0,6,0
1708257560279,COMM 102C,A03,395272,Campion; Camille E,5,0,6,1
1708257560805,COMM 102M,A01,395285,Davis; Zeinabu I.,9,0,10,1
1708257560805,COMM 102M,A02,395288,Davis; Zeinabu I.,8,0,10,2
1708257561334,COMM 103D,A00,395343,Gates; Kelly,34,0,35,1
1708257561859,COMM 107,A00,395461,Serlin; David,33,0,35,2
1708257562385,COMM 109D,A00,395462,Halm; Gavin Patrick,72,0,75,3
1708257562911,COMM 110G,A00,395481,Whitworth-Smith; Andrew C,32,0,35,3
1708257563439,COMM 110M,A00,395482,Harb; Anthony Joseph,34,0,35,1
1708257563968,COMM 111A,A00,487217,Pavon Aramburu; Maria Laur,34,0,35,1
1708257564496,COMM 113T,A00,395516,Fields; Gary,35,0,35,0
1708257565023,COMM 114A,A00,395517,Zilberg; Elana,32,0,35,3
1708257565548,COMM 114B,A00,395523,Zilberg; Elana,19,0,20,1
1708257566074,COMM 114E,A00,487218,Pavon Aramburu; Maria Laur,34,0,35,1
1708257566600,COMM 114W,A00,395524,Walkover; Lillian B,17,0,18,1
1708257567126,COMM 126,A00,479341,Staff,26,0,30,4
1708257567653,COMM 132,A00,481491,Rojo Solis; Juan Jose,0,0,0,0
1708257568179,COMM 134,A00,395578,Abuelhiga; Soraya Jill,28,0,30,2
1708257568705,COMM 143,A00,395579,Rojo Solis; Juan Jose,28,0,30,2
1708257569232,COMM 146,A00,395584,Jack; Caroline Sarah,29,0,30,1
1708257569759,COMM 168,A00,395592,Harb; Anthony Joseph,29,0,30,1
1708257570287,COMM 170,A00,395608,Pavon Aramburu; Maria Laur,30,0,30,0
1708257570813,COMM 173,A00,395609,Alac; Morana,29,0,30,1
1708257571341,COMM 174,A00,395679,Alac; Morana,30,0,30,0
1708257571866,COMM 190,A00,395682,Abuelhiga; Soraya Jill,19,0,23,4
1708257571866,COMM 190,B00,395696,Staff,21,0,23,2
1708257571866,COMM 190,C00,395697,Fattal; Alexander Leor,22,0,23,1
1708257572394,CSE 8A,A50,459200,Miranda; Gregory Joseph,34,0,35,1
1708257572394,CSE 8A,A51,459205,Miranda; Gregory Joseph,34,0,35,1
1708257572394,CSE 8A,A52,459206,Miranda; Gregory Joseph,34,0,35,1
1708257572394,CSE 8A,A53,459212,Miranda; Gregory Joseph,34,0,35,1
1708257572394,CSE 8A,A54,459213,Miranda; Gregory Joseph,34,0,35,1
1708257572394,CSE 8A,A55,459232,Miranda; Gregory Joseph,34,0,35,1
1708257572920,CSE 11,A01,470735,Ochoa; Benjamin Lawrence,180,0,195,15
1708257573447,CSE 12,A01,470744,Cao; Yingjun,189,0,200,11
1708257573447,CSE 12,B01,470752,Miranda; Gregory Joseph,71,0,100,29
1708257573447,CSE 12,B02,470760,Miranda; Gregory Joseph,93,0,100,7
1708257573979,CSE 15L,A01,410174,Solares; Edwin A,6,0,10,4
1708257573979,CSE 15L,B01,410215,Solares; Edwin A,7,0,10,3
1708257573979,CSE 15L,C01,410305,Solares; Edwin A,3,0,10,7
1708257573979,CSE 15L,D01,410400,Solares; Edwin A,1,0,10,9
1708257574507,CSE 20,A01,470765,Minnes Kemp; Mor Mia,145,0,150,5
1708257575031,CSE 21,A01,470776,Jones; Miles E,68,0,73,5
1708257575031,CSE 21,A02,482889,Jones; Miles E,68,0,72,4
1708257575559,CSE 29,A01,494014,Soosai Raj; Adalbert Geral,48,0,50,2
1708257575559,CSE 29,A02,494016,Soosai Raj; Adalbert Geral,40,0,50,10
1708257575559,CSE 29,B01,494018,Shalev; Aaron D,16,0,20,4
1708257576095,CSE 30,A01,470784,Cao; Yingjun,141,0,150,9
1708257576095,CSE 30,B01,467469,Muller; P Keith,98,0,120,22
1708257576621,CSE 87,A00,410528,Moshiri; Niema,20,0,20,0
1708257577147,CSE 90,A00,486885,Minnes Kemp; Mor Mia,0,0,0,0
1708257577677,CSE 91,A00,486872,Minnes Kemp; Mor Mia,0,0,0,0
1708257577677,CSE 91,B00,486873,Minnes Kemp; Mor Mia,0,0,0,0
1708257578205,CSE 95,A00,410529,Minnes Kemp; Mor Mia,50,0,50,0
1708257578732,CSE 100,A01,470792,Sahoo; Debashis,54,0,70,16
1708257579257,CSE 100R,A01,410556,Moshiri; Niema,2,0,40,38
1708257579782,CSE 101,A01,470797,Jones; Miles E,14,0,44,30
1708257579782,CSE 101,A02,482892,Jones; Miles E,31,0,43,12
1708257580308,CSE 105,A01,470800,Micciancio; Daniele,85,0,98,13
1708257580836,CSE 107,A01,467479,Bellare; Mihir,141,0,146,5
1708257581367,CSE 109,A01,459538,Shang; Jingbo,0,0,25,25
1708257581898,CSE 110,A50,459395,Powell; Thomas Allan,49,0,50,1
1708257581898,CSE 110,A51,459512,Powell; Thomas Allan,37,0,50,13
1708257581898,CSE 110,A52,459513,Powell; Thomas Allan,46,0,50,4
1708257581898,CSE 110,A53,459514,Powell; Thomas Allan,48,0,50,2
1708257581898,CSE 110,A54,459515,Powell; Thomas Allan,47,0,50,3
1708257581898,CSE 110,A55,459516,Powell; Thomas Allan,45,0,50,5
1708257581898,CSE 110,A56,459517,Powell; Thomas Allan,47,0,48,1
1708257582423,CSE 112,A50,459518,Powell; Thomas Allan,132,0,146,14
1708257582950,CSE 120,A01,470808,Zhou; Yuan-Yuan,167,0,200,33
1708257583476,CSE 125,A00,410564,Voelker; Geoffrey M.,30,0,30,0
1708257584006,CSE 127,A01,467484,Fernandes; Earlence T,174,0,196,22
1708257584536,CSE 130,A01,467485,Polikarpova; Nadezhda,176,0,192,16
1708257585065,CSE 131,A01,459522,Ding; Yufei,36,0,50,14
1708257585593,CSE 132B,A01,470816,Deutsch; Alin Bernard,60,0,70,10
1708257586120,CSE 140,A01,410606,Orailoglu; Alex,99,0,100,1
1708257586120,CSE 140,B01,410622,Eldon; John,130,0,146,16
1708257586700,CSE 140L,A01,410655,Orailoglu; Alex,99,0,100,1
1708257586700,CSE 140L,B01,410658,Eldon; John,122,0,146,24
1708257587230,CSE 141,A01,467486,Zhao; Jishen,173,0,196,23
1708257587756,CSE 141L,A01,410685,Eldon; John,162,0,196,34
1708257588284,CSE 145,A01,410713,Kastner; Ryan Charles,25,0,25,0
1708257588817,CSE 150B,A01,470824,Gao; Sicun,310,0,362,52
1708257589344,CSE 156,A01,467487,Nakashole; Ndapandula,137,0,192,55
1708257589870,CSE 165,A01,410757,Weibel; Nadir & Schulze; Jurgen P.,40,0,50,10
1708257590399,CSE 168,A01,410759,Ramamoorthi; Ravi,24,0,25,1
1708257590399,CSE 168,A02,410761,Ramamoorthi; Ravi,24,0,25,1
1708257590926,CSE 175,A01,410764,Kumar; Rakesh,48,0,50,2
1708257591451,CSE 182,A01,455011,Bafna; Vineet,47,0,50,3
1708257591982,CSE 185,A01,410895,Gymrek; Melissa Ann,41,0,57,16
1708257591982,CSE 185,A02,479240,Gymrek; Melissa Ann,53,0,58,5
1708257592510,CSE 190,A00,410982,Grier; Daniel T,48,0,50,2
1708257592510,CSE 190,B00,410983,Riek; Laurel D,50,0,50,0
1708257592510,CSE 190,C00,410984,Staff,36,0,50,14
1708257592510,CSE 190,D00,481666,Saha; Barna & Impagliazzo; Russell,27,0,28,1
1708257593039,CSE 203A,A00,410985,Saha; Barna & Impagliazzo; Russell,0,0,0,0
1708257593585,CSE 209A,A00,410986,Grier; Daniel T,0,0,0,0
1708257594111,CSE 209B,A00,410987,Bellare; Mihir,0,0,0,0
1708257595652,CSE 217,A01,459553,Weibel; Nadir,0,0,0,0
1708257596185,CSE 218,A00,410989,Griswold; William G.,0,0,0,0
1708257596711,CSE 219,A00,410990,Hollan; James D. & Xia; Haijun,0,0,0,0
1708257597240,CSE 224,A01,470832,Snoeren; Alex C.,0,0,0,0
1708257597766,CSE 229A,A00,410993,Shalev; Aaron D,0,0,0,0
1708257598294,CSE 229C,A00,410994,Fernandes; Earlence T,0,0,0,0
1708257598820,CSE 231,A01,467488,Jhala; Ranjit,0,0,0,0
1708257599345,CSE 233,A00,410996,Vianu; Victor Dan,0,0,0,0
1708257599871,CSE 237D,A00,410998,Kastner; Ryan Charles,0,0,0,0
1708257600396,CSE 239A,A00,410999,Vianu; Victor Dan,0,0,0,0
1708257600923,CSE 239B,A00,411000,Coblenz; Michael J,0,0,0,0
1708257601449,CSE 240A,A00,411001,Chin; Bryan W.,0,0,0,0
1708257601979,CSE 252D,A00,411004,Chandraker; Manmohan Krishna,0,0,0,0
1708257602505,CSE 256,A00,411005,Nakashole; Ndapandula,0,0,0,0
1708257603030,CSE 260,A01,467491,Chin; Bryan W.,0,0,0,0
1708257603559,CSE 276B,A00,411007,Riek; Laurel D,0,0,0,0
1708257604088,CSE 276F,A01,459554,Su; Hao,0,0,0,0
1708257604616,CSE 283,A00,411009,Bafna; Vineet & Zhong; Sheng,0,0,0,0
1708257605165,CSE 290,A00,411010,Gao; Sicun,0,0,0,0
1708257605165,CSE 290,B00,411011,Chern; Albert Ren-Haur,0,0,0,0
1708257605165,CSE 290,C00,411012,Swanson; Steven James,0,0,0,0
1708257605165,CSE 290,E00,411013,Su; Hao,0,0,0,0
1708257605165,CSE 290,F00,411014,Riek; Laurel D,0,0,0,0
1708257605165,CSE 290,G00,411015,Gymrek; Melissa Ann,0,0,0,0
1708257605165,CSE 290,H00,479239,Dasgupta; Sanjoy & Gymrek; Melissa Ann,0,0,0,0
1708257605165,CSE 290,I00,481669,Bafna; Vineet,0,0,0,0
1708257605165,CSE 290,J00,494949,Paturi; Ramamohan,0,0,0,0
1708257605692,CSE 291,A00,411016,Li; Tzumao,0,0,0,0
1708257605692,CSE 291,B00,411017,Heninger; Nadia A,0,0,0,0
1708257605692,CSE 291,C00,411114,Chern; Albert Ren-Haur,0,0,0,0
1708257605692,CSE 291,D00,411115,Zhang; Yiying,0,0,0,0
1708257605692,CSE 291,E00,411116,Cheng; Chung Kuan,0,0,0,0
1708257605692,CSE 291,G00,411118,Lerner; Sorin,0,0,0,0
1708257605692,CSE 291,I00,481509,Shang; Jingbo,0,0,0,0
1708257605692,CSE 291,J00,494844,Savage; Stefan & Stefan; Deian,50,0,50,0
1708257606286,CSE 293,001,487239,Bafna; Vineet,9999,0,9999,0
1708257606286,CSE 293,002,487240,Bellare; Mihir,9999,0,9999,0
1708257606286,CSE 293,003,487241,Berg-Kirkpatrick; Taylor D,9999,0,9999,0
1708257606286,CSE 293,004,487242,Chandraker; Manmohan Krishna,9999,0,9999,0
1708257606286,CSE 293,005,487243,Cheng; Chung Kuan,9999,0,9999,0
1708257606286,CSE 293,006,487244,Christensen; Henrik I,9999,0,9999,0
1708257606286,CSE 293,007,487245,Coblenz; Michael J,9999,0,9999,0
1708257606286,CSE 293,008,487363,Cottrell; Garrison W,9999,0,9999,0
1708257606286,CSE 293,009,487366,Deutsch; Alin Bernard,9999,0,9999,0
1708257606286,CSE 293,010,487433,Esmaeilzadeh; Hadi,9999,0,9999,0
1708257606286,CSE 293,011,487434,Freund; Yoav,9999,0,9999,0
1708257606286,CSE 293,012,487455,Griswold; William G.,9999,0,9999,0
1708257606286,CSE 293,013,487469,Gymrek; Melissa Ann,9999,0,9999,0
1708257606286,CSE 293,014,487470,Heninger; Nadia A,9999,0,9999,0
1708257606286,CSE 293,015,487471,Impagliazzo; Russell,9999,0,9999,0
1708257606286,CSE 293,016,487472,Jhala; Ranjit,9999,0,9999,0
1708257606286,CSE 293,017,487473,Kahng; Andrew Byun,9999,0,9999,0
1708257606286,CSE 293,018,487474,Kane; Daniel Mertz,9999,0,9999,0
1708257606286,CSE 293,019,487475,Kriegman; David J,9999,0,9999,0
1708257606286,CSE 293,020,487476,Kumar; Arun Kumar,9999,0,9999,0
1708257606286,CSE 293,021,487477,Lerner; Sorin,9999,0,9999,0
1708257606286,CSE 293,022,487478,Lovett; Shachar,9999,0,9999,0
1708257606286,CSE 293,023,487520,McAuley; Julian John,9999,0,9999,0
1708257606286,CSE 293,024,487522,Micciancio; Daniele,9999,0,9999,0
1708257606286,CSE 293,025,487577,Orailoglu; Alex,9999,0,9999,0
1708257606286,CSE 293,026,487586,Pannuto; Patrick William,9999,0,9999,0
1708257606286,CSE 293,027,487598,Paturi; Ramamohan,9999,0,9999,0
1708257606286,CSE 293,028,487604,Polikarpova; Nadezhda,9999,0,9999,0
1708257606286,CSE 293,029,487609,Politz; Joseph Gibbs,9999,0,9999,0
1708257606286,CSE 293,030,487642,Porter; George M,9999,0,9999,0
1708257606286,CSE 293,031,487665,Porter; Leonard Emerson,9999,0,9999,0
1708257606286,CSE 293,032,487689,Ramamoorthi; Ravi,9999,0,9999,0
1708257606286,CSE 293,033,487698,Riek; Laurel D,9999,0,9999,0
1708257606286,CSE 293,034,487712,Sahoo; Debashis,9999,0,9999,0
1708257606286,CSE 293,035,487721,Saul; Lawrence,9999,0,9999,0
1708257606286,CSE 293,036,487735,Savage; Stefan,9999,0,9999,0
1708257606286,CSE 293,037,487744,Schulze; Jurgen P.,9999,0,9999,0
1708257606286,CSE 293,038,487758,Snoeren; Alex C.,9999,0,9999,0
1708257606286,CSE 293,039,487767,Shang; Jingbo,9999,0,9999,0
1708257606286,CSE 293,040,487790,Stefan; Deian,9999,0,9999,0
1708257606286,CSE 293,041,487817,Su; Hao,9999,0,9999,0
1708257606286,CSE 293,042,487827,Swanson; Steven James,9999,0,9999,0
1708257606286,CSE 293,043,487830,Tullsen; Dean Michael,9999,0,9999,0
1708257606286,CSE 293,044,487837,Vaccaro; Kristen Marie,9999,0,9999,0
1708257606286,CSE 293,045,487838,Voelker; Geoffrey M.,9999,0,9999,0
1708257606286,CSE 293,046,487842,Zhao; Jishen,9999,0,9999,0
1708257606286,CSE 293,047,487847,Zhou; Yuan-Yuan,9999,0,9999,0
1708257606286,CSE 293,048,487852,Gao; Sicun,9999,0,9999,0
1708257606286,CSE 293,049,487853,Weibel; Nadir,9999,0,9999,0
1708257606286,CSE 293,050,487854,Gupta; Rajesh K.,9999,0,9999,0
1708257606286,CSE 293,051,487855,Soosai Raj; Adalbert Geral,9999,0,9999,0
1708257606286,CSE 293,052,494373,Zhang; Hao,9999,0,9999,0
1708257606814,CSE 294,A00,411124,Voelker; Geoffrey M.,15,0,15,0
1708257607354,CSS 100,A01,396053,Trott; Sean Thomas,43,0,50,7
1708257607879,CSS 120,A01,479237,Mignozzetti; Umberto,47,0,50,3
1708257607879,CSS 120,A02,479238,Mignozzetti; Umberto,50,0,50,0
1708257608408,CSS 209,A00,396054,Styler; William Francis,21,0,35,14
1708257608934,CSS 296,001,396055,Mignozzetti; Umberto,0,0,0,1
1708257608934,CSS 296,002,396056,Styler; William Francis,0,0,0,1
1708257608934,CSS 296,003,396057,Broz; James Lawrence,0,0,0,2
1708257608934,CSS 296,004,396058,Elliott; Graham,0,0,0,5
1708257608934,CSS 296,005,396059,Sun; Feiyang,0,0,0,0
1708257608934,CSS 296,006,396060,Dewaard; Andrew Michael,0,0,0,0
1708257609461,DDPM 210,A00,400652,Ma; Joseph David,36,0,36,0
1708257609990,DDPM 211,A00,400653,Ma; Joseph David,36,0,36,0
1708257610515,DDPM 214,A00,400720,Ma; Joseph David,36,0,36,0
1708257611044,DERM 296,001,464131,Staff,50,0,50,0
1708257611044,DERM 296,002,464178,Staff,50,0,50,0
1708257611044,DERM 296,003,464181,Staff,50,0,50,0
1708257611625,DOC 3,A01,399409,Strom; Megan C.,0,0,0,0
1708257611625,DOC 3,A02,399414,Strom; Megan C.,0,0,0,0
1708257611625,DOC 3,A03,399432,Strom; Megan C.,0,0,0,0
1708257611625,DOC 3,A04,399461,Strom; Megan C.,0,0,0,0
1708257611625,DOC 3,A05,399470,Strom; Megan C.,0,0,0,0
1708257611625,DOC 3,A06,399476,Strom; Megan C.,0,0,0,0
1708257611625,DOC 3,A07,399547,Strom; Megan C.,0,0,0,0
1708257611625,DOC 3,A08,399548,Strom; Megan C.,0,0,0,0
1708257611625,DOC 3,A09,399675,Strom; Megan C.,0,0,0,0
1708257611625,DOC 3,A10,399687,Strom; Megan C.,0,0,0,0
1708257611625,DOC 3,A11,399704,Strom; Megan C.,0,0,0,0
1708257611625,DOC 3,A12,399707,Strom; Megan C.,0,0,0,0
1708257611625,DOC 3,A13,399714,Strom; Megan C.,0,0,0,0
1708257611625,DOC 3,A14,399721,Strom; Megan C.,0,0,0,0
1708257611625,DOC 3,A15,399765,Strom; Megan C.,0,0,0,0
1708257611625,DOC 3,A16,399766,Strom; Megan C.,0,0,0,0
1708257611625,DOC 3,B01,399786,Strom; Megan C.,0,0,0,0
1708257611625,DOC 3,B02,399787,Strom; Megan C.,0,0,0,0
1708257611625,DOC 3,B03,399788,Strom; Megan C.,0,0,0,0
1708257611625,DOC 3,B04,399845,Strom; Megan C.,0,0,0,0
1708257611625,DOC 3,B05,399846,Strom; Megan C.,0,0,0,0
1708257611625,DOC 3,B06,399895,Strom; Megan C.,0,0,0,0
1708257611625,DOC 3,B07,399916,Strom; Megan C.,0,0,0,0
1708257611625,DOC 3,B08,400073,Strom; Megan C.,0,0,0,0
1708257611625,DOC 3,B09,400074,Strom; Megan C.,0,0,0,0
1708257611625,DOC 3,B10,400076,Strom; Megan C.,0,0,0,0
1708257611625,DOC 3,B11,400077,Strom; Megan C.,0,0,0,0
1708257611625,DOC 3,B12,400078,Strom; Megan C.,0,0,0,0
1708257611625,DOC 3,B13,400079,Strom; Megan C.,0,0,0,0
1708257611625,DOC 3,B14,400080,Strom; Megan C.,0,0,0,0
1708257611625,DOC 3,B15,400081,Strom; Megan C.,0,0,0,0
1708257611625,DOC 3,B16,400082,Strom; Megan C.,0,0,0,0
1708257611625,DOC 3,C01,400084,Chapman; Dillon,0,0,0,0
1708257611625,DOC 3,C02,400085,Chapman; Dillon,0,0,0,0
1708257611625,DOC 3,C03,400086,Chapman; Dillon,0,0,0,0
1708257611625,DOC 3,C04,400087,Chapman; Dillon,0,0,0,0
1708257611625,DOC 3,C05,400113,Chapman; Dillon,0,0,0,0
1708257611625,DOC 3,C06,400114,Chapman; Dillon,0,0,0,0
1708257611625,DOC 3,C07,400117,Chapman; Dillon,0,0,0,0
1708257611625,DOC 3,C08,400118,Chapman; Dillon,0,0,0,0
1708257611625,DOC 3,C09,400119,Chapman; Dillon,0,0,0,0
1708257611625,DOC 3,C10,400121,Chapman; Dillon,0,0,0,0
1708257611625,DOC 3,C11,400122,Chapman; Dillon,0,0,0,0
1708257611625,DOC 3,C12,400126,Chapman; Dillon,0,0,0,0
1708257611625,DOC 3,C13,400157,Chapman; Dillon,0,0,0,0
1708257611625,DOC 3,C14,400240,Chapman; Dillon,0,0,0,0
1708257611625,DOC 3,C15,400241,Chapman; Dillon,0,0,0,0
1708257611625,DOC 3,C16,400242,Chapman; Dillon,0,0,0,0
1708257611625,DOC 3,D01,400253,Chapman; Dillon,0,0,0,0
1708257611625,DOC 3,D02,400294,Chapman; Dillon,0,0,0,0
1708257611625,DOC 3,D03,400295,Chapman; Dillon,0,0,0,0
1708257611625,DOC 3,D04,400430,Chapman; Dillon,0,0,0,0
1708257611625,DOC 3,D05,400438,Chapman; Dillon,0,0,0,0
1708257611625,DOC 3,D06,400439,Chapman; Dillon,0,0,0,0
1708257611625,DOC 3,D07,400441,Chapman; Dillon,0,0,0,0
1708257611625,DOC 3,D08,400442,Chapman; Dillon,0,0,0,0
1708257611625,DOC 3,D09,400443,Chapman; Dillon,0,0,0,0
1708257611625,DOC 3,D10,400445,Chapman; Dillon,0,0,0,0
1708257611625,DOC 3,D11,400446,Chapman; Dillon,0,0,0,0
1708257611625,DOC 3,D12,400447,Chapman; Dillon,0,0,0,0
1708257611625,DOC 3,D13,400448,Chapman; Dillon,0,0,0,0
1708257611625,DOC 3,D14,400646,Chapman; Dillon,0,0,0,0
1708257611625,DOC 3,D15,400647,Chapman; Dillon,0,0,0,0
1708257611625,DOC 3,D16,400648,Chapman; Dillon,0,0,0,0
1708257612149,DOC 100D,A00,400649,Pass; Natalye Joann,22,0,25,3
1708257612149,DOC 100D,B00,400650,Pass; Natalye Joann,25,0,25,0
1708257612677,DSC 10,A01,398041,Tiefenbruck; Janine LoBue,142,0,147,5
1708257612677,DSC 10,B01,398180,Tiefenbruck; Janine LoBue,144,0,147,3
1708257612677,DSC 10,C01,398400,Tiefenbruck; Janine LoBue,143,0,147,4
1708257613204,DSC 20,A01,398415,Langlois; Marina,200,0,200,0
1708257613735,DSC 30,A01,398436,Langlois; Marina,156,0,158,2
1708257613735,DSC 30,B01,398439,Langlois; Marina,144,0,150,6
1708257614261,DSC 40A,A01,398441,Rampure; Suraj,123,0,125,2
1708257614261,DSC 40A,B01,398443,Rampure; Suraj,125,0,125,0
1708257614789,DSC 40B,A01,398445,Staff,150,0,150,0
1708257615315,DSC 80,A01,398470,Lau; Samuel Ethan,70,0,70,0
1708257615315,DSC 80,B01,398541,Lau; Samuel Ethan,68,0,70,2
1708257615906,DSC 95,A01,398650,Rampure; Suraj,50,0,50,0
1708257616432,DSC 100,A01,398683,Salimi; Babak,147,0,150,3
1708257616961,DSC 102,A01,398708,Jin; Haojian,145,0,150,5
1708257617503,DSC 106,A01,398711,Wilber; Jared Dane,146,0,149,3
1708257618030,DSC 140A,A01,398724,Eldridge; Justin Matthew,98,0,100,2
1708257618030,DSC 140A,B01,479346,Ustun; Tevfik Berk,50,0,50,0
1708257618559,DSC 140B,A01,398726,Weng; Tsui-Wei (lily),144,0,150,6
1708257619087,DSC 190,A01,398738,Silberman; Jack,20,0,20,0
1708257619087,DSC 190,B01,479475,Ustun; Tevfik Berk,29,0,30,1
1708257619087,DSC 190,C01,481341,Rahman; Tauhidur,50,0,50,0
1708257619617,DSC 197,001,494360,Eldridge; Justin Matthew,9999,0,9999,0
1708257620143,DSC 214,A00,477322,Staff,21,0,60,39
1708257620673,DSC 231,A01,398863,Gupta; Rajesh K.,60,0,60,0
1708257621201,DSC 232R,A01,487133,Solares; Edwin A,37,0,60,23
1708257621726,DSC 240,A00,398957,Belkin; Mikhail,74,0,90,16
1708257622780,DSC 243,A00,398958,Ma; Yian,59,0,60,1
1708257623307,DSC 245,A00,398959,Huang; Biwei,41,0,60,19
1708257623835,DSC 253,A00,398960,Shang; Jingbo,0,0,30,30
1708257624364,DSC 258R,A01,398962,Shang; Jingbo,41,0,60,19
1708257624889,DSC 267R,A01,398964,Staff,56,0,60,4
1708257625439,DSC 291,A00,398965,Belkin; Mikhail,90,0,90,0
1708257625439,DSC 291,B00,398966,Weng; Tsui-Wei (lily),90,0,90,0
1708257625439,DSC 291,C00,398997,Staff,60,0,60,0
1708257625439,DSC 291,D00,398998,Zhang; Hao,40,0,40,0
1708257625439,DSC 291,E00,477386,Staff,50,0,50,0
1708257625967,DSC 293,A00,477388,Ustun; Tevfik Berk,9989,0,9999,10
1708257626497,DSC 295,A00,480826,Danks; David J,30,0,40,10
1708257627023,DSE 220,A00,398034,Dasgupta; Sanjoy,20,0,20,0
1708257627552,DSE 230,A00,398035,Nguyen; Mai Huong,20,0,20,0
1708257628078,DSE 260B,A00,398037,Altintas De Callaf; Ilkay,20,0,20,0
1708257628604,DSGN 1,A01,408210,Klemmer; Scott R,46,0,50,4
1708257628604,DSGN 1,A02,408245,Klemmer; Scott R,47,0,50,3
1708257629132,DSGN 119,A00,407467,Hollan; James D. & Xia; Haijun,76,0,90,14
1708257629658,DSGN 160,A00,494371,Aronoff-Spencer; Eliah Sea,15,0,20,5
1708257630186,DSGN 219,A00,474323,Hollan; James D. & Xia; Haijun,15,0,15,0
1708257630712,ECE 5,A01,428645,Morris; Karcher William,21,0,24,3
1708257630712,ECE 5,A02,428646,Morris; Karcher William,24,0,24,0
1708257630712,ECE 5,A03,428647,Morris; Karcher William,24,0,24,0
1708257630712,ECE 5,A04,428648,Morris; Karcher William,24,0,24,0
1708257631238,ECE 15,A01,428650,Sahay; Rajeev,119,0,120,1
1708257631767,ECE 16,A01,428652,Wang; Edward Jay,22,0,30,8
1708257632296,ECE 17,A01,428654,Sahay; Rajeev,48,0,60,12
1708257632822,ECE 25,A50,428657,Dey; Sujit,30,0,30,0
1708257632822,ECE 25,A51,428658,Dey; Sujit,30,0,30,0
1708257633352,ECE 30,A50,428674,Mir Arabbaygi; Siavash,27,0,30,3
1708257633352,ECE 30,A51,428675,Mir Arabbaygi; Siavash,28,0,30,2
1708257633352,ECE 30,A52,428676,Mir Arabbaygi; Siavash,28,0,30,2
1708257633352,ECE 30,A53,428679,Mir Arabbaygi; Siavash,29,0,30,1
1708257633352,ECE 30,A54,428680,Mir Arabbaygi; Siavash,30,0,30,0
1708257633882,ECE 35,A50,428684,Taur; Yuan,29,0,30,1
1708257633882,ECE 35,A51,428685,Taur; Yuan,30,0,30,0
1708257633882,ECE 35,A52,428686,Taur; Yuan,30,0,30,0
1708257633882,ECE 35,A53,428687,Taur; Yuan,29,0,30,1
1708257634409,ECE 45,A01,428689,Zeger; Kenneth A.,137,0,150,13
1708257634942,ECE 65,A50,428701,Baghdadchi; Saharnaz,28,0,30,2
1708257634942,ECE 65,A51,428742,Baghdadchi; Saharnaz,29,0,30,1
1708257634942,ECE 65,A52,428743,Baghdadchi; Saharnaz,30,0,30,0
1708257634942,ECE 65,A53,428754,Baghdadchi; Saharnaz,26,0,30,4
1708257634942,ECE 65,A54,428796,Baghdadchi; Saharnaz,30,0,30,0
1708257634942,ECE 65,A55,428797,Baghdadchi; Saharnaz,29,0,30,1
1708257634942,ECE 65,A56,428803,Baghdadchi; Saharnaz,30,0,30,0
1708257635468,ECE 100,A01,428978,Baghdadchi; Saharnaz,29,0,30,1
1708257635468,ECE 100,A02,428988,Baghdadchi; Saharnaz,30,0,30,0
1708257635468,ECE 100,A03,428989,Baghdadchi; Saharnaz,29,0,30,1
1708257635468,ECE 100,A04,429008,Baghdadchi; Saharnaz,29,0,30,1
1708257635994,ECE 101,A01,429017,Bharadia; Dinesh,57,0,60,3
1708257635994,ECE 101,A02,429019,Bharadia; Dinesh,60,0,60,0
1708257636523,ECE 103,A01,429027,Kuzum; Duygu,74,0,75,1
1708257637049,ECE 107,A01,429055,Fullerton; Eric E,73,0,75,2
1708257637578,ECE 108,A01,429068,Kang; Mingu,53,0,60,7
1708257639120,ECE 109,A01,429085,Orlitsky; Alon,97,0,100,3
1708257639120,ECE 109,A02,429098,Orlitsky; Alon,96,0,100,4
1708257639646,ECE 111,A01,429132,Turakhia; Yatish Girish,173,0,180,7
1708257640174,ECE 115,A01,429314,Yip; Michael,21,0,26,5
1708257640702,ECE 123,A01,429327,Sievenpiper; Daniel F.,56,0,60,4
1708257641233,ECE 125B,A50,429397,Esmaili; Gholamreza,23,0,24,1
1708257641233,ECE 125B,A51,429627,Esmaili; Gholamreza,23,0,24,1
1708257641759,ECE 134,A00,429630,Ng; Tse Nga,50,0,50,0
1708257642338,ECE 136L,A01,429634,Dayeh; Shadi Ahmad,3,0,5,2
1708257642338,ECE 136L,A02,429636,Dayeh; Shadi Ahmad,3,0,5,2
1708257642338,ECE 136L,A03,429637,Dayeh; Shadi Ahmad,5,0,5,0
1708257642338,ECE 136L,A04,429641,Dayeh; Shadi Ahmad,5,0,5,0
1708257642867,ECE 139,A00,429642,Nomura; Kenji,17,0,20,3
1708257643394,ECE 140B,A01,455349,Khoshabeh; Ramsin & Gessner; Richard K.,19,0,24,5
1708257643394,ECE 140B,A02,455351,Khoshabeh; Ramsin & Gessner; Richard K.,23,0,24,1
1708257643394,ECE 140B,A03,455354,Khoshabeh; Ramsin & Gessner; Richard K.,21,0,22,1
1708257643921,ECE 141B,A01,455355,Gessner; Richard K.,47,0,50,3
1708257644450,ECE 148,A01,492803,Silberman; Jack,0,0,0,0
1708257644975,ECE 153,A01,429655,Naghizadeh Ardabili; Parin,94,0,100,6
1708257645501,ECE 157A,A01,429657,Bharadia; Dinesh,22,0,25,3
1708257646027,ECE 158B,A01,429659,Zhang; Xinyu,14,0,20,6
1708257646553,ECE 161C,A00,429660,Cosman; Pamela C.,58,0,60,2
1708257647083,ECE 163,A00,429664,Hsueh; Tzu-Chien,95,0,100,5
1708257647609,ECE 165,A51,429672,Mercier; Patrick Philip,20,0,30,10
1708257647609,ECE 165,A52,429673,Mercier; Patrick Philip,22,0,30,8
1708257647609,ECE 165,A53,429674,Mercier; Patrick Philip,30,0,30,0
1708257647609,ECE 165,A54,429675,Mercier; Patrick Philip,30,0,30,0
1708257648135,ECE 171A,A01,429813,Zheng; Yang,96,0,100,4
1708257648661,ECE 175B,A01,429886,Xie; Pengtao,72,0,75,3
1708257649189,ECE 183,A01,430023,Mookherjea; Shayan,26,0,30,4
1708257649715,ECE 185,A01,430025,Papen; George C.,19,0,20,1
1708257650243,ECE 191,A00,430039,Zhang; Xinyu,30,0,30,0
1708257650769,ECE 196,A00,430040,Morris; Karcher William,18,0,24,6
1708257650769,ECE 196,B00,430045,Morris; Karcher William,23,0,24,1
1708257651293,ECE 198,001,430052,Nguyen; Truong Quang,9999,0,9999,0
1708257651845,ECE 200,001,438659,Atanasov; Nikolay A.,9999,0,9999,0
1708257651845,ECE 200,002,438660,Bharadia; Dinesh,9999,0,9999,0
1708257651845,ECE 200,003,438668,Cheng; Chung Kuan,9999,0,9999,0
1708257651845,ECE 200,004,438845,Cosman; Pamela C.,9999,0,9999,0
1708257651845,ECE 200,005,438846,Dayeh; Shadi Ahmad,9999,0,9999,0
1708257651845,ECE 200,006,438847,Fainman; Yeshaiahu,9999,0,9999,0
1708257651845,ECE 200,007,438848,Ford; Joseph Earl,9999,0,9999,0
1708257651845,ECE 200,008,438849,Franceschetti; Massimo,9999,0,9999,0
1708257651845,ECE 200,009,438850,Fullerton; Eric E,9999,0,9999,0
1708257651845,ECE 200,010,438851,Galton; Ian A,9999,0,9999,0
1708257651845,ECE 200,011,438852,Gilja; Vikash,9999,0,9999,0
1708257651845,ECE 200,012,438853,Hall; Drew A.,9999,0,9999,0
1708257651845,ECE 200,013,438854,Hsueh; Tzu-Chien,9999,0,9999,0
1708257651845,ECE 200,014,438855,Javidi; Tara,9999,0,9999,0
1708257651845,ECE 200,015,438865,Kahng; Andrew Byun,9999,0,9999,0
1708257651845,ECE 200,016,438866,Kim; Young-Han,9999,0,9999,0
1708257651845,ECE 200,017,438876,Koushanfar; Farinaz,9999,0,9999,0
1708257651845,ECE 200,018,438877,Kuzum; Duygu,9999,0,9999,0
1708257651845,ECE 200,019,438934,Le; Hanh-Phuc,9999,0,9999,0
1708257651845,ECE 200,020,438954,Lin; Bill,9999,0,9999,0
1708257651845,ECE 200,021,438955,Liu; Zhaowei,9999,0,9999,0
1708257651845,ECE 200,022,438957,Lo; Yu-Hwa,9999,0,9999,0
1708257651845,ECE 200,023,439086,Lomakin; Vitaliy,9999,0,9999,0
1708257651845,ECE 200,024,439087,Mercier; Patrick Philip,9999,0,9999,0
1708257651845,ECE 200,025,439088,Meyer; Florian,9999,0,9999,0
1708257651845,ECE 200,026,439090,Milstein; Laurence B.,9999,0,9999,0
1708257651845,ECE 200,027,439208,Mir Arabbaygi; Siavash,9999,0,9999,0
1708257651845,ECE 200,028,439209,Mookherjea; Shayan,9999,0,9999,0
1708257651845,ECE 200,029,439210,Morris; Karcher William,9999,0,9999,0
1708257651845,ECE 200,030,439211,Ng; Tse Nga,9999,0,9999,0
1708257651845,ECE 200,031,439219,Nguyen; Truong Quang,9999,0,9999,0
1708257651845,ECE 200,032,439220,Nomura; Kenji,9999,0,9999,0
1708257651845,ECE 200,033,439221,Orlitsky; Alon,9999,0,9999,0
1708257651845,ECE 200,034,439222,Pal; Piya,9999,0,9999,0
1708257651845,ECE 200,035,439223,Papen; George C.,9999,0,9999,0
1708257651845,ECE 200,036,439224,Radic; Stojan,9999,0,9999,0
1708257651845,ECE 200,037,439225,Rao; Bhaskar D.,9999,0,9999,0
1708257651845,ECE 200,038,439227,Rao; Ramesh R,9999,0,9999,0
1708257651845,ECE 200,039,439231,Rebeiz; Gabriel,9999,0,9999,0
1708257651845,ECE 200,040,439232,Sanford; John R,9999,0,9999,0
1708257651845,ECE 200,041,439302,Siegel; Paul H.,9999,0,9999,0
1708257651845,ECE 200,042,439303,Sievenpiper; Daniel F.,9999,0,9999,0
1708257651845,ECE 200,043,439305,Sworder; David D.,9999,0,9999,0
1708257651845,ECE 200,044,439306,Taur; Yuan,9999,0,9999,0
1708257651845,ECE 200,045,439419,Touri; Behrouz,9999,0,9999,0
1708257651845,ECE 200,046,439425,Trivedi; Mohan M.,9999,0,9999,0
1708257651845,ECE 200,047,439538,Vasconcelos; Nuno,9999,0,9999,0
1708257651845,ECE 200,048,439546,Wang; Xiaolong,9999,0,9999,0
1708257651845,ECE 200,049,439549,Xie; Pengtao,9999,0,9999,0
1708257651845,ECE 200,050,439551,Yip; Michael,9999,0,9999,0
1708257651845,ECE 200,051,439553,Zeger; Kenneth A.,9999,0,9999,0
1708257651845,ECE 200,052,439554,Zhang; Xinyu,9999,0,9999,0
1708257651845,ECE 200,053,439555,Zheng; Yang,9999,0,9999,0
1708257651845,ECE 200,054,439557,Turakhia; Yatish Girish,9999,0,9999,0
1708257651845,ECE 200,055,439558,Kang; Mingu,9999,0,9999,0
1708257651845,ECE 200,056,439560,Shi; Yuanyuan,9999,0,9999,0
1708257651845,ECE 200,057,439564,Wang; Edward Jay,9999,0,9999,0
1708257651845,ECE 200,058,439565,Antipa; Nicholas A,9999,0,9999,0
1708257651845,ECE 200,059,439566,Zheng; Yang,9999,0,9999,0
1708257651845,ECE 200,060,492991,Yu; Paul K L,9999,0,9999,0
1708257651845,ECE 200,061,492992,Ndao; Abdoulaye,9999,0,9999,0
1708257651845,ECE 200,062,493019,Naghizadeh Ardabili; Parin,9999,0,9999,0
1708257651845,ECE 200,063,493033,Sahay; Rajeev,9999,0,9999,0
1708257652371,ECE 208,A00,430053,Mir Arabbaygi; Siavash,0,0,0,0
1708257652895,ECE 212CN,A00,430054,Liu; Zhaowei,0,0,0,0
1708257653423,ECE 222C,A00,430055,Lomakin; Vitaliy,0,0,0,0
1708257653951,ECE 227,A00,430057,Franceschetti; Massimo,0,0,0,0
1708257654476,ECE 228,A00,430078,Shi; Yuanyuan,0,0,0,0
1708257655005,ECE 230C,A00,430079,Yu; Paul K L,0,0,0,0
1708257655531,ECE 235,A00,430081,Taur; Yuan,0,0,0,0
1708257656059,ECE 236B,A00,430082,Lo; Yu-Hwa,0,0,0,0
1708257656588,ECE 240C,A00,430083,Mookherjea; Shayan,0,0,0,0
1708257657113,ECE 250,A00,430115,Touri; Behrouz,0,0,0,0
1708257657639,ECE 251B,A00,430166,Vasconcelos; Manuela,0,0,0,0
1708257658164,ECE 258B,A00,430167,Milstein; Laurence B.,0,0,0,0
1708257658689,ECE 260C,A00,430168,Eldon; John,0,0,0,0
1708257659215,ECE 264B,A00,430169,Galton; Ian A,0,0,0,0
1708257659745,ECE 265B,A00,430170,Gudem; Prasad S.S.,0,0,0,0
1708257660270,ECE 266,A01,430273,Hall; Drew A.,0,0,0,0
1708257660800,ECE 271C,A00,430283,Vasconcelos; Nuno,0,0,0,0
1708257661324,ECE 272A,A01,430340,Poveda Fonseca; Jorge,0,0,0,0
1708257661850,ECE 273,A00,430352,Wang; Jun-Kun,0,0,0,0
1708257662380,ECE 276B,A00,430353,Atanasov; Nikolay A.,0,0,0,0
1708257662912,ECE 284,A00,430385,Wang; Edward,0,0,0,0
1708257663439,ECE 285,A00,430386,Wang; Xiaolong,0,0,0,0
1708257663439,ECE 285,B00,430387,Antipa; Nicholas A,0,0,0,0
1708257663971,ECON 1,A01,409576,Crane; Meredith Helen,87,0,100,13
1708257663971,ECON 1,A02,409577,Crane; Meredith Helen,96,0,100,4
1708257663971,ECON 1,A03,409578,Crane; Meredith Helen,97,0,100,3
1708257664496,ECON 2,A01,409580,Candido; Maria Teresa,70,0,75,5
1708257665023,ECON 3,A01,409582,Crane; Meredith Helen,109,0,120,11
1708257665023,ECON 3,A02,409583,Crane; Meredith Helen,114,0,115,1
1708257665023,ECON 3,A03,409584,Crane; Meredith Helen,110,0,115,5
1708257665553,ECON 4,A01,409586,Levkoff; Steven B.,88,0,92,4
1708257665553,ECON 4,A02,409587,Levkoff; Steven B.,89,0,90,1
1708257666080,ECON 5,A01,409589,Dai; Yinlin,53,0,58,5
1708257666080,ECON 5,A02,409590,Dai; Yinlin,56,0,58,2
1708257666080,ECON 5,A03,409591,Dai; Yinlin,54,0,54,0
1708257666080,ECON 5,A04,409593,Dai; Yinlin,55,0,55,0
1708257666080,ECON 5,B01,409595,Dai; Yinlin,57,0,58,1
1708257666080,ECON 5,B02,409596,Dai; Yinlin,49,0,49,0
1708257666080,ECON 5,B03,409597,Dai; Yinlin,59,0,59,0
1708257666080,ECON 5,B04,409598,Dai; Yinlin,55,0,55,0
1708257666080,ECON 5,C01,487209,Staff,40,0,45,5
1708257666608,ECON 100A,A01,409600,Famulari; Melissa,94,0,100,6
1708257666608,ECON 100A,A02,409601,Famulari; Melissa,98,0,100,2
1708257666608,ECON 100A,A03,409604,Famulari; Melissa,98,0,100,2
1708257666608,ECON 100A,B01,409610,Famulari; Melissa,76,0,80,4
1708257667137,ECON 100AH,A00,409612,Famulari; Melissa,19,0,20,1
1708257667670,ECON 100B,A01,409614,Grigoryan; Aram,109,0,120,11
1708257667670,ECON 100B,A02,409616,Grigoryan; Aram,117,0,120,3
1708257667670,ECON 100B,B01,409626,Grigoryan; Aram,47,0,50,3
1708257667670,ECON 100B,B02,409627,Grigoryan; Aram,49,0,50,1
1708257668195,ECON 100C,A01,409629,Levkoff; Steven B.,143,0,146,3
1708257668195,ECON 100C,B01,409632,Levkoff; Steven B.,143,0,146,3
1708257668725,ECON 106,A00,409633,Bowen; T. Renee,90,0,90,0
1708257669252,ECON 109T,A00,409634,Trevino; Isabel,18,0,20,2
1708257669782,ECON 110A,A01,409637,Staff,68,0,75,7
1708257670313,ECON 110B,A01,409663,Herreno Lopera; Juan,119,0,125,6
1708257670313,ECON 110B,A02,409682,Herreno Lopera; Juan,125,0,125,0
1708257670313,ECON 110B,B01,409734,Herreno Lopera; Juan,99,0,100,1
1708257670841,ECON 120A,A01,409739,Candido; Maria Teresa,84,0,90,6
1708257670841,ECON 120A,A02,409740,Candido; Maria Teresa,87,0,90,3
1708257670841,ECON 120A,B01,409742,Candido; Maria Teresa,85,0,90,5
1708257670841,ECON 120A,B02,409743,Candido; Maria Teresa,90,0,90,0
1708257671373,ECON 120B,A01,409748,Ma; Xinwei,128,0,130,2
1708257671373,ECON 120B,A02,409754,Ma; Xinwei,128,0,130,2
1708257671373,ECON 120B,B01,409756,Ma; Xinwei,25,0,40,15
1708257671904,ECON 120C,A01,409758,Sun; Yixiao,141,0,146,5
1708257671904,ECON 120C,B01,409762,Sun; Yixiao,144,0,146,2
1708257672429,ECON 129,A00,409763,Eckert; Fabian Paul,44,0,50,6
1708257672954,ECON 134,A00,409764,Gelber; Alexander Michael,45,0,50,5
1708257672954,ECON 134,B00,409765,Gelber; Alexander Michael,49,0,50,1
1708257673482,ECON 137,A00,409766,Niehaus; Paul,19,0,20,1
1708257674008,ECON 142,A00,409767,Trevino; Isabel,39,0,40,1
1708257674008,ECON 142,B00,409768,Trevino; Isabel,38,0,40,2
1708257674539,ECON 164,A00,409771,Muralidharan; Karthik,118,0,120,2
1708257675064,ECON 172A,A01,409773,Newhouse; Herbert S,67,0,75,8
1708257675590,ECON 172B,A01,409775,Newhouse; Herbert S,74,0,75,1
1708257675590,ECON 172B,B01,409777,Newhouse; Herbert S,71,0,75,4
1708257676644,ECON 191A,A00,409780,Cullen; Julie,20,0,20,0
1708257677173,ECON 200C,A00,409782,Du; Songzi,34,0,35,1
1708257677699,ECON 210C,A00,409784,Herreno Lopera; Juan & Wieland; Johannes Friedrich,35,0,35,0
1708257678224,ECON 220C,A00,409785,Sun; Yixiao,35,0,35,0
1708257678750,ECON 220F,A00,409786,Carson; Richard T,27,0,30,3
1708257679277,ECON 221,A00,409787,Zhu; Ying,25,0,25,0
1708257679804,ECON 241,A00,409788,Muralidharan; Karthik,18,0,20,2
1708257680329,ECON 243,A00,409789,Niehaus; Paul,18,0,20,2
1708257680855,ECON 248,A00,409790,Eckert; Fabian Paul,18,0,20,2
1708257681387,ECON 250C,A00,409791,Arnold; David Hall & Betts; Julian,25,0,25,0
1708257681914,ECON 268,A00,409792,Jacobsen; Mark,24,0,25,1
1708257682446,ECON 281,A00,409793,Meckel; Katherine Hunter,19,0,20,1
1708257682446,ECON 281,B00,409794,Herreno Lopera; Juan & Wieland; Johannes Friedrich,19,0,20,1
1708257682446,ECON 281,C00,477854,Herreno Lopera; Juan & Wieland; Johannes Friedrich,18,0,20,2
1708257682971,ECON 285,A00,409795,Eckert; Fabian Paul,20,0,20,0
1708257683507,ECON 286,A00,409796,Ma; Xinwei,15,0,15,0
1708257683507,ECON 286,B00,409797,Hamilton; James D.,15,0,15,0
1708257683507,ECON 286,C00,409798,Grigoryan; Aram,15,0,15,0
1708257683507,ECON 286,D00,409799,Niehaus; Paul,15,0,15,0
1708257684033,ECON 296,A00,409800,Eckert; Fabian Paul,20,0,20,0
1708257684560,EDS 31,A00,409801,Bussey; Thomas J,9,0,10,1
1708257685089,EDS 38,A01,409803,Chung; Luz Marina,25,0,25,0
1708257685616,EDS 39,A01,409805,Heinzman; Erica M.,24,0,25,1
1708257686142,EDS 102,A01,409807,Ambo; Theresa Jean,37,0,45,8
1708257686671,EDS 110R,A01,409809,Staff,42,0,50,8
1708257686671,EDS 110R,B01,481358,Staff,20,0,20,0
1708257687201,EDS 111,A00,479044,Wishard Guerra; Alison G.,56,0,60,4
1708257687727,EDS 117,A01,409818,Jones; Gabrielle Anastasia,21,0,23,2
1708257687727,EDS 117,A02,409819,Jones; Gabrielle Anastasia,23,0,23,0
1708257687727,EDS 117,A03,409820,Jones; Gabrielle Anastasia,22,0,23,1
1708257687727,EDS 117,A04,409821,Jones; Gabrielle Anastasia,21,0,21,0
1708257688252,EDS 118,A00,409828,Warstadt; Melissa Fawn,46,0,50,4
1708257688777,EDS 123,A00,409831,Bussey; Thomas J,10,0,10,0
1708257689306,EDS 124AR,A00,419352,Simon; Elizabeth A,81,0,100,19
1708257689306,EDS 124AR,B00,419377,Simon; Elizabeth A,97,0,100,3
1708257689306,EDS 124AR,C00,481485,Simon; Elizabeth A,25,0,25,0
1708257689306,EDS 124AR,D00,481490,Simon; Elizabeth A,25,0,25,0
1708257689830,EDS 124BR,A00,409838,Eguchi; Emi,52,0,75,23
1708257689830,EDS 124BR,B00,481363,Eguchi; Emi,25,0,25,0
1708257690354,EDS 125,A00,409839,Aragon; Maria Jose,48,0,50,2
1708257690882,EDS 126,A01,409843,Jones; Makeba,19,0,25,6
1708257690882,EDS 126,A02,409844,Jones; Makeba,25,0,25,0
1708257690882,EDS 126,A03,409846,Jones; Makeba,25,0,25,0
1708257690882,EDS 126,A04,409847,Jones; Makeba,25,0,25,0
1708257691408,EDS 128B,A01,409851,Pappas; Elizabeth,49,0,50,1
1708257691935,EDS 129C,A01,409906,Millstone; Rachel Diana,44,0,50,6
1708257692465,EDS 130,A01,409954,Mendez; Kathrina Mendoza,14,0,15,1
1708257692465,EDS 130,A02,409955,Mendez; Kathrina Mendoza,24,0,25,1
1708257692465,EDS 130,A03,409956,Mendez; Kathrina Mendoza,20,0,20,0
1708257692991,EDS 133,A01,409961,Bintliff; Amy S.V.,15,0,20,5
1708257692991,EDS 133,A02,409962,Bintliff; Amy S.V.,20,0,20,0
1708257692991,EDS 133,A03,489636,Bintliff; Amy S.V.,15,0,15,0
1708257693516,EDS 136,A01,409964,Chung; Luz Marina,30,0,30,0
1708257693516,EDS 136,A02,409977,Chung; Luz Marina,30,0,30,0
1708257694049,EDS 139,A00,479197,Millstone; Rachel Diana,42,0,50,8
1708257694049,EDS 139,B00,479198,Pappas; Elizabeth,49,0,50,1
1708257694049,EDS 139,C00,479199,Mendez; Kathrina Mendoza,58,0,60,2
1708257694049,EDS 139,D00,479200,Bintliff; Amy S.V.,56,0,60,4
1708257694049,EDS 139,E00,479201,Chung; Luz Marina,59,0,60,1
1708257694049,EDS 139,F00,479202,Bintliff; Amy S.V.,15,0,15,0
1708257694049,EDS 139,G00,479203,Mamas; Christoforos,27,0,30,3
1708257694049,EDS 139,H00,493997,Choi; Bailey Miyeon,28,0,30,2
1708257694575,EDS 141,A00,409979,Mamas; Christoforos,38,0,40,2
1708257695104,EDS 145,A01,409989,Choi; Bailey Miyeon,13,0,15,2
1708257695104,EDS 145,A02,409990,Choi; Bailey Miyeon,15,0,15,0
1708257695685,EDS 180,A00,409991,Chapman; Thandeka K,30,0,30,0
1708257695685,EDS 180,B00,409992,Ambo; Theresa Jean,24,0,25,1
1708257695685,EDS 180,C00,409993,Jones; Gabrielle Anastasia,20,0,20,0
1708257695685,EDS 180,D00,409994,Phuong; Andrew,24,0,24,0
1708257696209,EDS 198,001,487216,Eguchi; Emi,20,0,20,0
1708257696738,EDS 205B,A00,409995,Staff,40,0,45,5
1708257696738,EDS 205B,B00,409997,Staff,42,0,45,3
1708257697264,EDS 232,A00,409999,Hopkins; Megan Beth,9,0,12,3
1708257697790,EDS 255,A00,410001,Phuong; Andrew,14,0,15,1
1708257698320,EDS 257,A00,410003,Datnow; Amanda Lee,14,0,15,1
1708257698846,EDS 282,A00,479192,Daly; Alan J.,16,0,16,0
1708257699374,EDS 287B,A00,479193,Daly; Alan J.,16,0,16,0
1708257699899,EDS 288A,A00,410005,Staff,18,0,18,0
1708257700428,EDS 288C,A00,410007,Staff,18,0,18,0
1708257700954,EDS 289B,A01,410009,Daly; Alan J.,18,0,18,0
1708257701482,EDS 290,A00,410010,Black; Alison Michelle,30,0,30,0
1708257701482,EDS 290,B00,410012,Choi; Bailey Miyeon,29,0,30,1
1708257701482,EDS 290,C00,479205,Heinzman; Erica M.,0,0,0,0
1708257702006,EDS 291B,A01,479195,Daly; Alan J.,16,0,16,0
1708257702531,EDS 293B,A01,410016,Staff,18,0,18,0
1708257703058,EDS 294B,A00,479196,Burrell; Sade Renee,16,0,16,0
1708257703591,EDS 296,001,478927,Ambo; Theresa Jean,0,0,0,0
1708257703591,EDS 296,002,478935,Aragon; Maria Jose,0,0,0,1
1708257703591,EDS 296,003,478936,Chapman; Thandeka K,0,0,0,0
1708257703591,EDS 296,004,478942,Bintliff; Amy S.V.,0,0,0,0
1708257703591,EDS 296,005,478943,Clarke; Sherice Nicole,0,0,0,0
1708257703591,EDS 296,006,478967,Cohen; Shana R,0,0,0,1
1708257703591,EDS 296,007,478968,Datnow; Amanda Lee,0,0,0,0
1708257703591,EDS 296,008,478969,Daly; Alan J.,0,0,0,0
1708257703591,EDS 296,009,478970,Eguchi; Emi,0,0,0,0
1708257703591,EDS 296,010,478971,Fine; Sarah,0,0,0,0
1708257703591,EDS 296,011,478972,Jones; Gabrielle Anastasia,0,0,0,0
1708257703591,EDS 296,012,479020,Jones; Makeba,0,0,0,0
1708257703591,EDS 296,013,479021,Halter; Christopher P.,0,0,0,0
1708257703591,EDS 296,014,479027,Hofstetter; Carolyn,0,0,0,0
1708257703591,EDS 296,015,479028,Hopkins; Megan Beth,0,0,0,0
1708257703591,EDS 296,016,479034,Mamas; Christoforos,0,0,0,0
1708257703591,EDS 296,017,479035,Pollock; Mica,0,0,0,0
1708257703591,EDS 296,018,479036,Wishard Guerra; Alison G.,0,0,0,0
1708257703591,EDS 296,019,494549,Phuong; Andrew,0,0,0,0
1708257704125,EMED 296,001,464428,Singh; Sukhdeep,49,0,50,1
1708257704125,EMED 296,002,464438,Subramony; Rachna,49,0,50,1
1708257704125,EMED 296,003,464490,Staff,50,0,50,0
1708257704654,ENG 10,A00,399006,Evdokimenko; Ekaterina,30,0,30,0
1708257705178,ENG 100D,A00,399084,Ngo; Anh-Thu T.,33,0,50,17
1708257705707,ENG 100DR,A00,479230,Ngo; Anh-Thu T.,29,0,40,11
1708257706235,ENG 100L,A00,399163,Kleissl; Jan,6,0,6,0
1708257706235,ENG 100L,B00,399217,Bratton; Maryann,8,0,8,0
1708257706235,ENG 100L,C00,399218,Yu; Paul K L,8,0,8,0
1708257706235,ENG 100L,D00,399257,Bratton; Maryann,6,0,6,0
1708257706235,ENG 100L,E00,399258,de Oliveira; Mauricio,9,0,10,1
1708257706235,ENG 100L,F00,399314,Bratton; Maryann,7,0,7,0
1708257706235,ENG 100L,G00,399394,Boyle; Mary E. T.,14,0,15,1
1708257706767,ENVR 102,A00,400777,Daly; Heather Marie,19,0,20,1
1708257706767,ENVR 102,B00,400778,Montejo; Carolina,24,0,25,1
1708257706767,ENVR 102,C00,400791,Staff,23,0,25,2
1708257707294,ENVR 140,A01,400813,Siapno; Jacqueline A,12,0,15,3
1708257707294,ENVR 140,A02,400870,Siapno; Jacqueline A,15,0,15,0
1708257707294,ENVR 140,A03,400889,Siapno; Jacqueline A,15,0,15,0
1708257707294,ENVR 140,A04,400890,Siapno; Jacqueline A,15,0,15,0
1708257707820,ENVR 144,A01,400929,Herbst; Matthew,20,0,20,0
1708257708345,ERC 20,A00,400722,Evans; Ivan T,30,0,30,0
1708257708872,ESYS 103,A01,400931,Lerner; Amy M,32,0,34,2
1708257708872,ESYS 103,A02,400934,Lerner; Amy M,34,0,34,0
1708257708872,ESYS 103,A03,400938,Lerner; Amy M,28,0,34,6
1708257708872,ESYS 103,A04,400939,Lerner; Amy M,33,0,34,1
1708257708872,ESYS 103,A05,400940,Lerner; Amy M,34,0,34,0
1708257708872,ESYS 103,A06,400941,Lerner; Amy M,33,0,34,1
1708257709401,ESYS 187C,A01,400945,Hetherington; Elizabeth Dorsey,28,0,40,12
1708257709401,ESYS 187C,A02,400946,Hetherington; Elizabeth Dorsey,39,0,40,1
1708257709928,ETHN 3R,A01,400948,Streeby; Shelley,21,0,25,4
1708257709928,ETHN 3R,A02,401220,Streeby; Shelley,24,0,25,1
1708257709928,ETHN 3R,A03,401231,Streeby; Shelley,22,0,25,3
1708257709928,ETHN 3R,A04,401236,Streeby; Shelley,23,0,25,2
1708257709928,ETHN 3R,A05,401241,Streeby; Shelley,21,0,25,4
1708257709928,ETHN 3R,A06,401311,Streeby; Shelley,21,0,25,4
1708257709928,ETHN 3R,A07,401318,Streeby; Shelley,25,0,25,0
1708257709928,ETHN 3R,A08,401319,Streeby; Shelley,25,0,25,0
1708257709928,ETHN 3R,A09,401397,Streeby; Shelley,25,0,25,0
1708257709928,ETHN 3R,A10,401398,Streeby; Shelley,25,0,25,0
1708257709928,ETHN 3R,A11,401399,Streeby; Shelley,24,0,25,1
1708257709928,ETHN 3R,A12,401518,Streeby; Shelley,25,0,25,0
1708257709928,ETHN 3R,A13,401551,Streeby; Shelley,24,0,25,1
1708257709928,ETHN 3R,A14,401552,Streeby; Shelley,23,0,25,2
1708257710467,ETHN 30,A01,401554,Fuste; Jose Ignacio,24,0,25,1
1708257710467,ETHN 30,A02,401555,Fuste; Jose Ignacio,25,0,25,0
1708257710467,ETHN 30,A03,401556,Fuste; Jose Ignacio,25,0,25,0
1708257710467,ETHN 30,A04,401557,Fuste; Jose Ignacio,25,0,25,0
1708257710993,ETHN 100C,A00,401558,Museus; Samuel David,36,0,40,4
1708257711522,ETHN 101TV,A01,401560,Marez; Curtis F.,21,0,25,4
1708257711522,ETHN 101TV,A02,401564,Marez; Curtis F.,25,0,25,0
1708257712049,ETHN 108,A00,401584,Hankins; Sarah E.,25,0,29,4
1708257712578,ETHN 113A,A00,401657,Werner; Bradley T.,15,0,15,0
1708257713106,ETHN 114B,A00,401724,Frank; Ross H.,19,0,20,1
1708257713631,ETHN 120D,A01,401848,Alvarez; Luis A,8,0,10,2
1708257713631,ETHN 120D,A02,401853,Alvarez; Luis A,10,0,10,0
1708257714154,ETHN 125R,A00,401858,Sasaki; Christen T,39,0,50,11
1708257714687,ETHN 126,A00,401865,Tran; Ly Thi Hai,39,0,40,1
1708257715218,ETHN 127,A00,401866,Martin Sandino; Amanda Maria Yoland,24,0,25,1
1708257715744,ETHN 137,A00,401867,Martin Sandino; Amanda Maria Yoland,19,0,19,0
1708257716270,ETHN 139,A00,401992,Perreira; Christopher Michael,25,0,25,0
1708257716798,ETHN 143,A00,402059,Marez; Curtis F.,39,0,40,1
1708257717327,ETHN 144M,A00,402060,Jolivette; Andrew J,62,0,65,3
1708257717854,ETHN 150,A00,402158,Taylor-Garcia; Daphne,16,0,18,2
1708257718380,ETHN 153,A00,402160,Martinez-Matsuda; Veronica,24,0,25,1
1708257718908,ETHN 179,A00,402165,Richards; Stephanie F,23,0,25,2
1708257719433,ETHN 183,A00,402217,Steelman; Katherine Wallis,16,0,16,0
1708257719959,ETHN 186,A00,402313,Perez; Roy,15,0,15,0
1708257720490,ETHN 189,A00,479226,Museus; Samuel David,29,0,30,1
1708257721018,ETHN 196H,A00,402314,Espiritu; Yen,0,0,0,0
1708257721018,ETHN 196H,B00,402325,Perreira; Christopher Michael,0,0,0,0
1708257721018,ETHN 196H,C00,402344,Perez; Roy,0,0,0,0
1708257721018,ETHN 196H,D00,402345,Streeby; Shelley,0,0,0,0
1708257721018,ETHN 196H,E00,402346,Taylor-Garcia; Daphne,0,0,0,0
1708257721548,ETHN 200C,A00,402358,Fuste; Jose Ignacio,19,0,20,1
1708257722077,ETHN 230,A00,402359,Streeby; Shelley,16,0,20,4
1708257722601,ETHN 291,A00,402363,Perreira; Christopher Michael,16,0,20,4
1708257723128,EXPR 100,A00,477778,Staff,9999,0,9999,0
1708257723651,EXPR 105,A00,477779,Staff,9999,0,9999,0
1708257724177,EXPR 201,A00,477780,Staff,9999,0,9999,0
1708257724704,EXPR 205,A00,477781,Staff,9999,0,9999,0
1708257725230,FILM 87,A00,402794,Rahimi; Babak,19,0,20,1
1708257725230,FILM 87,B00,402796,Rahimi; Babak,20,0,20,0
1708257725230,FILM 87,C00,402821,Havis; Allan,19,0,20,1
1708257725763,FMPH 95,A00,481734,Larsen; Britta Ann,0,0,0,2
1708257726288,FMPH 101,A00,404648,Tan; Gene Brian,31,0,40,9
1708257726812,FMPH 102,A01,404692,Rana; Brinda Kanti,24,0,28,4
1708257726812,FMPH 102,A02,404714,Rana; Brinda Kanti,28,0,28,0
1708257726812,FMPH 102,B01,404739,Rana; Brinda Kanti,26,0,28,2
1708257726812,FMPH 102,B02,404746,Rana; Brinda Kanti,28,0,28,0
1708257727343,FMPH 110,A00,404747,Campbell; Chadwick Karl,52,0,55,3
1708257727343,FMPH 110,B00,404789,Zoumas-Morse; Christine E.,24,0,30,6
1708257727870,FMPH 120,A00,404792,Nguyen-Grozavu; France T.,48,0,60,12
1708257728398,FMPH 130,A00,404859,Gould; Carlos Francisco,48,0,55,7
1708257728398,FMPH 130,B00,479047,Ciborowski; Haley Minae,52,0,55,3
1708257728922,FMPH 155,A00,404864,Fielding-Miller; Rebecca,65,0,65,0
1708257729446,FMPH 161,A00,404865,Zoumas-Morse; Christine E.,27,0,35,8
1708257729974,FMPH 191,A00,404866,Eikey; Elizabeth Victoria,35,0,35,0
1708257730502,FMPH 194,A00,404938,Larsen; Britta Ann,0,0,0,0
1708257730502,FMPH 194,B00,404939,Marquez; Becky,0,0,0,0
1708257730502,FMPH 194,C00,404949,Nguyen-Grozavu; France T.,0,0,0,0
1708257730502,FMPH 194,D00,404950,Stone; Matthew David,0,0,0,0
1708257730502,FMPH 194,E00,404958,White; Anne Elizabeth Clar,0,0,0,0
1708257730502,FMPH 194,F00,404969,Zoumas-Morse; Christine E.,0,0,0,0
1708257731032,FMPH 223,A00,404977,Vaida; Florin,7,0,26,19
1708257731556,FMPH 225,A00,404978,Zou; Jingjing,0,0,0,0
1708257732093,FMPH 291,A00,404992,Salem; Rany Mansour,15,0,15,0
1708257732093,FMPH 291,C00,405005,Schwartzman; Armin,0,0,0,11
1708257732093,FMPH 291,D00,479113,Shadyab; Aladdin Hassan,0,0,0,0
1708257732093,FMPH 291,E00,479114,Shadyab; Aladdin Hassan,0,0,0,0
1708257732093,FMPH 291,F00,479115,Wynn; Adriane Michelle,0,0,0,3
1708257732093,FMPH 291,G00,479116,Xu; Ronghui,0,0,0,10
1708257732093,FMPH 291,H00,479119,Vaida; Florin,0,0,0,2
1708257732619,FPM 258C,A00,405129,Chen; Brian Hwa-Yang,11,0,15,4
1708257733146,FPM 259C,A00,405130,Nguyen; Annie Lu & Araneta; Maria Rosario Gorrez,4,0,5,1
1708257733675,FPM 278,A00,405131,Strong; David R,13,0,15,2
1708257734200,FPM 280C,A01,405133,Banegas; Matthew Patrick,10,0,10,0
1708257734729,FPM 296,001,464651,Johnson; Michelle Lee,49,0,50,1
1708257734729,FPM 296,002,464652,Staff,50,0,50,0
1708257734729,FPM 296,003,464653,Staff,50,0,50,0
1708257735255,FPM 297,001,479175,Vaida; Florin,9999,0,9999,0
1708257735255,FPM 297,002,494007,Strong; David R,9999,0,9999,0
1708257735255,FPM 297,003,494364,Bazzi; Angela Robertson,9999,0,9999,0
1708257735780,GLBH 20,A00,405134,Elwardani; Nile Regina,143,0,146,3
1708257736315,GLBH 100,A00,405135,Bhavsar; Radhika,68,0,70,2
1708257736315,GLBH 100,B00,477773,Villarino; Margarita,39,0,44,5
1708257736315,GLBH 100,C00,477855,Jenkins; Janis A.,20,0,20,0
1708257736315,GLBH 100,D00,481337,Mishra; Jyoti,40,0,40,0
1708257736843,GLBH 101,A00,405136,Sloane; Julia Kathryn,40,0,40,0
1708257737368,GLBH 107,A00,405137,Wilson; Brenda K,63,0,70,7
1708257737899,GLBH 111,A01,486865,Burgos; Jose L.,0,0,0,0
1708257737899,GLBH 111,B01,486867,Burgos; Jose L.,0,0,0,0
1708257738429,GLBH 114W,A00,405138,Walkover; Lillian B,17,0,17,0
1708257738956,GLBH 118,A00,405140,Wilson; Brenda K,31,0,32,1
1708257739485,GLBH 147,A00,405141,Stewart; Alexander B,40,0,40,0
1708257740010,GLBH 148,A00,405142,Olivas Hernandez; Olga Lid,93,0,100,7
1708257740538,GLBH 150B,A00,486855,Sanchez; Giselle,0,0,0,0
1708257741068,GLBH 181,A00,405154,Burgos; Jose L.,211,0,216,5
1708257741594,GLBH 215,A00,479241,Walkover; Lillian B,18,0,18,0
1708257742126,GLBH 260,A00,480722,Elwardani; Nile Regina,18,0,18,0
1708257742653,GSS 20,A00,405155,Siapno; Jacqueline A,25,0,30,5
1708257743180,GSS 25,A00,405156,Batarseh; Amanda Alicia,24,0,30,6
1708257743712,HDS 1,A01,405160,Reese; Clarissa Jane,25,0,25,0
1708257743712,HDS 1,A02,405168,Reese; Clarissa Jane,25,0,25,0
1708257743712,HDS 1,A03,405169,Reese; Clarissa Jane,22,0,25,3
1708257743712,HDS 1,A04,405170,Reese; Clarissa Jane,24,0,25,1
1708257743712,HDS 1,A05,405171,Reese; Clarissa Jane,23,0,25,2
1708257743712,HDS 1,A06,405172,Reese; Clarissa Jane,24,0,25,1
1708257743712,HDS 1,A07,405173,Reese; Clarissa Jane,24,0,25,1
1708257744237,HDS 60,A01,405175,Warstadt; Melissa Fawn,34,0,35,1
1708257744237,HDS 60,A02,405176,Warstadt; Melissa Fawn,33,0,35,2
1708257744765,HDS 95,A00,405177,Staff,38,0,40,2
1708257745291,HDS 120,A00,405178,Staff,0,0,0,0
1708257745821,HDS 122,A00,405179,Rodriguez; Victoria Calip,64,0,75,11
1708257746350,HDS 150,A00,405180,Staff,20,0,20,0
1708257746350,HDS 150,B00,405181,Staff,20,0,20,0
1708257746350,HDS 150,C00,405182,Staff,20,0,20,0
1708257746876,HDS 181,A01,405185,Bjorklund; Peter,30,0,30,0
1708257747405,HDS 191,A01,405187,Reese; Clarissa Jane,40,0,40,0
1708257747405,HDS 191,B01,405194,Staff,25,0,25,0
1708257747930,HIAF 113,A00,403736,Prestholdt; Jeremy,74,0,75,1
1708257748458,HIAF 114,A00,403738,Gyamfi; Bright,49,0,50,1
1708257749038,HIEA 132,A00,403740,Kletzer; Benjamin Nathan,25,0,30,5
1708257749568,HIEA 154,A00,403741,Henry; Todd A.,62,0,64,2
1708257750092,HIEU 139,A00,403742,Strasser; Ulrike,52,0,56,4
1708257751637,HIEU 171,A00,403743,Hansen; Jan Eric,62,0,64,2
1708257752163,HIEU 176,A00,403744,Hertz; Deborah,14,0,15,1
1708257752687,HIEU 183,A00,403800,Gallant; Thomas W.,15,0,15,0
1708257753214,HIEU 276,A00,403862,Hertz; Deborah,0,0,0,0
1708257753741,HIGL 127,A00,403802,Ivey; James Alexander,56,0,56,0
1708257754266,HIGR 201,A00,494372,Pineda De Avila; Nydia,9,0,10,1
1708257754794,HIGR 205,A00,403863,Strasser; Ulrike,11,0,15,4
1708257755320,HIGR 217C,A00,403864,Lu; Weijing,9,0,10,1
1708257755849,HIGR 239,A00,403865,Serlin; David,4,0,5,1
1708257756374,HIGR 240,A00,403875,Gates; Kelly,2,0,5,3
1708257756903,HILA 101,A00,403818,LeNeave; Kimiko Nicole,62,0,64,2
1708257757433,HILA 119,A00,403819,Kozameh; Sara J,47,0,50,3
1708257757960,HILA 144,A00,403821,Kozameh; Sara J,50,0,50,0
1708257758492,HILD 2C,A01,402843,Hendrickson; Gerald M.,31,0,32,1
1708257758492,HILD 2C,A02,403030,Hendrickson; Gerald M.,31,0,32,1
1708257758492,HILD 2C,A03,403042,Hendrickson; Gerald M.,32,0,32,0
1708257758492,HILD 2C,A04,403048,Hendrickson; Gerald M.,30,0,32,2
1708257758492,HILD 2C,A05,403049,Hendrickson; Gerald M.,32,0,32,0
1708257758492,HILD 2C,A06,403098,Hendrickson; Gerald M.,32,0,32,0
1708257759019,HILD 7C,A01,403501,Bermudez; Rosie Cano,27,0,32,5
1708257759019,HILD 7C,A02,403513,Bermudez; Rosie Cano,30,0,32,2
1708257759019,HILD 7C,A03,403570,Bermudez; Rosie Cano,32,0,32,0
1708257759019,HILD 7C,A04,403572,Bermudez; Rosie Cano,32,0,32,0
1708257759019,HILD 7C,A05,403587,Bermudez; Rosie Cano,32,0,32,0
1708257759019,HILD 7C,A06,403588,Bermudez; Rosie Cano,32,0,32,0
1708257759019,HILD 7C,A07,403589,Bermudez; Rosie Cano,29,0,32,3
1708257759019,HILD 7C,A08,403590,Bermudez; Rosie Cano,32,0,32,0
1708257759019,HILD 7C,A09,403601,Bermudez; Rosie Cano,30,0,32,2
1708257759019,HILD 7C,A10,403602,Bermudez; Rosie Cano,32,0,32,0
1708257759019,HILD 7C,A11,403603,Bermudez; Rosie Cano,32,0,32,0
1708257759019,HILD 7C,A12,403604,Bermudez; Rosie Cano,32,0,32,0
1708257759544,HILD 12,A01,403607,Henry; Todd A.,32,0,32,0
1708257759544,HILD 12,A02,403608,Henry; Todd A.,31,0,32,1
1708257759544,HILD 12,A03,403609,Henry; Todd A.,32,0,32,0
1708257759544,HILD 12,A04,403699,Henry; Todd A.,32,0,32,0
1708257759544,HILD 12,A05,403700,Henry; Todd A.,32,0,32,0
1708257759544,HILD 12,A06,403701,Henry; Todd A.,32,0,32,0
1708257760072,HILD 30,A01,403703,Soleiman; Matthew Teymour,29,0,32,3
1708257760072,HILD 30,A02,403704,Soleiman; Matthew Teymour,30,0,32,2
1708257760599,HINE 118,A00,403822,Kayali; Hasan,50,0,50,0
1708257761128,HISC 119,A00,403823,Golan; Tal,26,0,30,4
1708257761655,HISC 123,A00,403839,Pineda De Avila; Nydia,44,0,50,6
1708257762183,HITO 87,A00,403707,Patterson; Patrick H.,15,0,15,0
1708257762183,HITO 87,B00,403709,Patterson; Patrick H.,15,0,15,0
1708257762183,HITO 87,C00,403735,Schneewind; Sarah,15,0,15,0
1708257762711,HITO 100,B00,403841,Klann; Mary Cameron,24,0,25,1
1708257763236,HITO 170,A00,403842,Watts; Edward J.,8,0,10,2
1708257763761,HITO 193,A00,455333,Hill; Seth J,0,0,0,0
1708257764287,HIUS 114A,A00,403843,Lewandoski; Julia Mavis,52,0,56,4
1708257764817,HIUS 120D,A01,403854,Alvarez; Luis A,8,0,10,2
1708257764817,HIUS 120D,A02,403855,Alvarez; Luis A,10,0,10,0
1708257765344,HIUS 136,A00,403857,Martinez-Matsuda; Veronica,21,0,25,4
1708257765872,HIUS 144,A00,403858,Martinez-Matsuda; Veronica,55,0,56,1
1708257765872,HIUS 144,B00,403859,Vandevelde; Kenneth Joseph,54,0,56,2
1708257765872,HIUS 144,C00,403860,Klann; Mary Cameron,52,0,56,4
1708257765872,HIUS 144,D00,403861,Lewandoski; Julia Mavis,55,0,56,1
1708257766422,HUM 2,A01,422723,Watts; Edward J.,16,0,16,0
1708257766422,HUM 2,A02,422735,Watts; Edward J.,15,0,16,1
1708257766422,HUM 2,A03,422736,Watts; Edward J.,15,0,16,1
1708257766422,HUM 2,A04,422737,Watts; Edward J.,16,0,16,0
1708257766422,HUM 2,A05,422738,Watts; Edward J.,15,0,16,1
1708257766422,HUM 2,A06,422760,Watts; Edward J.,15,0,16,1
1708257766422,HUM 2,A07,422778,Watts; Edward J.,16,0,16,0
1708257766422,HUM 2,A08,422793,Watts; Edward J.,16,0,16,0
1708257766422,HUM 2,A09,422794,Watts; Edward J.,16,0,16,0
1708257766422,HUM 2,A10,422795,Watts; Edward J.,16,0,16,0
1708257766422,HUM 2,B01,422805,Markman; Kristina,13,0,16,3
1708257766422,HUM 2,B02,422806,Markman; Kristina,14,0,16,2
1708257766422,HUM 2,B03,422807,Markman; Kristina,14,0,16,2
1708257766422,HUM 2,B04,422808,Markman; Kristina,16,0,16,0
1708257766422,HUM 2,B05,422809,Markman; Kristina,16,0,16,0
1708257766422,HUM 2,B06,422842,Markman; Kristina,16,0,16,0
1708257766422,HUM 2,B07,422843,Markman; Kristina,15,0,16,1
1708257766422,HUM 2,B08,422848,Markman; Kristina,16,0,16,0
1708257766422,HUM 2,B09,422850,Markman; Kristina,15,0,16,1
1708257766422,HUM 2,B10,422851,Markman; Kristina,12,0,16,4
1708257766422,HUM 2,B11,422852,Markman; Kristina,15,0,16,1
1708257766422,HUM 2,B12,422853,Markman; Kristina,16,0,16,0
1708257766422,HUM 2,C01,422855,Rodriguez; Bretton Sigfred,15,0,16,1
1708257766422,HUM 2,C02,422856,Rodriguez; Bretton Sigfred,16,0,16,0
1708257766422,HUM 2,C03,422859,Rodriguez; Bretton Sigfred,15,0,16,1
1708257766422,HUM 2,C04,423106,Rodriguez; Bretton Sigfred,12,0,16,4
1708257766422,HUM 2,C05,423107,Rodriguez; Bretton Sigfred,15,0,16,1
1708257766422,HUM 2,C06,423108,Rodriguez; Bretton Sigfred,14,0,16,2
1708257766422,HUM 2,C07,423109,Rodriguez; Bretton Sigfred,15,0,16,1
1708257766422,HUM 2,C08,423110,Rodriguez; Bretton Sigfred,15,0,16,1
1708257766422,HUM 2,C09,423133,Rodriguez; Bretton Sigfred,14,0,16,2
1708257766422,HUM 2,C10,423134,Rodriguez; Bretton Sigfred,14,0,16,2
1708257766422,HUM 2,C11,423135,Rodriguez; Bretton Sigfred,16,0,16,0
1708257766422,HUM 2,C12,423136,Rodriguez; Bretton Sigfred,15,0,16,1
1708257766422,HUM 2,C13,423137,Rodriguez; Bretton Sigfred,16,0,16,0
1708257766422,HUM 2,C14,423138,Rodriguez; Bretton Sigfred,16,0,16,0
1708257766422,HUM 2,D01,423140,West; Geoffrey Scott,13,0,16,3
1708257766422,HUM 2,D02,423141,West; Geoffrey Scott,15,0,16,1
1708257766422,HUM 2,D03,423142,West; Geoffrey Scott,15,0,16,1
1708257766422,HUM 2,D04,423143,West; Geoffrey Scott,14,0,16,2
1708257766422,HUM 2,D05,423144,West; Geoffrey Scott,16,0,16,0
1708257766422,HUM 2,D06,423145,West; Geoffrey Scott,16,0,16,0
1708257766422,HUM 2,D07,423146,West; Geoffrey Scott,16,0,16,0
1708257766422,HUM 2,D08,423158,West; Geoffrey Scott,16,0,16,0
1708257766422,HUM 2,D09,423169,West; Geoffrey Scott,16,0,16,0
1708257766422,HUM 2,D10,423174,West; Geoffrey Scott,16,0,16,0
1708257766422,HUM 2,D11,423175,West; Geoffrey Scott,16,0,16,0
1708257766422,HUM 2,D12,423179,West; Geoffrey Scott,15,0,16,1
1708257766422,HUM 2,D13,423188,West; Geoffrey Scott,15,0,16,1
1708257766422,HUM 2,D14,423204,West; Geoffrey Scott,16,0,16,0
1708257766953,HUM 5,A01,423221,Lyon; Antony J.,26,0,30,4
1708257766953,HUM 5,A02,423232,Lyon; Antony J.,24,0,30,6
1708257766953,HUM 5,A03,423237,Lyon; Antony J.,18,0,30,12
1708257766953,HUM 5,A04,423240,Lyon; Antony J.,25,0,30,5
1708257766953,HUM 5,A05,423242,Lyon; Antony J.,28,0,30,2
1708257766953,HUM 5,A06,423244,Lyon; Antony J.,23,0,30,7
1708257766953,HUM 5,A07,423247,Lyon; Antony J.,27,0,30,3
1708257766953,HUM 5,A08,423254,Lyon; Antony J.,27,0,30,3
1708257766953,HUM 5,B01,423286,Patterson; Patrick H.,28,0,30,2
1708257766953,HUM 5,B02,423291,Patterson; Patrick H.,29,0,30,1
1708257766953,HUM 5,B03,423294,Patterson; Patrick H.,28,0,30,2
1708257766953,HUM 5,B04,423297,Patterson; Patrick H.,29,0,30,1
1708257766953,HUM 5,B05,423313,Patterson; Patrick H.,30,0,30,0
1708257766953,HUM 5,B06,423318,Patterson; Patrick H.,30,0,30,0
1708257766953,HUM 5,B07,423362,Patterson; Patrick H.,29,0,30,1
1708257766953,HUM 5,B08,423363,Patterson; Patrick H.,29,0,30,1
1708257766953,HUM 5,C01,423365,Caldwell; Michael Alan,22,0,30,8
1708257766953,HUM 5,C02,423474,Caldwell; Michael Alan,24,0,30,6
1708257766953,HUM 5,C03,423528,Caldwell; Michael Alan,30,0,30,0
1708257766953,HUM 5,C04,423529,Caldwell; Michael Alan,27,0,30,3
1708257766953,HUM 5,C05,423545,Caldwell; Michael Alan,30,0,30,0
1708257766953,HUM 5,C06,423546,Caldwell; Michael Alan,30,0,30,0
1708257766953,HUM 5,C07,423547,Caldwell; Michael Alan,29,0,30,1
1708257766953,HUM 5,C08,423548,Caldwell; Michael Alan,28,0,30,2
1708257767483,INTL 101,A01,404350,Day; Joel Keith,23,0,25,2
1708257767483,INTL 101,A02,404356,Day; Joel Keith,25,0,25,0
1708257767483,INTL 101,A03,404357,Day; Joel Keith,24,0,25,1
1708257767483,INTL 101,A04,404360,Day; Joel Keith,25,0,25,0
1708257768013,INTL 102,A01,404375,Fisk; David Lee,25,0,25,0
1708257768013,INTL 102,A02,404376,Fisk; David Lee,22,0,25,3
1708257768013,INTL 102,A03,404377,Fisk; David Lee,20,0,25,5
1708257768013,INTL 102,A04,404381,Fisk; David Lee,25,0,25,0
1708257768541,INTL 190,A00,404396,Samphantharak; Krislert,24,0,25,1
1708257768541,INTL 190,B00,404402,McIntosh; Justin Daniel,24,0,25,1
1708257768541,INTL 190,C00,404403,Vos; Stacie N.,24,0,25,1
1708257768541,INTL 190,D00,404404,Nadkarni; Vidya,24,0,25,1
1708257768541,INTL 190,E00,404407,Scott; Jeffrey F,25,0,25,0
1708257768541,INTL 190,F00,404409,Auerbach; Bradford C,25,0,25,0
1708257768541,INTL 190,G00,404442,Auerbach; Bradford C,25,0,25,0
1708257768541,INTL 190,H00,404465,Segui; Alan S,25,0,25,0
1708257768541,INTL 190,I00,404481,Segui; Alan S,25,0,25,0
1708257769088,JAPN 10C,A01,403881,Iwamoto; Naoki,15,0,15,0
1708257769088,JAPN 10C,B01,403884,McKee; Mayumi Mochizuki,15,0,15,0
1708257769088,JAPN 10C,C01,403887,Sato; Kyoko,10,0,10,0
1708257769088,JAPN 10C,C02,403888,Sato; Kyoko,10,0,10,0
1708257769088,JAPN 10C,D01,403890,Inada; Minori,8,0,10,2
1708257769088,JAPN 10C,D02,403891,Inada; Minori,10,0,10,0
1708257769088,JAPN 10C,E01,403893,Sato; Kyoko,10,0,10,0
1708257769088,JAPN 10C,E02,403894,Sato; Kyoko,10,0,10,0
1708257769088,JAPN 10C,F01,403896,McKee; Mayumi Mochizuki,10,0,10,0
1708257769088,JAPN 10C,F02,403897,McKee; Mayumi Mochizuki,10,0,10,0
1708257769088,JAPN 10C,G01,403899,Homma; Kunihiko,10,0,10,0
1708257769088,JAPN 10C,G02,403900,Homma; Kunihiko,10,0,10,0
1708257769088,JAPN 10C,H01,403902,Maruyama; Rie,10,0,10,0
1708257769088,JAPN 10C,H02,403903,Maruyama; Rie,9,0,10,1
1708257769088,JAPN 10C,I01,403905,Inada; Minori,10,0,10,0
1708257769088,JAPN 10C,I02,403906,Inada; Minori,9,0,10,1
1708257769088,JAPN 10C,J01,403915,Iwamoto; Naoki,10,0,10,0
1708257769088,JAPN 10C,J02,403916,Iwamoto; Naoki,9,0,10,1
1708257769088,JAPN 10C,K01,403918,Ross; Kayoko F,10,0,10,0
1708257769088,JAPN 10C,K02,403928,Ross; Kayoko F,10,0,10,0
1708257769088,JAPN 10C,L01,403935,Homma; Kunihiko,9,0,10,1
1708257769088,JAPN 10C,L02,403936,Homma; Kunihiko,10,0,10,0
1708257769088,JAPN 10C,M02,403939,Kamioka; Sachiko,13,0,15,2
1708257769088,JAPN 10C,N01,479041,Iwamoto; Naoki,15,0,15,0
1708257769618,JAPN 10CR,A01,403982,Inada; Minori,12,0,12,0
1708257769618,JAPN 10CR,A02,403983,Inada; Minori,12,0,12,0
1708257770164,JAPN 20C,A01,403988,Homma; Kunihiko,10,0,12,2
1708257770164,JAPN 20C,B02,404029,Kamioka; Sachiko,10,0,12,2
1708257770164,JAPN 20C,C01,404033,Takeda; Izumi,8,0,12,4
1708257770164,JAPN 20C,D02,404114,Kamioka; Sachiko,11,0,12,1
1708257770164,JAPN 20C,E01,404135,Simpson; Junko Tokuda,12,0,12,0
1708257770706,JAPN 130C,A01,404144,Maruyama; Rie,9,0,9,0
1708257770706,JAPN 130C,A02,404145,Maruyama; Rie,9,0,9,0
1708257770706,JAPN 130C,B01,404147,Simpson; Junko Tokuda,8,0,9,1
1708257770706,JAPN 130C,B02,404148,Simpson; Junko Tokuda,9,0,9,0
1708257771235,JAPN 135C,A00,404176,Ross; Kayoko F,16,0,16,0
1708257771235,JAPN 135C,B00,404253,Takeda; Izumi,14,0,16,2
1708257771762,JAPN 140C,A00,404255,Sato; Kyoko,18,0,20,2
1708257772292,JAPN 150C,A00,404258,McKee; Mayumi Mochizuki,14,0,14,0
1708257772817,JAPN 190,A00,404260,Miyao; Daisuke,17,0,20,3
1708257773346,JAPN 196B,001,487237,Turner; Christena L.,9999,0,9999,0
1708257773871,JWSP 3,A01,404485,Shuster; Alana,20,0,20,0
1708257774415,LATI 10,A01,405201,Kennemore; Amy Michelle,27,0,30,3
1708257774415,LATI 10,A02,405202,Kennemore; Amy Michelle,27,0,30,3
1708257774415,LATI 10,A03,405208,Kennemore; Amy Michelle,28,0,30,2
1708257774941,LATI 50,A01,405214,Kokinis; Troy Andreas,34,0,35,1
1708257774941,LATI 50,A02,405215,Kokinis; Troy Andreas,34,0,35,1
1708257775467,LATI 130,A01,482880,Alvarez; Camila Huerta,29,0,30,1
1708257775995,LATI 160,A01,477482,Kokinis; Troy Andreas,30,0,30,0
1708257776521,LATI 180,A00,405221,Kennemore; Amy Michelle,28,0,30,2
1708257776521,LATI 180,B00,405222,Mostajo; Lorena,30,0,30,0
1708257777047,LIAB 1C,A00,405278,Saab; Dima,13,0,14,1
1708257777047,LIAB 1C,B00,405279,Saab; Dima,11,0,14,3
1708257777593,LIAB 1CX,A00,405281,Akjeje; Abdelhak,19,0,20,1
1708257777593,LIAB 1CX,B00,405291,Akjeje; Abdelhak,20,0,20,0
1708257778122,LIAB 1F,A00,482814,El Cheddadi; Youniss,14,0,14,0
1708257778679,LIDS 19,001,492979,Goodall; Grant Todd,9999,0,9999,0
1708257778679,LIDS 19,002,492980,Goodall; Grant Todd,9999,0,9999,0
1708257778679,LIDS 19,003,492981,Goodall; Grant Todd,9999,0,9999,0
1708257778679,LIDS 19,004,492982,Goodall; Grant Todd,9999,0,9999,0
1708257778679,LIDS 19,005,492983,Goodall; Grant Todd,9999,0,9999,0
1708257778679,LIDS 19,006,492984,Goodall; Grant Todd,9999,0,9999,0
1708257778679,LIDS 19,007,492985,Goodall; Grant Todd,9999,0,9999,0
1708257778679,LIDS 19,008,492986,Goodall; Grant Todd,9999,0,9999,0
1708257778679,LIDS 19,009,492987,Goodall; Grant Todd,9999,0,9999,0
1708257778679,LIDS 19,010,492988,Goodall; Grant Todd,9999,0,9999,0
1708257778679,LIDS 19,011,492989,Goodall; Grant Todd,9999,0,9999,0
1708257778679,LIDS 19,012,492990,Goodall; Grant Todd,9999,0,9999,0
1708257779206,LIFR 1A,A00,405299,Van Moer; Vinciane G,13,0,14,1
1708257779206,LIFR 1A,B00,405300,Van Moer; Vinciane G,13,0,14,1
1708257779206,LIFR 1A,C00,405301,Van Moer; Vinciane G,13,0,14,1
1708257779206,LIFR 1A,D00,405307,Van Moer; Vinciane G,14,0,14,0
1708257780750,LIFR 1AX,A00,405308,Van Moer; Vinciane G,27,0,28,1
1708257780750,LIFR 1AX,B00,405309,Van Moer; Vinciane G,27,0,28,1
1708257781292,LIFR 1C,A00,405310,Van Moer; Vinciane G,14,0,14,0
1708257781292,LIFR 1C,B00,405311,Van Moer; Vinciane G,12,0,14,2
1708257781292,LIFR 1C,C00,405325,Van Moer; Vinciane G,13,0,14,1
1708257781292,LIFR 1C,D00,405326,Van Moer; Vinciane G,11,0,14,3
1708257781821,LIFR 1CX,A00,405332,Van Moer; Vinciane G,25,0,28,3
1708257781821,LIFR 1CX,B00,405333,Van Moer; Vinciane G,27,0,28,1
1708257782346,LIFR 1D,A00,405334,Van Moer; Vinciane G,13,0,14,1
1708257782346,LIFR 1D,B00,405335,Van Moer; Vinciane G,13,0,14,1
1708257782346,LIFR 1D,C00,405336,Van Moer; Vinciane G,13,0,14,1
1708257782346,LIFR 1D,D00,405337,Van Moer; Vinciane G,13,0,14,1
1708257782888,LIFR 1DX,A00,405338,Van Moer; Vinciane G,25,0,28,3
1708257782888,LIFR 1DX,B00,405394,Van Moer; Vinciane G,27,0,28,1
1708257783414,LIFR 11,001,405395,Goodall; Grant Todd,999,0,999,0
1708257783944,LIGM 1C,A00,405398,Fischer-Grunski; Eva K,12,0,14,2
1708257783944,LIGM 1C,B00,405400,Fischer-Grunski; Eva K,13,0,14,1
1708257783944,LIGM 1C,C00,405403,Fischer-Grunski; Eva K,13,0,14,1
1708257783944,LIGM 1C,D00,405404,Fischer-Grunski; Eva K,13,0,14,1
1708257784470,LIGM 1CX,A00,405407,Fischer-Grunski; Eva K,27,0,28,1
1708257784470,LIGM 1CX,B00,405408,Fischer-Grunski; Eva K,26,0,28,2
1708257784996,LIGM 11,001,405464,Goodall; Grant Todd,999,0,999,0
1708257785523,LIGN 8,A00,411133,McIntosh; Justin Daniel,232,0,240,8
1708257786069,LIGN 17,A00,411141,Kehler; Andrew Scott,287,0,300,13
1708257786609,LIGN 101,A01,411144,Staff,28,0,30,2
1708257786609,LIGN 101,A02,411147,Staff,29,0,30,1
1708257786609,LIGN 101,A03,411154,Staff,27,0,30,3
1708257786609,LIGN 101,A04,411163,Staff,29,0,30,1
1708257787141,LIGN 120,A01,411165,Ackerman; Farrell,28,0,30,2
1708257787141,LIGN 120,A02,411177,Ackerman; Farrell,23,0,27,4
1708257787667,LIGN 130,A01,411223,Staff,29,0,30,1
1708257787667,LIGN 130,A02,411231,Staff,30,0,30,0
1708257787667,LIGN 130,A03,411232,Staff,29,0,30,1
1708257788194,LIGN 141,A00,411276,Rose; Sharon,37,0,40,3
1708257788720,LIGN 144,A00,411277,Lott; Margaret S.,22,0,24,2
1708257789260,LIGN 148,A00,411278,Mayberry; Rachel,71,0,75,4
1708257789790,LIGN 165,A00,411279,Bergen; Leon,41,0,70,29
1708257790319,LIGN 168,A01,411281,Styler; William Francis,65,0,70,5
1708257790850,LIGN 175,A00,482816,Rodriguez Aispuro; Alejandro,35,0,40,5
1708257791379,LIGN 230,A00,411293,Caponigro; Ivano,19,0,20,1
1708257791907,LIGN 238,A00,411308,Bergen; Benjamin,20,0,20,0
1708257792431,LIGN 252,A00,411309,Bergen; Leon,28,0,30,2
1708257792958,LIGN 256,A00,411310,Nakashole; Ndapandula,0,0,5,5
1708257793484,LIGN 272,A00,482887,Kluender; Robert,10,0,10,0
1708257794013,LIHL 112P,A00,405228,Pagkalinawan; Leticia Cant,27,0,28,1
1708257794539,LIHL 114P,A00,405229,Nguyen; Hoan Thi,26,0,28,2
1708257795065,LIHL 117P,A00,405256,Sadegholvad; Elham,27,0,28,1
1708257795595,LIHL 118,A00,405257,Chen; Areana Yen,28,0,28,0
1708257796121,LIHL 124P,A00,405262,Nguyen; Hoan Thi,28,0,28,0
1708257796650,LIHL 132P,A00,405263,Pagkalinawan; Leticia Cant,28,0,28,0
1708257797178,LIHL 134P,A00,405269,Nguyen; Hoan Thi,28,0,28,0
1708257797708,LIHL 138,A00,405270,Chen; Areana Yen,27,0,28,1
1708257798243,LIIT 1C,A00,405465,Carnelos; Chiara,12,0,14,2
1708257798243,LIIT 1C,B00,405466,Carnelos; Chiara,14,0,14,0
1708257798768,LIIT 1CX,A00,405594,Carnelos; Chiara,28,0,28,0
1708257799295,LIPO 1C,A00,405595,Paladini; Denise,13,0,14,1
1708257799295,LIPO 1C,B00,405596,Paladini; Denise,14,0,14,0
1708257799845,LIPO 1CX,A00,405597,De Abreu; Cassia,28,0,28,0
1708257800375,LISL 1A,C00,405600,Lott; Margaret S.,13,0,14,1
1708257800375,LISL 1A,D00,405601,Lott; Margaret S.,10,0,14,4
1708257800375,LISL 1A,E00,405602,Lott; Margaret S.,13,0,14,1
1708257800375,LISL 1A,F00,405603,Lott; Margaret S.,13,0,14,1
1708257800901,LISL 1AR,A00,480605,Lott; Margaret S.,13,0,15,2
1708257800901,LISL 1AR,B00,480606,Lott; Margaret S.,14,0,15,1
1708257801424,LISL 1AX,A00,405754,Lott; Margaret S.,26,0,28,2
1708257801424,LISL 1AX,B00,405755,Lott; Margaret S.,23,0,28,5
1708257801953,LISL 1C,A00,405776,Lott; Margaret S.,13,0,14,1
1708257801953,LISL 1C,B00,405779,Lott; Margaret S.,14,0,14,0
1708257801953,LISL 1C,C00,405785,Lott; Margaret S.,14,0,14,0
1708257801953,LISL 1C,D00,405787,Lott; Margaret S.,9,0,14,5
1708257801953,LISL 1C,E00,405827,Lott; Margaret S.,12,0,14,2
1708257801953,LISL 1C,F00,405830,Lott; Margaret S.,13,0,14,1
1708257802484,LISL 1CX,A00,405844,Lott; Margaret S.,25,0,28,3
1708257802484,LISL 1CX,B00,405848,Lott; Margaret S.,25,0,28,3
1708257802484,LISL 1CX,C00,405849,Lott; Margaret S.,28,0,28,0
1708257803010,LISL 1D,A00,405850,Lott; Margaret S.,8,0,14,6
1708257803010,LISL 1D,B00,405851,Lott; Margaret S.,13,0,14,1
1708257803010,LISL 1D,C00,405852,Lott; Margaret S.,10,0,14,4
1708257803550,LISL 1DX,A00,405854,Lott; Margaret S.,17,0,22,5
1708257803550,LISL 1DX,B00,405855,Lott; Margaret S.,18,0,22,4
1708257804077,LISP 1A,001,405856,Munoz Sanchez; Alicia,11,0,14,3
1708257804077,LISP 1A,002,405857,Munoz Sanchez; Alicia,13,0,14,1
1708257804077,LISP 1A,003,405858,Munoz Sanchez; Alicia,14,0,14,0
1708257804077,LISP 1A,004,405861,Munoz Sanchez; Alicia,14,0,14,0
1708257804658,LISP 1AX,001,405862,Munoz Sanchez; Alicia,28,0,28,0
1708257804658,LISP 1AX,002,405863,Munoz Sanchez; Alicia,25,0,28,3
1708257805190,LISP 1C,001,405864,Munoz Sanchez; Alicia,13,0,14,1
1708257805190,LISP 1C,002,405865,Munoz Sanchez; Alicia,12,0,14,2
1708257805190,LISP 1C,003,405879,Munoz Sanchez; Alicia,12,0,14,2
1708257805190,LISP 1C,004,405880,Munoz Sanchez; Alicia,13,0,14,1
1708257805190,LISP 1C,005,405881,Munoz Sanchez; Alicia,12,0,14,2
1708257805190,LISP 1C,006,405882,Munoz Sanchez; Alicia,12,0,14,2
1708257805190,LISP 1C,007,405904,Munoz Sanchez; Alicia,14,0,14,0
1708257805190,LISP 1C,008,405905,Munoz Sanchez; Alicia,14,0,14,0
1708257805190,LISP 1C,009,405908,Munoz Sanchez; Alicia,14,0,14,0
1708257805190,LISP 1C,010,405917,Munoz Sanchez; Alicia,13,0,14,1
1708257805715,LISP 1CX,001,405922,Munoz Sanchez; Alicia,24,0,28,4
1708257805715,LISP 1CX,002,405990,Munoz Sanchez; Alicia,26,0,28,2
1708257805715,LISP 1CX,003,406007,Munoz Sanchez; Alicia,27,0,28,1
1708257805715,LISP 1CX,004,406008,Munoz Sanchez; Alicia,25,0,28,3
1708257805715,LISP 1CX,005,406015,Munoz Sanchez; Alicia,26,0,28,2
1708257806270,LISP 1D,001,406016,Munoz Sanchez; Alicia,12,0,14,2
1708257806270,LISP 1D,002,406017,Munoz Sanchez; Alicia,13,0,14,1
1708257806270,LISP 1D,003,406018,Munoz Sanchez; Alicia,14,0,14,0
1708257806270,LISP 1D,004,406019,Munoz Sanchez; Alicia,11,0,14,3
1708257806270,LISP 1D,005,406020,Munoz Sanchez; Alicia,13,0,14,1
1708257806270,LISP 1D,006,406021,Munoz Sanchez; Alicia,10,0,14,4
1708257806270,LISP 1D,007,406022,Munoz Sanchez; Alicia,12,0,14,2
1708257806270,LISP 1D,008,406023,Munoz Sanchez; Alicia,13,0,14,1
1708257806270,LISP 1D,009,406024,Munoz Sanchez; Alicia,11,0,14,3
1708257806270,LISP 1D,010,406025,Munoz Sanchez; Alicia,12,0,14,2
1708257806270,LISP 1D,011,406026,Munoz Sanchez; Alicia,13,0,14,1
1708257806270,LISP 1D,012,406027,Munoz Sanchez; Alicia,13,0,14,1
1708257806270,LISP 1D,013,406028,Munoz Sanchez; Alicia,12,0,14,2
1708257806270,LISP 1D,014,406029,Munoz Sanchez; Alicia,12,0,14,2
1708257806270,LISP 1D,015,406030,Munoz Sanchez; Alicia,10,0,14,4
1708257806270,LISP 1D,016,406031,Munoz Sanchez; Alicia,14,0,14,0
1708257806270,LISP 1D,017,406032,Munoz Sanchez; Alicia,14,0,14,0
1708257806270,LISP 1D,018,406033,Munoz Sanchez; Alicia,12,0,14,2
1708257806270,LISP 1D,019,406034,Munoz Sanchez; Alicia,13,0,14,1
1708257806270,LISP 1D,020,406035,Munoz Sanchez; Alicia,14,0,14,0
1708257806270,LISP 1D,021,406036,Munoz Sanchez; Alicia,13,0,14,1
1708257806270,LISP 1D,022,406037,Munoz Sanchez; Alicia,14,0,14,0
1708257806270,LISP 1D,023,406038,Munoz Sanchez; Alicia,14,0,14,0
1708257806270,LISP 1D,024,406039,Munoz Sanchez; Alicia,13,0,14,1
1708257806808,LISP 1DX,001,406040,Munoz Sanchez; Alicia,28,0,28,0
1708257806808,LISP 1DX,002,406041,Munoz Sanchez; Alicia,27,0,28,1
1708257806808,LISP 1DX,003,406127,Munoz Sanchez; Alicia,24,0,28,4
1708257806808,LISP 1DX,004,406128,Munoz Sanchez; Alicia,17,0,28,11
1708257806808,LISP 1DX,005,406418,Munoz Sanchez; Alicia,24,0,28,4
1708257806808,LISP 1DX,006,406536,Munoz Sanchez; Alicia,27,0,28,1
1708257806808,LISP 1DX,007,406561,Munoz Sanchez; Alicia,23,0,28,5
1708257806808,LISP 1DX,008,406576,Munoz Sanchez; Alicia,25,0,28,3
1708257806808,LISP 1DX,009,406679,Munoz Sanchez; Alicia,28,0,28,0
1708257806808,LISP 1DX,010,406691,Munoz Sanchez; Alicia,26,0,28,2
1708257806808,LISP 1DX,011,406692,Munoz Sanchez; Alicia,28,0,28,0
1708257806808,LISP 1DX,012,406693,Munoz Sanchez; Alicia,28,0,28,0
1708257807336,LISP 17,001,406694,Munoz Sanchez; Alicia,18,0,20,2
1708257807861,LISP 18,001,406695,Munoz Sanchez; Alicia,20,0,20,0
1708257808389,LTAM 105,A00,412520,Ruiz; Ariana,28,0,40,12
1708257808919,LTCH 101,A00,479214,Zhu; Ping,39,0,40,1
1708257809444,LTCS 87,A00,492906,Nguyen; Hoang Tan,20,0,20,0
1708257809444,LTCS 87,B00,492907,Nguyen; Hoang Tan,20,0,20,0
1708257809972,LTCS 150,A00,412543,Liao; Ping H,39,0,40,1
1708257810497,LTCS 225,A00,412819,Mendoza; Andrea,14,0,15,1
1708257811024,LTCS 250,A00,412821,Lee; Jin-Kyung,15,0,15,0
1708257811552,LTEA 110B,A00,412548,Liao; Ping H,60,0,60,0
1708257812081,LTEA 120A,A00,479216,Zhu; Ping,36,0,40,4
1708257812607,LTEA 120C,A00,412552,Fiss; Geraldine Anna,295,0,300,5
1708257813137,LTEA 132,A00,412561,Mendoza; Andrea,51,0,60,9
1708257813662,LTEA 141,A00,412565,Lee; Jin-Kyung,37,0,40,3
1708257814193,LTEN 23,A01,411317,Vijay; Ameeth Varma,24,0,25,1
1708257814193,LTEN 23,A02,411318,Vijay; Ameeth Varma,24,0,25,1
1708257814193,LTEN 23,A03,411371,Vijay; Ameeth Varma,25,0,25,0
1708257814193,LTEN 23,A04,411375,Vijay; Ameeth Varma,24,0,25,1
1708257814736,LTEN 28,A01,411632,Blanco; John D,25,0,25,0
1708257814736,LTEN 28,A02,411697,Blanco; John D,25,0,25,0
1708257814736,LTEN 28,A03,411698,Blanco; John D,25,0,25,0
1708257814736,LTEN 28,A04,411709,Blanco; John D,25,0,25,0
1708257814736,LTEN 28,A05,411719,Blanco; John D,25,0,25,0
1708257814736,LTEN 28,A06,411744,Blanco; John D,25,0,25,0
1708257814736,LTEN 28,A07,411780,Blanco; John D,25,0,25,0
1708257814736,LTEN 28,A08,411820,Blanco; John D,25,0,25,0
1708257815263,LTEN 110,A00,486891,Vitkus; Daniel J.,38,0,40,2
1708257815807,LTEN 144,A00,412570,Vijay; Ameeth Varma,39,0,40,1
1708257816332,LTEN 180,A00,412581,Perreira; Christopher Michael,18,0,25,7
1708257816862,LTEN 181,A00,412582,Mukherjee; Silpa,55,0,60,5
1708257817391,LTEN 245,A00,412824,Johnson; Sara E.,13,0,15,2
1708257817918,LTEN 259,A00,412825,Streeby; Shelley,13,0,15,2
1708257818447,LTEU 111,A00,412588,Kontje; Todd Curtis,38,0,40,2
1708257818974,LTEU 140,A00,480172,De Marchi Gherini; Adriana,36,0,37,1
1708257819503,LTEU 141,A00,412592,Cohen; Alain J. J.,40,0,40,0
1708257820034,LTFR 2A,A01,411996,Ploye; Catherine,25,0,25,0
1708257820560,LTFR 2C,A00,411997,Ploye; Catherine,24,0,25,1
1708257821085,LTFR 142,A00,412597,Zhiri; Oumelbanine,20,0,20,0
1708257821617,LTGK 3,A00,412001,Murray; Kourtney Kristine,30,0,30,0
1708257822159,LTGM 2C,A00,412002,Fischer-Grunski; Eva K,25,0,25,0
1708257822706,LTKO 1C,A01,412029,Cho; Hye Jin,24,0,25,1
1708257822706,LTKO 1C,B01,412164,Cho; Hye Jin,23,0,25,2
1708257822706,LTKO 1C,C01,412168,Cho; Hye Jin,25,0,25,0
1708257822706,LTKO 1C,D01,412353,Yim; Nancy,24,0,25,1
1708257822706,LTKO 1C,E01,412372,Yim; Nancy,25,0,25,0
1708257823247,LTKO 2C,A01,412374,Yim; Nancy,21,0,25,4
1708257823773,LTKO 130P,A00,412601,Lee; Jeyseon,25,0,25,0
1708257824301,LTKO 135,A00,412606,Lee; Jeyseon,25,0,25,0
1708257824829,LTLA 3,A00,412375,Murray; Kourtney Kristine,36,0,40,4
1708257825357,LTRU 1C,A01,412491,Wells; Patricia Rebecca,24,0,25,1
1708257825884,LTRU 104A,A01,412614,Wells; Patricia Rebecca,20,0,20,0
1708257826414,LTSP 2A,A01,412493,Lampell; Toni,24,0,25,1
1708257826941,LTSP 2B,A01,412497,Lampell; Toni,22,0,25,3
1708257826941,LTSP 2B,B01,479218,Lampell; Toni,24,0,25,1
1708257827472,LTSP 2C,A01,412499,Mastromartino; Alexandra L,23,0,25,2
1708257827999,LTSP 2D,A00,412500,Dominguez; Noelia,24,0,25,1
1708257828528,LTSP 2E,A00,412501,Mastromartino; Alexandra L,24,0,25,1
1708257828528,LTSP 2E,B00,412502,Mastromartino; Alexandra L,25,0,25,0
1708257829054,LTSP 87,A00,479212,Bessett; Ryan Matthew,20,0,20,0
1708257829595,LTSP 100B,A00,412619,Dominguez; Noelia,25,0,25,0
1708257829595,LTSP 100B,B00,412623,Dominguez; Noelia,24,0,25,1
1708257830121,LTSP 116,A00,412628,Blanco; John D,28,0,30,2
1708257831664,LTSP 135A,A00,412631,Parra; Max,27,0,30,3
1708257832192,LTSP 174,A00,479213,Staff,28,0,30,2
1708257832719,LTTH 115,A00,412632,Kontje; Todd Curtis,35,0,40,5
1708257833246,LTTH 210C,A00,412826,Batarseh; Amanda Alicia,14,0,15,1
1708257833776,LTTH 255,A00,412827,Ali; Mohammad Kazim,13,0,15,2
1708257834301,LTTH 260,A00,412828,Kim; Joo Ok,30,0,30,0
1708257834827,LTWL 19C,A00,412503,Kelting; Edward William,40,0,40,0
1708257835357,LTWL 101,A00,412633,Kelting; Edward William,39,0,40,1
1708257835886,LTWL 114,A00,412656,Fiss; Geraldine Anna,60,0,60,0
1708257836411,LTWL 123,A00,412674,Lampert-Weissig; Lisa,31,0,40,9
1708257836941,LTWL 172,A00,412729,De Marchi Gherini; Adriana,37,0,40,3
1708257837470,LTWL 183,A00,412731,Cohen; Alain J. J.,38,0,40,2
1708257837996,LTWL 184,A00,479219,Mukherjee; Silpa,38,0,40,2
1708257838525,LTWL 194A,A00,489635,Vijay; Ameeth Varma,27,0,31,4
1708257839052,LTWR 8A,A01,412505,Springer; Anna Joy,24,0,25,1
1708257839052,LTWR 8A,A02,412506,Springer; Anna Joy,24,0,25,1
1708257839052,LTWR 8A,A03,412507,Springer; Anna Joy,25,0,25,0
1708257839052,LTWR 8A,A04,412508,Springer; Anna Joy,23,0,25,2
1708257839579,LTWR 8C,A01,412511,Forbes; Camille,23,0,25,2
1708257839579,LTWR 8C,A02,412512,Forbes; Camille,25,0,25,0
1708257839579,LTWR 8C,A03,412514,Forbes; Camille,25,0,25,0
1708257839579,LTWR 8C,A04,412519,Forbes; Camille,24,0,25,1
1708257840104,LTWR 100,A00,412734,Forbes; Camille,7,0,15,8
1708257840635,LTWR 113,A00,412816,Carroll; Amy Sara,28,0,30,2
1708257841162,LTWR 114,A00,412817,Springer; Anna Joy,23,0,30,7
1708257841691,LTWR 126,A00,412818,Hoang; Lily Kim,25,0,30,5
1708257842216,LTWR 215,A00,412880,Carroll; Amy Sara,19,0,20,1
1708257842776,MAE 3,A01,435606,Qi; Huihui,16,0,20,4
1708257842776,MAE 3,A02,435607,Qi; Huihui,15,0,20,5
1708257842776,MAE 3,A03,435608,Qi; Huihui,19,0,20,1
1708257842776,MAE 3,B01,435618,Delson; Nathan Joseph & Mullin; Jennifer S,20,0,20,0
1708257842776,MAE 3,B02,435626,Delson; Nathan Joseph & Mullin; Jennifer S,20,0,20,0
1708257842776,MAE 3,B03,435666,Delson; Nathan Joseph & Mullin; Jennifer S,20,0,20,0
1708257842776,MAE 3,B04,435679,Delson; Nathan Joseph & Mullin; Jennifer S,20,0,20,0
1708257842776,MAE 3,B05,494545,Delson; Nathan Joseph & Mullin; Jennifer S,20,0,20,0
1708257843307,MAE 8,A01,435688,Pham; Hieu Tan,197,0,200,3
1708257843832,MAE 30B,A00,435689,Lubarda; Marko,128,0,130,2
1708257843832,MAE 30B,B00,435701,Ghazinejad; Maziar,117,0,130,13
1708257844360,MAE 101B,A00,435702,Saintillan; David,146,0,150,4
1708257844360,MAE 101B,B00,435703,Nomura; Keiko K.,138,0,146,8
1708257844886,MAE 101C,A00,435704,Sadeghizadeh; Zahra,53,0,65,12
1708257845417,MAE 101D,A00,435705,Chen; Renkun,14,0,20,6
1708257845943,MAE 105,A00,435706,Becker; Janet Maria,115,0,120,5
1708257846475,MAE 107,A00,435707,Lindsey; Stephanie,48,0,50,2
1708257846475,MAE 107,B00,435708,Davidson; Michael R,55,0,60,5
1708257847002,MAE 119,A00,435710,Hidalgo-Gonzalez; Patricia,100,0,120,20
1708257847528,MAE 120,A00,435722,Arefiev; Alexey,49,0,65,16
1708257848057,MAE 125,A00,435723,Kleissl; Jan,60,0,65,5
1708257848584,MAE 131A,A00,435724,Qi; Huihui,119,0,125,6
1708257848584,MAE 131A,B00,435725,Meyers; Marc,123,0,125,2
1708257849115,MAE 143B,A00,435726,Morimoto; Tania,114,0,120,6
1708257849115,MAE 143B,B00,435727,Herbert; Sylvia Lee,117,0,120,3
1708257849115,MAE 143B,C00,435728,Diagne; Mamadou Lamine,107,0,120,13
1708257849641,MAE 145,A00,435729,Martinez; Sonia,41,0,60,19
1708257850168,MAE 148,A01,492802,Silberman; Jack,14,0,24,10
1708257850695,MAE 150,A00,435730,Pham; Hieu Tan,51,0,60,9
1708257851226,MAE 152,A00,435731,Llewellyn Smith; Stefan G.,14,0,14,0
1708257851226,MAE 152,B00,435747,Llewellyn Smith; Stefan G.,12,0,14,2
1708257851226,MAE 152,C00,435748,Llewellyn Smith; Stefan G.,12,0,14,2
1708257851226,MAE 152,D00,435749,Llewellyn Smith; Stefan G.,8,0,14,6
1708257851226,MAE 152,E00,435750,Llewellyn Smith; Stefan G.,13,0,14,1
1708257851758,MAE 155B,A01,435752,Hwang; John T,36,0,50,14
1708257851758,MAE 155B,B01,435768,Anderson; Mark Ronald,27,0,50,23
1708257851758,MAE 155B,C01,494006,Saha; Abhishek,0,0,0,0
1708257852286,MAE 156B,A01,435770,Tustaniwskyj; Jerry I,32,0,40,8
1708257852286,MAE 156B,B01,435772,Ghazinejad; Maziar,35,0,40,5
1708257852286,MAE 156B,C01,435774,Delson; Nathan Joseph,38,0,40,2
1708257852286,MAE 156B,D01,435776,Saha; Abhishek,31,0,40,9
1708257852819,MAE 166,A00,435777,Fullerton; Eric E,44,0,50,6
1708257853347,MAE 170,A01,435779,Lubarda; Marko,30,0,32,2
1708257853347,MAE 170,A02,435780,Lubarda; Marko,27,0,32,5
1708257853347,MAE 170,A03,435781,Lubarda; Marko,32,0,32,0
1708257853347,MAE 170,A04,435782,Lubarda; Marko,31,0,32,1
1708257853347,MAE 170,A05,435783,Lubarda; Marko,29,0,32,3
1708257853347,MAE 170,A06,435784,Lubarda; Marko,30,0,32,2
1708257853347,MAE 170,B01,435786,Evdokimenko; Ekaterina,23,0,24,1
1708257853347,MAE 170,B02,435787,Evdokimenko; Ekaterina,20,0,24,4
1708257853347,MAE 170,B03,435788,Evdokimenko; Ekaterina,23,0,24,1
1708257853347,MAE 170,B04,435789,Evdokimenko; Ekaterina,23,0,24,1
1708257853347,MAE 170,B05,435790,Evdokimenko; Ekaterina,19,0,24,5
1708257853347,MAE 170,B06,435791,Evdokimenko; Ekaterina,23,0,24,1
1708257853890,MAE 180,A00,479477,Sadeghizadeh; Zahra,55,0,60,5
1708257854419,MAE 184,A00,435792,Anderson; Mark Ronald,6,0,50,44
1708257854947,MAE 190,A00,435793,Beg; Farhat N.,17,0,20,3
1708257854947,MAE 190,B00,479209,Gerardo; Hortense Flotilde,12,0,15,3
1708257855473,MAE 202,A00,435794,Bandaru; Prabhakar,32,0,70,38
1708257856007,MAE 205,A00,435804,Hwang; John T & Tynan; George Robert & Seshadri; Kalyanasundaram & Rangamani; Padmini & Bandaru; Prabhakar,9990,0,9999,9
1708257856534,MAE 207,A00,435805,Beg; Farhat N.,9,0,10,1
1708257856534,MAE 207,B00,435815,Campbell; Edward Michael,6,0,10,4
1708257856534,MAE 207,C00,477499,Gerardo; Hortense Flotilde,6,0,30,24
1708257857060,MAE 209,A00,435816,Scholtes Acevedo; Claire,25,0,30,5
1708257857591,MAE 210C,A00,435817,Becker; Janet Maria,22,0,30,8
1708257858116,MAE 211,A00,435818,Seshadri; Kalyanasundaram,20,0,30,10
1708257858645,MAE 214A,A00,435819,Sarkar; Sutanu,27,0,35,8
1708257860239,MAE 217C,A00,435820,Marinoni; Alessandro,10,0,10,0
1708257860766,MAE 221C,A00,435821,Seshadri; Kalyanasundaram,9,0,15,6
1708257861291,MAE 221D,A00,435822,Poulikakos; Lisa Voula,23,0,30,7
1708257861819,MAE 224A,A00,435823,Pawlak; Geno Ronald,5,0,10,5
1708257862345,MAE 227,A00,435824,Hidalgo-Gonzalez; Patricia,21,0,35,14
1708257862869,MAE 231A,A00,435825,Boechler; Nicholas Sebastia,14,0,30,16
1708257863400,MAE 240,A00,435826,Rosengren; Aaron,19,0,30,11
1708257863928,MAE 242,A00,435827,Martinez; Sonia,0,0,45,45
1708257864455,MAE 249,A00,435842,Tolley; Michael Thomas,0,0,35,35
1708257864983,MAE 253,A00,435891,Staff,24,0,25,1
1708257865510,MAE 256,A00,435949,Coimbra; Carlos F.,6,0,10,4
1708257866035,MAE 263,A00,435987,Rangamani; Padmini,10,0,10,0
1708257866579,MAE 266,A00,435988,Evdokimenko; Ekaterina,7,0,30,23
1708257867109,MAE 271C,A00,435990,Arzt; Eduard,10,0,10,0
1708257867635,MAE 281B,A00,435991,Cortes; Jorge,9,0,25,16
1708257868164,MAE 288A,A00,435998,McEneaney; William Michael,6,0,40,34
1708257868694,MAE 288B,A00,435999,Bitmead; Robert R.,41,0,45,4
1708257869220,MAE 290C,A00,436008,Schmidt; Oliver,26,0,30,4
1708257869749,MAE 294C,A01,436010,Young; William Roy,19,0,20,1
1708257870274,MATH 2,A01,431271,Staff,31,0,35,4
1708257870274,MATH 2,B01,431273,Staff,29,0,35,6
1708257870274,MATH 2,C01,431275,Staff,31,0,35,4
1708257870801,MATH 3C,A01,431277,Safii; Soheil,12,0,15,3
1708257870801,MATH 3C,A02,431278,Safii; Soheil,12,0,15,3
1708257870801,MATH 3C,A03,431279,Safii; Soheil,12,0,15,3
1708257870801,MATH 3C,A04,431280,Safii; Soheil,15,0,15,0
1708257870801,MATH 3C,A05,431281,Safii; Soheil,14,0,15,1
1708257870801,MATH 3C,A06,431282,Safii; Soheil,15,0,15,0
1708257871336,MATH 10A,A01,431284,Bowers; Adam R.,20,0,30,10
1708257871336,MATH 10A,A02,431285,Bowers; Adam R.,18,0,30,12
1708257871336,MATH 10A,A03,431369,Bowers; Adam R.,28,0,30,2
1708257871336,MATH 10A,A04,431395,Bowers; Adam R.,27,0,30,3
1708257871336,MATH 10A,A05,431450,Bowers; Adam R.,28,0,30,2
1708257871336,MATH 10A,A06,431508,Bowers; Adam R.,30,0,30,0
1708257871336,MATH 10A,B01,431572,Kowalenko; Ethan J,24,0,30,6
1708257871336,MATH 10A,B02,431573,Kowalenko; Ethan J,29,0,30,1
1708257871336,MATH 10A,B03,431574,Kowalenko; Ethan J,30,0,30,0
1708257871336,MATH 10A,B04,431576,Kowalenko; Ethan J,30,0,30,0
1708257871336,MATH 10A,B05,431577,Kowalenko; Ethan J,30,0,30,0
1708257871336,MATH 10A,B06,431583,Kowalenko; Ethan J,30,0,30,0
1708257871896,MATH 10B,A01,431595,Habib; Yousaf,29,0,36,7
1708257871896,MATH 10B,A02,431597,Habib; Yousaf,35,0,36,1
1708257871896,MATH 10B,A03,431669,Habib; Yousaf,37,0,37,0
1708257871896,MATH 10B,A04,431670,Habib; Yousaf,36,0,37,1
1708257871896,MATH 10B,A05,431671,Habib; Yousaf,70,0,70,0
1708257871896,MATH 10B,B01,431673,Habib; Yousaf,25,0,33,8
1708257871896,MATH 10B,B02,431712,Habib; Yousaf,33,0,33,0
1708257871896,MATH 10B,B03,431713,Habib; Yousaf,33,0,33,0
1708257871896,MATH 10B,B04,431714,Habib; Yousaf,33,0,33,0
1708257871896,MATH 10B,B05,431715,Habib; Yousaf,60,0,60,0
1708257871896,MATH 10B,C01,431717,Bach; Quang Tran,57,0,60,3
1708257871896,MATH 10B,C02,431718,Bach; Quang Tran,18,0,34,16
1708257871896,MATH 10B,C03,431719,Bach; Quang Tran,34,0,34,0
1708257871896,MATH 10B,C04,431720,Bach; Quang Tran,33,0,34,1
1708257871896,MATH 10B,C05,431721,Bach; Quang Tran,32,0,34,2
1708257871896,MATH 10B,D01,431723,Staff,28,0,34,6
1708257871896,MATH 10B,D02,431724,Staff,34,0,34,0
1708257871896,MATH 10B,D03,431725,Staff,34,0,34,0
1708257871896,MATH 10B,D04,431726,Staff,34,0,34,0
1708257871896,MATH 10B,D05,431727,Staff,57,0,60,3
1708257872437,MATH 10C,A01,431741,Staff,94,0,96,2
1708257872437,MATH 10C,A02,431742,Staff,39,0,40,1
1708257872437,MATH 10C,B01,431744,Staff,95,0,96,1
1708257872437,MATH 10C,B02,431746,Staff,27,0,40,13
1708257872437,MATH 10C,C01,431748,Pardo Guerra; Sebastian,30,0,40,10
1708257872437,MATH 10C,C02,431885,Pardo Guerra; Sebastian,40,0,40,0
1708257872437,MATH 10C,C03,431895,Pardo Guerra; Sebastian,32,0,33,1
1708257872437,MATH 10C,C04,431896,Pardo Guerra; Sebastian,32,0,32,0
1708257872986,MATH 11,A01,431933,Rava; Denise,82,0,100,18
1708257872986,MATH 11,A02,431960,Rava; Denise,66,0,70,4
1708257872986,MATH 11,A03,431971,Rava; Denise,39,0,40,1
1708257872986,MATH 11,B01,432053,Staff,99,0,100,1
1708257872986,MATH 11,B02,432064,Staff,37,0,45,8
1708257872986,MATH 11,B03,432073,Staff,44,0,45,1
1708257873546,MATH 18,A01,432082,Mackall; Eoin Travis,65,0,70,5
1708257873546,MATH 18,A02,432086,Mackall; Eoin Travis,68,0,70,2
1708257873546,MATH 18,B01,432089,Suk; Andrew Hoon,39,0,40,1
1708257873546,MATH 18,B02,432090,Suk; Andrew Hoon,35,0,40,5
1708257873546,MATH 18,B03,432091,Suk; Andrew Hoon,33,0,40,7
1708257873546,MATH 18,B04,432092,Suk; Andrew Hoon,30,0,40,10
1708257873546,MATH 18,B05,432093,Suk; Andrew Hoon,34,0,35,1
1708257873546,MATH 18,B06,432094,Suk; Andrew Hoon,33,0,35,2
1708257873546,MATH 18,B07,432095,Suk; Andrew Hoon,98,0,100,2
1708257873546,MATH 18,B08,432096,Suk; Andrew Hoon,100,0,100,0
1708257873546,MATH 18,B09,432097,Suk; Andrew Hoon,98,0,100,2
1708257873546,MATH 18,B10,432098,Suk; Andrew Hoon,69,0,70,1
1708257874077,MATH 20A,A01,432101,Briones; Jor-el Thomas Caparas,30,0,40,10
1708257874077,MATH 20A,A02,432102,Briones; Jor-el Thomas Caparas,98,0,100,2
1708257874077,MATH 20A,B01,432104,Briones; Jor-el Thomas Caparas,99,0,100,1
1708257874077,MATH 20A,B02,432105,Briones; Jor-el Thomas Caparas,40,0,40,0
1708257874618,MATH 20B,A01,432107,Quarfoot; David James,33,0,35,2
1708257874618,MATH 20B,A02,432108,Quarfoot; David James,18,0,35,17
1708257874618,MATH 20B,A03,432109,Quarfoot; David James,32,0,35,3
1708257874618,MATH 20B,A04,432110,Quarfoot; David James,34,0,35,1
1708257874618,MATH 20B,A05,432331,Quarfoot; David James,26,0,32,6
1708257874618,MATH 20B,A06,432411,Quarfoot; David James,31,0,32,1
1708257874618,MATH 20B,B01,432413,Mackall; Eoin Travis,62,0,65,3
1708257874618,MATH 20B,B02,432443,Mackall; Eoin Travis,65,0,65,0
1708257874618,MATH 20B,B03,432444,Mackall; Eoin Travis,60,0,60,0
1708257874618,MATH 20B,B04,432471,Mackall; Eoin Travis,60,0,60,0
1708257875186,MATH 20C,A01,432473,Ohm; Ko Woon,26,0,38,12
1708257875186,MATH 20C,A02,432474,Ohm; Ko Woon,36,0,38,2
1708257875186,MATH 20C,A03,432475,Ohm; Ko Woon,34,0,37,3
1708257875186,MATH 20C,A04,432546,Ohm; Ko Woon,36,0,37,1
1708257875186,MATH 20C,A05,432550,Ohm; Ko Woon,88,0,90,2
1708257875186,MATH 20C,B01,432568,Ohm; Ko Woon,43,0,45,2
1708257875186,MATH 20C,B02,432594,Ohm; Ko Woon,40,0,45,5
1708257875186,MATH 20C,B03,432609,Ohm; Ko Woon,85,0,90,5
1708257875186,MATH 20C,C01,432613,Cheng; Hsiao-Bing,67,0,70,3
1708257875186,MATH 20C,C02,432614,Cheng; Hsiao-Bing,68,0,70,2
1708257875186,MATH 20C,C03,432615,Cheng; Hsiao-Bing,70,0,70,0
1708257875186,MATH 20C,D01,432617,Cheng; Hsiao-Bing,69,0,70,1
1708257875186,MATH 20C,D02,432618,Cheng; Hsiao-Bing,68,0,70,2
1708257875186,MATH 20C,D03,432619,Cheng; Hsiao-Bing,70,0,70,0
1708257875730,MATH 20D,A01,432622,Hammock; Frances H,58,0,60,2
1708257875730,MATH 20D,A02,432623,Hammock; Frances H,58,0,60,2
1708257875730,MATH 20D,A03,432658,Hammock; Frances H,35,0,35,0
1708257875730,MATH 20D,A04,432660,Hammock; Frances H,35,0,35,0
1708257875730,MATH 20D,B01,432702,Hammock; Frances H,66,0,70,4
1708257875730,MATH 20D,B02,432703,Hammock; Frances H,70,0,70,0
1708257875730,MATH 20D,B03,432766,Hammock; Frances H,30,0,30,0
1708257875730,MATH 20D,B04,432782,Hammock; Frances H,20,0,30,10
1708257875730,MATH 20D,C01,432811,Sheng; Hongyi,60,0,60,0
1708257875730,MATH 20D,C02,432931,Sheng; Hongyi,60,0,60,0
1708257875730,MATH 20D,C03,432945,Sheng; Hongyi,27,0,30,3
1708257875730,MATH 20D,C04,432949,Sheng; Hongyi,30,0,30,0
1708257876261,MATH 20E,A01,433007,Eggers; John Dietrich,70,0,80,10
1708257876261,MATH 20E,A02,433070,Eggers; John Dietrich,77,0,80,3
1708257876261,MATH 20E,A03,433079,Eggers; John Dietrich,32,0,35,3
1708257876261,MATH 20E,B01,433092,Staff,86,0,90,4
1708257876261,MATH 20E,B02,433093,Staff,90,0,90,0
1708257876261,MATH 20E,C01,433237,Bach; Quang Tran,52,0,60,8
1708257876261,MATH 20E,C02,433238,Bach; Quang Tran,69,0,70,1
1708257876261,MATH 20E,C03,433239,Bach; Quang Tran,70,0,70,0
1708257876794,MATH 31CH,A01,433241,Rabin; Jeffrey Mark,35,0,35,0
1708257877323,MATH 95,A00,433242,Stevens; Laura Jeanne,30,0,30,0
1708257877853,MATH 100C,A01,433244,Pollack; Aaron,31,0,35,4
1708257877853,MATH 100C,A02,433245,Pollack; Aaron,35,0,35,0
1708257878387,MATH 102,A01,433298,Ophir; Amit,29,0,30,1
1708257878387,MATH 102,A02,433369,Ophir; Amit,30,0,30,0
1708257878387,MATH 102,A03,433373,Ophir; Amit,30,0,30,0
1708257878387,MATH 102,A04,433374,Ophir; Amit,29,0,30,1
1708257878387,MATH 102,B01,433572,Zhang; Ming,28,0,30,2
1708257878387,MATH 102,B02,433732,Zhang; Ming,30,0,30,0
1708257878387,MATH 102,B03,433733,Zhang; Ming,30,0,30,0
1708257878387,MATH 102,B04,433734,Zhang; Ming,29,0,30,1
1708257878915,MATH 103B,A01,433793,Lu; Yunze,23,0,30,7
1708257878915,MATH 103B,A02,433795,Lu; Yunze,30,0,30,0
1708257878915,MATH 103B,A03,433830,Lu; Yunze,28,0,30,2
1708257878915,MATH 103B,B01,433845,Lahiri; Aranya,24,0,30,6
1708257878915,MATH 103B,B02,433846,Lahiri; Aranya,28,0,30,2
1708257878915,MATH 103B,B03,433847,Lahiri; Aranya,27,0,30,3
1708257879440,MATH 109,A01,433849,Aycock; Jon Merrill,6,0,10,4
1708257879440,MATH 109,A02,433850,Aycock; Jon Merrill,9,0,10,1
1708257879440,MATH 109,B01,433852,Klevdal; Christian Sleek,10,0,10,0
1708257879440,MATH 109,B02,433859,Klevdal; Christian Sleek,10,0,10,0
1708257879440,MATH 109,C01,433861,Treuer; John N,5,0,10,5
1708257879440,MATH 109,C02,433862,Treuer; John N,10,0,10,0
1708257879440,MATH 109,D01,433864,Treuer; John N,8,0,10,2
1708257879440,MATH 109,D02,433865,Treuer; John N,8,0,10,2
1708257879440,MATH 109,E01,433868,Sheng; Hongyi,10,0,10,0
1708257879440,MATH 109,E02,433869,Sheng; Hongyi,19,0,20,1
1708257879967,MATH 110,A01,433871,Pillai; Mohandas K,24,0,35,11
1708257879967,MATH 110,A02,433872,Pillai; Mohandas K,33,0,35,2
1708257880493,MATH 112B,A01,480683,Komarova; Natalia,27,0,27,0
1708257881040,MATH 120B,A01,433885,Xiao; Ming,32,0,35,3
1708257881040,MATH 120B,A02,433886,Xiao; Ming,34,0,35,1
1708257881566,MATH 121B,A01,433888,Stevens; Laura Jeanne,29,0,30,1
1708257882106,MATH 140B,A01,433890,Seward; Brandon M.,31,0,35,4
1708257882106,MATH 140B,A02,433891,Seward; Brandon M.,35,0,35,0
1708257882637,MATH 140C,A01,433895,Spolaor; Luca,32,0,35,3
1708257882637,MATH 140C,A02,433896,Spolaor; Luca,35,0,35,0
1708257883167,MATH 142B,A01,433966,Eggers; John Dietrich,25,0,35,10
1708257883167,MATH 142B,A02,434063,Eggers; John Dietrich,32,0,35,3
1708257883167,MATH 142B,B01,434071,Sanchez; Anthony,32,0,35,3
1708257883167,MATH 142B,B02,434083,Sanchez; Anthony,34,0,35,1
1708257883167,MATH 142B,C01,434094,Kunnawalkam Elayavalli; Sr,31,0,35,4
1708257883167,MATH 142B,C02,434095,Kunnawalkam Elayavalli; Sr,34,0,35,1
1708257883698,MATH 144,A01,434097,Cloninger; Alexander,30,0,30,0
1708257884224,MATH 150B,A01,434104,Parise; Davide,33,0,35,2
1708257884750,MATH 152,A01,434107,Grier; Daniel T,20,0,40,20
1708257885283,MATH 154,A01,434109,Wesley; William J,31,0,35,4
1708257885283,MATH 154,A02,434119,Wesley; William J,35,0,35,0
1708257885283,MATH 154,A03,434120,Wesley; William J,35,0,35,0
1708257885283,MATH 154,A04,434121,Wesley; William J,34,0,35,1
1708257885283,MATH 154,B01,434126,Aliabadi Sr.; Mohsen,26,0,35,9
1708257885283,MATH 154,B02,434127,Aliabadi Sr.; Mohsen,34,0,35,1
1708257885283,MATH 154,B03,434138,Aliabadi Sr.; Mohsen,35,0,35,0
1708257885283,MATH 154,B04,434139,Aliabadi Sr.; Mohsen,35,0,35,0
1708257885808,MATH 163,A01,434144,Bowers; Adam R.,0,0,5,5
1708257886338,MATH 170A,A01,434148,Nag; Panchali,36,0,36,0
1708257886338,MATH 170A,A02,434149,Nag; Panchali,36,0,36,0
1708257886338,MATH 170A,A03,434150,Nag; Panchali,36,0,37,1
1708257886338,MATH 170A,A04,434151,Nag; Panchali,36,0,36,0
1708257886869,MATH 170B,A01,434155,Huang; Lei,31,0,35,4
1708257886869,MATH 170B,A02,434160,Huang; Lei,35,0,35,0
1708257886869,MATH 170B,A03,434161,Huang; Lei,35,0,35,0
1708257886869,MATH 170B,A04,434162,Huang; Lei,35,0,35,0
1708257887395,MATH 170C,A01,434176,Leok; Melvin,30,0,35,5
1708257887395,MATH 170C,A02,434300,Leok; Melvin,34,0,35,1
1708257887920,MATH 171B,A01,434576,Nie; Jiawang,24,0,35,11
1708257887920,MATH 171B,A02,434583,Nie; Jiawang,35,0,35,0
1708257887920,MATH 171B,A03,434584,Nie; Jiawang,35,0,35,0
1708257887920,MATH 171B,A04,434609,Nie; Jiawang,35,0,35,0
1708257888445,MATH 180A,A01,434638,Gartland; Christopher John,29,0,30,1
1708257888445,MATH 180A,A02,434821,Gartland; Christopher John,28,0,30,2
1708257888445,MATH 180A,A03,434833,Gartland; Christopher John,24,0,30,6
1708257888445,MATH 180A,A04,434839,Gartland; Christopher John,30,0,30,0
1708257888445,MATH 180A,A05,434843,Gartland; Christopher John,30,0,30,0
1708257888445,MATH 180A,A06,434895,Gartland; Christopher John,30,0,30,0
1708257888976,MATH 180B,A01,435085,Gartland; Christopher John,30,0,35,5
1708257888976,MATH 180B,A02,435086,Gartland; Christopher John,35,0,35,0
1708257888976,MATH 180B,A03,435087,Gartland; Christopher John,34,0,35,1
1708257888976,MATH 180B,A04,435088,Gartland; Christopher John,35,0,35,0
1708257889505,MATH 180C,A01,435090,Carfagnini; Marco,29,0,35,6
1708257889505,MATH 180C,A02,435091,Carfagnini; Marco,35,0,35,0
1708257889505,MATH 180C,A03,435092,Carfagnini; Marco,32,0,35,3
1708257889505,MATH 180C,A04,435113,Carfagnini; Marco,35,0,35,0
1708257890031,MATH 181A,A01,435279,Zhang; Danna,30,0,35,5
1708257890031,MATH 181A,A02,435300,Zhang; Danna,35,0,35,0
1708257890031,MATH 181A,A03,435301,Zhang; Danna,21,0,35,14
1708257890031,MATH 181A,A04,435302,Zhang; Danna,31,0,35,4
1708257890557,MATH 181B,A01,435315,Rava; Denise,33,0,35,2
1708257890557,MATH 181B,A02,435316,Rava; Denise,32,0,35,3
1708257890557,MATH 181B,A03,435317,Rava; Denise,33,0,35,2
1708257890557,MATH 181B,A04,435318,Rava; Denise,35,0,35,0
1708257891085,MATH 183,A01,435320,Quarfoot; David James,26,0,35,9
1708257891085,MATH 183,A02,435321,Quarfoot; David James,35,0,35,0
1708257891085,MATH 183,A03,435322,Quarfoot; David James,32,0,35,3
1708257891085,MATH 183,A04,435323,Quarfoot; David James,34,0,35,1
1708257891085,MATH 183,A05,435327,Quarfoot; David James,34,0,35,1
1708257891085,MATH 183,A06,435329,Quarfoot; David James,33,0,35,2
1708257891609,MATH 184,A01,435337,Verstraete; Jacques Allan,32,0,35,3
1708257891609,MATH 184,A02,435338,Verstraete; Jacques Allan,35,0,35,0
1708257891609,MATH 184,A03,435339,Verstraete; Jacques Allan,34,0,35,1
1708257891609,MATH 184,A04,435347,Verstraete; Jacques Allan,30,0,35,5
1708257892139,MATH 185,A01,435432,Arias-Castro; Ery,15,0,30,15
1708257892139,MATH 185,A02,435436,Arias-Castro; Ery,30,0,30,0
1708257892139,MATH 185,A03,435437,Arias-Castro; Ery,30,0,30,0
1708257892139,MATH 185,A04,435438,Arias-Castro; Ery,30,0,30,0
1708257892666,MATH 187A,A01,435443,Agrawal; Shishir,15,0,30,15
1708257892666,MATH 187A,A02,435444,Agrawal; Shishir,30,0,30,0
1708257892666,MATH 187A,A03,435503,Agrawal; Shishir,28,0,30,2
1708257892666,MATH 187A,A04,435507,Agrawal; Shishir,30,0,30,0
1708257892666,MATH 187A,A05,435554,Agrawal; Shishir,22,0,30,8
1708257892666,MATH 187A,A06,435558,Agrawal; Shishir,28,0,30,2
1708257893193,MATH 187B,A01,435570,Bucur; Alina Ioana,24,0,35,11
1708257893193,MATH 187B,A02,435571,Bucur; Alina Ioana,35,0,35,0
1708257893720,MATH 188,A01,435573,Kunnawalkam Elayavalli; Sr,35,0,35,0
1708257894249,MATH 189,A01,435577,Vishwanath; Siddharth,0,0,10,10
1708257894249,MATH 189,A02,435594,Vishwanath; Siddharth,0,0,10,10
1708257894249,MATH 189,A03,435595,Vishwanath; Siddharth,0,0,10,10
1708257894249,MATH 189,A04,435596,Vishwanath; Siddharth,0,0,10,10
1708257894249,MATH 189,A05,480706,Vishwanath; Siddharth,2,0,10,8
1708257894249,MATH 189,A06,481362,Vishwanath; Siddharth,6,0,10,4
1708257894776,MATH 200C,A00,430388,Bucur; Alina Ioana,15,0,15,0
1708257895302,MATH 202C,A00,430389,Rhoades; Brendon Patrick,15,0,15,0
1708257895832,MATH 203C,A00,430390,Izadi; Elham,15,0,15,0
1708257896357,MATH 204C,A00,430391,Sorensen; Claus M,15,0,15,0
1708257896883,MATH 208,A00,430392,Izadi; Elham,8,0,10,2
1708257897412,MATH 209,A00,430393,Pollack; Aaron,10,0,10,0
1708257897943,MATH 211A,A00,430394,Salehi Golsefidy; Alireza,10,0,10,0
1708257898469,MATH 211B,A00,430395,Seward; Brandon M.,10,0,10,0
1708257898996,MATH 212B,A01,480692,Komarova; Natalia,5,0,5,0
1708257899526,MATH 216C,A00,430429,Saab; Rayan,13,0,15,2
1708257900054,MATH 217,A00,430430,Li; Bo,13,0,15,2
1708257900583,MATH 218,A00,430431,Li; Bo,8,0,10,2
1708257901112,MATH 220C,A00,430432,Xiao; Ming,15,0,15,0
1708257901643,MATH 240C,A00,430433,Ebenfelt; Peter F,14,0,15,1
1708257902168,MATH 241B,A00,430434,Ioana; Adrian,14,0,15,1
1708257902694,MATH 243,A00,430435,Kunnawalkam Elayavalli; Sr,9,0,10,1
1708257903223,MATH 248,A00,430436,Bejenaru; Ioan,9,0,10,1
1708257903750,MATH 251C,A00,430437,Wenzl; Hans G,15,0,15,0
1708257904278,MATH 258,A00,430438,Spolaor; Luca,10,0,10,0
1708257904808,MATH 261C,A00,430439,Manners; Frederick,14,0,15,1
1708257905349,MATH 262A,A00,430440,Warnke; Lutz Peter,14,0,15,1
1708257905877,MATH 268,A00,430441,Buss; Samuel R,10,0,10,0
1708257906404,MATH 269,A00,430442,Rhoades; Brendon Patrick & Warnke; Lutz Peter,10,0,10,0
1708257906930,MATH 270C,A00,430445,Cheng; Li-Tien,15,0,15,0
1708257907457,MATH 273B,A00,430452,Zhu; Yuhua,15,0,15,0
1708257907987,MATH 276,A00,430458,Mc Culloch; Andrew Douglas & Amaro; Rommie E,0,0,0,0
1708257908516,MATH 277A,A00,430464,Dumitriu; Ioana,14,0,15,1
1708257909041,MATH 278A,A00,430470,Cheng; Li-Tien,9,0,10,1
1708257909569,MATH 278B,A00,430471,Cloninger; Alexander,10,0,10,0
1708257910099,MATH 278C,A00,430472,Nie; Jiawang,9,0,10,1
1708257910625,MATH 280C,A00,430485,Schweinsberg; Jason,13,0,15,2
1708257911155,MATH 281C,A00,430496,Arias-Castro; Ery,8,0,15,7
1708257911699,MATH 284,A00,430503,Xu; Ronghui,11,0,15,4
1708257912224,MATH 287C,A00,430520,Zhang; Danna,14,0,15,1
1708257912751,MATH 288,A00,430527,Carfagnini; Marco,9,0,10,1
1708257913277,MATH 289A,A00,430541,Novak; Jonathan I,14,0,15,1
1708257913857,MATH 290C,A00,430548,Roberts; Justin Deritter,13,0,15,2
1708257914386,MATH 292,A00,430660,Lu; Yunze,10,0,10,0
1708257914910,MATH 294,A00,430678,Fitzsimmons; Patrick J,11,0,15,4
1708257915439,MATH 295,A00,430692,Bejenaru; Ioan,15,0,15,0
1708257915965,MATH 297,001,430721,Gamst; Anthony Collins,0,0,0,0
1708257916491,MATS 200,A00,414457,Graeve; Olivia A,9995,0,9999,4
1708257917019,MATS 201C,A00,414465,Arzt; Eduard,38,0,50,12
1708257917546,MATS 236,A00,414466,Staff,17,0,20,3
1708257918078,MATS 252,A00,414467,Evdokimenko; Ekaterina,42,0,45,3
1708257918603,MATS 261B,A00,414468,Qiao; Yu,17,0,25,8
1708257919132,MATS 295,A00,414469,Graeve; Olivia A,9999,0,9999,0
1708257919132,MATS 295,B00,478858,Kummel; Andrew C,9999,0,9999,0
1708257919658,MCWP 40,001,414476,Montejo; Carolina,19,0,20,1
1708257919658,MCWP 40,004,414480,Wastal; Carrie King,13,0,15,2
1708257919658,MCWP 40,005,414481,Wastal; Carrie King,10,0,15,5
1708257919658,MCWP 40,006,414482,Wastal; Carrie King,12,0,15,3
1708257919658,MCWP 40,007,414483,Wastal; Carrie King,13,0,15,2
1708257919658,MCWP 40,008,414484,Wastal; Carrie King,15,0,15,0
1708257919658,MCWP 40,009,414487,Wastal; Carrie King,12,0,15,3
1708257919658,MCWP 40,014,414505,Staff,20,0,20,0
1708257919658,MCWP 40,015,494362,Wastal; Carrie King,14,0,15,1
1708257920189,MCWP 50,002,414534,Bartulis; Jason Michael,20,0,20,0
1708257920189,MCWP 50,003,414536,Bartulis; Jason Michael,20,0,20,0
1708257920189,MCWP 50,004,414538,Krone; Jarret,16,0,20,4
1708257920189,MCWP 50,005,414539,Krone; Jarret,19,0,20,1
1708257920189,MCWP 50,006,414540,Smith; Haydee Marie,16,0,20,4
1708257920189,MCWP 50,007,414544,Compas; Sean Matthew,14,0,20,6
1708257920189,MCWP 50,008,414549,Redela; Pamela Morgan,20,0,20,0
1708257920189,MCWP 50,011,414557,Carter; Andrea L,16,0,20,4
1708257920189,MCWP 50,012,414592,Silva; Kelly B,20,0,20,0
1708257920189,MCWP 50,013,414593,Silva; Kelly B,19,0,20,1
1708257920189,MCWP 50,014,414594,Carter; Andrea L,20,0,20,0
1708257920189,MCWP 50,016,414596,Morshed; Michael James,14,0,20,6
1708257920189,MCWP 50,017,414598,Morshed; Michael James,17,0,20,3
1708257920189,MCWP 50,019,414601,Redela; Pamela Morgan,17,0,20,3
1708257920189,MCWP 50,020,414606,Carter; Jennifer A,20,0,20,0
1708257920189,MCWP 50,021,414607,Carter; Jennifer A,19,0,20,1
1708257920189,MCWP 50,022,414649,Compas; Sean Matthew,11,0,20,9
1708257920189,MCWP 50,023,414650,Smith; Haydee Marie,20,0,20,0
1708257920189,MCWP 50,024,414651,Nies; Laurie Elizabeth,19,0,20,1
1708257920189,MCWP 50,025,414655,Nies; Laurie Elizabeth,18,0,20,2
1708257920189,MCWP 50,026,414656,Pham; Vincent Minhduc,19,0,20,1
1708257920189,MCWP 50,027,414657,Pham; Vincent Minhduc,20,0,20,0
1708257920189,MCWP 50,028,414668,Morshed; Michael James,16,0,20,4
1708257920189,MCWP 50,029,414669,Morshed; Michael James,19,0,20,1
1708257920716,MCWP 50R,A00,486838,Miller; Elizabeth Deen,19,0,20,1
1708257920716,MCWP 50R,B00,486843,Miller; Elizabeth Deen,16,0,20,4
1708257920716,MCWP 50R,C00,486844,Miller; Elizabeth Deen,19,0,20,1
1708257921242,MCWP 125,A00,414670,Wilson; Marion E.,20,0,20,0
1708257921242,MCWP 125,B00,414674,Guillen; Melinda,20,0,20,0
1708257921242,MCWP 125,C00,414678,Guillen; Melinda,20,0,20,0
1708257921242,MCWP 125,D00,414682,Guillen; Melinda,20,0,20,0
1708257921769,MED 231,A00,476440,Hurst; Samantha,7,0,7,0
1708257922304,MED 246,A00,492785,Gordts; Philip & Varki; Ajit P & Lewis; Amanda Lark & Godula; Kamil & Gagneux; Pascal & Esko; Jeffrey D. & Bode; Lars,10,0,10,0
1708257922830,MED 262,A00,492942,Koola; Jejo David,28,0,30,2
1708257923357,MED 267,A01,492789,Hogarth; Michael Andrew,25,0,30,5
1708257923889,MED 275,A00,464684,Liu; George Yenhsi,10,0,10,0
1708257924414,MED 276,A00,492786,Sitapati; Amy,23,0,25,2
1708257925205,MED 278,A00,492787,Carter; Hannah Kathryn & Mesirov; Jill P. & Curtius; Kathleen Mary,20,0,20,0
1708257925749,MED 296,001,464685,Chi; Neil C.,48,0,50,2
1708257925749,MED 296,002,464686,Hong; Kimberly N,49,0,50,1
1708257925749,MED 296,003,464687,Staff,50,0,50,0
1708257926275,MGT 3,A00,442429,Wagner; Timothy Ryan,95,0,98,3
1708257926802,MGT 4,A01,442443,Levkoff; Steven B.,0,0,5,5
1708257926802,MGT 4,A02,442444,Levkoff; Steven B.,4,0,5,1
1708257927331,MGT 5,A00,442446,Molloie Jr.; William H,184,0,196,12
1708257927857,MGT 12,A00,442447,Lindenberger; Wade Douglas,83,0,100,17
1708257927857,MGT 12,B00,442448,Lindenberger; Wade Douglas,71,0,100,29
1708257927857,MGT 12,C00,442449,Pecore; Joseph P.,88,0,100,12
1708257928384,MGT 16,A00,442452,Buchanan; Harold G,97,0,100,3
1708257928384,MGT 16,B00,442459,Buchanan; Harold G,92,0,100,8
1708257928384,MGT 16,C00,442461,Campbell; Robert Harold,113,0,120,7
1708257928384,MGT 16,D00,442475,Campbell; Robert Harold,118,0,120,2
1708257928923,MGT 18,A00,442477,McKay; Michael J,98,0,98,0
1708257928923,MGT 18,B00,442491,McKay; Michael J,96,0,98,2
1708257928923,MGT 18,C00,442493,McKay; Michael J,98,0,98,0
1708257928923,MGT 18,D00,442503,Chamberlain; Travis Dean,98,0,98,0
1708257929448,MGT 45,A00,442508,Pecore; Joseph P.,146,0,150,4
1708257929448,MGT 45,B00,442510,Pecore; Joseph P.,142,0,150,8
1708257929977,MGT 71,A00,442524,Lee; Hyun Seok,77,0,98,21
1708257941134,MGT 71R,A00,442526,Phiroz; Zal Navroze,77,0,98,21
1708257941664,MGT 100,A00,442541,Wilbur; Kenneth C,82,0,98,16
1708257941664,MGT 100,B00,442542,Wilbur; Kenneth C,89,0,98,9
1708257942192,MGT 103,A00,442543,Eberhard; Craig A,98,0,98,0
1708257942192,MGT 103,B00,442544,Eberhard; Craig A,95,0,98,3
1708257942192,MGT 103,C00,442545,Ehrich; Kristine R,90,0,98,8
1708257942192,MGT 103,D00,442547,Ehrich; Kristine R,96,0,98,2
1708257942192,MGT 103,E00,442548,Ehrich; Kristine R,97,0,98,1
1708257942192,MGT 103,F00,442549,Demill; Burritt,92,0,98,6
1708257942192,MGT 103,G00,442550,Bates; Kenneth Walter,97,0,98,1
1708257942718,MGT 105,A00,442558,Bates; Kenneth Walter,86,0,98,12
1708257943246,MGT 106,A00,442560,Eberhard; Craig A,95,0,98,3
1708257943771,MGT 109,A00,442574,Campbell; Colin Leslie,90,0,98,8
1708257944297,MGT 112,A00,442576,Somasundaram; Tyagarajan,96,0,98,2
1708257944297,MGT 112,B00,442590,Somasundaram; Tyagarajan,94,0,98,4
1708257944297,MGT 112,C00,442592,Zimmermann; Carsten,87,0,98,11
1708257944830,MGT 119,A00,442602,Staff,97,0,98,1
1708257944830,MGT 119,B00,442603,Anderson; Jon Marcus,96,0,98,2
1708257945356,MGT 121B,A00,442606,Klaas; Jeffrey David,93,0,98,5
1708257945885,MGT 128R,A00,442607,Krishnan; Viswanathan,84,0,98,14
1708257946412,MGT 131A,A00,442608,Houskeeper; Robert,148,0,150,2
1708257946942,MGT 131B,A00,442609,Houskeeper; Robert,100,0,100,0
1708257947468,MGT 132,A00,442610,Blakley; Bruce,97,0,98,1
1708257947996,MGT 137,A00,442611,Lindenberger; Wade Douglas,85,0,98,13
1708257948522,MGT 147,A00,442612,Anderson; John Charles,31,0,40,9
1708257949048,MGT 151R,A00,442613,Phiroz; Zal Navroze,92,0,98,6
1708257949582,MGT 153,A00,442650,Perols; Johan Lars,55,0,80,25
1708257950109,MGT 162,A00,442652,Demill; Burritt,81,0,98,17
1708257950109,MGT 162,B00,442654,Demill; Burritt,88,0,98,10
1708257950109,MGT 162,C00,442776,Staff,95,0,98,3
1708257950109,MGT 162,D00,442778,Staff,96,0,98,2
1708257950656,MGT 164,A00,442780,McKay; Mary A,97,0,98,1
1708257950656,MGT 164,B00,442849,McKay; Mary A,96,0,98,2
1708257950656,MGT 164,C00,442917,McKay; Mary A,97,0,98,1
1708257950656,MGT 164,D00,442949,Meyer; Alison Bloomfield,90,0,98,8
1708257951197,MGT 166,A00,443017,Moran; Cathleen L.,95,0,98,3
1708257951197,MGT 166,B00,443045,Moran; Cathleen L.,97,0,98,1
1708257951197,MGT 166,C00,443046,Moran; Cathleen L.,98,0,98,0
1708257951722,MGT 167,A00,443047,Klaas; Jeffrey David,93,0,98,5
1708257952251,MGT 171R,A00,443048,Phiroz; Zal Navroze,86,0,98,12
1708257952777,MGT 172,A00,443049,Hedges; Kathleen & Royal; Rebecca,116,0,120,4
1708257952777,MGT 172,B00,443050,Hedges; Kathleen,95,0,98,3
1708257952777,MGT 172,C00,443051,Zimmermann; Carsten,96,0,98,2
1708257953304,MGT 173,A00,443052,Hayes; Sherry Lorine,92,0,100,8
1708257953832,MGT 175,A00,443053,Gopal; Christopher S.,98,0,98,0
1708257954371,MGT 180,A00,443055,Bliss; Barbara Ann,139,0,150,11
1708257954371,MGT 180,B00,443069,Bliss; Barbara Ann,145,0,150,5
1708257954895,MGT 181,A00,443120,Buchanan; Harold G,147,0,150,3
1708257955424,MGT 183,A00,443121,Banerjee; Snehal,88,0,98,10
1708257955952,MGT 185,A00,443122,Dunn; Louis Jean,90,0,98,8
1708257956494,MGT 187,A00,443133,Dunn; Louis Jean,95,0,100,5
1708257957023,MGT 189,A00,443134,Avenancio-Leon; Carlos,98,0,98,0
1708257957547,MGT 227,A00,479242,Serra Garcia; Marta,19,0,20,1
1708257958073,MGT 259,A00,443135,Oveis; Christopher S,19,0,20,1
1708257958618,MGT 296,001,481416,Gneezy; Ayelet,3,0,3,0
1708257958618,MGT 296,002,481420,Amir; On,3,0,3,0
1708257958618,MGT 296,003,481466,Amir; On & Karmarkar; Uma R,3,0,3,0
1708257958618,MGT 296,004,481468,Liu; Jun,3,0,3,0
1708257958618,MGT 296,005,481469,Misra; Kanishka,3,0,3,0
1708257958618,MGT 296,006,481470,Erat; Sanjiv,3,0,3,0
1708257958618,MGT 296,007,481473,Timmermann; Allan,3,0,3,0
1708257958618,MGT 296,008,481474,Smith; Pamela Karen,3,0,3,0
1708257958618,MGT 296,009,481477,Zhang; Zhe,3,0,3,0
1708257958618,MGT 296,010,481478,Oveis; Christopher S,3,0,3,0
1708257958618,MGT 296,011,481479,Amir; On & Gneezy; Ayelet,3,0,3,0
1708257958618,MGT 296,012,481481,Wilbur; Kenneth C,3,0,3,0
1708257960274,MMW 13,A01,412918,Chang; Edmond Yi-Teh,15,0,16,1
1708257960274,MMW 13,A02,412928,Chang; Edmond Yi-Teh,16,0,16,0
1708257960274,MMW 13,A03,413017,Chang; Edmond Yi-Teh,16,0,16,0
1708257960274,MMW 13,A04,413018,Chang; Edmond Yi-Teh,16,0,16,0
1708257960274,MMW 13,A05,413019,Chang; Edmond Yi-Teh,15,0,16,1
1708257960274,MMW 13,A06,413020,Chang; Edmond Yi-Teh,16,0,16,0
1708257960274,MMW 13,A07,413021,Chang; Edmond Yi-Teh,15,0,16,1
1708257960274,MMW 13,A08,413023,Chang; Edmond Yi-Teh,16,0,16,0
1708257960274,MMW 13,A09,413024,Chang; Edmond Yi-Teh,16,0,16,0
1708257960274,MMW 13,A10,413025,Chang; Edmond Yi-Teh,16,0,16,0
1708257960274,MMW 13,A11,413026,Chang; Edmond Yi-Teh,16,0,16,0
1708257960274,MMW 13,A12,413027,Chang; Edmond Yi-Teh,16,0,16,0
1708257960274,MMW 13,A13,413028,Chang; Edmond Yi-Teh,0,0,0,0
1708257960274,MMW 13,A14,413029,Chang; Edmond Yi-Teh,0,0,0,0
1708257960274,MMW 13,A15,413030,Chang; Edmond Yi-Teh,14,0,16,2
1708257960274,MMW 13,A16,413031,Chang; Edmond Yi-Teh,15,0,16,1
1708257960274,MMW 13,A17,413032,Chang; Edmond Yi-Teh,16,0,16,0
1708257960274,MMW 13,A18,413034,Chang; Edmond Yi-Teh,14,0,16,2
1708257960274,MMW 13,A19,413035,Chang; Edmond Yi-Teh,16,0,16,0
1708257960274,MMW 13,A20,413036,Chang; Edmond Yi-Teh,16,0,16,0
1708257960274,MMW 13,A21,413037,Chang; Edmond Yi-Teh,0,0,0,0
1708257960274,MMW 13,A22,413038,Chang; Edmond Yi-Teh,0,0,0,0
1708257960274,MMW 13,B01,413290,Zhiri; Oumelbanine,15,0,16,1
1708257960274,MMW 13,B02,413291,Zhiri; Oumelbanine,15,0,16,1
1708257960274,MMW 13,B03,413308,Zhiri; Oumelbanine,14,0,16,2
1708257960274,MMW 13,B04,413322,Zhiri; Oumelbanine,14,0,16,2
1708257960274,MMW 13,B05,413343,Zhiri; Oumelbanine,12,0,16,4
1708257960274,MMW 13,B06,413344,Zhiri; Oumelbanine,14,0,16,2
1708257960274,MMW 13,B07,413524,Zhiri; Oumelbanine,16,0,16,0
1708257960274,MMW 13,B08,413584,Zhiri; Oumelbanine,16,0,16,0
1708257960274,MMW 13,B09,413588,Zhiri; Oumelbanine,15,0,16,1
1708257960274,MMW 13,B10,413590,Zhiri; Oumelbanine,16,0,16,0
1708257960274,MMW 13,B11,413779,Zhiri; Oumelbanine,12,0,16,4
1708257960274,MMW 13,B12,413780,Zhiri; Oumelbanine,9,0,16,7
1708257960274,MMW 13,B13,413781,Zhiri; Oumelbanine,0,0,0,0
1708257960274,MMW 13,B14,413782,Zhiri; Oumelbanine,0,0,0,0
1708257960274,MMW 13,B15,413808,Zhiri; Oumelbanine,16,0,16,0
1708257960274,MMW 13,B16,413815,Zhiri; Oumelbanine,15,0,16,1
1708257960274,MMW 13,B17,413816,Zhiri; Oumelbanine,15,0,16,1
1708257960274,MMW 13,B18,413817,Zhiri; Oumelbanine,12,0,16,4
1708257960274,MMW 13,B19,413822,Zhiri; Oumelbanine,16,0,16,0
1708257960274,MMW 13,B20,413823,Zhiri; Oumelbanine,14,0,16,2
1708257960274,MMW 13,B21,413825,Zhiri; Oumelbanine,0,0,0,0
1708257960274,MMW 13,B22,413826,Zhiri; Oumelbanine,0,0,0,0
1708257960274,MMW 13,B23,413827,Zhiri; Oumelbanine,16,0,16,0
1708257960274,MMW 13,B24,413834,Zhiri; Oumelbanine,15,0,16,1
1708257960274,MMW 13,C01,413859,Vitkus; Daniel J.,16,0,16,0
1708257960274,MMW 13,C02,413860,Vitkus; Daniel J.,16,0,16,0
1708257960274,MMW 13,C04,413868,Vitkus; Daniel J.,0,0,0,0
1708257960274,MMW 13,C05,413869,Vitkus; Daniel J.,16,0,16,0
1708257960274,MMW 13,C06,413871,Vitkus; Daniel J.,16,0,16,0
1708257960274,MMW 13,C07,413886,Vitkus; Daniel J.,16,0,16,0
1708257960274,MMW 13,C08,413908,Vitkus; Daniel J.,16,0,16,0
1708257960274,MMW 13,C09,413930,Vitkus; Daniel J.,16,0,16,0
1708257960274,MMW 13,C10,413952,Vitkus; Daniel J.,15,0,16,1
1708257960274,MMW 13,C11,413972,Vitkus; Daniel J.,16,0,16,0
1708257960274,MMW 13,C12,413991,Vitkus; Daniel J.,16,0,16,0
1708257960274,MMW 13,C13,414007,Vitkus; Daniel J.,0,0,0,0
1708257960274,MMW 13,C14,414017,Vitkus; Daniel J.,0,0,0,0
1708257960274,MMW 13,C15,414030,Vitkus; Daniel J.,16,0,16,0
1708257960274,MMW 13,C16,414032,Vitkus; Daniel J.,16,0,16,0
1708257960274,MMW 13,C17,414033,Vitkus; Daniel J.,15,0,16,1
1708257960274,MMW 13,C18,414034,Vitkus; Daniel J.,16,0,16,0
1708257960274,MMW 13,C19,414041,Vitkus; Daniel J.,16,0,16,0
1708257960274,MMW 13,C20,414056,Vitkus; Daniel J.,16,0,16,0
1708257960274,MMW 13,C21,414057,Vitkus; Daniel J.,15,0,16,1
1708257960274,MMW 13,C22,414059,Vitkus; Daniel J.,16,0,16,0
1708257960871,MMW 15,A01,414065,Chang; Edmond Yi-Teh,28,0,28,0
1708257960871,MMW 15,A02,414067,Chang; Edmond Yi-Teh,27,0,28,1
1708257960871,MMW 15,A03,414092,Chang; Edmond Yi-Teh,26,0,28,2
1708257960871,MMW 15,A04,414104,Chang; Edmond Yi-Teh,28,0,28,0
1708257960871,MMW 15,A05,414121,Chang; Edmond Yi-Teh,0,0,0,0
1708257960871,MMW 15,A06,414122,Chang; Edmond Yi-Teh,0,0,0,0
1708257960871,MMW 15,A07,414123,Chang; Edmond Yi-Teh,27,0,28,1
1708257960871,MMW 15,A08,414124,Chang; Edmond Yi-Teh,28,0,28,0
1708257960871,MMW 15,A09,414125,Chang; Edmond Yi-Teh,0,0,0,0
1708257960871,MMW 15,A10,414130,Chang; Edmond Yi-Teh,0,0,0,0
1708257960871,MMW 15,B01,414132,Radcliff; Pamela B.,27,0,28,1
1708257960871,MMW 15,B02,414134,Radcliff; Pamela B.,27,0,28,1
1708257960871,MMW 15,B03,414135,Radcliff; Pamela B.,26,0,28,2
1708257960871,MMW 15,B04,414136,Radcliff; Pamela B.,27,0,28,1
1708257960871,MMW 15,B05,414137,Radcliff; Pamela B.,28,0,28,0
1708257960871,MMW 15,B06,414138,Radcliff; Pamela B.,27,0,28,1
1708257960871,MMW 15,B07,414140,Radcliff; Pamela B.,26,0,28,2
1708257960871,MMW 15,B08,414141,Radcliff; Pamela B.,28,0,28,0
1708257960871,MMW 15,C01,414143,Prestholdt; Jeremy,0,0,0,0
1708257960871,MMW 15,C02,414144,Prestholdt; Jeremy,0,0,0,0
1708257960871,MMW 15,C03,414145,Prestholdt; Jeremy,24,0,28,4
1708257960871,MMW 15,C04,414147,Prestholdt; Jeremy,17,0,28,11
1708257960871,MMW 15,C05,414148,Prestholdt; Jeremy,28,0,28,0
1708257960871,MMW 15,C06,414149,Prestholdt; Jeremy,26,0,28,2
1708257960871,MMW 15,C07,414152,Prestholdt; Jeremy,25,0,28,3
1708257960871,MMW 15,C08,414153,Prestholdt; Jeremy,23,0,28,5
1708257961404,MSED 295,A00,477850,Rabin; Jeffrey Mark,5,0,5,0
1708257961404,MSED 295,B00,477852,Lo; Stanley M.,5,0,5,0
1708257961933,MSED 296C,A00,477853,Staff,14,0,15,1
1708257962468,MUS 1C,A01,416488,Ishov; Alexander Alexandrovich,24,0,25,1
1708257962468,MUS 1C,A02,416502,Ishov; Alexander Alexandrovich,25,0,25,0
1708257962468,MUS 1C,A03,416519,Ishov; Alexander Alexandrovich,25,0,25,0
1708257962468,MUS 1C,A04,416520,Ishov; Alexander Alexandrovich,25,0,25,0
1708257962468,MUS 1C,A05,416521,Ishov; Alexander Alexandrovich,25,0,25,0
1708257962994,MUS 2C,A01,416523,Richards; Stephanie F,30,0,30,0
1708257963519,MUS 2CK,A00,416524,Ohnishi; Takae,15,0,15,0
1708257963519,MUS 2CK,B00,416547,Ohnishi; Takae,15,0,15,0
1708257964044,MUS 2JK,A00,416548,Kenyatta; Kamau,15,0,15,0
1708257964572,MUS 4,A01,416562,Staff,25,0,25,0
1708257964572,MUS 4,A02,416634,Staff,24,0,25,1
1708257964572,MUS 4,A03,416644,Staff,25,0,25,0
1708257964572,MUS 4,A04,416659,Staff,24,0,25,1
1708257964572,MUS 4,A05,416667,Staff,25,0,25,0
1708257964572,MUS 4,A06,416757,Staff,25,0,25,0
1708257964572,MUS 4,A07,416830,Staff,25,0,25,0
1708257964572,MUS 4,A08,416953,Staff,23,0,25,2
1708257964572,MUS 4,A09,417005,Staff,25,0,25,0
1708257964572,MUS 4,A10,417007,Staff,24,0,25,1
1708257965100,MUS 7,A01,417048,Staff,23,0,24,1
1708257965100,MUS 7,A02,417102,Staff,23,0,24,1
1708257965100,MUS 7,A03,417103,Staff,23,0,24,1
1708257965100,MUS 7,A04,417114,Staff,22,0,24,2
1708257965629,MUS 8,A01,417119,Staff,14,0,20,6
1708257965629,MUS 8,A02,417163,Staff,16,0,20,4
1708257965629,MUS 8,A03,417164,Staff,16,0,20,4
1708257965629,MUS 8,A04,417165,Staff,17,0,20,3
1708257965629,MUS 8,A05,417194,Staff,18,0,20,2
1708257965629,MUS 8,A06,417198,Staff,20,0,20,0
1708257966155,MUS 11,A01,417201,Terrazas Perez; Wilfrido D,21,0,25,4
1708257966155,MUS 11,A02,417219,Terrazas Perez; Wilfrido D,23,0,25,2
1708257966155,MUS 11,A03,417220,Terrazas Perez; Wilfrido D,25,0,25,0
1708257966155,MUS 11,A04,417222,Terrazas Perez; Wilfrido D,25,0,25,0
1708257966155,MUS 11,A05,417223,Terrazas Perez; Wilfrido D,24,0,25,1
1708257966155,MUS 11,A06,417295,Terrazas Perez; Wilfrido D,23,0,25,2
1708257966155,MUS 11,A07,417297,Terrazas Perez; Wilfrido D,24,0,25,1
1708257966155,MUS 11,A08,417298,Terrazas Perez; Wilfrido D,25,0,25,0
1708257966681,MUS 12,A01,417300,Guy; Nancy,25,0,25,0
1708257966681,MUS 12,A02,417301,Guy; Nancy,25,0,25,0
1708257966681,MUS 12,A03,417302,Guy; Nancy,25,0,25,0
1708257966681,MUS 12,A04,417303,Guy; Nancy,25,0,25,0
1708257967210,MUS 13,A01,417305,Leslie Santana; Myrta,25,0,25,0
1708257967210,MUS 13,A02,417306,Leslie Santana; Myrta,25,0,25,0
1708257967210,MUS 13,A03,417307,Leslie Santana; Myrta,25,0,25,0
1708257967210,MUS 13,A04,417308,Leslie Santana; Myrta,25,0,25,0
1708257967756,MUS 15,A01,417327,Schaffer; Max Benjamin,18,0,20,2
1708257967756,MUS 15,A02,417331,Schaffer; Max Benjamin,19,0,20,1
1708257967756,MUS 15,A03,417358,Schaffer; Max Benjamin,19,0,20,1
1708257967756,MUS 15,A04,417359,Schaffer; Max Benjamin,17,0,20,3
1708257967756,MUS 15,A05,417360,Schaffer; Max Benjamin,20,0,20,0
1708257967756,MUS 15,A06,417370,Schaffer; Max Benjamin,20,0,20,0
1708257967756,MUS 15,A07,417371,Schaffer; Max Benjamin,17,0,20,3
1708257967756,MUS 15,A08,417372,Schaffer; Max Benjamin,18,0,20,2
1708257967756,MUS 15,A09,417378,Schaffer; Max Benjamin,19,0,20,1
1708257967756,MUS 15,A10,417379,Schaffer; Max Benjamin,19,0,20,1
1708257968304,MUS 17,A01,417381,Staff,22,0,25,3
1708257968304,MUS 17,A02,417406,Staff,24,0,25,1
1708257968304,MUS 17,A03,417420,Staff,24,0,25,1
1708257968304,MUS 17,A04,417594,Staff,24,0,25,1
1708257968304,MUS 17,A05,417595,Staff,25,0,25,0
1708257968304,MUS 17,A06,417605,Staff,21,0,25,4
1708257968304,MUS 17,A07,417606,Staff,25,0,25,0
1708257968304,MUS 17,A08,417627,Staff,25,0,25,0
1708257968304,MUS 17,A09,417628,Staff,21,0,25,4
1708257968304,MUS 17,A10,417629,Staff,24,0,25,1
1708257968304,MUS 17,A11,417630,Staff,25,0,25,0
1708257968304,MUS 17,A12,417631,Staff,24,0,25,1
1708257968304,MUS 17,A13,417632,Staff,25,0,25,0
1708257968304,MUS 17,A14,417633,Staff,25,0,25,0
1708257968831,MUS 32,001,418855,Dresser; Mark Stuart,10,0,10,0
1708257968831,MUS 32,002,418856,Kenyatta; Kamau,9,0,10,1
1708257968831,MUS 32,003,418864,Curtis; Charles Rector,10,0,10,0
1708257968831,MUS 32,004,418865,Carlstrom; Mitchell Kraig,9,0,10,1
1708257968831,MUS 32,005,418868,Terrazas Perez; Wilfrido D,10,0,10,0
1708257968831,MUS 32,006,418869,Ohnishi; Takae,10,0,10,0
1708257968831,MUS 32,007,418872,Burr; Anthony I,10,0,10,0
1708257968831,MUS 32,008,418873,Carlson; Erik Norman,10,0,10,0
1708257968831,MUS 32,009,418874,Blair; Kyle Adam,10,0,10,0
1708257968831,MUS 32,010,418875,Richards; Stephanie F,10,0,10,0
1708257969357,MUS 32V,A00,417634,Narucki; Susan M,10,0,10,0
1708257969357,MUS 32V,B00,417635,Staff,10,0,10,0
1708257969883,MUS 32VM,A00,417636,Staff,15,0,15,0
1708257970410,MUS 33C,A00,417637,Taylor; Alexander Lawther,20,0,20,0
1708257970935,MUS 43,A00,417647,Burr; Anthony I,83,0,90,7
1708257971461,MUS 95D,A00,417919,Staff,40,0,40,0
1708257971991,MUS 95E,A00,417933,Henson; Matthew Alexander,55,0,55,0
1708257972522,MUS 95G,A00,417935,Anderson; Kenneth,387,0,395,8
1708257972522,MUS 95G,B00,417937,Anderson; Kenneth,394,0,395,1
1708257973051,MUS 95JC,A00,417939,Kenyatta; Kamau,30,0,30,0
1708257973580,MUS 95L,A00,417940,Jones; Michael David,50,0,50,0
1708257974106,MUS 95W,A00,417946,Seshadri; Kartik,29,0,30,1
1708257974106,MUS 95W,B00,417948,Seshadri; Kartik,30,0,30,0
1708257974649,MUS 101C,A01,417951,Burr; Anthony I,33,0,35,2
1708257975179,MUS 103C,A00,417952,Davis; Anthony Curtis,14,0,15,1
1708257975705,MUS 103F,A00,417959,Obermueller; Karola,1,0,1,0
1708257976235,MUS 113,A00,418015,Narucki; Susan M,13,0,15,2
1708257976763,MUS 120C,A01,418032,Leslie Santana; Myrta,25,0,25,0
1708257977290,MUS 127,A00,418037,Richards; Stephanie F,92,0,100,8
1708257977816,MUS 130,A00,418047,Ohnishi; Takae,30,0,30,0
1708257978341,MUS 131,A00,418065,Roberts; Matana,30,0,30,0
1708257978871,MUS 132,001,418883,Dresser; Mark Stuart,10,0,10,0
1708257978871,MUS 132,002,418885,Kenyatta; Kamau,10,0,10,0
1708257978871,MUS 132,003,418886,Curtis; Charles Rector,10,0,10,0
1708257978871,MUS 132,004,418887,Carlstrom; Mitchell Kraig,10,0,10,0
1708257978871,MUS 132,005,418888,Jones; Michael David,10,0,10,0
1708257978871,MUS 132,006,418889,Terrazas Perez; Wilfrido D,10,0,10,0
1708257978871,MUS 132,007,418893,Ohnishi; Takae,10,0,10,0
1708257978871,MUS 132,008,418894,Burr; Anthony I,10,0,10,0
1708257978871,MUS 132,009,418896,Carlson; Erik Norman,10,0,10,0
1708257978871,MUS 132,010,418900,Blair; Kyle Adam,10,0,10,0
1708257978871,MUS 132,011,418932,Richards; Stephanie F,10,0,10,0
1708257978871,MUS 132,012,418933,Nourai; Keyarash,10,0,10,0
1708257979397,MUS 132R,A00,418067,Burr; Anthony I,5,0,5,0
1708257979397,MUS 132R,B00,418078,Jones; Michael David,5,0,5,0
1708257979941,MUS 132V,A00,418092,Narucki; Susan M,15,0,15,0
1708257979941,MUS 132V,B00,418096,Staff,15,0,15,0
1708257980467,MUS 134,A00,418098,Staff,40,0,40,0
1708257980997,MUS 137C,A00,418109,Kenyatta; Kamau,25,0,25,0
1708257981522,MUS 143,A00,418123,Burr; Anthony I,33,0,40,7
1708257982052,MUS 150,A00,418127,Davis; Anthony Curtis,28,0,30,2
1708257982581,MUS 151,A00,418129,Hankins; Sarah E.,20,0,30,10
1708257983112,MUS 160B,A00,418172,Staff,11,0,15,4
1708257983112,MUS 160B,B00,418175,Dubnov; Shlomo,14,0,15,1
1708257983638,MUS 172,A01,418178,Staff,36,0,40,4
1708257984169,MUS 174C,A00,418179,Erbe; Tom,24,0,27,3
1708257984695,MUS 175,A00,418247,Smyth; Tamara R.,28,0,30,2
1708257985222,MUS 177,A00,418265,Erbe; Tom,11,0,15,4
1708257985752,MUS 201A,A00,418267,Narucki; Susan M,15,0,15,0
1708257985752,MUS 201A,B00,418268,Dresser; Mark Stuart,13,0,15,2
1708257986284,MUS 203C,A00,418269,Lou; Michelle Siulai,15,0,15,0
1708257986810,MUS 203D,A00,418272,Davis; Anthony Curtis,4,0,5,1
1708257986810,MUS 203D,B00,418275,Obermueller; Karola,5,0,5,0
1708257986810,MUS 203D,C00,418277,Liang; Lei,5,0,5,0
1708257986810,MUS 203D,D00,418323,Lou; Michelle Siulai,5,0,5,0
1708257987338,MUS 204,A00,418324,Obermueller; Karola,24,0,25,1
1708257987864,MUS 205,A00,418325,Cimini; Amy Marie,22,0,25,3
1708257988389,MUS 206,A00,418326,Liang; Lei,13,0,15,2
1708257988389,MUS 206,B00,418327,Roberts; Matana,13,0,15,2
1708257988916,MUS 215C,A00,418328,Cimini; Amy Marie,14,0,15,1
1708257989448,MUS 232,001,418937,Dresser; Mark Stuart,9,0,10,1
1708257989448,MUS 232,002,418969,Kenyatta; Kamau,10,0,10,0
1708257989448,MUS 232,003,418971,Curtis; Charles Rector,10,0,10,0
1708257989448,MUS 232,004,418974,Terrazas Perez; Wilfrido D,10,0,10,0
1708257989448,MUS 232,005,418979,Ohnishi; Takae,10,0,10,0
1708257989448,MUS 232,006,418980,Burr; Anthony I,10,0,10,0
1708257989448,MUS 232,007,418981,Carlson; Erik Norman,10,0,10,0
1708257989448,MUS 232,008,418982,Richards; Stephanie F,10,0,10,0
1708257989448,MUS 232,009,418985,Narucki; Susan M,10,0,10,0
1708257989973,MUS 234,A00,418329,Staff,15,0,15,0
1708257990553,MUS 245,A00,418330,Carlson; Erik Norman,14,0,15,1
1708257991086,MUS 267,A00,418331,Erbe; Tom,15,0,15,0
1708257991612,MUS 270B,A00,418332,Staff,15,0,15,0
1708257992143,MUS 270D,A00,479231,Smyth; Tamara R.,15,0,15,0
1708257992668,NANO 103,A00,414714,Jahed Motlagh; Zeinab,40,0,40,0
1708257993193,NANO 108,A00,414740,Lubarda; Vlado,70,0,70,0
1708257993725,NANO 112,A01,414825,Vazquez Mena; Oscar,70,0,70,0
1708257994256,NANO 115L,A01,414830,Yang; Kesong,37,0,38,1
1708257994256,NANO 115L,B01,414832,Xu; Sheng,35,0,38,3
1708257994781,NANO 120B,A01,414835,Vecchio; Kenneth S,33,0,35,2
1708257994781,NANO 120B,B01,414841,Fenning; David,30,0,35,5
1708257995309,NANO 156,A00,414843,Fullerton; Eric E,24,0,30,6
1708257995835,NANO 158,A00,414844,Luo; Jian,29,0,30,1
1708257996359,NANO 175,A00,414850,Steinmetz; Nicole F,30,0,35,5
1708257996886,NANO 200,A00,414852,Jahed Motlagh; Zeinab,118,0,120,2
1708257997415,NANO 241,A00,414854,Pokorski; Jonathan Kyle,18,0,25,7
1708257997939,NANO 262,A00,414858,Wang; Joseph,50,0,50,0
1708257998481,NANO 271,A00,414862,Cubukcu; Ertugrul,22,0,25,3
1708257999009,NANO 272,A00,414877,Xu; Sheng,42,0,50,8
1708257999536,NANO 279,A00,414878,Liu; Ping,32,0,40,8
1708258000064,NANO 282,A00,414879,Steinmetz; Nicole F,30,0,30,0
1708258000590,NEU 200C,A00,455013,Staff,0,0,0,1
1708258001115,NEU 276,A01,479489,Staff,35,0,36,1
1708258001661,NEU 277,A00,479492,Risbrough; Victoria Blythe,0,0,0,0
1708258002188,NEU 296,001,464921,Evans; Sean Jeffrey,48,0,50,2
1708258002188,NEU 296,002,464922,Staff,50,0,50,0
1708258002188,NEU 296,003,464925,Staff,50,0,50,0
1708258002714,NEUG 221,A00,479490,Zheng; Binhai,15,0,15,0
1708258003239,NEUG 280,A00,479491,Chen; Xu,0,0,0,0
1708258003767,NEUG 296,A00,479493,Bloodgood; Brenda Laurie,9998,0,9999,1
1708258004293,OPTH 296,001,465054,Baxter; Sally Liu,49,0,50,1
1708258004293,OPTH 296,002,465068,Afshari; Natalie,49,0,50,1
1708258004293,OPTH 296,003,465074,Staff,50,0,50,0
1708258004822,ORTH 296,A00,465104,Staff,50,0,50,0
1708258004822,ORTH 296,001,465111,Staff,50,0,50,0
1708258004822,ORTH 296,002,465120,Staff,50,0,50,0
1708258005348,PATH 224,A01,494386,Ross; Camille,11,0,12,1
1708258005875,PATH 296,001,465373,Calcutt; Nigel A,49,0,50,1
1708258005875,PATH 296,002,465374,Staff,50,0,50,0
1708258005875,PATH 296,003,465375,Staff,50,0,50,0
1708258006402,PEDS 296,001,465527,Weiss; Katherine Jean,49,0,50,1
1708258006402,PEDS 296,002,465528,Staff,50,0,50,0
1708258006402,PEDS 296,003,465529,Staff,50,0,50,0
1708258006932,PH 196BH,A01,405158,Binkin; Nancy Jeanne,20,0,20,0
1708258007458,PHAR 219,A00,415016,Ross; Camille,1,0,1,0
1708258007987,PHAR 231,A00,415017,Furnari; Frank,20,0,20,0
1708258007987,PHAR 231,B00,415018,Lopez Ramirez; Miguel Alej,20,0,20,0
1708258008516,PHAR 276,A00,415020,Mc Culloch; Andrew Douglas & Amaro; Rommie E,1,0,1,0
1708258009043,PHAR 295,A00,415022,Brown; Joan Heller,15,0,15,0
1708258009569,PHIL 1,A00,415023,Harrell; Maralee Mae,58,0,60,2
1708258010099,PHIL 10,A01,415026,Grush; Rick Scott,40,0,44,4
1708258010099,PHIL 10,A02,415028,Grush; Rick Scott,42,0,44,2
1708258010099,PHIL 10,A03,415029,Grush; Rick Scott,0,0,0,0
1708258010099,PHIL 10,A04,415031,Grush; Rick Scott,0,0,0,0
1708258010099,PHIL 10,A05,415113,Grush; Rick Scott,43,0,44,1
1708258010099,PHIL 10,A06,415114,Grush; Rick Scott,43,0,44,1
1708258010099,PHIL 10,A07,415116,Grush; Rick Scott,44,0,44,0
1708258010099,PHIL 10,A08,415118,Grush; Rick Scott,43,0,44,1
1708258010625,PHIL 12,A01,415120,McKenzie; Kerry V.,28,0,30,2
1708258010625,PHIL 12,A02,415136,McKenzie; Kerry V.,30,0,30,0
1708258010625,PHIL 12,A03,415137,McKenzie; Kerry V.,27,0,30,3
1708258010625,PHIL 12,A04,415142,McKenzie; Kerry V.,30,0,30,0
1708258011150,PHIL 13,A01,415165,Brink; David O.,25,0,25,0
1708258011150,PHIL 13,A02,415179,Brink; David O.,22,0,25,3
1708258011150,PHIL 13,A03,415185,Brink; David O.,24,0,25,1
1708258011150,PHIL 13,A04,415201,Brink; David O.,25,0,25,0
1708258011150,PHIL 13,A05,415204,Brink; David O.,25,0,25,0
1708258011150,PHIL 13,A06,415220,Brink; David O.,25,0,25,0
1708258011677,PHIL 15,A01,415250,Fulkerson; Matthew Todd,26,0,30,4
1708258011677,PHIL 15,A02,415281,Fulkerson; Matthew Todd,29,0,30,1
1708258012204,PHIL 27,A01,415293,Brandt; Reuven A,20,0,25,5
1708258012204,PHIL 27,A02,415296,Brandt; Reuven A,0,0,0,0
1708258012204,PHIL 27,A03,415332,Brandt; Reuven A,22,0,25,3
1708258012204,PHIL 27,A04,415333,Brandt; Reuven A,22,0,25,3
1708258012204,PHIL 27,A05,415342,Brandt; Reuven A,20,0,25,5
1708258012204,PHIL 27,A06,415384,Brandt; Reuven A,24,0,25,1
1708258012204,PHIL 27,A07,415385,Brandt; Reuven A,25,0,25,0
1708258012204,PHIL 27,A08,415391,Brandt; Reuven A,0,0,0,0
1708258012204,PHIL 27,A09,415406,Brandt; Reuven A,0,0,0,0
1708258012204,PHIL 27,A10,415407,Brandt; Reuven A,0,0,0,0
1708258012735,PHIL 28,A01,415412,Lamey; Andy M.,24,0,25,1
1708258012735,PHIL 28,A02,415470,Lamey; Andy M.,20,0,25,5
1708258012735,PHIL 28,A03,415474,Lamey; Andy M.,0,0,0,0
1708258012735,PHIL 28,A04,415475,Lamey; Andy M.,22,0,25,3
1708258012735,PHIL 28,A05,415487,Lamey; Andy M.,24,0,25,1
1708258012735,PHIL 28,A06,415506,Lamey; Andy M.,21,0,25,4
1708258012735,PHIL 28,A07,415507,Lamey; Andy M.,25,0,25,0
1708258012735,PHIL 28,A08,415508,Lamey; Andy M.,24,0,25,1
1708258012735,PHIL 28,A09,415509,Lamey; Andy M.,24,0,25,1
1708258012735,PHIL 28,A10,415510,Lamey; Andy M.,0,0,0,0
1708258013259,PHIL 33,A01,415521,Hardimon; Michael O.,35,0,35,0
1708258013259,PHIL 33,A02,415522,Hardimon; Michael O.,35,0,35,0
1708258013788,PHIL 60,A00,415523,Marechal; Patricia,55,0,60,5
1708258014312,PHIL 102,A00,415524,Johnson; Monte,37,0,40,3
1708258014841,PHIL 106,A00,415544,Watkins; Eric,40,0,40,0
1708258015367,PHIL 112,A00,415545,Watkins; Eric,34,0,40,6
1708258015894,PHIL 115,A00,415548,Nelkin; Dana Kay,20,0,20,0
1708258016424,PHIL 120,A00,415549,Carr; Jennifer Rose,64,0,65,1
1708258016950,PHIL 134,A00,415552,Carr; Jennifer Rose,40,0,40,0
1708258017475,PHIL 150,A00,415553,Cohen; Jonathan David,38,0,40,2
1708258018007,PHIL 171,A00,415561,Brink; David O.,39,0,40,1
1708258018533,PHIL 172,A00,415563,Lamey; Andy M.,40,0,40,0
1708258019059,PHIL 174,A01,415576,Danks; David J,20,0,25,5
1708258019059,PHIL 174,A02,415582,Danks; David J,22,0,25,3
1708258019059,PHIL 174,A03,415583,Danks; David J,24,0,25,1
1708258019059,PHIL 174,A04,415584,Danks; David J,25,0,25,0
1708258019589,PHIL 175,A00,415585,Shields; Christopher John,40,0,40,0
1708258020116,PHIL 181,A00,415601,Tolley; Clinton,34,0,40,6
1708258020646,PHIL 209B,A00,415655,Serlin; David,4,0,5,1
1708258021171,PHIL 209C,A00,415658,Gates; Kelly,5,0,5,0
1708258021698,PHIL 210,A00,415659,Marechal; Patricia,20,0,20,0
1708258022228,PHIL 230,A00,415661,Grush; Rick Scott,20,0,20,0
1708258022754,PHIL 232,A00,415662,Sher; Gila,20,0,20,0
1708258023281,PHIL 260,A00,415675,Bazargan-Forward; Saba,20,0,20,0
1708258023807,PHIL 277,A00,479176,Tolley; Clinton,9,0,10,1
1708258024334,PHIL 285,A00,415685,Kovaka; Karenc,20,0,20,0
1708258024864,PHIL 287,A00,415697,Marechal; Patricia,5,0,5,0
1708258025392,PHIL 290,001,415701,Nelkin; Dana Kay,9999,0,9999,0
1708258025392,PHIL 290,002,415721,Bazargan-Forward; Saba,9999,0,9999,0
1708258025392,PHIL 290,003,415731,Brandt; Reuven A,9999,0,9999,0
1708258025392,PHIL 290,004,415743,Brink; David O.,9999,0,9999,0
1708258025392,PHIL 290,005,415747,Callender; Craig Adam,9999,0,9999,0
1708258025392,PHIL 290,006,415779,Carr; Jennifer Rose,9999,0,9999,0
1708258025392,PHIL 290,007,415780,Cartwright; Nancy D.,9999,0,9999,0
1708258025392,PHIL 290,008,415781,Cohen; Jonathan David,9999,0,9999,0
1708258025392,PHIL 290,009,415782,Danks; David J,9999,0,9999,0
1708258025392,PHIL 290,010,415783,Fulkerson; Matthew Todd,9999,0,9999,0
1708258025392,PHIL 290,011,415784,Grush; Rick Scott,9999,0,9999,0
1708258025392,PHIL 290,012,415785,Hardimon; Michael O.,9999,0,9999,0
1708258025392,PHIL 290,013,415786,Harrell; Maralee Mae,9999,0,9999,0
1708258025392,PHIL 290,014,415787,Johnson; Monte,9999,0,9999,0
1708258025392,PHIL 290,015,415788,Kovaka; Karenc,9999,0,9999,0
1708258025392,PHIL 290,016,415789,Lamey; Andy M.,9999,0,9999,0
1708258025392,PHIL 290,017,415790,Marechal; Patricia,9999,0,9999,0
1708258025392,PHIL 290,018,415791,McKenzie; Kerry V.,9999,0,9999,0
1708258025392,PHIL 290,019,415792,Rickless; Samuel Charles,9999,0,9999,0
1708258025392,PHIL 290,020,415793,Sher; Gila,9999,0,9999,0
1708258025392,PHIL 290,021,415794,Shields; Christopher John,9999,0,9999,0
1708258025392,PHIL 290,022,415805,Tolley; Clinton,9999,0,9999,0
1708258025392,PHIL 290,023,415806,Vargas; Manuel Rogelio,9999,0,9999,0
1708258025392,PHIL 290,024,415807,Watkins; Eric,9999,0,9999,0
1708258025392,PHIL 290,025,415815,Chen; Keming,9999,0,9999,0
1708258025924,PHIL 295,001,415816,Bazargan-Forward; Saba,9999,0,9999,0
1708258025924,PHIL 295,002,415857,Brandt; Reuven A,9999,0,9999,0
1708258025924,PHIL 295,003,415858,Brink; David O.,9999,0,9999,0
1708258025924,PHIL 295,004,415877,Callender; Craig Adam,9999,0,9999,0
1708258025924,PHIL 295,005,415878,Carr; Jennifer Rose,9999,0,9999,0
1708258025924,PHIL 295,006,415884,Cartwright; Nancy D.,9999,0,9999,0
1708258025924,PHIL 295,007,415885,Chen; Keming,9999,0,9999,0
1708258025924,PHIL 295,008,415891,Cohen; Jonathan David,9999,0,9999,0
1708258025924,PHIL 295,009,415892,Danks; David J,9999,0,9999,0
1708258025924,PHIL 295,010,415937,Fulkerson; Matthew Todd,9999,0,9999,0
1708258025924,PHIL 295,011,415940,Grush; Rick Scott,9999,0,9999,0
1708258025924,PHIL 295,012,415945,Hardimon; Michael O.,9999,0,9999,0
1708258025924,PHIL 295,013,415946,Harrell; Maralee Mae,9999,0,9999,0
1708258025924,PHIL 295,014,415953,Johnson; Monte,9999,0,9999,0
1708258025924,PHIL 295,015,415954,Kovaka; Karenc,9999,0,9999,0
1708258025924,PHIL 295,016,415957,Lamey; Andy M.,9999,0,9999,0
1708258025924,PHIL 295,017,415958,Marechal; Patricia,9999,0,9999,0
1708258025924,PHIL 295,018,415959,McKenzie; Kerry V.,9999,0,9999,0
1708258025924,PHIL 295,019,415960,Nelkin; Dana Kay,9999,0,9999,0
1708258025924,PHIL 295,020,415961,Rickless; Samuel Charles,9999,0,9999,0
1708258025924,PHIL 295,021,415987,Sher; Gila,9999,0,9999,0
1708258025924,PHIL 295,022,416027,Shields; Christopher John,9999,0,9999,0
1708258025924,PHIL 295,023,416030,Tolley; Clinton,9999,0,9999,0
1708258025924,PHIL 295,024,416033,Vargas; Manuel Rogelio,9999,0,9999,0
1708258025924,PHIL 295,025,416034,Watkins; Eric,9999,0,9999,0
1708258026452,PHYA 224,A00,442106,Sandstrom; Karin Marie,30,0,30,0
1708258026979,PHYS 1A,A00,441607,Gilbert; Dylan Paul,346,0,362,16
1708258027506,PHYS 1AL,001,441608,Arlett; Jessica Lynn & Yagil; Avi,30,0,30,0
1708258027506,PHYS 1AL,002,441609,Arlett; Jessica Lynn & Yagil; Avi,28,0,30,2
1708258027506,PHYS 1AL,003,441610,Arlett; Jessica Lynn & Yagil; Avi,26,0,30,4
1708258027506,PHYS 1AL,004,441611,Arlett; Jessica Lynn & Yagil; Avi,29,0,30,1
1708258027506,PHYS 1AL,005,441612,Arlett; Jessica Lynn & Yagil; Avi,28,0,30,2
1708258027506,PHYS 1AL,006,441616,Arlett; Jessica Lynn & Yagil; Avi,28,0,30,2
1708258027506,PHYS 1AL,007,441618,Arlett; Jessica Lynn & Yagil; Avi,26,0,30,4
1708258027506,PHYS 1AL,008,441620,Arlett; Jessica Lynn & Yagil; Avi,29,0,30,1
1708258027506,PHYS 1AL,009,441623,Arlett; Jessica Lynn & Yagil; Avi,29,0,30,1
1708258027506,PHYS 1AL,010,441625,Arlett; Jessica Lynn & Yagil; Avi,29,0,30,1
1708258027506,PHYS 1AL,011,441626,Arlett; Jessica Lynn & Yagil; Avi,29,0,30,1
1708258027506,PHYS 1AL,012,441627,Arlett; Jessica Lynn & Yagil; Avi,29,0,30,1
1708258028035,PHYS 1B,A00,441630,Groisman; Alexander,351,0,362,11
1708258028562,PHYS 1BL,001,441632,Arlett; Jessica Lynn & Yagil; Avi,28,0,30,2
1708258028562,PHYS 1BL,002,441634,Arlett; Jessica Lynn & Yagil; Avi,29,0,30,1
1708258028562,PHYS 1BL,003,441636,Arlett; Jessica Lynn & Yagil; Avi,29,0,30,1
1708258028562,PHYS 1BL,004,441637,Arlett; Jessica Lynn & Yagil; Avi,29,0,30,1
1708258028562,PHYS 1BL,005,441639,Arlett; Jessica Lynn & Yagil; Avi,29,0,30,1
1708258028562,PHYS 1BL,006,441641,Arlett; Jessica Lynn & Yagil; Avi,26,0,30,4
1708258028562,PHYS 1BL,007,441642,Arlett; Jessica Lynn & Yagil; Avi,23,0,30,7
1708258028562,PHYS 1BL,008,441643,Arlett; Jessica Lynn & Yagil; Avi,30,0,30,0
1708258028562,PHYS 1BL,009,441646,Arlett; Jessica Lynn & Yagil; Avi,29,0,30,1
1708258028562,PHYS 1BL,010,441648,Arlett; Jessica Lynn & Yagil; Avi,29,0,30,1
1708258028562,PHYS 1BL,011,441652,Arlett; Jessica Lynn & Yagil; Avi,29,0,30,1
1708258028562,PHYS 1BL,012,441654,Arlett; Jessica Lynn & Yagil; Avi,30,0,30,0
1708258029095,PHYS 1C,A00,441658,Popmintchev; Tenio,587,0,600,13
1708258029095,PHYS 1C,B00,441662,Popmintchev; Tenio,558,0,600,42
1708258029639,PHYS 1CL,001,441664,Arlett; Jessica Lynn & Yagil; Avi,29,0,30,1
1708258029639,PHYS 1CL,002,441665,Arlett; Jessica Lynn & Yagil; Avi,27,0,30,3
1708258029639,PHYS 1CL,003,441666,Arlett; Jessica Lynn & Yagil; Avi,25,0,30,5
1708258029639,PHYS 1CL,004,441667,Arlett; Jessica Lynn & Yagil; Avi,30,0,30,0
1708258029639,PHYS 1CL,005,441668,Arlett; Jessica Lynn & Yagil; Avi,28,0,30,2
1708258029639,PHYS 1CL,006,441669,Arlett; Jessica Lynn & Yagil; Avi,25,0,30,5
1708258029639,PHYS 1CL,007,441671,Arlett; Jessica Lynn & Yagil; Avi,27,0,30,3
1708258029639,PHYS 1CL,008,441673,Arlett; Jessica Lynn & Yagil; Avi,30,0,30,0
1708258029639,PHYS 1CL,009,441674,Arlett; Jessica Lynn & Yagil; Avi,26,0,30,4
1708258029639,PHYS 1CL,010,441676,Arlett; Jessica Lynn & Yagil; Avi,30,0,30,0
1708258029639,PHYS 1CL,011,441677,Arlett; Jessica Lynn & Yagil; Avi,30,0,30,0
1708258029639,PHYS 1CL,012,441683,Arlett; Jessica Lynn & Yagil; Avi,30,0,30,0
1708258029639,PHYS 1CL,013,441685,Arlett; Jessica Lynn & Yagil; Avi,28,0,30,2
1708258029639,PHYS 1CL,014,441687,Arlett; Jessica Lynn & Yagil; Avi,30,0,30,0
1708258029639,PHYS 1CL,015,441689,Arlett; Jessica Lynn & Yagil; Avi,17,0,30,13
1708258029639,PHYS 1CL,016,441692,Arlett; Jessica Lynn & Yagil; Avi,29,0,30,1
1708258029639,PHYS 1CL,017,441696,Arlett; Jessica Lynn & Yagil; Avi,24,0,30,6
1708258029639,PHYS 1CL,018,441698,Arlett; Jessica Lynn & Yagil; Avi,25,0,30,5
1708258029639,PHYS 1CL,019,441702,Arlett; Jessica Lynn & Yagil; Avi,25,0,30,5
1708258029639,PHYS 1CL,020,441705,Arlett; Jessica Lynn & Yagil; Avi,29,0,30,1
1708258029639,PHYS 1CL,021,441706,Arlett; Jessica Lynn & Yagil; Avi,30,0,30,0
1708258029639,PHYS 1CL,022,441707,Arlett; Jessica Lynn & Yagil; Avi,30,0,30,0
1708258029639,PHYS 1CL,023,441708,Arlett; Jessica Lynn & Yagil; Avi,27,0,30,3
1708258029639,PHYS 1CL,024,441710,Arlett; Jessica Lynn & Yagil; Avi,29,0,30,1
1708258029639,PHYS 1CL,025,441711,Arlett; Jessica Lynn & Yagil; Avi,28,0,30,2
1708258029639,PHYS 1CL,026,441712,Arlett; Jessica Lynn & Yagil; Avi,29,0,30,1
1708258029639,PHYS 1CL,027,441713,Arlett; Jessica Lynn & Yagil; Avi,26,0,30,4
1708258029639,PHYS 1CL,028,441714,Arlett; Jessica Lynn & Yagil; Avi,29,0,30,1
1708258029639,PHYS 1CL,029,441715,Arlett; Jessica Lynn & Yagil; Avi,25,0,30,5
1708258029639,PHYS 1CL,030,441717,Arlett; Jessica Lynn & Yagil; Avi,29,0,30,1
1708258029639,PHYS 1CL,031,441718,Arlett; Jessica Lynn & Yagil; Avi,27,0,30,3
1708258029639,PHYS 1CL,032,441721,Arlett; Jessica Lynn & Yagil; Avi,30,0,30,0
1708258029639,PHYS 1CL,033,441724,Arlett; Jessica Lynn & Yagil; Avi,28,0,30,2
1708258029639,PHYS 1CL,034,441726,Arlett; Jessica Lynn & Yagil; Avi,29,0,30,1
1708258029639,PHYS 1CL,035,441728,Arlett; Jessica Lynn & Yagil; Avi,29,0,30,1
1708258029639,PHYS 1CL,036,441729,Arlett; Jessica Lynn & Yagil; Avi,30,0,30,0
1708258029639,PHYS 1CL,037,441730,Arlett; Jessica Lynn & Yagil; Avi,27,0,30,3
1708258029639,PHYS 1CL,038,441732,Arlett; Jessica Lynn & Yagil; Avi,29,0,30,1
1708258029639,PHYS 1CL,039,441733,Arlett; Jessica Lynn & Yagil; Avi,27,0,30,3
1708258029639,PHYS 1CL,040,441734,Arlett; Jessica Lynn & Yagil; Avi,30,0,30,0
1708258029639,PHYS 1CL,041,441735,Arlett; Jessica Lynn & Yagil; Avi,29,0,30,1
1708258029639,PHYS 1CL,042,441766,Arlett; Jessica Lynn & Yagil; Avi,30,0,30,0
1708258029639,PHYS 1CL,043,441768,Arlett; Jessica Lynn & Yagil; Avi,29,0,30,1
1708258029639,PHYS 1CL,044,441770,Arlett; Jessica Lynn & Yagil; Avi,30,0,30,0
1708258030169,PHYS 2A,A01,460308,Bal; Gurleen K,28,0,30,2
1708258030169,PHYS 2A,A02,460320,Bal; Gurleen K,30,0,30,0
1708258030169,PHYS 2A,A03,460321,Bal; Gurleen K,29,0,30,1
1708258030169,PHYS 2A,A04,460325,Bal; Gurleen K,28,0,30,2
1708258030169,PHYS 2A,A05,460326,Bal; Gurleen K,29,0,30,1
1708258030169,PHYS 2A,A06,460327,Bal; Gurleen K,30,0,30,0
1708258030169,PHYS 2A,A07,460495,Bal; Gurleen K,28,0,30,2
1708258030169,PHYS 2A,A08,460535,Bal; Gurleen K,27,0,30,3
1708258030169,PHYS 2A,A09,460536,Bal; Gurleen K,30,0,30,0
1708258030169,PHYS 2A,A10,460537,Bal; Gurleen K,30,0,30,0
1708258030169,PHYS 2A,A11,460538,Bal; Gurleen K,30,0,30,0
1708258030169,PHYS 2A,A12,460539,Bal; Gurleen K,30,0,30,0
1708258030714,PHYS 2B,A01,460620,Barreiro Guerrero; Julio,30,0,30,0
1708258030714,PHYS 2B,A02,460625,Barreiro Guerrero; Julio,30,0,30,0
1708258030714,PHYS 2B,A03,460626,Barreiro Guerrero; Julio,29,0,30,1
1708258030714,PHYS 2B,A04,460716,Barreiro Guerrero; Julio,26,0,30,4
1708258030714,PHYS 2B,A05,460756,Barreiro Guerrero; Julio,29,0,30,1
1708258030714,PHYS 2B,A06,460837,Barreiro Guerrero; Julio,30,0,30,0
1708258030714,PHYS 2B,A07,460865,Barreiro Guerrero; Julio,30,0,30,0
1708258030714,PHYS 2B,A08,460866,Barreiro Guerrero; Julio,30,0,30,0
1708258030714,PHYS 2B,A09,460867,Barreiro Guerrero; Julio,29,0,30,1
1708258030714,PHYS 2B,A10,460868,Barreiro Guerrero; Julio,30,0,30,0
1708258030714,PHYS 2B,A11,460869,Barreiro Guerrero; Julio,30,0,30,0
1708258030714,PHYS 2B,A12,460874,Barreiro Guerrero; Julio,30,0,30,0
1708258030714,PHYS 2B,B01,469381,Barreiro Guerrero; Julio,30,0,30,0
1708258030714,PHYS 2B,B02,469382,Barreiro Guerrero; Julio,29,0,30,1
1708258030714,PHYS 2B,B03,469402,Barreiro Guerrero; Julio,27,0,30,3
1708258030714,PHYS 2B,B04,469403,Barreiro Guerrero; Julio,28,0,30,2
1708258030714,PHYS 2B,B05,469442,Barreiro Guerrero; Julio,30,0,30,0
1708258030714,PHYS 2B,B06,469449,Barreiro Guerrero; Julio,30,0,30,0
1708258030714,PHYS 2B,B07,469450,Barreiro Guerrero; Julio,29,0,30,1
1708258030714,PHYS 2B,B08,469451,Barreiro Guerrero; Julio,30,0,30,0
1708258030714,PHYS 2B,B09,469457,Barreiro Guerrero; Julio,29,0,30,1
1708258030714,PHYS 2B,B10,469460,Barreiro Guerrero; Julio,30,0,30,0
1708258030714,PHYS 2B,B11,469468,Barreiro Guerrero; Julio,30,0,30,0
1708258030714,PHYS 2B,B12,469475,Barreiro Guerrero; Julio,30,0,30,0
1708258031242,PHYS 2BL,A01,441779,Meyertholen; Andrew D.,21,0,24,3
1708258031242,PHYS 2BL,A02,441780,Meyertholen; Andrew D.,17,0,24,7
1708258031242,PHYS 2BL,A03,441781,Meyertholen; Andrew D.,20,0,24,4
1708258031242,PHYS 2BL,A04,441782,Meyertholen; Andrew D.,21,0,24,3
1708258031242,PHYS 2BL,A05,441784,Meyertholen; Andrew D.,23,0,24,1
1708258031242,PHYS 2BL,A06,441786,Meyertholen; Andrew D.,23,0,24,1
1708258031242,PHYS 2BL,A07,441788,Meyertholen; Andrew D.,23,0,24,1
1708258031242,PHYS 2BL,A08,441790,Meyertholen; Andrew D.,24,0,24,0
1708258031242,PHYS 2BL,A09,441792,Meyertholen; Andrew D.,24,0,24,0
1708258031242,PHYS 2BL,A10,441794,Meyertholen; Andrew D.,23,0,24,1
1708258031242,PHYS 2BL,A11,441796,Meyertholen; Andrew D.,22,0,24,2
1708258031242,PHYS 2BL,A12,441798,Meyertholen; Andrew D.,24,0,24,0
1708258031242,PHYS 2BL,A13,441800,Meyertholen; Andrew D.,24,0,24,0
1708258031242,PHYS 2BL,A14,441802,Meyertholen; Andrew D.,24,0,24,0
1708258031242,PHYS 2BL,A15,441804,Meyertholen; Andrew D.,23,0,24,1
1708258031770,PHYS 2C,A01,460540,Tan; Tzer Han,30,0,30,0
1708258031770,PHYS 2C,A02,460541,Tan; Tzer Han,28,0,30,2
1708258031770,PHYS 2C,A03,460542,Tan; Tzer Han,28,0,30,2
1708258031770,PHYS 2C,A04,460543,Tan; Tzer Han,28,0,30,2
1708258031770,PHYS 2C,A05,460544,Tan; Tzer Han,28,0,30,2
1708258031770,PHYS 2C,A06,460545,Tan; Tzer Han,29,0,30,1
1708258031770,PHYS 2C,A07,460553,Tan; Tzer Han,30,0,30,0
1708258031770,PHYS 2C,A08,460561,Tan; Tzer Han,30,0,30,0
1708258031770,PHYS 2C,A09,460562,Tan; Tzer Han,28,0,30,2
1708258031770,PHYS 2C,A10,460563,Tan; Tzer Han,29,0,30,1
1708258031770,PHYS 2C,A11,460567,Tan; Tzer Han,30,0,30,0
1708258031770,PHYS 2C,A12,460568,Tan; Tzer Han,28,0,30,2
1708258032297,PHYS 2CL,A01,441809,Ni; Kaixuan,25,0,28,3
1708258032297,PHYS 2CL,A02,441811,Ni; Kaixuan,27,0,28,1
1708258032297,PHYS 2CL,A03,441814,Ni; Kaixuan,23,0,28,5
1708258032297,PHYS 2CL,A04,441817,Ni; Kaixuan,28,0,28,0
1708258032297,PHYS 2CL,A05,441819,Ni; Kaixuan,26,0,28,2
1708258032297,PHYS 2CL,A06,441820,Ni; Kaixuan,27,0,28,1
1708258032829,PHYS 2D,A01,460569,Sharma; Vivek A.,24,0,25,1
1708258032829,PHYS 2D,A02,460574,Sharma; Vivek A.,24,0,25,1
1708258032829,PHYS 2D,A03,460575,Sharma; Vivek A.,25,0,25,0
1708258033357,PHYS 4B,A01,441829,Grinstein; Benjamin,34,0,38,4
1708258033357,PHYS 4B,A02,441831,Grinstein; Benjamin,30,0,32,2
1708258033357,PHYS 4B,A03,441832,Grinstein; Benjamin,30,0,30,0
1708258033357,PHYS 4B,A04,441833,Grinstein; Benjamin,30,0,30,0
1708258033884,PHYS 4E,A01,441907,Frano Pereira; Alex M,33,0,34,1
1708258033884,PHYS 4E,A02,441958,Frano Pereira; Alex M,34,0,34,0
1708258034410,PHYS 10,A01,441971,Burgasser; Adam Jonathan,118,0,120,2
1708258034935,PHYS 13,A01,441974,Wright; Shelley Adams,61,0,65,4
1708258035460,PHYS 87,A00,486898,Grinstein; Benjamin,19,0,20,1
1708258035990,PHYS 100C,A01,441978,Averitt; Richard Douglas,58,0,60,2
1708258036516,PHYS 105B,A01,441985,Green; Daniel Richard,37,0,40,3
1708258037043,PHYS 120,A01,441995,Arnold; Kam S,40,0,44,4
1708258037043,PHYS 120,A02,442011,Arnold; Kam S,41,0,44,3
1708258037573,PHYS 130A,A01,442032,Parker; Daniel E,74,0,75,1
1708258038099,PHYS 130B,A01,442056,Branson; James G,47,0,50,3
1708258038630,PHYS 139,A00,442057,Jun; Suckjoon,30,0,30,0
1708258038630,PHYS 139,B00,442059,Duarte; Javier Mauricio & Li; Aobo,42,0,50,8
1708258039157,PHYS 140A,A01,442065,Shotwell; Brian,49,0,50,1
1708258039684,PHYS 152B,A01,442067,Hirsch; Jorge Eduardo,16,0,20,4
1708258040214,PHYS 154,A01,442069,Jenkins; Elizabeth,29,0,30,1
1708258040740,PHYS 162,A01,442096,Keating; Brian,64,0,65,1
1708258041270,PHYS 170,A01,486870,Oh; Seungeun,39,0,40,1
1708258041795,PHYS 177,A00,442103,Dudko; Olga,20,0,20,0
1708258042322,PHYS 203B,A01,442132,Fogler; Michael M.,20,0,20,0
1708258042852,PHYS 210A,A01,442143,Hwa; Terence T.,20,0,20,0
1708258043379,PHYS 212C,A01,442200,Chivukula; Raja S,18,0,20,2
1708258043959,PHYS 215C,A00,442201,Intriligator; Kenneth Arthur,19,0,20,1
1708258044491,PHYS 225C,A01,442203,Flauger; Raphael M,19,0,20,1
1708258045017,PHYS 227,A00,442204,Tytler; David Robert,29,0,30,1
1708258045545,PHYS 230,A01,442206,McGreevy; John A.,20,0,20,0
1708258046071,PHYS 239,A00,442207,Goldenfeld; Nigel,20,0,20,0
1708258046071,PHYS 239,B00,442208,Duarte; Javier Mauricio & Li; Aobo,5,0,5,0
1708258046597,PHYS 244,A01,442280,Norman; Michael L,12,0,20,8
1708258047124,PHYS 250,A00,442300,Fogler; Michael M.,50,0,50,0
1708258047652,PHYS 251,A00,442307,Grinstein; Benjamin,20,0,20,0
1708258048177,PHYS 252,A00,442348,Diamond; Patrick H,10,0,10,0
1708258048702,PHYS 253,A00,442349,Theissen; Christopher Alexander,30,0,30,0
1708258049228,PHYS 254,A00,442352,Hwa; Terence T.,30,0,30,0
1708258049756,PHYS 255,A00,442423,Hwa; Terence T.,30,0,30,0
1708258050283,PHYS 258,A00,442426,Theissen; Christopher Alexander,30,0,30,0
1708258050811,PHYS 260,A00,442427,Frano Pereira; Alex M,50,0,50,0
1708258051341,PHYS 277,A00,442428,Dudko; Olga,20,0,20,0
1708258051876,POLI 5D,A01,419010,Dai; Yinlin,5,0,7,2
1708258051876,POLI 5D,A02,419020,Dai; Yinlin,7,0,7,0
1708258051876,POLI 5D,A03,419022,Dai; Yinlin,4,0,6,2
1708258051876,POLI 5D,A04,419040,Dai; Yinlin,5,0,5,0
1708258051876,POLI 5D,B01,419065,Dai; Yinlin,7,0,7,0
1708258051876,POLI 5D,B02,419068,Dai; Yinlin,7,0,7,0
1708258051876,POLI 5D,B03,419069,Dai; Yinlin,6,0,6,0
1708258051876,POLI 5D,B04,419070,Dai; Yinlin,5,0,5,0
1708258051876,POLI 5D,C01,487211,Staff,3,0,5,2
1708258052402,POLI 11D,A01,419072,Desposato; Scott,32,0,34,2
1708258052402,POLI 11D,A02,419073,Desposato; Scott,33,0,34,1
1708258052402,POLI 11D,A03,419082,Desposato; Scott,32,0,34,2
1708258052402,POLI 11D,A04,419123,Desposato; Scott,34,0,34,0
1708258052402,POLI 11D,A05,419124,Desposato; Scott,34,0,34,0
1708258052402,POLI 11D,A06,419125,Desposato; Scott,34,0,34,0
1708258052932,POLI 12D,A01,419127,Gartzke; Erik,29,0,34,5
1708258052932,POLI 12D,A02,419128,Gartzke; Erik,34,0,34,0
1708258052932,POLI 12D,A03,419129,Gartzke; Erik,34,0,34,0
1708258052932,POLI 12D,A04,419130,Gartzke; Erik,34,0,34,0
1708258052932,POLI 12D,A05,419131,Gartzke; Erik,32,0,34,2
1708258052932,POLI 12D,A06,419168,Gartzke; Erik,34,0,34,0
1708258053458,POLI 13DR,A01,477733,Draper; Matthew William,28,0,34,6
1708258053458,POLI 13DR,A02,477734,Draper; Matthew William,32,0,34,2
1708258053458,POLI 13DR,A03,477736,Draper; Matthew William,33,0,34,1
1708258053458,POLI 13DR,A04,477737,Draper; Matthew William,32,0,34,2
1708258053458,POLI 13DR,A05,477739,Draper; Matthew William,31,0,34,3
1708258053458,POLI 13DR,A06,477740,Draper; Matthew William,34,0,34,0
1708258053985,POLI 30D,A01,419179,Desposato; Scott,19,0,28,9
1708258053985,POLI 30D,A02,419180,Desposato; Scott,25,0,28,3
1708258053985,POLI 30D,A03,419181,Desposato; Scott,27,0,28,1
1708258053985,POLI 30D,A04,419182,Desposato; Scott,28,0,28,0
1708258053985,POLI 30D,A05,419187,Desposato; Scott,24,0,28,4
1708258053985,POLI 30D,A06,419189,Desposato; Scott,28,0,28,0
1708258054514,POLI 100E,A00,419191,Pitcher; Kennedy Anell,105,0,115,10
1708258055040,POLI 104P,A00,419192,Orfield; Michael Bennett,183,0,196,13
1708258055569,POLI 104U,A00,419193,Nichter; Maysa,88,0,115,27
1708258056094,POLI 108,A00,419194,Adida; Claire,293,0,295,2
1708258056620,POLI 110C,A00,419195,Soon; Valerie,47,0,50,3
1708258057150,POLI 120D,A00,419207,Hansen; Jan Eric,48,0,50,2
1708258057677,POLI 124A,A00,419209,Fortunato; David,48,0,50,2
1708258058212,POLI 131CR,A00,419211,Hoston; Germaine,41,0,50,9
1708258058212,POLI 131CR,B00,481592,Hoston; Germaine,10,0,10,0
1708258058738,POLI 136A,A00,419212,Roeder; Philip G,111,0,115,4
1708258059263,POLI 140D,A00,419213,Wong; Tak Kei,183,0,192,9
1708258059792,POLI 142D,A00,419214,Gartzke; Erik,227,0,230,3
1708258060333,POLI 145C,A00,419222,Fisk; David Lee,101,0,115,14
1708258060862,POLI 150A,A00,419225,Wong; Tak Kei,216,0,230,14
1708258061388,POLI 170A,A00,419226,Skillman; Rachel Diane,115,0,115,0
1708258061918,POLI 179,A00,419238,Staff,95,0,104,9
1708258062443,POLI 194,A00,455332,Hill; Seth J,0,0,0,0
1708258062967,POLI 194SD,A00,419248,Nichter; Maysa,999,0,999,0
1708258063496,POLI 197SD,001,419258,Nichter; Maysa,999,0,999,0
1708258064023,POLI 203B,A00,419265,Slantchev; Branislav,21,0,25,4
1708258064547,POLI 214R,A00,419275,Hoston; Germaine,23,0,25,2
1708258065073,POLI 219,A00,419289,Soon; Valerie,24,0,25,1
1708258065599,POLI 220A,A00,419299,Ferree; Karen E,21,0,25,4
1708258066125,POLI 233,A00,419333,Adida; Claire,23,0,25,2
1708258066654,POLI 243,A00,479118,Joseph; Michael F,23,0,25,2
1708258067180,POLI 251,A00,419334,Ban; Pamela M,23,0,25,2
1708258067710,POLI 257,A00,419335,Hill; Seth J,25,0,25,0
1708258068236,POLI 273,A00,419336,Mignozzetti; Umberto,16,0,25,9
1708258068763,POLI 280,A00,419337,Hafner-Burton; Emilie,18,0,25,7
1708258069292,POLI 281,A00,419338,Ban; Pamela M,21,0,25,4
1708258069817,POLI 282,A00,419339,Ferree; Karen E,19,0,25,6
1708258070343,POLI 283,A00,419340,Naoi; Megumi,23,0,25,2
1708258070871,POLI 285,A00,419341,Ingham; Sean,25,0,25,0
1708258071396,POLI 286,A00,419342,Mignozzetti; Umberto,23,0,25,2
1708258071925,POLI 288,A00,479174,Fowler; James,13,0,15,2
1708258072450,PSY 296,001,465760,Besterman; Aaron David,49,0,50,1
1708258072450,PSY 296,002,465765,Eyler; Lisa T.,49,0,50,1
1708258072450,PSY 296,003,465767,Patel; Ekta Himanshu,49,0,50,1
1708258072976,PSYC 3R,A00,419378,Pilegard; Celeste Cristine,314,0,325,11
1708258073502,PSYC 7,A00,419384,Powell; Lindsey Jane,288,0,295,7
1708258074036,PSYC 60,A01,460208,Lowe; Angela Beth,31,0,35,4
1708258074036,PSYC 60,A02,460209,Lowe; Angela Beth,28,0,35,7
1708258074036,PSYC 60,A03,460210,Lowe; Angela Beth,35,0,35,0
1708258074036,PSYC 60,A04,460211,Lowe; Angela Beth,33,0,35,2
1708258074036,PSYC 60,A05,460212,Lowe; Angela Beth,34,0,35,1
1708258074036,PSYC 60,A06,460213,Lowe; Angela Beth,35,0,35,0
1708258074036,PSYC 60,A07,460214,Lowe; Angela Beth,33,0,35,2
1708258074036,PSYC 60,B01,460215,Rose; Fred E.,35,0,35,0
1708258074036,PSYC 60,B02,460216,Rose; Fred E.,35,0,35,0
1708258074036,PSYC 60,B03,460218,Rose; Fred E.,35,0,35,0
1708258074036,PSYC 60,B04,460219,Rose; Fred E.,35,0,35,0
1708258074036,PSYC 60,B05,460220,Rose; Fred E.,32,0,35,3
1708258074036,PSYC 60,B06,460221,Rose; Fred E.,35,0,35,0
1708258074036,PSYC 60,B07,460222,Rose; Fred E.,35,0,35,0
1708258074564,PSYC 70,A01,460223,Pilegard; Celeste Cristine,29,0,35,6
1708258074564,PSYC 70,A02,460224,Pilegard; Celeste Cristine,32,0,35,3
1708258074564,PSYC 70,A03,460225,Pilegard; Celeste Cristine,34,0,35,1
1708258074564,PSYC 70,A04,460266,Pilegard; Celeste Cristine,33,0,35,2
1708258074564,PSYC 70,A05,460267,Pilegard; Celeste Cristine,35,0,35,0
1708258074564,PSYC 70,A06,460277,Pilegard; Celeste Cristine,34,0,35,1
1708258075089,PSYC 71,A01,419620,Staff,19,0,21,2
1708258075089,PSYC 71,A02,419662,Staff,20,0,21,1
1708258075089,PSYC 71,B01,419682,Geller; Emma Harlan,24,0,25,1
1708258075089,PSYC 71,B02,419732,Geller; Emma Harlan,26,0,26,0
1708258075615,PSYC 88,A00,419733,Dobkins; Karen R.,47,0,65,18
1708258076142,PSYC 100,A00,419734,Chapman; Eddie Nathaniel,388,0,410,22
1708258076668,PSYC 101,A00,419735,Walker; Caren Michelle,272,0,295,23
1708258077197,PSYC 102,A00,419779,Moranton; Nirelia Melbina-,292,0,295,3
1708258077724,PSYC 104,A00,419880,Fine; Rachel,267,0,295,28
1708258078251,PSYC 105,A00,419946,Lowe; Angela Beth,276,0,295,19
1708258078779,PSYC 111B,A01,419948,Geller; Emma Harlan,35,0,35,0
1708258079304,PSYC 116C,A01,420046,Lang; Ariel,25,0,25,0
1708258079830,PSYC 117,A01,420092,Bajic; Daniel Andrew,25,0,25,0
1708258080359,PSYC 118,A01,420095,Miller; Cory T.,37,0,45,8
1708258080884,PSYC 124,A00,420096,Chapman; Eddie Nathaniel,381,0,410,29
1708258081412,PSYC 127,A00,420097,Dickenson; Janna Alene,14,0,20,6
1708258081938,PSYC 132,A00,420121,Staff,114,0,120,6
1708258082467,PSYC 133R,A01,420172,Golden; Susan S. & Gorman; Michael R.,10,0,16,6
1708258082467,PSYC 133R,A02,420173,Golden; Susan S. & Gorman; Michael R.,16,0,16,0
1708258082467,PSYC 133R,A03,420175,Golden; Susan S. & Gorman; Michael R.,16,0,16,0
1708258082467,PSYC 133R,A04,420249,Golden; Susan S. & Gorman; Michael R.,13,0,16,3
1708258082996,PSYC 134,A00,420311,Kaye; Walter H.,296,0,300,4
1708258083522,PSYC 137,A00,420312,Lin; Chujun,292,0,295,3
1708258084047,PSYC 144,A00,420313,Wixted; John T,287,0,295,8
1708258084577,PSYC 147,A00,420315,Wong; Lauren Hitomi,120,0,146,26
1708258085104,PSYC 164,A00,420328,Kaplan; Paul,259,0,295,36
1708258085630,PSYC 172,A00,420336,Dickenson; Janna Alene,294,0,300,6
1708258086161,PSYC 178,A00,420337,Glaser; Dale,131,0,146,15
1708258086687,PSYC 179,A00,420338,Lacefield; Katharine I,256,0,328,72
1708258087218,PSYC 181,A00,420339,Anagnostaras; Stephan,333,0,350,17
1708258087748,PSYC 184,A00,420367,Wilson; Brent M,275,0,295,20
1708258088274,PSYC 188,A00,420368,Lacefield; Katharine I,234,0,300,66
1708258088803,PSYC 190,A00,420378,Barner; David A.,374,0,395,21
1708258089330,PSYC 193,B00,420626,Brashier; Nadia Marie,215,0,216,1
1708258089330,PSYC 193,C00,420643,Gremel; Christina M,33,0,35,2
1708258089859,PSYC 193L,A01,420817,Brown; Sandra A,65,0,65,0
1708258089859,PSYC 193L,B01,420830,Staff,26,0,30,4
1708258089859,PSYC 193L,C01,420832,Staff,49,0,49,0
1708258089859,PSYC 193L,D01,420834,Staff,27,0,30,3
1708258089859,PSYC 193L,E01,493996,Aron; Adam,24,0,24,0
1708258090391,PSYC 194C,A01,420905,Heyman; Gail D.,1,0,1,0
1708258090920,PSYC 205,A00,420906,Harris; Christine Renee,17,0,20,3
1708258091446,PSYC 218,A00,420907,Brady; Timothy Francis,11,0,20,9
1708258091974,PSYC 224,A00,420908,Gremel; Christina M,30,0,30,0
1708258092500,PSYC 242,A00,421469,Walker; Caren Michelle,27,0,30,3
1708258093026,PSYC 247,A00,421473,Walker; Caren Michelle,14,0,20,6
1708258093555,PSYC 270C,A00,421554,Dobkins; Karen R.,13,0,20,7
1708258094081,PSYC 272,A00,421561,Gentner; Tim,20,0,20,0
1708258094606,PSYC 274,A00,421564,McCullough; Michael E,29,0,30,1
1708258095133,PSYC 275,A00,421620,Staff,23,0,30,7
1708258095658,PSYC 276,A00,421622,McCullough; Michael E,14,0,20,6
1708258096188,PSYC 280,A00,421623,Serences; John Thomas,76,0,85,9
1708258096718,PSYC 296,001,421667,Anagnostaras; Stephan,9999,0,9999,0
1708258096718,PSYC 296,002,421773,Aron; Adam,9999,0,9999,0
1708258096718,PSYC 296,003,421794,Mukku; Dhananjaya,9999,0,9999,0
1708258096718,PSYC 296,004,421795,Barner; David A.,9998,0,9999,1
1708258096718,PSYC 296,005,421796,Schachner; Adena,9999,0,9999,0
1708258096718,PSYC 296,006,421797,Brown; Sandra A,9999,0,9999,0
1708258096718,PSYC 296,007,421798,Chapman; Eddie Nathaniel,9999,0,9999,0
1708258096718,PSYC 296,008,421799,Dickenson; Janna Alene,9999,0,9999,0
1708258096718,PSYC 296,009,421800,Dobkins; Karen R.,9998,0,9999,1
1708258096718,PSYC 296,010,421801,Fan; Judith Ellen,9999,0,9999,0
1708258096718,PSYC 296,011,421803,Ferreira; Victor,9999,0,9999,0
1708258096718,PSYC 296,012,421814,Geller; Emma Harlan,9998,0,9999,1
1708258096718,PSYC 296,013,422102,Gentner; Tim,9999,0,9999,0
1708258096718,PSYC 296,014,422103,Gorman; Michael R.,9999,0,9999,0
1708258096718,PSYC 296,015,422104,Gremel; Christina M,9999,0,9999,0
1708258096718,PSYC 296,016,422106,Harris; Christine Renee,9999,0,9999,0
1708258096718,PSYC 296,017,422107,Heyman; Gail D.,9999,0,9999,0
1708258096718,PSYC 296,018,422108,McCullough; Michael E,9999,0,9999,0
1708258096718,PSYC 296,019,422109,Mc Kenzie; Craig R.M.,9999,0,9999,0
1708258096718,PSYC 296,020,422122,Miller; Cory T.,9999,0,9999,0
1708258096718,PSYC 296,021,422123,Pashler; Harold E,9999,0,9999,0
1708258096718,PSYC 296,022,422124,Pilegard; Celeste Cristine,9999,0,9999,0
1708258096718,PSYC 296,023,422125,Powell; Lindsey Jane,9999,0,9999,0
1708258096718,PSYC 296,025,422127,Rickard; Timothy C.,9998,0,9999,1
1708258096718,PSYC 296,026,422128,Serences; John Thomas,9998,0,9999,1
1708258096718,PSYC 296,027,422130,Walker; Caren Michelle,9998,0,9999,1
1708258096718,PSYC 296,028,422132,Winkielman; Piotr,9999,0,9999,0
1708258096718,PSYC 296,029,422134,Wixted; John T,9996,0,9999,3
1708258096718,PSYC 296,030,422146,Brady; Timothy Francis,9998,0,9999,1
1708258096718,PSYC 296,031,422154,Carver; Leslie J.,9999,0,9999,0
1708258096718,PSYC 296,032,422161,Lin; Chujun,9999,0,9999,0
1708258096718,PSYC 296,033,422169,Brashier; Nadia Marie,9998,0,9999,1
1708258096718,PSYC 296,034,422177,Oesch; Nicholas W,9999,0,9999,0
1708258097299,RAD 296,001,465795,Staff,50,0,50,0
1708258097299,RAD 296,002,465796,Staff,50,0,50,0
1708258097299,RAD 296,003,465797,Staff,50,0,50,0
1708258097828,RELI 150,A00,419353,Rahimi; Babak,37,0,40,3
1708258098353,REV 87,A00,422721,Lyon; Antony J.,19,0,20,1
1708258098883,RMAS 296,001,465827,Murphy; James D,49,0,50,1
1708258098883,RMAS 296,002,465828,Staff,50,0,50,0
1708258098883,RMAS 296,003,465831,Staff,50,0,50,0
1708258099409,RMED 296,001,466791,Staff,50,0,50,0
1708258099409,RMED 296,002,466792,Staff,50,0,50,0
1708258099409,RMED 296,003,466793,Staff,50,0,50,0
1708258099940,SE 3,A01,446938,Van Den Einde; Yael Dahlia,50,0,52,2
1708258099940,SE 3,A02,446942,Van Den Einde; Yael Dahlia,49,0,52,3
1708258099940,SE 3,A03,446948,Van Den Einde; Yael Dahlia,52,0,53,1
1708258099940,SE 3,A04,446965,Van Den Einde; Yael Dahlia,53,0,53,0
1708258100466,SE 9,A01,447015,Kuester; Falko,30,0,34,4
1708258100466,SE 9,A02,447017,Kuester; Falko,33,0,33,0
1708258100466,SE 9,A03,447022,Kuester; Falko,31,0,33,2
1708258100991,SE 101B,A01,447040,Kosmatka; John B,55,0,56,1
1708258101523,SE 105,A01,447042,Qiao; Yu,118,0,120,2
1708258102049,SE 110A,A01,467467,Asaro; Robert J,56,0,56,0
1708258102576,SE 110B,A00,447045,Zhu; Qiang,122,0,125,3
1708258103103,SE 130B,A01,447049,Chadha; Mayank,92,0,100,8
1708258103629,SE 131A,A01,447059,Krysl; Petr,102,0,110,8
1708258104155,SE 132,A01,447078,Chen; Jiun-Shyan,48,0,50,2
1708258104685,SE 140B,A01,447086,Restrepo; Jose,29,0,34,5
1708258104685,SE 140B,A02,447123,Restrepo; Jose,21,0,33,12
1708258104685,SE 140B,A03,447124,Restrepo; Jose,30,0,33,3
1708258105212,SE 143B,A01,447133,Tehrani; Mehran,11,0,15,4
1708258105212,SE 143B,A02,447134,Tehrani; Mehran,12,0,15,3
1708258105737,SE 150A,A01,447136,Uang; Chia-Ming,94,0,100,6
1708258106262,SE 150B,A01,447214,Morrison; Machel Leigh,49,0,50,1
1708258106793,SE 151B,A00,447215,Shing; P. Benson,71,0,75,4
1708258107319,SE 160B,A01,467468,Kim; Hyunsun Alicia,91,0,100,9
1708258107849,SE 165,A00,447238,Farrar; Charles R.,9,0,10,1
1708258108376,SE 184,A00,447253,Hutchinson; Tara,20,0,20,0
1708258108900,SE 202,A00,447392,Kosmatka; John B,25,0,30,5
1708258109428,SE 204,A00,447482,Todd; Michael,12,0,20,8
1708258109958,SE 206,A00,447483,Conte; Joel P,30,0,30,0
1708258110483,SE 213,A00,447499,Palermo; Alessandro,17,0,30,13
1708258111011,SE 215,A00,447500,Zhu; Qiang,34,0,45,11
1708258111540,SE 222,A00,447507,Elgamal; Ahmed,30,0,30,0
1708258112065,SE 227,A00,447576,Hutchinson; Tara,20,0,25,5
1708258112592,SE 244,A00,447577,Elgamal; Ahmed,29,0,30,1
1708258113116,SE 247,A00,447580,Hutchinson; Tara,0,0,5,5
1708258113643,SE 251B,A00,447612,Qiao; Yu,15,0,25,10
1708258114172,SE 253B,A00,447613,Kim; Hyonny,28,0,30,2
1708258114698,SE 260B,A00,447614,Kim; Hyunsun Alicia,10,0,10,0
1708258115224,SE 265,A00,447615,Farrar; Charles R.,20,0,25,5
1708258115755,SE 266,A00,447616,Loh; Chin Hsiung,23,0,25,2
1708258116822,SE 280,A00,447650,Krysl; Petr,22,0,25,3
1708258117348,SE 281,A01,447658,Kuester; Falko,12,0,30,18
1708258117875,SE 290,A00,447659,Qiao; Yu,78,0,100,22
1708258118407,SE 296,001,447666,Asaro; Robert J,9999,0,9999,0
1708258118407,SE 296,002,447669,Chen; Jiun-Shyan,9999,0,9999,0
1708258118407,SE 296,003,447689,Conte; Joel P,9999,0,9999,0
1708258118407,SE 296,004,447690,Elgamal; Ahmed,9999,0,9999,0
1708258118407,SE 296,005,447728,Hutchinson; Tara,9999,0,9999,0
1708258118407,SE 296,006,447733,Jandaghi Semnani; Shabnam,9999,0,9999,0
1708258118407,SE 296,007,447734,Kim; Hyonny,9999,0,9999,0
1708258118407,SE 296,008,447737,Kim; Hyunsun Alicia,9999,0,9999,0
1708258118407,SE 296,009,447738,Kosmatka; John B,9999,0,9999,0
1708258118407,SE 296,010,447739,Krysl; Petr,9999,0,9999,0
1708258118407,SE 296,011,447740,Kuester; Falko,9999,0,9999,0
1708258118407,SE 296,012,447741,Lanza Di Scalea; Francesco,9999,0,9999,0
1708258118407,SE 296,013,447742,Loh; Kenneth J. H.,9999,0,9999,0
1708258118407,SE 296,014,447745,McCartney; John Scott,9999,0,9999,0
1708258118407,SE 296,015,447747,Morrison; Machel Leigh,9999,0,9999,0
1708258118407,SE 296,016,447749,Mosqueda; Gilberto,9999,0,9999,0
1708258118407,SE 296,017,447874,Qiao; Yu,9999,0,9999,0
1708258118407,SE 296,018,447875,Restrepo; Jose,9999,0,9999,0
1708258118407,SE 296,019,447886,Shing; P. Benson,9999,0,9999,0
1708258118407,SE 296,020,447887,Todd; Michael,9999,0,9999,0
1708258118407,SE 296,021,447888,Tomac; Ingrid,9999,0,9999,0
1708258118407,SE 296,022,447889,Tsampras; Georgios,9999,0,9999,0
1708258118407,SE 296,023,447890,Uang; Chia-Ming,9999,0,9999,0
1708258118407,SE 296,024,447931,Van Den Einde; Yael Dahlia,9999,0,9999,0
1708258118407,SE 296,025,447932,Zhu; Qiang,9999,0,9999,0
1708258118407,SE 296,026,448007,Tehrani; Mehran,9999,0,9999,0
1708258118407,SE 296,027,448008,Palermo; Alessandro,9999,0,9999,0
1708258118407,SE 296,028,492941,Farrar; Charles R.,9998,0,9999,1
1708258118934,SIO 10,A00,446025,Borsa; Adrian Antal,573,0,590,17
1708258119464,SIO 16,A00,446031,Gee; Jeffrey S,119,0,120,1
1708258119990,SIO 50,A01,446057,Cook; Geoffrey W,19,0,22,3
1708258119990,SIO 50,A02,446058,Cook; Geoffrey W,21,0,22,1
1708258120517,SIO 75,A00,446060,Norris; Richard D.,32,0,35,3
1708258121049,SIO 87,A00,479215,Feddersen; Falk & Morzfeld; Matthias,20,0,20,0
1708258121049,SIO 87,B00,489613,Cook; Geoffrey W,19,0,20,1
1708258121049,SIO 87,C00,489620,Cook; Geoffrey W,20,0,20,0
1708258121575,SIO 90,A00,446061,Staff,61,0,70,9
1708258122107,SIO 113,A01,446064,May; David Alexander,27,0,30,3
1708258123159,SIO 128,A00,446115,Bartlett; Douglas H,110,0,120,10
1708258123690,SIO 135,A01,446153,Fricker; Helen A.,16,0,17,1
1708258123690,SIO 135,A02,446156,Fricker; Helen A.,14,0,18,4
1708258124218,SIO 136,A01,446159,Kacev; David & Wegner; Nicholas Craig & Bartlett; Douglas H,31,0,33,2
1708258124218,SIO 136,A02,446160,Kacev; David & Wegner; Nicholas Craig & Bartlett; Douglas H,33,0,33,0
1708258124743,SIO 139,A00,446164,Kacev; David,66,0,70,4
1708258125273,SIO 141,A01,446173,Pomeroy; Robert S.,11,0,12,1
1708258125798,SIO 143,A01,446175,Andersson; Andreas Jerry,20,0,30,10
1708258126329,SIO 145,A01,446181,Choy; Carolyn Anela,6,0,18,12
1708258126856,SIO 152,A01,446184,Van Allen; Emily Joyce,8,0,10,2
1708258126856,SIO 152,A02,479204,Van Allen; Emily Joyce,10,0,10,0
1708258127384,SIO 153,A01,446188,Capaldi; Tomas,24,0,26,2
1708258127915,SIO 160,A00,446189,Stegman; David,21,0,25,4
1708258128440,SIO 164,A00,446193,Staff,27,0,35,8
1708258128969,SIO 173,A00,446194,Lutsko; Nicholas J.,28,0,30,2
1708258129495,SIO 174,A00,446197,Aluwihare; Lihini & Russell; Lynn M.,26,0,30,4
1708258130027,SIO 181,A01,446200,Tresguerres; Martin,18,0,25,7
1708258130027,SIO 181,A02,446201,Tresguerres; Martin,23,0,25,2
1708258130027,SIO 181,A03,446209,Tresguerres; Martin,24,0,25,1
1708258130027,SIO 181,A04,446211,Tresguerres; Martin,24,0,25,1
1708258130027,SIO 181,A05,446223,Tresguerres; Martin,24,0,25,1
1708258130027,SIO 181,A06,446236,Tresguerres; Martin,24,0,25,1
1708258130553,SIO 192,A00,479211,Gerwick; William Henry,20,0,20,0
1708258131080,SIO 194,A00,455340,Hill; Seth J,0,0,0,0
1708258131610,SIOB 262,A00,446243,Gerwick; William Henry,23,0,25,2
1708258132136,SIOB 269,A00,446244,Staff,19,0,20,1
1708258132661,SIOB 270,A01,446261,Allen; Andrew Ellis & Petrik; Colleen Mary,18,0,20,2
1708258133192,SIOB 278,A00,446273,Arcila; Dahiana K,13,0,15,2
1708258133192,SIOB 278,B00,481742,Aburto Oropeza; Marco Octavio,18,0,20,2
1708258133719,SIOB 279,A00,446286,Franks; Peter,31,0,35,4
1708258134245,SIOB 291,A00,446292,Hechinger; Ryan F.,20,0,20,0
1708258134774,SIOB 296,A00,446293,Mongiardino Koch; Nicolas,16,0,20,4
1708258135304,SIOB 297,A00,446294,Allen; Eric,66,0,70,4
1708258135835,SIOC 202B,A00,446312,Stramski; Dariusz & Gabriel; Anne Alice-Agnes,17,0,20,3
1708258136361,SIOC 203C,A01,446314,Young; William Roy,5,0,5,0
1708258136887,SIOC 207C,A00,492798,Vasconcelos; Manuela,5,0,5,0
1708258137417,SIOC 208,A00,446315,Merrifield; Mark A,16,0,20,4
1708258137946,SIOC 209,A00,478924,Werner; Bradley T.,11,0,15,4
1708258137946,SIOC 209,B00,479224,Watson-Parris; Duncan,15,0,25,10
1708258137946,SIOC 209,C00,480739,Ricke; Katharine L,24,0,24,0
1708258138480,SIOC 212B,A01,446324,Cessi; Paola,40,0,40,0
1708258139006,SIOC 217C,A00,446325,Lutsko; Nicholas J.,25,0,25,0
1708258139533,SIOC 220,A00,446326,Rudnick; Daniel Lars,13,0,15,2
1708258140058,SIOC 224,A00,446327,Eisenman; Ian,20,0,25,5
1708258140583,SIOC 228,A00,446328,Shi; Yuanyuan,1,0,10,9
1708258141116,SIOC 235,A00,446342,Xie; Shang-Ping,14,0,15,1
1708258141644,SIOC 251,A00,446343,Evan; Amato Tomas,19,0,20,1
1708258142171,SIOG 200B,A00,446344,Gabriel; Anne Alice-Agnes,9,0,10,1
1708258142697,SIOG 221,A00,446354,Parnell-Turner; Ross Ernes,29,0,30,1
1708258143228,SIOG 227B,A00,446355,Laske; Gabi & Shearer; Peter M,19,0,20,1
1708258143754,SIOG 228,A00,446356,Van Allen; Emily Joyce,7,0,20,13
1708258144280,SIOG 230,A00,446359,Constable; Catherine G,25,0,25,0
1708258144810,SIOG 232,A00,446360,Constable; Catherine G & Constable; Steven C,37,0,40,3
1708258145337,SIOG 234,A00,446361,Sandwell; David T,15,0,15,0
1708258145868,SIOG 236,A01,477658,Fricker; Helen A.,5,0,5,0
1708258145868,SIOG 236,A02,477685,Fricker; Helen A.,3,0,5,2
1708258146396,SIOG 239,A00,446362,Gabriel; Anne Alice-Agnes,19,0,20,1
1708258146396,SIOG 239,B00,481507,May; David Alexander,6,0,6,0
1708258146396,SIOG 239,C00,486863,Fialko; Yuri A.,15,0,15,0
1708258146924,SIOG 268,A00,446364,Barbeau; Katherine,12,0,15,3
1708258147450,SOCE 194,A00,455341,Hill; Seth J,0,0,0,0
1708258147979,SOCG 204,A00,446551,Ng; Kwai,0,0,8,8
1708258148509,SOCG 206,A00,446552,Alvarez; Camila Huerta,4,0,8,4
1708258149035,SOCG 214,A00,446553,Raudenbush; Danielle,3,0,8,5
1708258149567,SOCG 255B,A00,446602,Serlin; David,2,0,5,3
1708258150097,SOCG 255C,A00,446813,Gates; Kelly,3,0,5,2
1708258150679,SOCG 290,A00,446910,Thorpe; Charles Robert,0,0,10,10
1708258150679,SOCG 290,B00,446911,Goldman; Harvey Stern,1,0,10,9
1708258150679,SOCG 290,C00,446914,Lampland; Martha,5,0,10,5
1708258151209,SOCI 2,A01,446373,Rogers; Julia Ellen,28,0,30,2
1708258151209,SOCI 2,A02,446374,Rogers; Julia Ellen,29,0,30,1
1708258151209,SOCI 2,A03,446382,Rogers; Julia Ellen,29,0,30,1
1708258151209,SOCI 2,A04,446384,Rogers; Julia Ellen,30,0,30,0
1708258151209,SOCI 2,A05,446389,Rogers; Julia Ellen,30,0,30,0
1708258151209,SOCI 2,A06,446393,Rogers; Julia Ellen,29,0,30,1
1708258151734,SOCI 20,A01,446396,Calderon-Zaks; Michael Aar,33,0,34,1
1708258151734,SOCI 20,A02,446409,Calderon-Zaks; Michael Aar,34,0,34,0
1708258152258,SOCI 40,A01,446417,Raudenbush; Danielle,30,0,32,2
1708258152258,SOCI 40,A02,446419,Raudenbush; Danielle,31,0,32,1
1708258152258,SOCI 40,A03,446434,Raudenbush; Danielle,31,0,32,1
1708258152258,SOCI 40,A04,446436,Raudenbush; Danielle,28,0,32,4
1708258152258,SOCI 40,A05,446441,Raudenbush; Danielle,29,0,32,3
1708258152258,SOCI 40,A06,446445,Raudenbush; Danielle,32,0,32,0
1708258152788,SOCI 60,A01,446461,Sutton; April Marie,30,0,32,2
1708258152788,SOCI 60,A02,446468,Sutton; April Marie,30,0,32,2
1708258152788,SOCI 60,A03,446469,Sutton; April Marie,26,0,32,6
1708258152788,SOCI 60,A04,446471,Sutton; April Marie,31,0,32,1
1708258153316,SOCI 100,A01,446480,Payne; Christine Anna,28,0,30,2
1708258153316,SOCI 100,A02,446491,Payne; Christine Anna,29,0,30,1
1708258153316,SOCI 100,A03,446492,Payne; Christine Anna,28,0,30,2
1708258153316,SOCI 100,A04,446493,Payne; Christine Anna,27,0,30,3
1708258153861,SOCI 103M,A00,481672,Kilpatrick; Kevin,27,0,28,1
1708258154386,SOCI 104,A00,446494,Turner; Christena L.,28,0,30,2
1708258154913,SOCI 104Q,A00,446495,Rogers; Julia Ellen,27,0,30,3
1708258155442,SOCI 106,A00,446496,Payne; Christine Anna,25,0,30,5
1708258155969,SOCI 107,A00,446497,Staff,30,0,30,0
1708258156498,SOCI 109,A00,446498,Rona-Tas; Akos,20,0,25,5
1708258157027,SOCI 111,A00,446499,Ribas Norris; Janet Vanesa,54,0,56,2
1708258157554,SOCI 114,A00,446500,Lampland; Martha,73,0,75,2
1708258158086,SOCI 117,A01,446502,Jones; Gabrielle Anastasia,14,0,17,3
1708258158086,SOCI 117,A02,446516,Jones; Gabrielle Anastasia,17,0,17,0
1708258158086,SOCI 117,A03,458787,Jones; Gabrielle Anastasia,17,0,17,0
1708258158086,SOCI 117,A04,458835,Jones; Gabrielle Anastasia,19,0,19,0
1708258158612,SOCI 120T,A00,446518,Staff,56,0,56,0
1708258159136,SOCI 123,A00,446519,Staff,79,0,80,1
1708258159661,SOCI 125,A00,487186,Calderon-Zaks; Michael Aar,55,0,56,1
1708258160188,SOCI 126,A01,446532,Jones; Makeba,15,0,15,0
1708258160188,SOCI 126,A02,446533,Jones; Makeba,15,0,15,0
1708258160188,SOCI 126,A03,458839,Jones; Makeba,15,0,15,0
1708258160188,SOCI 126,A04,458840,Jones; Makeba,15,0,15,0
1708258160718,SOCI 133,A00,446534,Calderon-Zaks; Michael Aar,53,0,56,3
1708258161248,SOCI 135,A00,486886,Ruiz; Jonathan Joseph,55,0,56,1
1708258161773,SOCI 136,A00,486887,Ruiz; Jonathan Joseph,56,0,56,0
1708258162303,SOCI 139,A00,446535,Ribas Norris; Janet Vanesa,78,0,80,2
1708258162828,SOCI 140J,A00,446537,Estefan; Michel,75,0,100,25
1708258163355,SOCI 142,A00,477639,Crofts; Christine,43,0,50,7
1708258163881,SOCI 146,A00,446538,Summers; Valerie R.,113,0,120,7
1708258164409,SOCI 151,A00,446540,Goldman; Harvey Stern,56,0,56,0
1708258164934,SOCI 156,A00,446541,Ostovany; Khashayar,55,0,56,1
1708258165461,SOCI 157,A00,446542,Jules-Rosette; Bennetta W.,28,0,28,0
1708258165991,SOCI 159,A00,494493,Estefan; Michel,93,0,96,3
1708258166518,SOCI 161,A00,477638,Staff,45,0,45,0
1708258167045,SOCI 162,A00,477642,Staff,54,0,55,1
1708258167569,SOCI 165,A00,446543,Rona-Tas; Akos,49,0,56,7
1708258168099,SOCI 171,A00,446544,Thorpe; Charles Robert,56,0,56,0
1708258168625,SOCI 173,A00,482888,Crofts; Christine,92,0,100,8
1708258169155,SOCI 180,A00,446545,Ostovany; Khashayar,55,0,56,1
1708258169680,SOCI 183,A00,446546,Sutton; April Marie,43,0,45,2
1708258170206,SOCI 185,A00,494495,Staff,30,0,30,0
1708258170734,SOCI 188D,A00,446549,Kokinis; Troy Andreas,24,0,25,1
1708258171260,SOCI 198RA,001,446550,Ng; Kwai,30,0,30,0
1708258171787,SOMC 224C,A00,466928,Bhakta; Savita Ganapathi,160,0,160,0
1708258172314,SOMC 229,A00,466925,Hoang; Mai Phuong,160,0,160,0
1708258172840,SOMC 240,A00,466937,Coyne; Christopher John,150,0,150,0
1708258173371,SOMC 242,A00,466931,Kline; Ahnika Sarah,160,0,160,0
1708258173896,SOMC 244,A00,466939,Mandel; Jess,150,0,150,0
1708258174422,SOMC 245C,A01,466935,Noel; Geoffroy Pierre Jean,160,0,160,0
1708258174955,SOMC 246C,A00,487163,Eyler; Lisa T.,160,0,160,0
1708258175482,SOMC 247C,A50,466950,Calcutt; Nigel A,160,0,160,0
1708258176011,SOMC 248C,A00,466936,Joshi; Weena Erin,160,0,160,0
1708258176537,SOMC 255C,A00,466951,Allison; Matthew,160,0,160,0
1708258177068,SPPH 161R,A01,476600,Chambers; Christina D,99,0,100,1
1708258177595,SPPH 263B,A01,460901,Hook; Vivian Yuan-Ho,25,0,25,0
1708258178122,SPPS 200A,A00,460907,Luli; Alex J,99,0,99,0
1708258178652,SPPS 200B,A00,460928,Luli; Alex J,99,0,99,0
1708258179177,SPPS 200C,A00,460934,Luli; Alex J,95,0,99,4
1708258179703,SPPS 203,A00,460955,Painter; Nathan A.,83,0,99,16
1708258180233,SPPS 205,A01,460978,Bandeira; Nuno Filipe Cabrita,64,0,80,16
1708258180759,SPPS 209,A00,460979,Bounthavong; Mark,94,0,99,5
1708258181285,SPPS 210,001,460980,Gustafsson; Asa Birgitta,99,0,99,0
1708258181815,SPPS 211A,A00,460987,Ferguson; Fleur,85,0,99,14
1708258182339,SPPS 211B,A00,460991,Ferguson; Fleur,96,0,99,3
1708258182864,SPPS 211C,A00,460992,Ferguson; Fleur,95,0,99,4
1708258183393,SPPS 211D,A00,460993,Tsunoda; Shirley M.,99,0,99,0
1708258183919,SPPS 212C,A01,460995,Saunders; Ila Maewal,95,0,99,4
1708258184446,SPPS 213C,A00,460996,Awdishu; Linda,95,0,99,4
1708258184976,SPPS 218B,A00,460997,Mandyam; Chitra,95,0,99,4
1708258185502,SPPS 225,A01,460999,Reed; Chantal,83,0,99,16
1708258186030,SPPS 236,A00,461000,Reid; Erin G.,96,0,99,3
1708258186556,SPPS 237,A00,461002,Mimoto; Mizuho Stacy,96,0,99,3
1708258187319,SPPS 238,A00,461041,Beyhan; Sinem,96,0,99,3
1708258187845,SPPS 241,A01,461122,Tsunoda; Shirley M.,83,0,99,16
1708258188374,SPPS 249,A00,461123,Brandl; Katharina,96,0,99,3
1708258188900,SPPS 250,A00,461126,Tsunoda; Shirley M.,45,0,50,5
1708258189426,SPPS 251,A00,461127,Chen; Timothy,99,0,99,0
1708258189952,SPPS 252,A00,461128,Abdul-Mutakabbir; Jacinda,74,0,80,6
1708258190484,SPPS 254,A00,481670,Shapiro; Desiree Nicolette,77,0,80,3
1708258191009,SPPS 261,A00,461129,Chambers; Christina D,93,0,99,6
1708258191540,SPPS 278,A00,459983,Fricovsky; Eduardo Santiago,98,0,99,1
1708258192065,SPPS 280,A00,461259,Fricovsky; Eduardo Santiago,19,0,20,1
1708258192590,SPPS 283,A00,461283,Tsunoda; Shirley M.,96,0,99,3
1708258193115,SURG 261,A00,466973,Staff,50,0,50,0
1708258193645,SURG 296,001,467004,Agha Hosseini; Ava,49,0,50,1
1708258193645,SURG 296,002,467005,Hinchcliff; Katharine Moss,49,0,50,1
1708258193645,SURG 296,003,467006,Eliceiri; Brian,49,0,50,1
1708258194219,SYN 1,001,448577,Bishop; Graham,19,0,20,1
1708258194219,SYN 1,002,448578,Iatarola; Briana Marie,19,0,20,1
1708258194219,SYN 1,003,448579,Browne; Emily,20,0,20,0
1708258194219,SYN 1,004,448580,Vega; Adrian,20,0,20,0
1708258194219,SYN 1,005,448581,Browne; Emily,20,0,20,0
1708258194219,SYN 1,006,448582,Rock; Martin,20,0,20,0
1708258194219,SYN 1,007,448583,Rock; Martin,20,0,20,0
1708258194219,SYN 1,008,448584,Iatarola; Briana Marie,19,0,20,1
1708258194219,SYN 1,009,448585,Bishop; Graham,20,0,20,0
1708258194219,SYN 1,010,448586,Bishop; Graham,20,0,20,0
1708258194219,SYN 1,011,448587,Gladstein; Jill M,15,0,15,0
1708258194219,SYN 1,012,448588,Meyer; Leslie Rose,20,0,20,0
1708258194219,SYN 1,013,448589,Rosenberg; Ryan Glenn,20,0,20,0
1708258194219,SYN 1,014,448627,Rosenberg; Ryan Glenn,19,0,20,1
1708258194219,SYN 1,015,448630,Atkinson; Arthur Laird,20,0,20,0
1708258194219,SYN 1,016,448651,Hom; Kirstyn Courtney,20,0,20,0
1708258194219,SYN 1,017,448652,Difruscio; Mark,20,0,20,0
1708258194219,SYN 1,018,448669,Hom; Kirstyn Courtney,20,0,20,0
1708258194219,SYN 1,019,448674,Hom; Kirstyn Courtney,18,0,20,2
1708258194219,SYN 1,020,448675,Atkinson; Arthur Laird,20,0,20,0
1708258194219,SYN 1,021,448678,Gladstein; Jill M,15,0,15,0
1708258194219,SYN 1,022,448682,Iatarola; Briana Marie,20,0,20,0
1708258194219,SYN 1,023,448691,Birberick; Brittany Celest,20,0,20,0
1708258194219,SYN 1,024,448751,Birberick; Brittany Celest,20,0,20,0
1708258194219,SYN 1,027,448766,Deavenport; James Cary,19,0,20,1
1708258194219,SYN 1,028,448767,Meyer; Leslie Rose,20,0,20,0
1708258194219,SYN 1,029,448775,Tawater; Hanna Jean,20,0,20,0
1708258194219,SYN 1,030,448777,Tawater; Hanna Jean,20,0,20,0
1708258194219,SYN 1,031,448792,Deavenport; James Cary,20,0,20,0
1708258194219,SYN 1,032,480169,Tawater; Hanna Jean,18,0,20,2
1708258194747,SYN 1R,001,448793,Difruscio; Mark,20,0,20,0
1708258194747,SYN 1R,004,449146,Difruscio; Mark,20,0,20,0
1708258195278,SYN 100,A01,449148,Staff,11,0,15,4
1708258195278,SYN 100,A02,449149,Staff,15,0,15,0
1708258195278,SYN 100,B01,449164,Gladstein; Jill M,0,0,0,0
1708258195278,SYN 100,B02,449166,Gladstein; Jill M,0,0,0,1
1708258195278,SYN 100,C01,449244,Staff,7,0,15,8
1708258195278,SYN 100,C02,449274,Staff,13,0,15,2
1708258195278,SYN 100,D01,449278,Staff,20,0,20,0
1708258195278,SYN 100,D02,449279,Staff,20,0,20,0
1708258195278,SYN 100,E01,449281,Rock; Martin,9,0,15,6
1708258195278,SYN 100,E02,449282,Rock; Martin,14,0,15,1
1708258195278,SYN 100,F01,449304,Browne; Emily,12,0,15,3
1708258195278,SYN 100,F02,449306,Browne; Emily,14,0,15,1
1708258195278,SYN 100,I01,449390,Gormally; Brenna,0,0,0,0
1708258195278,SYN 100,I02,449391,Gormally; Brenna,0,0,0,0
1708258195278,SYN 100,J01,449401,Atkinson; Arthur Laird,11,0,15,4
1708258195278,SYN 100,J02,449402,Atkinson; Arthur Laird,14,0,15,1
1708258195278,SYN 100,K01,449404,Deavenport; James Cary,11,0,15,4
1708258195278,SYN 100,K02,449405,Deavenport; James Cary,14,0,15,1
1708258195278,SYN 100,L01,449408,Rosenberg; Ryan Glenn,10,0,15,5
1708258195278,SYN 100,L02,449420,Rosenberg; Ryan Glenn,15,0,15,0
1708258195808,SYN 150,001,450016,Vega; Adrian,19,0,19,0
1708258195808,SYN 150,003,450031,Birberick; Brittany Celest,20,0,20,0
1708258196334,SYN 150R,001,494950,Vega; Adrian,20,0,20,0
1708258196859,SYN 198,001,494388,Staff,9999,0,9999,0
1708258197386,TDAC 1,A00,450042,Walsh; Kim C.,14,0,20,6
1708258197386,TDAC 1,B00,450043,Walsh; Kim C.,11,0,20,9
1708258197386,TDAC 1,C00,450044,Walsh; Kim C.,15,0,20,5
1708258197386,TDAC 1,D00,486830,Basso; Beatrice,20,0,20,0
1708258197386,TDAC 1,E00,492912,Walsh; Kim C.,15,0,20,5
1708258197386,TDAC 1,F00,492936,Walsh; Kim C.,18,0,20,2
1708258197915,TDAC 101,A00,450895,Celik; Aysan Karagasli,18,0,20,2
1708258198444,TDAC 102,A00,450904,Walsh; Kim C.,20,0,20,0
1708258198444,TDAC 102,B00,450916,Harting; Carla Kelso,20,0,20,0
1708258198970,TDAC 108,A00,450917,Buescher; Stephen W.,18,0,20,2
1708258199499,TDAC 109,A00,450924,Blair; Kyle Adam,20,0,20,0
1708258200027,TDAC 122,A00,451025,Perry; Lamar,30,0,30,0
1708258200027,TDAC 122,B00,480845,Perry; Lamar,30,0,30,0
1708258200554,TDAC 123,A00,451026,Buescher; Stephen W.,30,0,30,0
1708258200554,TDAC 123,B00,451028,Celik; Aysan Karagasli,30,0,30,0
1708258200554,TDAC 123,C00,480851,Perry; Lamar,30,0,30,0
1708258201083,TDDE 101,A00,451030,Guirguis; Mark C,18,0,20,2
1708258201609,TDDE 112,A00,451032,Staff,20,0,20,0
1708258202139,TDDE 130,A00,451033,Guirguis; Mark C,19,0,20,1
1708258202663,TDDE 132,A00,451034,Guirguis; Mark C,20,0,20,0
1708258203190,TDDE 169A,A00,481304,Petrovich; Victoria A.,19,0,20,1
1708258203718,TDDM 1,A00,450045,Weinberg; Sadie,27,0,30,3
1708258204297,TDDM 101,A00,451067,Staff,29,0,30,1
1708258204825,TDDR 101,A00,451068,Powell; Lora,29,0,34,5
1708258205351,TDDR 102,A00,451069,Powell; Lora,19,0,20,1
1708258205880,TDDR 111,A00,451070,Castro; Robert Jess,15,0,16,1
1708258205880,TDDR 111,B00,451071,Castro; Robert Jess,15,0,16,1
1708258206406,TDDR 190,A00,451073,Perry; Lamar,1,0,1,0
1708258206933,TDGE 1,A01,450047,Salovey; Todd,20,0,20,0
1708258206933,TDGE 1,A02,450048,Salovey; Todd,20,0,20,0
1708258206933,TDGE 1,A03,450085,Salovey; Todd,18,0,20,2
1708258206933,TDGE 1,A04,450093,Salovey; Todd,20,0,20,0
1708258206933,TDGE 1,A05,450096,Salovey; Todd,19,0,20,1
1708258206933,TDGE 1,A06,450132,Salovey; Todd,16,0,20,4
1708258207459,TDGE 25,A00,450236,Harting; Carla Kelso,12,0,20,8
1708258207459,TDGE 25,B00,450240,Harting; Carla Kelso,16,0,20,4
1708258207459,TDGE 25,C00,450243,Harting; Carla Kelso,14,0,20,6
1708258207459,TDGE 25,D00,450388,Harting; Carla Kelso,16,0,20,4
1708258207987,TDGE 100,A01,451098,Salovey; Todd,24,0,25,1
1708258207987,TDGE 100,A02,451099,Salovey; Todd,24,0,25,1
1708258208516,TDGE 124,A00,451122,Fulton; Julia,168,0,200,32
1708258209044,TDGE 125,A00,480853,Havis; Allan,197,0,200,3
1708258209044,TDGE 125,B00,480886,Staff,216,0,220,4
1708258209570,TDGE 133,A00,481097,Brill; Robert L.,20,0,20,0
1708258210101,TDGE 196B,A00,493144,Barricelli; Marc Alexander,1,0,1,0
1708258210101,TDGE 196B,B00,493148,Buescher; Stephen W.,2,0,2,0
1708258210101,TDGE 196B,C00,493151,Burelle; Julie Sara Veronique,1,0,1,0
1708258210101,TDGE 196B,D00,493189,Castro; Robert Jess,2,0,2,0
1708258210101,TDGE 196B,E00,493190,Guirguis; Mark C,1,0,1,0
1708258210101,TDGE 196B,F00,493240,Iizuka; Naomi Hisako,1,0,1,0
1708258210101,TDGE 196B,G00,493241,Perry; Lamar,1,0,1,0
1708258210101,TDGE 196B,H00,493249,Powell; Lora,1,0,1,0
1708258210101,TDGE 196B,I00,493296,Stein; Deborah Isobel,6,0,6,0
1708258210626,TDGR 213C,A00,451385,Buescher; Stephen W.,10,0,10,0
1708258211152,TDGR 220A,A00,451386,Barricelli; Marc Alexander,10,0,10,0
1708258211682,TDGR 239,A00,451387,Blair; Kyle Adam,10,0,10,0
1708258212206,TDGR 240,A00,481306,Portes; Elizabeth Marie,5,0,5,0
1708258212731,TDGR 245,A00,451388,Perry; Lamar,7,0,7,0
1708258213259,TDGR 250,A00,451395,Iizuka; Naomi Hisako,8,0,10,2
1708258213784,TDGR 251,A00,451397,Iizuka; Naomi Hisako,9,0,10,1
1708258213784,TDGR 251,B00,451398,Stein; Deborah Isobel,9,0,10,1
1708258214311,TDGR 257B,A00,451399,Finch; Michael S,8,0,10,2
1708258214836,TDGR 278,A00,481307,Petrovich; Victoria A.,4,0,5,1
1708258215365,TDGR 279,A00,451400,Bokovikova; Alina V,9,0,10,1
1708258215365,TDGR 279,B00,451401,Brill; Robert L.,10,0,10,0
1708258215365,TDGR 279,C00,451402,Petrovich; Victoria A.,10,0,10,0
1708258215365,TDGR 279,D00,451403,McElver; Robert Harrison,10,0,10,0
1708258215365,TDGR 279,E00,451404,Kuhl; Christopher August,10,0,10,0
1708258215890,TDGR 286,A00,451405,Knox; Leila Elizabeth,9,0,10,1
1708258216416,TDGR 288,A00,451406,Powell; Lora,6,0,7,1
1708258216947,TDGR 292,A00,451407,Power; Jade Yukana,10,0,10,0
1708258216947,TDGR 292,B00,451408,Mehrishi; Rishika,10,0,10,0
1708258217474,TDGR 293,001,451417,Power; Jade Yukana,7,0,7,0
1708258217474,TDGR 293,002,451418,Burelle; Julie Sara Veronique,7,0,7,0
1708258217474,TDGR 293,003,451419,Yapp; Hentyle T,7,0,7,0
1708258217474,TDGR 293,005,451421,Anderson; Mysia Anyse,7,0,7,0
1708258218003,TDGR 294,001,451429,Burelle; Julie Sara Veronique,7,0,7,0
1708258218003,TDGR 294,002,451431,Power; Jade Yukana,7,0,7,0
1708258218003,TDGR 294,003,451432,Yapp; Hentyle T,7,0,7,0
1708258218529,TDGR 295,A00,451433,Barricelli; Marc Alexander,10,0,10,0
1708258219055,TDGR 296,A00,451489,Powell; Lora,6,0,7,1
1708258219055,TDGR 296,B00,451497,Porter; Lisa,6,0,7,1
1708258219584,TDHD 175,A00,451123,Jun; Grace Shin Hae,40,0,40,0
1708258220110,TDHD 176,A00,451124,Caligagan; Maria T.,40,0,40,0
1708258220640,TDHT 10,A00,450409,Power; Jade Yukana,20,0,20,0
1708258220640,TDHT 10,B00,450450,Power; Jade Yukana,19,0,20,1
1708258221171,TDHT 23,A01,450546,Salimi; Rana,24,0,24,0
1708258221171,TDHT 23,A02,450549,Salimi; Rana,22,0,24,2
1708258221171,TDHT 23,A03,450553,Salimi; Rana,24,0,24,0
1708258221701,TDHT 101,A00,451125,Anderson; Mysia Anyse,25,0,25,0
1708258221701,TDHT 101,B00,451126,Mehrishi; Rishika,23,0,25,2
1708258222227,TDHT 104,A00,451225,Basso; Beatrice,22,0,25,3
1708258222752,TDHT 109,A01,451227,Anderson; Mysia Anyse,25,0,25,0
1708258223278,TDHT 122,A00,451228,Power; Jade Yukana,21,0,25,4
1708258223808,TDMV 1,A00,450558,Caligagan; Maria T.,15,0,30,15
1708258224338,TDMV 2,A00,450627,Anabo; Cherry,24,0,30,6
1708258224868,TDMV 3,A00,450630,Arcidiacono; Kristin,37,0,40,3
1708258225395,TDMV 11,A00,481244,Fyall; DauntÉ Edward,30,0,30,0
1708258225924,TDMV 20,A00,450789,Smith; Alison D,38,0,40,2
1708258226453,TDMV 110,A00,451229,Caligagan; Maria T.,28,0,30,2
1708258226981,TDMV 111,A00,451234,Smith; Alison D,28,0,30,2
1708258227507,TDMV 120,A00,451260,Weinberg; Sadie,30,0,30,0
1708258227507,TDMV 120,B00,451261,Sammartano; Tonnie,30,0,30,0
1708258228036,TDMV 122,A00,451262,Staff,28,0,30,2
1708258228562,TDMV 123,A00,451263,Duran; Marcos Antonio,28,0,30,2
1708258229087,TDMV 130,A00,451272,Mack; Kara Shanai',30,0,30,0
1708258229612,TDMV 138,A00,451275,Jun; Grace Shin Hae,4,0,30,26
1708258230145,TDMV 140,A00,451276,Lima; Paulo Henrique,40,0,40,0
1708258230145,TDMV 140,B00,451308,Power; Jade Yukana,39,0,40,1
1708258230145,TDMV 140,C00,451371,Caligagan; Tony,40,0,40,0
1708258230145,TDMV 140,D00,451373,Corrales; Joseph Bernales,28,0,30,2
1708258230672,TDMV 141,A00,451374,Caligagan; Tony,26,0,30,4
1708258231202,TDMV 142,A00,451375,Blanco; Juan Carlos,25,0,40,15
1708258231728,TDMV 143,A00,451376,Fyall; DauntÉ Edward,39,0,40,1
1708258232257,TDMV 144,A00,451377,Anabo; Cherry,39,0,40,1
1708258232782,TDMV 149,A00,451378,Jun; Grace Shin Hae,36,0,40,4
1708258233310,TDPF 162,A00,451379,Alvarez; Ana Maria,40,0,40,0
1708258233836,TDPR 6,A01,450799,Guirguis; Mark C,50,0,50,0
1708258233836,TDPR 6,A02,450801,Guirguis; Mark C,50,0,50,0
1708258234363,TDPR 102,A00,451380,Guirguis; Mark C,20,0,20,0
1708258234891,TDPR 104,A00,451381,Powell; Lora,15,0,15,0
1708258235417,TDPW 1,A00,450808,Stein; Deborah Isobel,14,0,15,1
1708258235417,TDPW 1,B00,450864,Stein; Deborah Isobel,13,0,15,2
1708258235417,TDPW 1,C00,450865,Stein; Deborah Isobel,15,0,15,0
1708258235417,TDPW 1,D00,450868,Stein; Deborah Isobel,13,0,15,2
1708258235417,TDPW 1,E00,450874,Stein; Deborah Isobel,14,0,15,1
1708258235946,TDPW 102,A00,451382,Staff,18,0,20,2
1708258236472,TDPW 104,A00,481182,Staff,17,0,20,3
1708258236998,TDTR 10,A00,450881,Wilson; Terry A.,28,0,30,2
1708258237528,TDTR 15,A00,450882,Smith; Alison D,30,0,30,0
1708258238054,TMC 15,A00,479039,Hemans; Patricia Ann Benitez,25,0,25,0
1708258238579,TMC 87,A00,479049,Solomon; Amanda Lee Albaniel,20,0,20,0
1708258239107,UROL 296,001,467060,Anger; Jennifer Tash,49,0,50,1
1708258239107,UROL 296,002,467061,Staff,50,0,50,0
1708258239633,USP 3,A01,458852,Martin; Isaac,34,0,35,1
1708258239633,USP 3,A02,458853,Martin; Isaac,35,0,35,0
1708258239633,USP 3,A03,458861,Martin; Isaac,34,0,35,1
1708258239633,USP 3,A04,458862,Martin; Isaac,32,0,35,3
1708258240158,USP 4,A00,451772,Schwaller; Nora Louise,19,0,25,6
1708258240684,USP 5,A01,458863,Shenkman; Michael Thomas,33,0,35,2
1708258240684,USP 5,A02,458864,Shenkman; Michael Thomas,31,0,35,4
1708258241215,USP 15,A01,458931,Staff,33,0,35,2
1708258241215,USP 15,A02,459024,Staff,31,0,35,4
1708258241740,USP 25,A00,451786,Sun; Feiyang,57,0,60,3
1708258242264,USP 100,A00,451787,Moses; Kelema Lee,55,0,60,5
1708258242790,USP 108,A00,477594,Martin; Isaac,25,0,25,0
1708258243320,USP 119,A00,477595,Schwaller; Nora Louise,23,0,25,2
1708258243846,USP 124,A00,451790,Hinds; Juli Beth,62,0,70,8
1708258244373,USP 128B,A01,451910,Lewis; Leslie R,12,0,13,1
1708258244897,USP 142B,A01,451954,Lewis; Leslie R,24,0,25,1
1708258245423,USP 142C,A00,451977,Lerner; Amy M,0,0,0,0
1708258245952,USP 145,A00,451999,Yaghmaee; Saman,140,0,146,6
1708258246478,USP 150,A00,452165,Staff,44,0,50,6
1708258247007,USP 151,A00,452166,Staff,49,0,50,1
1708258247535,USP 152A,A01,459025,Weaver; Todd D,25,0,25,0
1708258247535,USP 152A,A02,459074,Weaver; Todd D,24,0,25,1
1708258248061,USP 152B,A00,452224,Moeder; Nathan L,21,0,25,4
1708258248588,USP 153,A00,452339,Shenkman; Michael Thomas,50,0,50,0
1708258249117,USP 158A,A00,452410,Sun; Feiyang,25,0,25,0
1708258249641,USP 159B,A00,452411,Gherini; Paul Pier-Carlo,6,0,8,2
1708258250171,USP 160,A00,452412,Wartell; Julie Dara,25,0,25,0
1708258250701,USP 164,A00,452413,Moses; Kelema Lee,22,0,25,3
1708258251226,USP 165C,A00,452442,Frank; Lawrence Douglas,20,0,20,0
1708258251755,USP 169,A00,452598,Bajaj; Ravi Siddharth,32,0,35,3
1708258252283,USP 170,A00,477593,Entezam; Maryam,60,0,60,0
1708258252809,USP 172,A00,452676,Peerson; Susan,19,0,25,6
1708258253335,USP 175,A00,452848,Velasco; Diego,18,0,20,2
1708258253864,USP 177A,A00,453084,Velasco; Diego,21,0,25,4
1708258254389,USP 177B,A00,453127,Peerson; Susan,22,0,25,3
1708258254915,USP 183,A00,453128,Sutton; April Marie,19,0,20,1
1708258255444,USP 188B,A00,453187,Pezzoli; Keith,30,0,30,0
1708258255972,USP 190,A00,453234,Pezzoli; Keith,0,0,0,1
1708258256498,USP 191B,A00,453240,Polat; Soydan Alihan,18,0,20,2
1708258257028,USP 193,A00,453251,Bussell; Mirle Rabinowitz,24,0,25,1
1708258257612,USP 194,A00,455342,Hill; Seth J,0,0,0,0
1708258258145,USP 265C,A00,453264,Frank; Lawrence Douglas,10,0,10,0
1708258258672,VIS 3,A01,453427,Staff,25,0,25,0
1708258258672,VIS 3,A02,453428,Staff,15,0,25,10
1708258258672,VIS 3,A03,453429,Staff,25,0,25,0
1708258258672,VIS 3,A04,453430,Staff,21,0,25,4
1708258258672,VIS 3,A05,453431,Staff,25,0,25,0
1708258258672,VIS 3,A06,453432,Staff,23,0,25,2
1708258258672,VIS 3,A07,453433,Staff,17,0,25,8
1708258258672,VIS 3,A08,453434,Staff,23,0,25,2
1708258258672,VIS 3,A09,453435,Staff,21,0,25,4
1708258258672,VIS 3,A10,453436,Staff,23,0,25,2
1708258259200,VIS 9,A00,453437,Camargo; William,116,0,146,30
1708258259726,VIS 10,A00,453438,Kiratli; Solen,189,0,200,11
1708258260271,VIS 21B,A01,453440,Shen; Kuiyi,31,0,32,1
1708258260271,VIS 21B,A02,453441,Shen; Kuiyi,31,0,32,1
1708258260271,VIS 21B,A03,453442,Shen; Kuiyi,31,0,32,1
1708258260271,VIS 21B,A04,453443,Shen; Kuiyi,32,0,32,0
1708258260271,VIS 21B,A05,453444,Shen; Kuiyi,32,0,32,0
1708258260271,VIS 21B,A06,453452,Shen; Kuiyi,32,0,32,0
1708258260271,VIS 21B,A07,453468,Shen; Kuiyi,30,0,32,2
1708258260271,VIS 21B,A08,453587,Shen; Kuiyi,32,0,32,0
1708258260803,VIS 22,A01,453589,Rose; Jordan M,32,0,32,0
1708258260803,VIS 22,A02,453590,Rose; Jordan M,32,0,32,0
1708258260803,VIS 22,A03,453615,Rose; Jordan M,31,0,32,1
1708258260803,VIS 22,A04,453616,Rose; Jordan M,32,0,32,0
1708258260803,VIS 22,A05,453617,Rose; Jordan M,30,0,32,2
1708258260803,VIS 22,A06,453618,Rose; Jordan M,30,0,32,2
1708258260803,VIS 22,A07,453620,Rose; Jordan M,32,0,32,0
1708258260803,VIS 22,A08,453621,Rose; Jordan M,32,0,32,0
1708258260803,VIS 22,A09,453635,Rose; Jordan M,32,0,32,0
1708258260803,VIS 22,A10,453636,Rose; Jordan M,32,0,32,0
1708258261330,VIS 31,A00,453637,Dominguez; Ricardo,133,0,146,13
1708258261860,VIS 41,A01,453644,D'Elena-Tweed; Jessica Erin,23,0,25,2
1708258261860,VIS 41,A02,453645,D'Elena-Tweed; Jessica Erin,22,0,25,3
1708258261860,VIS 41,A03,453646,D'Elena-Tweed; Jessica Erin,25,0,25,0
1708258261860,VIS 41,A04,453647,D'Elena-Tweed; Jessica Erin,18,0,25,7
1708258261860,VIS 41,A05,453648,D'Elena-Tweed; Jessica Erin,25,0,25,0
1708258261860,VIS 41,A06,453650,D'Elena-Tweed; Jessica Erin,24,0,25,1
1708258262401,VIS 70N,A01,453652,Garnett; Mariah J,21,0,22,1
1708258262401,VIS 70N,A02,453653,Garnett; Mariah J,21,0,22,1
1708258262401,VIS 70N,A03,453654,Garnett; Mariah J,22,0,22,0
1708258262401,VIS 70N,A04,453657,Garnett; Mariah J,22,0,22,0
1708258262401,VIS 70N,A05,453662,Garnett; Mariah J,20,0,22,2
1708258262401,VIS 70N,A06,453663,Garnett; Mariah J,22,0,22,0
1708258262927,VIS 83,A00,453664,Kester; Grant,137,0,146,9
1708258263452,VIS 101A,A00,453666,Cruz; Edwin Teddy,10,0,15,5
1708258263982,VIS 102,A00,453668,Cruz; Edwin Teddy,81,0,85,4
1708258264508,VIS 105A,A00,453669,Adler; Amy,29,0,30,1
1708258265034,VIS 105B,A00,453738,Herc-Balaszek; Malgorzata,25,0,30,5
1708258265034,VIS 105B,B00,453739,Staff,27,0,30,3
1708258265559,VIS 106A,A00,453740,Staff,22,0,25,3
1708258266087,VIS 106B,A00,453741,De Luca; Mara Julia,20,0,25,5
1708258266614,VIS 106C,A00,453746,Vangenderen; Monique Luise,11,0,15,4
1708258267143,VIS 107A,A00,453747,Gregoire; Mathieu,19,0,25,6
1708258267668,VIS 107B,A00,453748,Dean; Danielle Adobi,23,0,25,2
1708258268194,VIS 110A,A00,453749,Adler; Amy,13,0,15,2
1708258268719,VIS 110E,A00,453798,Gregoire; Mathieu,14,0,15,1
1708258269244,VIS 110F,A00,453799,Staff,15,0,15,0
1708258269773,VIS 110N,A00,453803,Dean; Danielle Adobi,15,0,15,0
1708258270299,VIS 123B,A00,453804,Gaines; Malik Julian,75,0,75,0
1708258270825,VIS 125BN,A00,453813,Welchman; John C.,75,0,75,0
1708258271357,VIS 126P,A00,453814,Wardwell; Mariana Razo,74,0,75,1
1708258271882,VIS 128E,A00,453815,Staff,75,0,75,0
1708258272408,VIS 129E,A00,453855,Shen; Kuiyi,12,0,15,3
1708258272939,VIS 131,A00,453859,Trigilio; Michael,12,0,15,3
1708258272939,VIS 131,B00,479342,Mangolte; Babette,15,0,15,0
1708258274478,VIS 133A,A00,454231,Barbosa; Erika Katrina,13,0,15,2
1708258275005,VIS 134,A00,454232,Yoldas; Pinar,59,0,75,16
1708258275533,VIS 141B,A00,454233,Stalbaum; Brett,12,0,15,3
1708258276066,VIS 145B,A00,454234,Alexander; Amy J,14,0,15,1
1708258276066,VIS 145B,B00,454235,Kiratli; Solen,8,0,15,7
1708258276611,VIS 147A,A01,454237,Stalbaum; Brett,20,0,22,2
1708258276611,VIS 147A,A02,454238,Stalbaum; Brett,18,0,22,4
1708258277151,VIS 157,A01,454240,Cartwright; Lisa,32,0,34,2
1708258277151,VIS 157,A02,454241,Cartwright; Lisa,32,0,34,2
1708258277696,VIS 159,A01,454243,Akten; Mehmet,34,0,34,0
1708258277696,VIS 159,A02,454244,Akten; Mehmet,32,0,34,2
1708258277696,VIS 159,A03,454300,Akten; Mehmet,30,0,34,4
1708258277696,VIS 159,A04,454301,Akten; Mehmet,33,0,34,1
1708258277696,VIS 159,A05,454302,Akten; Mehmet,30,0,34,4
1708258277696,VIS 159,A06,454307,Akten; Mehmet,33,0,34,1
1708258277696,VIS 159,A07,454308,Akten; Mehmet,34,0,34,0
1708258277696,VIS 159,A08,454309,Akten; Mehmet,33,0,34,1
1708258278221,VIS 160B,A00,454310,Alexander; Amy J,13,0,15,2
1708258278221,VIS 160B,B00,454311,Akten; Mehmet,14,0,15,1
1708258278221,VIS 160B,C00,454312,Stone; Patricia,12,0,15,3
1708258278748,VIS 164,A00,454313,Cross; Brian R,19,0,22,3
1708258278748,VIS 164,B00,454314,Camargo; William,22,0,22,0
1708258279275,VIS 165,A00,454315,Erdmann; Dean,22,0,22,0
1708258279800,VIS 167,A00,454316,Staff,18,0,22,4
1708258280329,VIS 169A,A00,454317,Mostajo; Lorena,21,0,22,1
1708258280856,VIS 171,A00,454318,Nakayama; Yue,21,0,22,1
1708258281386,VIS 174,A00,454319,Staff,19,0,22,3
1708258281912,VIS 177,A00,454320,Cho; Erica,21,0,22,1
1708258282440,VIS 178,A00,454321,Staff,0,0,0,0
1708258282965,VIS 179,A00,454322,Erdmann; Dean,22,0,22,0
1708258283492,VIS 180A,A00,454323,Nakayama; Yue,21,0,22,1
1708258284022,VIS 180B,A00,454341,Cross; Brian R,20,0,22,2
1708258284548,VIS 183A,A00,454342,Cho; Erica,17,0,22,5
1708258285074,VIS 185,A00,454343,Miller; Nicole L,18,0,22,4
1708258285605,VIS 190,A00,454360,Crandall; Jordan,15,0,15,0
1708258285605,VIS 190,B00,454361,D'Elena-Tweed; Jessica Erin,10,0,15,5
1708258286130,VIS 202,A00,454369,Miller; Nicole L,12,0,15,3
1708258286658,VIS 203,A00,454370,Garnett; Mariah J,8,0,15,7
1708258287186,VIS 206,A00,454376,Kester; Grant,10,0,15,5
1708258287711,VIS 208,A00,454377,Moss; Ceci,15,0,15,0
1708258288240,VIS 211,A00,454413,Segade; Alexandro Abraham,0,0,0,2
1708258288766,VIS 243,A00,454429,Rose; Jordan M,5,0,15,10
1708258289292,VIS 255,A00,454430,Welchman; John C.,8,0,15,7
1708258289821,VIS 262,A00,454431,Yoldas; Pinar,11,0,15,4
1708258290364,WCWP 10A,001,454442,Uriarte; Emma,17,0,20,3
1708258290364,WCWP 10A,002,454443,Uriarte; Emma,14,0,20,6
1708258290364,WCWP 10A,003,454479,Uriarte; Emma,19,0,20,1
1708258290364,WCWP 10A,004,454480,Staff,0,0,0,0
1708258290364,WCWP 10A,005,454484,Staff,0,0,0,0
1708258290364,WCWP 10A,006,454485,Staff,0,0,0,0
1708258290364,WCWP 10A,007,454487,Staff,0,0,0,0
1708258290364,WCWP 10A,008,454488,Susi; Natalie,14,0,20,6
1708258290364,WCWP 10A,009,454489,Staff,0,0,0,0
1708258290364,WCWP 10A,010,454490,Staff,0,0,0,0
1708258290934,WCWP 10B,001,454492,Ornelas; Tricia,20,0,20,0
1708258290934,WCWP 10B,002,454501,Ornelas; Tricia,20,0,20,0
1708258290934,WCWP 10B,003,454565,Gagnon; Jeffrey C,2,0,20,18
1708258290934,WCWP 10B,004,454604,Ornelas; Tricia,16,0,20,4
1708258290934,WCWP 10B,005,454668,Staff,16,0,16,0
1708258290934,WCWP 10B,006,454724,Staff,16,0,16,0
1708258290934,WCWP 10B,007,454725,Staff,14,0,16,2
1708258290934,WCWP 10B,008,454768,Staff,0,0,0,0
1708258290934,WCWP 10B,009,454769,Staff,0,0,0,0
1708258290934,WCWP 10B,010,454770,Staff,0,0,0,0
1708258290934,WCWP 10B,011,454771,Dhir; Simrita,16,0,20,4
1708258290934,WCWP 10B,012,454772,Dhir; Simrita,16,0,20,4
1708258290934,WCWP 10B,013,454773,Merryman; Walter,17,0,20,3
1708258290934,WCWP 10B,014,454774,Dhir; Simrita,18,0,20,2
1708258290934,WCWP 10B,015,454775,Merryman; Walter,17,0,20,3
1708258290934,WCWP 10B,016,454776,Merryman; Walter,18,0,20,2
1708258290934,WCWP 10B,017,454777,Welji; Haleema Nazir,14,0,16,2
1708258290934,WCWP 10B,018,478868,Staff,16,0,16,0
1708258290934,WCWP 10B,019,478869,Staff,0,0,0,0
1708258290934,WCWP 10B,020,478876,Staff,0,0,0,0
1708258290934,WCWP 10B,021,478877,Staff,0,0,0,0
1708258290934,WCWP 10B,022,478887,Staff,0,0,0,0
1708258290934,WCWP 10B,023,478889,Staff,16,0,16,0
1708258290934,WCWP 10B,024,478892,Staff,0,0,0,0
1708258290934,WCWP 10B,025,478907,Staff,0,0,0,0
1708258291485,WCWP 100,A00,454800,McCleary; Keith Long,20,0,20,0
1708258291485,WCWP 100,B00,454804,McCleary; Keith Long,20,0,20,0
1708258291485,WCWP 100,C00,454822,Twohig; Niall Ivan,19,0,20,1
1708258291485,WCWP 100,D00,454855,Young; Mark T,20,0,20,0
1708258291485,WCWP 100,E00,454860,Twohig; Niall Ivan,19,0,20,1
1708258291485,WCWP 100,F00,454932,Young; Mark T,20,0,20,0
1708258291485,WCWP 100,G00,454933,Young; Mark T,20,0,20,0
1708258292011,WES 207,A00,454941,Kastner; Ryan Charles,20,0,20,0
1708258292537,WES 265,A00,454942,Staff,19,0,20,1
1708258294864,AAS 10,A01,392963,Butler; Elizabeth Annette,34,0,34,0
1708258294864,AAS 10,A02,392965,Butler; Elizabeth Annette,33,0,34,1
1708258295389,AAS 170,A00,392977,Butler; Elizabeth Annette,31,0,32,1
1708258295917,AAS 198,001,479182,Childs; Dennis R.,20,0,20,0
1708258296445,AESE 261,A00,387945,Staff,33,0,33,0
1708258296970,AESE 278D,A00,387953,Staff,33,0,33,0
1708258297733,AESE 278E,A00,387954,Staff,33,0,33,0
1708258298259,AESE 279A,A00,387956,Staff,33,0,33,0
1708258298793,AIP 197P,001,494494,Goldfarb; Brian,9999,0,9999,0
1708258299322,ANAR 100,A00,387884,Shtienberg; Gilad,15,0,16,1
1708258299848,ANAR 104,A01,387886,Tamberino; Anthony Thomas,21,0,25,4
1708258300374,ANAR 111,A00,387888,Staff,36,0,36,0
1708258300900,ANAR 115,A00,387889,Shtienberg; Gilad,36,0,36,0
1708258301430,ANAR 120,A00,387890,Staff,36,0,36,0
1708258301955,ANAR 155,A00,387891,Braswell; Geoffrey E.,15,0,25,10
1708258302483,ANAR 164,A00,387892,Staff,32,0,35,3
1708258303011,ANBI 100,A00,489626,Fox; Patrick Keolu Ozer,39,0,40,1
1708258303541,ANBI 111,A00,387893,Hrvoj Mihic; Branka,37,0,40,3
1708258304595,ANBI 144,A00,387896,Wilder; Linnea Lorene,72,0,75,3
1708258305121,ANBI 149,A00,489628,Non; Amy L,0,0,0,0
1708258305651,ANBI 173,A00,387897,Wilder; Linnea Lorene,74,0,75,1
1708258306181,ANBI 174,A00,489627,Strum; Shirley C.,13,0,15,2
1708258306707,ANES 296,001,463968,Gabriel; Rodney A,49,0,50,1
1708258306707,ANES 296,002,463969,Staff,50,0,50,0
1708258306707,ANES 296,003,463970,Staff,50,0,50,0
1708258307236,ANSC 100,A00,387898,Bialecki; Jon Anthony,40,0,40,0
1708258307763,ANSC 101,A00,387900,Sloane; Julia Kathryn,34,0,40,6
1708258308289,ANSC 117,A00,387901,Martin Sandino; Amanda Maria Yoland,13,0,15,2
1708258308815,ANSC 134,A00,387902,Staff,38,0,40,2
1708258309340,ANSC 137,A00,387903,Stewart; Alexander B,80,0,80,0
1708258309866,ANSC 138,A00,387904,Parish; Steven Martin,14,0,15,1
1708258310391,ANSC 142,A00,387905,Stone; Annika Britt,34,0,40,6
1708258310920,ANSC 147,A00,387906,Stewart; Alexander B,40,0,40,0
1708258311462,ANSC 148,A00,387907,Olivas Hernandez; Olga Lid,92,0,92,0
1708258311991,ANSC 186,A00,387910,Hankins; Joseph D.,28,0,30,2
1708258312522,ANTH 2,A01,387863,Marchetto; Maria Carolina,37,0,40,3
1708258312522,ANTH 2,A02,387864,Marchetto; Maria Carolina,40,0,40,0
1708258312522,ANTH 2,A03,387865,Marchetto; Maria Carolina,36,0,40,4
1708258312522,ANTH 2,A04,387866,Marchetto; Maria Carolina,39,0,40,1
1708258313052,ANTH 3,A01,387868,Stroth; Luke Reyneri,28,0,30,2
1708258313052,ANTH 3,A02,387869,Stroth; Luke Reyneri,29,0,30,1
1708258313052,ANTH 3,A03,387870,Stroth; Luke Reyneri,30,0,30,0
1708258313052,ANTH 3,A04,387871,Stroth; Luke Reyneri,29,0,30,1
1708258313631,ANTH 10,A00,387872,Stewart; Alexander B,80,0,80,0
1708258314160,ANTH 21,A01,387874,Stone; Annika Britt,40,0,40,0
1708258314160,ANTH 21,A02,387875,Stone; Annika Britt,40,0,40,0
1708258314160,ANTH 21,A03,387876,Stone; Annika Britt,40,0,40,0
1708258314160,ANTH 21,A04,387877,Stone; Annika Britt,39,0,40,1
1708258314686,ANTH 23,A01,387879,Staff,40,0,40,0
1708258314686,ANTH 23,A02,387880,Staff,40,0,40,0
1708258314686,ANTH 23,A03,387881,Staff,40,0,40,0
1708258314686,ANTH 23,A04,387882,Staff,40,0,40,0
1708258315213,ANTH 24,A00,387883,Pedersen; David,40,0,40,0
1708258315743,ANTH 103,A00,387911,Staff,343,0,350,7
1708258316268,ANTH 105,A00,387912,Staff,73,0,75,2
1708258316796,ANTH 112,A00,387913,Staff,23,0,25,2
1708258317324,ANTH 120,A00,479486,Parish; Steven Martin,28,0,30,2
1708258317854,ANTH 128B,A01,387923,Lewis; Leslie R,12,0,12,0
1708258318380,ANTH 192,A00,387925,Varma; Saiba,20,0,20,0
1708258318906,ANTH 196C,A00,387927,Varma; Saiba,15,0,15,0
1708258319439,ANTH 212,A00,387931,Marchetto; Maria Carolina,25,0,25,0
1708258319439,ANTH 212,B00,479487,Semendeferi; Ekaterini,25,0,25,0
1708258319965,ANTH 220,A00,387932,Csordas; Thomas J.,9,0,12,3
1708258320491,ANTH 230,001,493297,Goldstein; Paul S,18,0,20,2
1708258321021,ANTH 260,A00,479223,Jenkins; Janis A.,25,0,25,0
1708258321547,ANTH 272,A00,387936,Serlin; David,5,0,5,0
1708258322073,ANTH 273,A00,387938,Gates; Kelly,5,0,5,0
1708258322605,ANTH 288,A00,387940,Braswell; Geoffrey E.,25,0,25,0
1708258323132,ANTH 295,001,493298,Algaze; Guillermo,3,0,3,0
1708258323132,ANTH 295,002,493299,Brenner; Suzanne A,3,0,3,0
1708258323132,ANTH 295,003,493300,Csordas; Thomas J.,3,0,3,0
1708258323132,ANTH 295,004,493422,Fox; Patrick Keolu Ozer,3,0,3,0
1708258323132,ANTH 295,005,493472,Gagneux; Pascal,3,0,3,0
1708258323132,ANTH 295,006,493515,Goldstein; Paul S,3,0,3,0
1708258323132,ANTH 295,007,493592,Hankins; Joseph D.,3,0,3,0
1708258323132,ANTH 295,008,493631,Jassal; Aftab,3,0,3,0
1708258323132,ANTH 295,009,493639,Jenkins; Janis A.,3,0,3,0
1708258323132,ANTH 295,010,493657,Kaiser; Bronwyn Nicole,3,0,3,0
1708258323132,ANTH 295,011,493692,Kang; Byung Chu,3,0,3,0
1708258323132,ANTH 295,012,493758,Marchetto; Maria Carolina,3,0,3,0
1708258323132,ANTH 295,013,493761,Non; Amy L,3,0,3,0
1708258323132,ANTH 295,014,493762,Pedersen; David,3,0,3,0
1708258323132,ANTH 295,015,493825,Rivera-Collazo; Isabel C,3,0,3,0
1708258323132,ANTH 295,016,493826,Varma; Saiba,3,0,3,0
1708258323132,ANTH 295,017,493828,Yeh; Rihan Wen Xin,3,0,3,0
1708258323665,ANTH 296,001,493830,Braswell; Geoffrey E.,3,0,3,0
1708258323665,ANTH 296,002,493836,Marchetto; Maria Carolina,3,0,3,0
1708258323665,ANTH 296,003,493838,Rivera-Collazo; Isabel C,3,0,3,0
1708258323665,ANTH 296,004,493840,Varma; Saiba,3,0,3,0
1708258323665,ANTH 296,005,493842,Algaze; Guillermo,3,0,3,0
1708258323665,ANTH 296,006,493845,Brenner; Suzanne A,3,0,3,0
1708258323665,ANTH 296,007,493846,Csordas; Thomas J.,3,0,3,0
1708258323665,ANTH 296,008,493907,Fox; Patrick Keolu Ozer,3,0,3,0
1708258323665,ANTH 296,009,493949,Gagneux; Pascal,3,0,3,0
1708258323665,ANTH 296,010,493960,Goldstein; Paul S,3,0,3,0
1708258323665,ANTH 296,011,493961,Hankins; Joseph D.,3,0,3,0
1708258323665,ANTH 296,012,493962,Jassal; Aftab,3,0,3,0
1708258323665,ANTH 296,013,493963,Jenkins; Janis A.,3,0,3,0
1708258323665,ANTH 296,014,493964,Kaiser; Bronwyn Nicole,3,0,3,0
1708258323665,ANTH 296,015,493965,Kang; Byung Chu,3,0,3,0
1708258323665,ANTH 296,016,493966,Levy; Thomas E,3,0,3,0
1708258323665,ANTH 296,017,493967,Non; Amy L,3,0,3,0
1708258323665,ANTH 296,018,493968,Pedersen; David,3,0,3,0
1708258323665,ANTH 296,019,493969,Postero; Nancy Grey,3,0,3,0
1708258323665,ANTH 296,020,493970,Semendeferi; Ekaterini,3,0,3,0
1708258323665,ANTH 296,021,493971,Yeh; Rihan Wen Xin,3,0,3,0
1708258324196,AUD 236,A00,480192,Harris; Jeffrey Paul,12,0,12,0
1708258324725,AUD 260,A00,480227,Spriggs; Meghan K,12,0,12,0
1708258325251,AUD 272,A00,480367,Zettner; Erika,12,0,12,0
1708258325780,AUD 275,A00,480369,Zettner; Erika,12,0,12,0
1708258326309,AUD 284,A00,480370,Zettner; Erika,12,0,12,0
1708258326309,AUD 284,B00,480372,Spriggs; Meghan K,12,0,12,0
1708258326833,AUD 291,A00,480374,Zettner; Erika,12,0,12,0
1708258327362,AUD 296,A00,480375,Zettner; Erika,12,0,12,0
1708258327362,AUD 296,B00,480376,Harris; Jeffrey Paul,12,0,12,0
1708258327362,AUD 296,C00,480377,Ryan; Allen F.,12,0,12,0
1708258327907,AWP 3,002,387672,Given; William Allan,9,0,9,0
1708258327907,AWP 3,003,387678,Staff,5,0,5,0
1708258327907,AWP 3,004,387681,Staff,0,0,0,0
1708258327907,AWP 3,007,387784,West; Geoffrey Scott,4,0,5,1
1708258327907,AWP 3,009,387786,Kolodezh; Samuel,5,0,5,0
1708258327907,AWP 3,010,387787,Gilbert; Peter W,5,0,5,0
1708258328433,AWP 4A,001,387791,Staff,12,0,12,0
1708258328433,AWP 4A,002,387792,Staff,0,0,0,0
1708258329003,AWP 4B,001,387793,Bolin; Jillian,0,0,0,0
1708258329003,AWP 4B,002,387794,Bolin; Jillian,0,0,0,0
1708258329003,AWP 4B,003,387795,Bauer; Holly Jean,0,0,0,0
1708258329003,AWP 4B,004,387796,Vaughn; Kelsey Sara,0,0,0,0
1708258329003,AWP 4B,005,387797,Vaughn; Kelsey Sara,0,0,0,0
1708258329003,AWP 4B,007,387799,Ajo; Frances Margaret,0,0,0,0
1708258329003,AWP 4B,008,387800,Ajo; Frances Margaret,0,0,0,0
1708258329003,AWP 4B,009,387801,Hall; Graham T,0,0,0,0
1708258329003,AWP 4B,010,387802,Hall; Graham T,0,0,0,0
1708258329003,AWP 4B,011,387803,Heiser; Jerrod A,0,0,0,0
1708258329003,AWP 4B,012,387804,Heiser; Jerrod A,0,0,0,0
1708258329003,AWP 4B,013,387805,Jones; William Jadie,0,0,0,0
1708258329003,AWP 4B,014,387806,Jones; William Jadie,0,0,0,0
1708258329003,AWP 4B,015,387807,Christie; Veronica Ann,0,0,0,0
1708258329003,AWP 4B,016,387808,Christie; Veronica Ann,0,0,0,0
1708258329003,AWP 4B,019,387820,Falcon; Jennifer A,0,0,0,0
1708258329003,AWP 4B,020,387821,Falcon; Jennifer A,0,0,0,0
1708258329003,AWP 4B,021,387822,Eastin; Schuyler E.,0,0,0,0
1708258329003,AWP 4B,023,387824,Coulter; Jane Elisabeth,0,0,0,0
1708258329003,AWP 4B,025,387826,O'Neil; Courtney L,0,0,0,0
1708258329003,AWP 4B,026,387827,O'Neil; Courtney L,0,0,0,0
1708258329003,AWP 4B,027,387828,Tsurska Svetina; Olena,0,0,0,0
1708258329003,AWP 4B,028,387829,Tsurska Svetina; Olena,0,0,0,0
1708258329003,AWP 4B,029,387830,Spicer; Jacqueline,0,0,0,0
1708258329003,AWP 4B,030,387831,Spicer; Jacqueline,0,0,0,0
1708258329003,AWP 4B,031,387832,Steinberg; Stacy A,0,0,0,0
1708258329003,AWP 4B,032,387833,Steinberg; Stacy A,0,0,0,0
1708258329003,AWP 4B,033,387834,Chandler; Bailee Daniele,0,0,0,0
1708258329003,AWP 4B,034,387835,Chandler; Bailee Daniele,0,0,0,0
1708258329003,AWP 4B,035,387836,Tiernan; Christa Michelle,0,0,0,0
1708258329003,AWP 4B,036,387837,Tiernan; Christa Michelle,0,0,0,0
1708258329003,AWP 4B,037,387840,Gardella; Alexander Drew,0,0,0,0
1708258329003,AWP 4B,038,387841,Gardella; Alexander Drew,0,0,0,0
1708258329003,AWP 4B,039,387857,Zimmerman; Guy,0,0,0,0
1708258329003,AWP 4B,040,387858,Zimmerman; Guy,0,0,0,0
1708258329003,AWP 4B,041,387859,Zroka; Amy Liane,0,0,0,0
1708258329003,AWP 4B,042,387860,Zroka; Amy Liane,0,0,0,0
1708258329533,BENG 87,A00,489656,Sah; Robert Lie-Yuan,20,0,20,0
1708258329533,BENG 87,B00,489657,Sah; Robert Lie-Yuan,20,0,20,0
1708258329533,BENG 87,C00,494754,Omens; Jeffrey Howard,20,0,20,0
1708258330060,BENG 100,A01,387959,Alexandrov; Ludmil B,26,0,28,2
1708258330060,BENG 100,A02,387960,Alexandrov; Ludmil B,26,0,28,2
1708258330060,BENG 100,A03,387984,Alexandrov; Ludmil B,26,0,28,2
1708258330060,BENG 100,A04,387985,Alexandrov; Ludmil B,25,0,28,3
1708258330060,BENG 100,A05,387986,Alexandrov; Ludmil B,27,0,28,1
1708258330588,BENG 102,A00,387987,Chapelin; Fanny,55,0,56,1
1708258331119,BENG 103B,A00,387993,Fraley; Stephanie I.,116,0,120,4
1708258331645,BENG 112B,A01,388053,Shi; Lingyan,26,0,30,4
1708258331645,BENG 112B,A02,388054,Shi; Lingyan,29,0,30,1
1708258332175,BENG 125,A00,388055,Hasty; Jeff M,120,0,160,40
1708258332700,BENG 133,A01,388866,Mali; Prashant Gulab Ram,36,0,40,4
1708258333241,BENG 140B,A01,388884,Cabrales; Pedro,28,0,30,2
1708258333241,BENG 140B,A02,388885,Cabrales; Pedro,30,0,30,0
1708258333241,BENG 140B,A03,388886,Cabrales; Pedro,26,0,30,4
1708258333787,BENG 160,A50,388889,Aguado; Brian Alberto,23,0,25,2
1708258333787,BENG 160,A51,388919,Aguado; Brian Alberto,25,0,25,0
1708258333787,BENG 160,A52,388920,Aguado; Brian Alberto,25,0,25,0
1708258334312,BENG 168,A01,388961,Khojah; Reem I,30,0,30,0
1708258334838,BENG 172,A50,389087,Omens; Jeffrey Howard & Cabrales; Pedro,15,0,20,5
1708258334838,BENG 172,A51,389088,Omens; Jeffrey Howard & Cabrales; Pedro,14,0,20,6
1708258335368,BENG 182,A01,389128,Bafna; Vineet,28,0,30,2
1708258335894,BENG 186A,A00,389130,Kwon; Ester Jihae,105,0,120,15
1708258336423,BENG 187A,A00,389289,Taylor Amos; Alyssa C,157,0,170,13
1708258336948,BENG 187D,A00,389290,Taylor Amos; Alyssa C,33,0,60,27
1708258336948,BENG 187D,B00,389300,Taylor Amos; Alyssa C,51,0,60,9
1708258336948,BENG 187D,C00,389302,Taylor Amos; Alyssa C,35,0,60,25
1708258337473,BENG 189,A00,389303,Contijoch; Francisco,26,0,30,4
1708258338005,BENG 193,A00,389328,Engler; Adam J.,0,0,0,0
1708258338531,BENG 196,A00,436038,Engler; Adam J.,9999,0,9999,0
1708258339059,BENG 197,A00,436081,Engler; Adam J.,9999,0,9999,0
1708258339589,BENG 203,A00,389385,Bafna; Vineet & Zhong; Sheng,20,0,20,0
1708258340116,BENG 207,A00,389386,Kwon; Ester Jihae,10,0,40,30
1708258340116,BENG 207,B00,389400,Taylor Amos; Alyssa C,8,0,30,22
1708258340116,BENG 207,C00,389432,Khojah; Reem I,20,0,40,20
1708258340645,BENG 209,A00,389456,Scholtes Acevedo; Claire,30,0,30,0
1708258341187,BENG 213,A00,389496,Palsson; Bernhard O.,16,0,20,4
1708258342240,BENG 224,A00,389515,Staff,0,0,0,0
1708258342780,BENG 226,A01,479043,Schmid-Schoenbein; Geert W,7,0,30,23
1708258343310,BENG 227,A00,389591,Fraley; Stephanie I.,55,0,120,65
1708258343835,BENG 230C,A00,389810,Mc Culloch; Andrew Douglas,43,0,90,47
1708258344379,BENG 232,A01,390161,Sah; Robert Lie-Yuan,6,0,50,44
1708258344908,BENG 233,A00,390290,Shah; Sameer B,33,0,50,17
1708258345434,BENG 234,A00,390291,Silva; Gabriel,20,0,56,36
1708258345959,BENG 235,A00,390318,Bintu; Bogdan,16,0,40,24
1708258346487,BENG 276,A00,390357,Mc Culloch; Andrew Douglas & Amaro; Rommie E,0,0,0,0
1708258347017,BENG 280C,A01,390443,McVeigh; Elliot R.,45,0,56,11
1708258347544,BENG 281,A00,390444,Kravets; Vira V.,50,0,110,60
1708258348073,BENG 283,A00,390445,Komives; Elizabeth A,4,0,4,0
1708258348603,BENG 292,A01,390623,Ross; Camille,20,0,20,0
1708258349128,BENG 294C,A00,390709,Engler; Adam J.,17,0,20,3
1708258349653,BENG 295,A00,436300,Watson; John Thomas,9999,0,9999,0
1708258350179,BGGN 205,A00,423656,Daugherty; Matthew Dorton,47,0,60,13
1708258350702,BGGN 207,A01,423703,Ross; Camille,0,0,0,0
1708258351226,BGGN 215,A00,423704,Petrie; Katherine Lynn,22,0,30,8
1708258351756,BGGN 216,A01,423855,Mueller; Liam O'Connor,37,0,50,13
1708258352300,BGGN 218,A00,423861,David; Michael,19,0,30,11
1708258352826,BGGN 223,A00,423862,Bier; Ethan,17,0,35,18
1708258353357,BGGN 230,A00,423863,Taylor; Susan S.,8,0,15,7
1708258353887,BGGN 232,A00,423864,Briggs; Steven & Troemel; Emily Ruth,25,0,30,5
1708258354417,BGGN 239,A01,424014,Kronenberg; Mitchell E.,30,0,30,0
1708258354943,BGGN 240,A01,424016,Juavinett; Ashley Lauren,0,0,6,6
1708258355469,BGGN 248,A00,424017,Halpain; Shelley,26,0,30,4
1708258355995,BGGN 249C,A00,424052,Staff,33,0,33,0
1708258356520,BGGN 250,A01,424091,Zou; Yimin,7,0,8,1
1708258357046,BGGN 252,A01,424093,Sejnowski; Terrence J,5,0,6,1
1708258357575,BGGN 255,A00,424094,Root; Cory Matthew,29,0,30,1
1708258358101,BGGN 262,A01,424096,Villa Rodriguez; Elizabeth,30,0,30,0
1708258358629,BGGN 267,A01,424099,Benna; Marcus K & Aljadeff; Johnatan,5,0,6,1
1708258359160,BGGN 270,A00,477483,Juavinett; Ashley Lauren,67,0,75,8
1708258359855,BGGN 271,001,481745,Ackerman; Susan,9998,0,9999,1
1708258359855,BGGN 271,002,481746,Akbari; Omar Sultan,9999,0,9999,0
1708258359855,BGGN 271,003,481747,Allen; Nicola J,9999,0,9999,0
1708258359855,BGGN 271,004,481748,Banegas; Matthew Patrick,9999,0,9999,0
1708258359855,BGGN 271,005,481749,Breen; Ellen C.,9998,0,9999,1
1708258359855,BGGN 271,006,481750,Briggs; Steven,9998,0,9999,1
1708258359855,BGGN 271,007,481751,Bui; Jack D,9999,0,9999,0
1708258359855,BGGN 271,008,481762,Busch; Wolfgang,9999,0,9999,0
1708258359855,BGGN 271,009,481763,Castle; Michael James,9999,0,9999,0
1708258359855,BGGN 271,010,481764,Chang; John Tzu-yu,9999,0,9999,0
1708258359855,BGGN 271,011,481765,Chen; Ju,9998,0,9999,1
1708258359855,BGGN 271,012,481766,Chen; Xu,9999,0,9999,0
1708258359855,BGGN 271,013,481767,Cheng; Christine Shiang-Ling,9999,0,9999,0
1708258359855,BGGN 271,014,481768,Cherqui; Stephanie,9999,0,9999,0
1708258359855,BGGN 271,015,481769,Cho; Yoshitake,9999,0,9999,0
1708258359855,BGGN 271,016,481770,Church; Kellie Breen,9998,0,9999,1
1708258359855,BGGN 271,017,481771,Cleland; Elsa Eleanor,9999,0,9999,0
1708258359855,BGGN 271,018,481779,Cohen; Shiran,9998,0,9999,1
1708258359855,BGGN 271,019,481814,Cook-Andersen; Heidi Leigh,9999,0,9999,0
1708258359855,BGGN 271,020,481815,Cooke; James Edward,9999,0,9999,0
1708258359855,BGGN 271,021,481816,Coufal; Nicole Gabriele,9998,0,9999,1
1708258359855,BGGN 271,022,481818,Crotty Alexander; Laura E,9999,0,9999,0
1708258359855,BGGN 271,023,481819,Daugherty; Matthew Dorton,9998,0,9999,1
1708258359855,BGGN 271,024,481820,De Guglielmo; Giordano,9998,0,9999,1
1708258359855,BGGN 271,025,481821,Doherty; Taylor Alan,9998,0,9999,1
1708258359855,BGGN 271,026,481822,Dulawa; Stephanie Carole,9999,0,9999,0
1708258359855,BGGN 271,027,481823,Esko; Jeffrey D.,9998,0,9999,1
1708258359855,BGGN 271,028,481824,Feldstein; Ariel E,9998,0,9999,1
1708258359855,BGGN 271,029,481825,Friedman; Rick Adam,9999,0,9999,0
1708258359855,BGGN 271,030,481826,Furnari; Frank,9999,0,9999,0
1708258359855,BGGN 271,031,481829,Ghosh; Pradipta,9998,0,9999,1
1708258359855,BGGN 271,032,481830,Gleeson; Joseph Gerard,9999,0,9999,0
1708258359855,BGGN 271,033,481831,Golden; Susan S.,9998,0,9999,1
1708258359855,BGGN 271,034,481832,Goren; Alon M,9998,0,9999,1
1708258359855,BGGN 271,035,481834,Gustafsson; Asa Birgitta,9999,0,9999,0
1708258359855,BGGN 271,036,481836,Hamdoun; Amr,9999,0,9999,0
1708258359855,BGGN 271,037,481837,Hao; Nan,9999,0,9999,0
1708258359855,BGGN 271,038,481840,Holway; David A.,9998,0,9999,1
1708258359855,BGGN 271,039,481841,Huffaker; Alisa,9998,0,9999,1
1708258359855,BGGN 271,040,481843,Sebat; Lilia Mikhailovna,9998,0,9999,1
1708258359855,BGGN 271,041,481889,Ideker; Trey,9999,0,9999,0
1708258359855,BGGN 271,042,481890,Jiang; Qingfei,9998,0,9999,1
1708258359855,BGGN 271,043,482311,Jin; Yishi,9999,0,9999,0
1708258359855,BGGN 271,044,482334,Joiner; William J.,9999,0,9999,0
1708258359855,BGGN 271,045,482353,Kaech; Susan Michelle,9998,0,9999,1
1708258359855,BGGN 271,046,482378,Karin; Michael,9999,0,9999,0
1708258359855,BGGN 271,047,482379,Kleinfeld; David,9999,0,9999,0
1708258359855,BGGN 271,048,482413,Koffler; Yacov,9999,0,9999,0
1708258359855,BGGN 271,049,482414,Komiyama; Takaki,9999,0,9999,0
1708258359855,BGGN 271,050,482415,Kryazhimskiy; Sergey A,9999,0,9999,0
1708258359855,BGGN 271,051,482416,Lawson; Mark Andrew,9999,0,9999,0
1708258359855,BGGN 271,052,482417,Lee; Yun Sok,9999,0,9999,0
1708258359855,BGGN 271,053,482451,Leutgeb; Stefan,9998,0,9999,1
1708258359855,BGGN 271,054,482452,Lo; Stanley M.,9999,0,9999,0
1708258359855,BGGN 271,055,482453,Lu; Pengzhe,9998,0,9999,1
1708258359855,BGGN 271,056,482454,Lykke-Andersen; Jens,9998,0,9999,1
1708258359855,BGGN 271,057,482456,McDonnell; Lisa Marie,9999,0,9999,0
1708258359855,BGGN 271,058,482461,McHugh; Colleen A,9998,0,9999,1
1708258359855,BGGN 271,059,482478,Meharena; Hiruy Sibhatu,9999,0,9999,0
1708258359855,BGGN 271,060,482497,Morris; Gerald P,9999,0,9999,0
1708258359855,BGGN 271,061,482499,Mukamel; Eran A,9998,0,9999,1
1708258359855,BGGN 271,062,482535,Muotri; Alysson,9999,0,9999,0
1708258359855,BGGN 271,063,482551,Muroyama; Andrew David,9999,0,9999,0
1708258359855,BGGN 271,064,482552,Neal; Sonya E,9999,0,9999,0
1708258359855,BGGN 271,065,482618,Nieh; James Charles,9999,0,9999,0
1708258359855,BGGN 271,066,482619,O'Donoghue; Anthony John,9999,0,9999,0
1708258359855,BGGN 271,067,482626,Pantham; Priyadarshini,9999,0,9999,0
1708258359855,BGGN 271,068,482633,Parast; Mana,9999,0,9999,0
1708258359855,BGGN 271,069,482634,Perry; Michael William,9999,0,9999,0
1708258359855,BGGN 271,070,482639,Pride; David Tevis,9999,0,9999,0
1708258359855,BGGN 271,071,482645,Pruneda-Paz; Jose L.,9999,0,9999,0
1708258359855,BGGN 271,072,482648,Rana; Tariq,9999,0,9999,0
1708258359855,BGGN 271,073,482650,Risbrough; Victoria Blythe,9999,0,9999,0
1708258359855,BGGN 271,074,482655,Rissman; Robert Andrew,9999,0,9999,0
1708258359855,BGGN 271,075,482656,Rosenfeld; Michael G,9999,0,9999,0
1708258359855,BGGN 271,076,482657,Saier; Milton H.,9999,0,9999,0
1708258359855,BGGN 271,077,482663,Sander; Maike,9999,0,9999,0
1708258359855,BGGN 271,078,482664,Schenk; Simon,9999,0,9999,0
1708258359855,BGGN 271,079,482665,Schoeneberg; Johannes,9998,0,9999,1
1708258359855,BGGN 271,080,482666,Schroeder; Julian I,9998,0,9999,1
1708258359855,BGGN 271,081,482667,Shaner; Nathan C.,9999,0,9999,0
1708258359855,BGGN 271,082,482668,Sheikh; Farah,9999,0,9999,0
1708258359855,BGGN 271,083,482669,Shurin; Jonathan,9999,0,9999,0
1708258359855,BGGN 271,084,482675,Sigurdson; Christina,9999,0,9999,0
1708258359855,BGGN 271,085,482676,Smith; David M.,9999,0,9999,0
1708258359855,BGGN 271,086,482677,Steinmetz; Nicole F,9999,0,9999,0
1708258359855,BGGN 271,087,482692,Su; Chih-Ying,9999,0,9999,0
1708258359855,BGGN 271,088,482694,Suel; Gurol Mehmet,9999,0,9999,0
1708258359855,BGGN 271,089,482695,Telese; Francesca,9999,0,9999,0
1708258359855,BGGN 271,090,482745,Thackray; Varykina G.,9999,0,9999,0
1708258359855,BGGN 271,091,482746,Towers; Christina Garlingt,9999,0,9999,0
1708258359855,BGGN 271,092,482747,Troemel; Emily Ruth,9997,0,9999,2
1708258359855,BGGN 271,093,482748,Tye; Kay M,9999,0,9999,0
1708258359855,BGGN 271,094,482749,Valdez-Jasso; Daniela,9998,0,9999,1
1708258359855,BGGN 271,095,482750,Wahlin; Karl Jonas,9997,0,9999,2
1708258359855,BGGN 271,096,482751,Welsbie; Derek,9999,0,9999,0
1708258359855,BGGN 271,097,482752,Wilkinson; Miles Frome,9999,0,9999,0
1708258359855,BGGN 271,098,482754,Yaksh; Tony L.,9999,0,9999,0
1708258359855,BGGN 271,099,482760,Yang; Jing,9999,0,9999,0
1708258359855,BGGN 271,100,482761,Yeo; Eugene Wei-Ming,9998,0,9999,1
1708258359855,BGGN 271,101,482763,Ying; Wei,9999,0,9999,0
1708258359855,BGGN 271,102,482764,Zarrinpar; Amir,9999,0,9999,0
1708258359855,BGGN 271,103,482765,Zengler; Karsten B,9999,0,9999,0
1708258359855,BGGN 271,104,482766,Zhang; Dong-Er,9999,0,9999,0
1708258359855,BGGN 271,105,482768,Zhao; Yunde,9999,0,9999,0
1708258359855,BGGN 271,106,482776,Zheng; Binhai,9999,0,9999,0
1708258359855,BGGN 271,107,482777,Zheng; Ye,9998,0,9999,1
1708258359855,BGGN 271,108,482806,Zuniga; Elina I,9999,0,9999,0
1708258360380,BGGN 273,A01,424101,Mueller; Liam O'Connor,43,0,50,7
1708258360908,BGGN 280,A00,424102,Ernst; Andreas,3,0,5,2
1708258360908,BGGN 280,C00,481361,Amaro; Rommie E,2,0,5,3
1708258361437,BGGN 281,A00,424103,Desai; Arshad & Oegema; Karen,0,0,5,5
1708258361968,BGGN 283,A00,424104,Rivera; Fabian Chavez,0,0,5,5
1708258361968,BGGN 283,B00,424105,Russell; Alistair B,4,0,5,1
1708258361968,BGGN 283,D00,424107,Wildonger; Jill Cathleen,1,0,5,4
1708258362494,BGGN 284,A00,424108,Glasgow; Stacey Marie,2,0,5,3
1708258363025,BGGN 285,A00,424109,Chisholm; Andrew D.,1,0,5,4
1708258363025,BGGN 285,B00,424110,Farley; Emma Kristen,2,0,5,3
1708258363554,BGGN 295,A00,424120,Tour; Ella,9,0,30,21
1708258364080,BGJC 204,A00,424138,Lu; Li-Fan & Chang; John Tzu-yu,9998,0,9999,1
1708258364609,BGJC 215,A00,424139,Cooke; James Edward & Lo; Stanley M.,10,0,10,0
1708258365342,BGRD 200,001,485528,Ackerman; Susan,9998,0,9999,1
1708258365342,BGRD 200,002,485529,Akbari; Omar Sultan,9999,0,9999,0
1708258365342,BGRD 200,003,485530,Allen; Eric,9999,0,9999,0
1708258365342,BGRD 200,004,485531,Allen; Nicola J,9999,0,9999,0
1708258365342,BGRD 200,005,485533,Amaro; Rommie E,9999,0,9999,0
1708258365342,BGRD 200,006,485535,Augustine; Vineet,9999,0,9999,0
1708258365342,BGRD 200,007,485536,Ayres; Janelle Samantha,9999,0,9999,0
1708258365342,BGRD 200,008,485538,Banegas; Matthew Patrick,9999,0,9999,0
1708258365342,BGRD 200,009,485539,Banghart; Matthew Ryan,9999,0,9999,0
1708258365342,BGRD 200,010,485542,Benna; Marcus K,9999,0,9999,0
1708258365342,BGRD 200,011,485543,Bennett; Eric J,9999,0,9999,0
1708258365342,BGRD 200,012,485545,Bloodgood; Brenda Laurie,9999,0,9999,0
1708258365342,BGRD 200,013,485546,Breen; Ellen C.,9998,0,9999,1
1708258365342,BGRD 200,014,485548,Briggs; Steven,9998,0,9999,1
1708258365342,BGRD 200,015,485549,Bui; Jack D,9999,0,9999,0
1708258365342,BGRD 200,016,485552,Busch; Wolfgang,9999,0,9999,0
1708258365342,BGRD 200,017,485621,Callaway; Edward M,9999,0,9999,0
1708258365342,BGRD 200,018,485622,Castle; Michael James,9999,0,9999,0
1708258365342,BGRD 200,019,485623,Chaim; Isaac,9999,0,9999,0
1708258365342,BGRD 200,020,485624,Chang; John Tzu-yu,9999,0,9999,0
1708258365342,BGRD 200,021,485625,Chen; Ju,9999,0,9999,0
1708258365342,BGRD 200,022,485626,Chen; Xu,9999,0,9999,0
1708258365342,BGRD 200,023,485627,Cheng; Christine Shiang-Ling,9999,0,9999,0
1708258365342,BGRD 200,024,485632,Cherqui; Stephanie,9999,0,9999,0
1708258365342,BGRD 200,025,485633,Cho; Yoshitake,9999,0,9999,0
1708258365342,BGRD 200,026,485634,Church; Kellie Breen,9999,0,9999,0
1708258365342,BGRD 200,027,485635,Cleland; Elsa Eleanor,9999,0,9999,0
1708258365342,BGRD 200,028,485636,Cohen; Shiran,9998,0,9999,1
1708258365342,BGRD 200,029,485639,Cook-Andersen; Heidi Leigh,9999,0,9999,0
1708258365342,BGRD 200,030,485686,Cooke; James Edward,9999,0,9999,0
1708258365342,BGRD 200,031,485688,Cooper; Kimberly Lynn,9999,0,9999,0
1708258365342,BGRD 200,032,485689,Coufal; Nicole Gabriele,9998,0,9999,1
1708258365342,BGRD 200,033,485690,Crotty Alexander; Laura E,9999,0,9999,0
1708258365342,BGRD 200,034,485691,Staff,9999,0,9999,0
1708258365342,BGRD 200,035,485692,De Guglielmo; Giordano,9999,0,9999,0
1708258365342,BGRD 200,036,485693,De Silva; Shermin,9999,0,9999,0
1708258365342,BGRD 200,037,485694,Desai; Arshad,9999,0,9999,0
1708258365342,BGRD 200,038,485695,Dickinson; Alexandra Jazz,9999,0,9999,0
1708258365342,BGRD 200,039,485717,Doherty; Taylor Alan,9998,0,9999,1
1708258365342,BGRD 200,040,485720,Dulawa; Stephanie Carole,9999,0,9999,0
1708258365342,BGRD 200,041,485721,Ecker; Joseph R,9999,0,9999,0
1708258365342,BGRD 200,042,485760,Engle; Dannielle D,9999,0,9999,0
1708258365342,BGRD 200,043,485761,Ernst; Andreas,9998,0,9999,1
1708258365342,BGRD 200,044,485766,Esko; Jeffrey D.,9998,0,9999,1
1708258365342,BGRD 200,045,485905,Evans; Ronald M,9999,0,9999,0
1708258365342,BGRD 200,046,485907,Staff,9999,0,9999,0
1708258365342,BGRD 200,047,485918,Feldstein; Ariel E,9998,0,9999,1
1708258365342,BGRD 200,048,485938,Friedman; Rick Adam,9999,0,9999,0
1708258365342,BGRD 200,049,485986,Furnari; Frank,9999,0,9999,0
1708258365342,BGRD 200,050,486018,Gage; Fred H,9999,0,9999,0
1708258365342,BGRD 200,051,486139,George; Monique Leana,9999,0,9999,0
1708258365342,BGRD 200,052,486140,Ghosh; Pradipta,9998,0,9999,1
1708258365342,BGRD 200,053,486141,Glass; Christopher,9998,0,9999,1
1708258365342,BGRD 200,054,486142,Gleeson; Joseph Gerard,9999,0,9999,0
1708258365342,BGRD 200,055,486143,Golden; Susan S.,9999,0,9999,0
1708258365342,BGRD 200,056,486144,Goldrath; Ananda,9999,0,9999,0
1708258365342,BGRD 200,057,486145,Goren; Alon M,9998,0,9999,1
1708258365342,BGRD 200,058,486146,Gustafsson; Asa Birgitta,9999,0,9999,0
1708258365342,BGRD 200,059,486164,Gutkind; Jorge Silvio,9999,0,9999,0
1708258365342,BGRD 200,060,486203,Hamdoun; Amr,9999,0,9999,0
1708258365342,BGRD 200,061,486204,Hampton; Randolph Y.,9999,0,9999,0
1708258365342,BGRD 200,062,486205,Hao; Nan,9999,0,9999,0
1708258365342,BGRD 200,063,486206,Staff,9999,0,9999,0
1708258365342,BGRD 200,064,486207,Hasty; Jeff M,9999,0,9999,0
1708258365342,BGRD 200,065,486208,Hollern; Daniel Patrick,9999,0,9999,0
1708258365342,BGRD 200,066,486209,Holway; David A.,9997,0,9999,2
1708258365342,BGRD 200,067,486214,Huffaker; Alisa,9998,0,9999,1
1708258365342,BGRD 200,068,486215,Hui; Enfu,9999,0,9999,0
1708258365342,BGRD 200,069,486216,Hwa; Terence T.,9999,0,9999,0
1708258365342,BGRD 200,070,486217,Sebat; Lilia Mikhailovna,9998,0,9999,1
1708258365342,BGRD 200,071,486218,Ideker; Trey,9999,0,9999,0
1708258365342,BGRD 200,072,486219,Jackrel; Sara,9998,0,9999,1
1708258365342,BGRD 200,073,486224,Jiang; Qingfei,9998,0,9999,1
1708258365342,BGRD 200,074,486225,Jin; Yishi,9999,0,9999,0
1708258365342,BGRD 200,075,486226,Joiner; William J.,9999,0,9999,0
1708258365342,BGRD 200,076,486227,Jun; Suckjoon,9999,0,9999,0
1708258365342,BGRD 200,077,486228,Kadonaga; James T,9998,0,9999,1
1708258365342,BGRD 200,078,486229,Kaech; Susan Michelle,9997,0,9999,2
1708258365342,BGRD 200,079,486237,Karin; Michael,9999,0,9999,0
1708258365342,BGRD 200,080,486238,Kleinfeld; David,9999,0,9999,0
1708258365342,BGRD 200,081,486239,Knight; Robin,9999,0,9999,0
1708258365342,BGRD 200,082,486335,Koffler; Yacov,9999,0,9999,0
1708258365342,BGRD 200,083,486336,Komiyama; Takaki,9999,0,9999,0
1708258365342,BGRD 200,084,486337,Kosuri; Pallav,9999,0,9999,0
1708258365342,BGRD 200,085,486353,Kryazhimskiy; Sergey A,9999,0,9999,0
1708258365342,BGRD 200,086,486354,Kurle; Carolyn M.,9999,0,9999,0
1708258365342,BGRD 200,087,486355,Law; Julie A,9999,0,9999,0
1708258365342,BGRD 200,088,486356,Lawson; Mark Andrew,9999,0,9999,0
1708258365342,BGRD 200,089,486357,Lee; Kuo Fen,9999,0,9999,0
1708258365342,BGRD 200,090,486376,Lee; Yun Sok,9999,0,9999,0
1708258365342,BGRD 200,091,486413,Leutgeb; Jill K.,9999,0,9999,0
1708258365342,BGRD 200,092,486414,Leutgeb; Stefan,9998,0,9999,1
1708258365342,BGRD 200,093,486415,Lim; Byungkook,9999,0,9999,0
1708258365342,BGRD 200,094,486419,Lo; Stanley M.,9999,0,9999,0
1708258365342,BGRD 200,095,486420,Looger; Loren Lee,9999,0,9999,0
1708258365342,BGRD 200,096,486422,Lovett-Barron; Matthew Rod,9999,0,9999,0
1708258365342,BGRD 200,097,486423,Lu; Li-Fan,9998,0,9999,1
1708258365342,BGRD 200,098,486424,Lu; Pengzhe,9998,0,9999,1
1708258365342,BGRD 200,099,486425,Lykke-Andersen; Jens,9998,0,9999,1
1708258365342,BGRD 200,100,486426,Lyumkis; Dmitry Evgenievich,9999,0,9999,0
1708258365342,BGRD 200,101,486427,Madigan; Cressida Ariana,9999,0,9999,0
1708258365342,BGRD 200,102,486428,Staff,9999,0,9999,0
1708258365342,BGRD 200,103,486429,Mayfield; Stephen P.,9998,0,9999,1
1708258365342,BGRD 200,104,486430,McDonnell; Lisa Marie,9999,0,9999,0
1708258365342,BGRD 200,105,486620,McHugh; Colleen A,9998,0,9999,1
1708258365342,BGRD 200,106,486621,Meharena; Hiruy Sibhatu,9999,0,9999,0
1708258365342,BGRD 200,107,486622,Staff,9999,0,9999,0
1708258365342,BGRD 200,108,486681,Morris; Gerald P,9999,0,9999,0
1708258365342,BGRD 200,109,486682,Mukamel; Eran A,9998,0,9999,1
1708258365342,BGRD 200,110,486683,Muotri; Alysson,9999,0,9999,0
1708258365342,BGRD 200,111,486684,Muroyama; Andrew David,9999,0,9999,0
1708258365342,BGRD 200,112,486687,Murre; Cornelis,9999,0,9999,0
1708258365342,BGRD 200,113,486691,Neal; Sonya E,9999,0,9999,0
1708258365342,BGRD 200,114,486692,Nieh; James Charles,9998,0,9999,1
1708258365342,BGRD 200,115,486693,Nimmerjahn; Axel,9999,0,9999,0
1708258365342,BGRD 200,116,486694,Nizet; Victor F.,9999,0,9999,0
1708258365342,BGRD 200,117,486695,O'Donoghue; Anthony John,9999,0,9999,0
1708258365342,BGRD 200,118,486706,Oegema; Karen,9999,0,9999,0
1708258365342,BGRD 200,119,486708,O'Shea; Clodagh,9999,0,9999,0
1708258365342,BGRD 200,120,486709,Pantham; Priyadarshini,9999,0,9999,0
1708258365342,BGRD 200,121,486715,Parast; Mana,9999,0,9999,0
1708258365342,BGRD 200,122,486716,Pasquinelli; Amy,9998,0,9999,1
1708258365342,BGRD 200,123,486718,Pekkurnaz Banghart; Gulcin,9999,0,9999,0
1708258365342,BGRD 200,124,486720,Perry; Michael William,9999,0,9999,0
1708258365342,BGRD 200,125,486721,Pfaff; Samuel,9999,0,9999,0
1708258365342,BGRD 200,126,486723,Pogliano; Joseph,9999,0,9999,0
1708258365342,BGRD 200,127,486724,Pogliano; Kit J.,9999,0,9999,0
1708258365342,BGRD 200,128,486727,Pride; David Tevis,9999,0,9999,0
1708258365342,BGRD 200,129,486728,Pruneda-Paz; Jose L.,9999,0,9999,0
1708258365342,BGRD 200,130,486733,Staff,9999,0,9999,0
1708258365342,BGRD 200,131,486734,Rana; Tariq,9999,0,9999,0
1708258365342,BGRD 200,132,486736,Reck-Peterson; Samara L,9999,0,9999,0
1708258365342,BGRD 200,133,486738,Rennison; Diana,9999,0,9999,0
1708258365342,BGRD 200,134,486741,Rifkin; Scott,9999,0,9999,0
1708258365342,BGRD 200,135,486743,Risbrough; Victoria Blythe,9999,0,9999,0
1708258365342,BGRD 200,136,486749,Rissman; Robert Andrew,9999,0,9999,0
1708258365342,BGRD 200,137,486750,Rivera; Fabian Chavez,9999,0,9999,0
1708258365342,BGRD 200,138,486753,Root; Cory Matthew,9999,0,9999,0
1708258365342,BGRD 200,139,486760,Rosenfeld; Michael G,9998,0,9999,1
1708258365342,BGRD 200,140,486763,Russell; Alistair B,9999,0,9999,0
1708258365342,BGRD 200,141,486766,Saier; Milton H.,9999,0,9999,0
1708258365342,BGRD 200,142,486768,Sander; Maike,9999,0,9999,0
1708258365342,BGRD 200,143,486770,Saphire; Erica Ollmann,9999,0,9999,0
1708258365342,BGRD 200,144,486771,Schenk; Simon,9999,0,9999,0
1708258365342,BGRD 200,145,486774,Schoeneberg; Johannes,9999,0,9999,0
1708258365342,BGRD 200,146,486777,Schroeder; Julian I,9998,0,9999,1
1708258365342,BGRD 200,147,486783,Shah; Sameer B,9999,0,9999,0
1708258365342,BGRD 200,148,486784,Shaner; Nathan C.,9999,0,9999,0
1708258365342,BGRD 200,149,486785,Shaw; Reuben,9999,0,9999,0
1708258365342,BGRD 200,150,486786,Sheikh; Farah,9999,0,9999,0
1708258365342,BGRD 200,151,486787,Staff,9999,0,9999,0
1708258365342,BGRD 200,152,486788,Signer; Robert,9999,0,9999,0
1708258365342,BGRD 200,153,486789,Sigurdson; Christina,9999,0,9999,0
1708258365342,BGRD 200,154,486790,Smith; David M.,9999,0,9999,0
1708258365342,BGRD 200,155,486791,Soncin; Francesca,9999,0,9999,0
1708258365342,BGRD 200,156,486792,Steinmetz; Nicole F,9999,0,9999,0
1708258365342,BGRD 200,157,486793,Su; Chih-Ying,9999,0,9999,0
1708258365342,BGRD 200,158,486794,Suel; Gurol Mehmet,9999,0,9999,0
1708258365342,BGRD 200,159,486795,Sun; Xin,9999,0,9999,0
1708258365342,BGRD 200,160,486796,Telese; Francesca,9999,0,9999,0
1708258365342,BGRD 200,161,486797,Thackray; Varykina G.,9999,0,9999,0
1708258365342,BGRD 200,162,486798,Towers; Christina Garlingt,9999,0,9999,0
1708258365342,BGRD 200,163,486799,Traver; David,9999,0,9999,0
1708258365342,BGRD 200,164,486800,Troemel; Emily Ruth,9998,0,9999,1
1708258365342,BGRD 200,165,486801,Tye; Kay M,9999,0,9999,0
1708258365342,BGRD 200,166,486802,Valdez-Jasso; Daniela,9998,0,9999,1
1708258365342,BGRD 200,167,486803,Vijayanand; Pandurangan,9999,0,9999,0
1708258365342,BGRD 200,168,486804,Villa Rodriguez; Elizabeth,9999,0,9999,0
1708258365342,BGRD 200,169,486805,Wahlin; Karl Jonas,9997,0,9999,2
1708258365342,BGRD 200,170,486806,Wang; Jean Yin Jen,9999,0,9999,0
1708258365342,BGRD 200,171,486807,Welsbie; Derek,9999,0,9999,0
1708258365342,BGRD 200,172,486808,Wildonger; Jill Cathleen,9998,0,9999,1
1708258365342,BGRD 200,173,486809,Wilkinson; Miles Frome,9999,0,9999,0
1708258365342,BGRD 200,174,486810,Winzeler; Elizabeth A,9999,0,9999,0
1708258365342,BGRD 200,175,486811,Yaksh; Tony L.,9999,0,9999,0
1708258365342,BGRD 200,176,486812,Yang; Jing,9999,0,9999,0
1708258365342,BGRD 200,177,486813,Staff,9999,0,9999,0
1708258365342,BGRD 200,178,486814,Yeo; Eugene Wei-Ming,9998,0,9999,1
1708258365342,BGRD 200,179,486815,Ying; Wei,9999,0,9999,0
1708258365342,BGRD 200,180,486816,Zarrinpar; Amir,9999,0,9999,0
1708258365342,BGRD 200,181,486817,Zengler; Karsten B,9999,0,9999,0
1708258365342,BGRD 200,182,486818,Zhang; Dong-Er,9999,0,9999,0
1708258365342,BGRD 200,183,486819,Zhao; Yunde,9999,0,9999,0
1708258365342,BGRD 200,184,486820,Zheng; Binhai,9999,0,9999,0
1708258365342,BGRD 200,185,486821,Zheng; Ye,9998,0,9999,1
1708258365342,BGRD 200,186,486822,Zuniga; Elina I,9999,0,9999,0
1708258365871,BGSE 200,A00,424140,Tour; Ella & Petrie; Katherine Lynn,9995,0,9999,4
1708258366397,BGSE 205,A00,424177,Bennett; Eric J,49,0,50,1
1708258366397,BGSE 205,B00,424179,Bennett; Eric J,48,0,50,2
1708258366397,BGSE 205,C00,424182,Bennett; Eric J,47,0,50,3
1708258366397,BGSE 205,D00,424184,Bennett; Eric J,46,0,50,4
1708258366397,BGSE 205,E00,424185,Bennett; Eric J,50,0,50,0
1708258366924,BIBC 100,A01,425401,Corbett; Kevin Daniel,150,0,158,8
1708258366924,BIBC 100,B01,477769,Amaro; Rommie E,156,0,158,2
1708258367507,BIBC 102,A01,425425,Bozinovic; Goran,255,0,256,1
1708258367507,BIBC 102,B01,425440,Hampton; Randolph Y.,250,0,256,6
1708258367507,BIBC 102,C01,486849,Flagg; Matthew Paul,61,0,120,59
1708258368047,BIBC 103,A01,425476,Grossman; Emily N,17,0,24,7
1708258368047,BIBC 103,A02,425509,Grossman; Emily N,21,0,24,3
1708258368047,BIBC 103,A03,425530,Grossman; Emily N,18,0,24,6
1708258368047,BIBC 103,A04,425536,Grossman; Emily N,22,0,24,2
1708258368047,BIBC 103,B01,425538,Boumechache; Miyyada,20,0,24,4
1708258368047,BIBC 103,B02,425539,Boumechache; Miyyada,24,0,24,0
1708258368047,BIBC 103,B03,425548,Boumechache; Miyyada,24,0,24,0
1708258368047,BIBC 103,B04,425549,Boumechache; Miyyada,24,0,24,0
1708258368580,BIBC 120,A01,425592,Coleman; Aaron B.,242,0,256,14
1708258369107,BIBC 194,A00,425609,Ernst; Andreas,21,0,27,6
1708258369107,BIBC 194,B00,477632,Saier; Milton H.,26,0,27,1
1708258369107,BIBC 194,C00,481360,Amaro; Rommie E,23,0,27,4
1708258369107,BIBC 194,D00,486852,Flagg; Matthew Paul,21,0,32,11
1708258369645,BICD 100,A01,470377,Troemel; Emily Ruth,127,0,128,1
1708258369645,BICD 100,A02,470378,Troemel; Emily Ruth,126,0,128,2
1708258369645,BICD 100,B01,470409,Reinagel; Pam,59,0,64,5
1708258369645,BICD 100,B02,470413,Reinagel; Pam,62,0,64,2
1708258369645,BICD 100,B03,470464,Reinagel; Pam,64,0,64,0
1708258369645,BICD 100,B04,470468,Reinagel; Pam,63,0,64,1
1708258369645,BICD 100,C01,470469,Beyhan; Sinem,51,0,64,13
1708258369645,BICD 100,C02,470605,Beyhan; Sinem,58,0,64,6
1708258369645,BICD 100,C03,470606,Beyhan; Sinem,60,0,64,4
1708258369645,BICD 100,C04,470607,Beyhan; Sinem,63,0,64,1
1708258369645,BICD 100,D01,477465,Nguyen; Vu Quang,158,0,160,2
1708258370173,BICD 100R,A01,425674,Smith; Laurie,29,0,34,5
1708258370173,BICD 100R,A02,425675,Smith; Laurie,30,0,34,4
1708258370173,BICD 100R,A03,425676,Smith; Laurie,30,0,34,4
1708258370700,BICD 104,A01,425696,Greenspan; Ralph J.,60,0,64,4
1708258371230,BICD 110,A01,470608,Muroyama; Andrew David,264,0,275,11
1708258371230,BICD 110,B01,425721,Ernst; Andreas,244,0,275,31
1708258371759,BICD 112,A01,458177,Cooper; Kimberly Lynn & Traver; David,10,0,32,22
1708258371759,BICD 112,A02,458180,Cooper; Kimberly Lynn & Traver; David,28,0,32,4
1708258372286,BICD 123,A01,425725,Zhao; Yunde,23,0,32,9
1708258372816,BICD 140,A01,425728,Lu; Li-Fan,227,0,240,13
1708258373346,BICD 158,A01,425730,Bier; Ethan,136,0,145,9
1708258373874,BICD 194,A00,425731,Desai; Arshad & Oegema; Karen,17,0,27,10
1708258373874,BICD 194,B00,481735,Wilhelm; James E.,29,0,32,3
1708258374399,BIEB 121,A00,425732,Butler; Shannon Rhey,21,0,32,11
1708258374399,BIEB 121,B00,425733,Butler; Shannon Rhey,24,0,32,8
1708258374930,BIEB 130,A01,425735,Kurle; Carolyn M.,243,0,295,52
1708258375456,BIEB 146,A01,425737,Petrie; Katherine Lynn,365,0,395,30
1708258375983,BIEB 148,A01,470637,Rose; Noah Hartmann,59,0,63,4
1708258375983,BIEB 148,A02,470638,Rose; Noah Hartmann,61,0,63,2
1708258376514,BIEB 154,A01,458184,Stockwell; Sarah R,29,0,30,1
1708258376514,BIEB 154,A02,458186,Stockwell; Sarah R,29,0,30,1
1708258377040,BIEB 176,A01,425741,De Silva; Shermin,56,0,64,8
1708258377570,BIEB 182,A01,458194,Roy; Kaustuv,25,0,32,7
1708258377570,BIEB 182,A02,458215,Roy; Kaustuv,31,0,32,1
1708258378100,BILD 1,A01,424267,Patrick; Gentry,249,0,250,1
1708258378100,BILD 1,B01,424272,Burg; Michael,231,0,250,19
1708258378100,BILD 1,C01,424293,Pickett; Brooke Elizabeth,245,0,250,5
1708258378100,BILD 1,D01,458292,Gonzalez Gamboa; Ivonne,48,0,50,2
1708258378100,BILD 1,D02,458295,Gonzalez Gamboa; Ivonne,50,0,50,0
1708258378100,BILD 1,D03,458296,Gonzalez Gamboa; Ivonne,50,0,50,0
1708258378100,BILD 1,D04,458297,Gonzalez Gamboa; Ivonne,49,0,50,1
1708258378100,BILD 1,D05,458303,Gonzalez Gamboa; Ivonne,50,0,50,0
1708258378630,BILD 2,A01,458304,Reyes Gonzalez; Catalina,53,0,56,3
1708258378630,BILD 2,A02,458307,Reyes Gonzalez; Catalina,55,0,56,1
1708258378630,BILD 2,A03,458313,Reyes Gonzalez; Catalina,55,0,56,1
1708258378630,BILD 2,A04,458320,Reyes Gonzalez; Catalina,56,0,56,0
1708258378630,BILD 2,B01,458324,Reyes Gonzalez; Catalina,47,0,56,9
1708258378630,BILD 2,B02,458327,Reyes Gonzalez; Catalina,54,0,56,2
1708258378630,BILD 2,B03,458339,Reyes Gonzalez; Catalina,56,0,56,0
1708258378630,BILD 2,B04,458340,Reyes Gonzalez; Catalina,56,0,56,0
1708258378630,BILD 2,C01,458387,Park; Ji Young,44,0,49,5
1708258378630,BILD 2,C02,458544,Park; Ji Young,46,0,49,3
1708258378630,BILD 2,C03,458557,Park; Ji Young,47,0,49,2
1708258378630,BILD 2,C04,458563,Park; Ji Young,46,0,49,3
1708258379164,BILD 3,A01,424312,Hammond; LaTisha Marie,331,0,350,19
1708258379164,BILD 3,B01,470107,Stockwell; Sarah R,66,0,70,4
1708258379164,BILD 3,B02,470110,Stockwell; Sarah R,70,0,70,0
1708258379164,BILD 3,B03,470116,Stockwell; Sarah R,70,0,70,0
1708258379164,BILD 3,B04,470123,Stockwell; Sarah R,67,0,70,3
1708258379164,BILD 3,B05,470150,Stockwell; Sarah R,70,0,70,0
1708258379164,BILD 3,C01,470159,Cooper; Kimberly Lynn,67,0,70,3
1708258379164,BILD 3,C02,470160,Cooper; Kimberly Lynn,69,0,70,1
1708258379164,BILD 3,C03,470164,Cooper; Kimberly Lynn,70,0,70,0
1708258379164,BILD 3,C04,470165,Cooper; Kimberly Lynn,69,0,70,1
1708258379164,BILD 3,C05,470374,Cooper; Kimberly Lynn,68,0,70,2
1708258379693,BILD 4,A01,424318,Staff,22,0,24,2
1708258379693,BILD 4,A02,424324,Staff,24,0,24,0
1708258379693,BILD 4,A03,424325,Staff,24,0,24,0
1708258379693,BILD 4,A04,424326,Staff,22,0,24,2
1708258379693,BILD 4,A05,424327,Staff,24,0,24,0
1708258379693,BILD 4,A06,424330,Staff,24,0,24,0
1708258379693,BILD 4,A07,424331,Staff,24,0,24,0
1708258379693,BILD 4,A08,424342,Staff,24,0,24,0
1708258379693,BILD 4,B01,424462,Pickett; Brooke Elizabeth,23,0,24,1
1708258379693,BILD 4,B02,424466,Pickett; Brooke Elizabeth,24,0,24,0
1708258379693,BILD 4,B03,424469,Pickett; Brooke Elizabeth,23,0,24,1
1708258379693,BILD 4,B04,424470,Pickett; Brooke Elizabeth,22,0,24,2
1708258379693,BILD 4,B05,424700,Pickett; Brooke Elizabeth,23,0,24,1
1708258379693,BILD 4,B06,424723,Pickett; Brooke Elizabeth,24,0,24,0
1708258379693,BILD 4,B07,424730,Pickett; Brooke Elizabeth,24,0,24,0
1708258379693,BILD 4,B08,424929,Pickett; Brooke Elizabeth,22,0,24,2
1708258379693,BILD 4,C01,424947,Gonzalez Gamboa; Ivonne,22,0,24,2
1708258379693,BILD 4,C02,424951,Gonzalez Gamboa; Ivonne,23,0,24,1
1708258379693,BILD 4,C03,424991,Gonzalez Gamboa; Ivonne,23,0,24,1
1708258379693,BILD 4,C04,424993,Gonzalez Gamboa; Ivonne,24,0,24,0
1708258379693,BILD 4,C05,424994,Gonzalez Gamboa; Ivonne,24,0,24,0
1708258379693,BILD 4,C06,425209,Gonzalez Gamboa; Ivonne,24,0,24,0
1708258379693,BILD 4,C07,425233,Gonzalez Gamboa; Ivonne,24,0,24,0
1708258379693,BILD 4,C08,425247,Gonzalez Gamboa; Ivonne,24,0,24,0
1708258380217,BILD 60,A01,425326,Hammond; LaTisha Marie,62,0,64,2
1708258380747,BILD 83,A00,425347,Pogliano; Joseph,25,0,30,5
1708258381275,BILD 87,A00,425368,Saier; Milton H.,20,0,20,0
1708258381802,BIMM 100,A01,425744,Cooper; Andrew Michael,303,0,320,17
1708258381802,BIMM 100,B01,425746,Cooper; Andrew Michael,315,0,320,5
1708258382337,BIMM 101,A01,425748,McDonnell; Lisa Marie,8,0,24,16
1708258382337,BIMM 101,A02,425749,McDonnell; Lisa Marie,23,0,24,1
1708258382337,BIMM 101,B01,425751,Day; Christopher D,22,0,24,2
1708258382337,BIMM 101,B02,425752,Day; Christopher D,24,0,24,0
1708258382337,BIMM 101,B03,425753,Day; Christopher D,22,0,24,2
1708258382337,BIMM 101,B04,425754,Day; Christopher D,24,0,24,0
1708258382337,BIMM 101,C01,425756,Rusert; Jessica Marie,16,0,24,8
1708258382337,BIMM 101,C02,425757,Rusert; Jessica Marie,23,0,24,1
1708258382337,BIMM 101,C03,425758,Rusert; Jessica Marie,23,0,24,1
1708258382337,BIMM 101,C04,425759,Rusert; Jessica Marie,23,0,24,1
1708258382863,BIMM 110,A01,425764,Niwa; Maho,55,0,56,1
1708258382863,BIMM 110,A02,425765,Niwa; Maho,56,0,56,0
1708258382863,BIMM 110,A03,425766,Niwa; Maho,56,0,56,0
1708258382863,BIMM 110,A04,425767,Niwa; Maho,55,0,56,1
1708258383392,BIMM 116R,A01,425771,Golden; Susan S. & Gorman; Michael R.,55,0,72,17
1708258383392,BIMM 116R,A02,425772,Golden; Susan S. & Gorman; Michael R.,53,0,72,19
1708258383392,BIMM 116R,A03,425773,Golden; Susan S. & Gorman; Michael R.,66,0,72,6
1708258383392,BIMM 116R,A04,425774,Golden; Susan S. & Gorman; Michael R.,70,0,72,2
1708258383918,BIMM 118,A01,425779,David; Michael,83,0,96,13
1708258384446,BIMM 120,A01,425792,Pirino; Giorgia,203,0,216,13
1708258384446,BIMM 120,B01,470639,Saier; Milton H.,201,0,216,15
1708258384981,BIMM 121,A01,425830,Gustafson-Brown; Cindy,18,0,24,6
1708258384981,BIMM 121,A02,425831,Gustafson-Brown; Cindy,21,0,24,3
1708258384981,BIMM 121,A03,425832,Gustafson-Brown; Cindy,24,0,24,0
1708258384981,BIMM 121,A04,425833,Gustafson-Brown; Cindy,23,0,24,1
1708258384981,BIMM 121,B01,425835,Pirino; Giorgia,17,0,24,7
1708258384981,BIMM 121,B02,425836,Pirino; Giorgia,24,0,24,0
1708258384981,BIMM 121,C01,425838,Park; Ji Young,6,0,24,18
1708258384981,BIMM 121,C02,425839,Park; Ji Young,20,0,24,4
1708258385511,BIMM 134,A01,425841,Burg; Michael,393,0,416,23
1708258386038,BIMM 143,A01,425843,Grant; Barry J,17,0,40,23
1708258386038,BIMM 143,B01,425845,Bozinovic; Goran,33,0,40,7
1708258386566,BIMM 182,A01,455012,Bafna; Vineet,28,0,50,22
1708258387093,BIMM 194,A00,425847,Rivera; Fabian Chavez,24,0,27,3
1708258387093,BIMM 194,B00,425868,Russell; Alistair B,16,0,27,11
1708258387093,BIMM 194,D00,425870,Wildonger; Jill Cathleen,14,0,27,13
1708258387619,BIOM 202,A00,390710,Corbett; Kevin Daniel,93,0,100,7
1708258388151,BIOM 219,A00,390713,Ross; Camille,0,0,0,7
1708258388677,BIOM 231,A00,455099,Furnari; Frank,0,0,0,0
1708258388677,BIOM 231,B00,455100,Lopez Ramirez; Miguel Alej,0,0,0,0
1708258389203,BIOM 242,A00,390714,Hamilton; Bruce Alan,20,0,20,0
1708258389731,BIOM 246,A00,492784,Gordts; Philip & Varki; Ajit P & Lewis; Amanda Lark & Godula; Kamil & Gagneux; Pascal & Esko; Jeffrey D. & Bode; Lars,0,0,0,0
1708258390262,BIOM 252,A00,390715,Ayyagari; Radha,27,0,28,1
1708258390789,BIOM 254,A00,390718,Corbett; Kevin Daniel,14,0,20,6
1708258391314,BIOM 272,A00,390722,Hangauer; Matthew John,16,0,20,4
1708258391843,BIOM 274,A00,390725,Sun; Bryan Kee-Hong,7,0,15,8
1708258392370,BIOM 283,A00,390728,Komives; Elizabeth A,2,0,2,0
1708258392895,BIOM 285,A00,390730,Gaulton; Kyle J,10,0,20,10
1708258393421,BIOM 295,A00,455083,Brown; Joan Heller,0,0,0,0
1708258393950,BIPN 100,A01,425872,Augustine; Vineet,240,0,245,5
1708258393950,BIPN 100,B01,425874,George; Monique Leana,240,0,245,5
1708258393950,BIPN 100,C01,458640,Maita; Isabella Vincenza,44,0,49,5
1708258393950,BIPN 100,C02,458646,Maita; Isabella Vincenza,48,0,49,1
1708258393950,BIPN 100,C03,458714,Maita; Isabella Vincenza,48,0,49,1
1708258393950,BIPN 100,C04,458716,Maita; Isabella Vincenza,48,0,49,1
1708258393950,BIPN 100,C05,458717,Maita; Isabella Vincenza,46,0,49,3
1708258394483,BIPN 105,A01,425877,Armour; Jon Christopher,12,0,21,9
1708258394483,BIPN 105,A02,425878,Armour; Jon Christopher,21,0,21,0
1708258394483,BIPN 105,A03,425879,Armour; Jon Christopher,10,0,21,11
1708258394483,BIPN 105,A04,425880,Armour; Jon Christopher,20,0,21,1
1708258395009,BIPN 120,A01,425882,Cooke; James Edward,370,0,395,25
1708258395534,BIPN 140,A01,425884,Hibbs; Ryan E.,183,0,192,9
1708258396061,BIPN 144,A01,425886,Zou; Yimin,153,0,158,5
1708258396588,BIPN 145,A01,425888,Maita; Isabella Vincenza,41,0,42,1
1708258396588,BIPN 145,B01,425918,Marino; Marc J,37,0,42,5
1708258396588,BIPN 145,B02,425954,Marino; Marc J,40,0,42,2
1708258397115,BIPN 147,A01,426086,Sejnowski; Terrence J,53,0,64,11
1708258397700,BIPN 152,A01,426112,Halpain; Shelley,97,0,128,31
1708258398225,BIPN 162,A01,426120,Juavinett; Ashley Lauren,17,0,30,13
1708258398753,BIPN 164,A01,455010,Benna; Marcus K & Aljadeff; Johnatan,120,0,120,0
1708258399284,BIPN 194,A00,426122,Glasgow; Stacey Marie,20,0,27,7
1708258399810,BISP 170,A00,426158,French; Kathleen Ann,26,0,30,4
1708258400338,BISP 182,A00,426168,Pogliano; Joseph,9999,0,9999,0
1708258400867,BISP 194,A00,426240,Chisholm; Andrew D.,11,0,27,16
1708258400867,BISP 194,B00,426241,Farley; Emma Kristen,25,0,27,2
1708258401393,BNFO 281,A00,427175,Gaasterland; Theresa,85,0,100,15
1708258401926,BNFO 283,A00,427211,Carter; Hannah Kathryn & Chavez; Alejandro,39,0,50,11
1708258401926,BNFO 283,B00,480483,Amariuta-Bartell; Tiffany & Dorrestein; Pieter,21,0,30,9
1708258402459,BNFO 294,B01,427269,Ross; Camille,47,0,50,3
1708258402996,CAT 3,A01,396994,Glaser; Amelia,15,0,15,0
1708258402996,CAT 3,A02,396995,Glaser; Amelia,15,0,15,0
1708258402996,CAT 3,A03,396996,Glaser; Amelia,7,0,15,8
1708258402996,CAT 3,A04,396997,Glaser; Amelia,12,0,15,3
1708258402996,CAT 3,A05,397004,Glaser; Amelia,15,0,15,0
1708258402996,CAT 3,A06,397039,Glaser; Amelia,11,0,15,4
1708258402996,CAT 3,A07,397040,Glaser; Amelia,13,0,15,2
1708258402996,CAT 3,A08,397084,Glaser; Amelia,15,0,15,0
1708258402996,CAT 3,A09,397269,Glaser; Amelia,13,0,15,2
1708258402996,CAT 3,A10,397270,Glaser; Amelia,0,0,15,15
1708258402996,CAT 3,A11,397271,Glaser; Amelia,9,0,15,6
1708258402996,CAT 3,A12,397272,Glaser; Amelia,12,0,15,3
1708258402996,CAT 3,A13,397273,Glaser; Amelia,15,0,15,0
1708258402996,CAT 3,A14,397274,Glaser; Amelia,14,0,15,1
1708258402996,CAT 3,B01,397276,Porter; Lisa,15,0,15,0
1708258402996,CAT 3,B02,397277,Porter; Lisa,15,0,15,0
1708258402996,CAT 3,B03,397278,Porter; Lisa,14,0,15,1
1708258402996,CAT 3,B04,397279,Porter; Lisa,15,0,15,0
1708258402996,CAT 3,B06,397281,Porter; Lisa,15,0,15,0
1708258402996,CAT 3,B07,397291,Porter; Lisa,15,0,15,0
1708258402996,CAT 3,B09,397293,Porter; Lisa,15,0,15,0
1708258402996,CAT 3,B10,397294,Porter; Lisa,15,0,15,0
1708258402996,CAT 3,B11,397295,Porter; Lisa,12,0,15,3
1708258402996,CAT 3,B12,397296,Porter; Lisa,14,0,15,1
1708258402996,CAT 3,B13,397297,Porter; Lisa,11,0,15,4
1708258402996,CAT 3,B14,397298,Porter; Lisa,15,0,15,0
1708258402996,CAT 3,B15,397299,Porter; Lisa,15,0,15,0
1708258402996,CAT 3,B16,397300,Porter; Lisa,15,0,15,0
1708258402996,CAT 3,C01,397302,Marchisotto; Jennifer Anne,13,0,15,2
1708258402996,CAT 3,C02,397308,Marchisotto; Jennifer Anne,9,0,15,6
1708258402996,CAT 3,C03,397309,Marchisotto; Jennifer Anne,9,0,15,6
1708258402996,CAT 3,C04,397315,Marchisotto; Jennifer Anne,11,0,15,4
1708258402996,CAT 3,C05,397316,Marchisotto; Jennifer Anne,14,0,15,1
1708258402996,CAT 3,C06,397322,Marchisotto; Jennifer Anne,15,0,15,0
1708258402996,CAT 3,C07,397323,Marchisotto; Jennifer Anne,15,0,15,0
1708258402996,CAT 3,C08,397329,Marchisotto; Jennifer Anne,15,0,15,0
1708258402996,CAT 3,C09,397333,Marchisotto; Jennifer Anne,15,0,15,0
1708258402996,CAT 3,C10,397336,Marchisotto; Jennifer Anne,15,0,15,0
1708258402996,CAT 3,C11,397354,Marchisotto; Jennifer Anne,13,0,15,2
1708258402996,CAT 3,C12,397357,Marchisotto; Jennifer Anne,15,0,15,0
1708258402996,CAT 3,C13,397364,Marchisotto; Jennifer Anne,14,0,15,1
1708258402996,CAT 3,C14,397367,Marchisotto; Jennifer Anne,14,0,15,1
1708258402996,CAT 3,C15,397369,Marchisotto; Jennifer Anne,15,0,15,0
1708258402996,CAT 3,C16,397373,Marchisotto; Jennifer Anne,15,0,15,0
1708258402996,CAT 3,C17,397374,Marchisotto; Jennifer Anne,15,0,15,0
1708258402996,CAT 3,C18,397380,Marchisotto; Jennifer Anne,14,0,15,1
1708258402996,CAT 3,D02,397405,Rahimi; Babak,13,0,15,2
1708258402996,CAT 3,D03,397408,Rahimi; Babak,14,0,15,1
1708258402996,CAT 3,D04,397415,Rahimi; Babak,15,0,15,0
1708258402996,CAT 3,D05,397416,Rahimi; Babak,15,0,15,0
1708258402996,CAT 3,D06,397422,Rahimi; Babak,15,0,15,0
1708258402996,CAT 3,D07,397426,Rahimi; Babak,14,0,15,1
1708258402996,CAT 3,D09,397447,Rahimi; Babak,11,0,15,4
1708258402996,CAT 3,D10,397450,Rahimi; Babak,13,0,15,2
1708258402996,CAT 3,D11,397625,Rahimi; Babak,13,0,15,2
1708258402996,CAT 3,D12,397630,Rahimi; Babak,15,0,15,0
1708258402996,CAT 3,D13,397631,Rahimi; Babak,14,0,15,1
1708258402996,CAT 3,D14,397635,Rahimi; Babak,14,0,15,1
1708258403525,CAT 3CE,A01,397642,Bronstein; Phoebe Malan,25,0,25,0
1708258404051,CAT 87,A00,397645,Bronstein; Phoebe Malan,19,0,20,1
1708258404582,CAT 90,A00,480731,Bronstein; Phoebe Malan,20,0,20,0
1708258405110,CAT 124,A01,397662,Knight; Amy,5,0,5,0
1708258405110,CAT 124,A02,397722,Knight; Amy,5,0,5,0
1708258405110,CAT 124,A03,397726,Knight; Amy,5,0,5,0
1708258405110,CAT 124,A04,397829,Knight; Amy,4,0,5,1
1708258405652,CAT 125,001,397832,Popko; Elizabeth Ashley,20,0,20,0
1708258405652,CAT 125,002,397833,Delaville; Romain,20,0,20,0
1708258405652,CAT 125,003,397834,Marchisotto; Jennifer Anne,18,0,20,2
1708258405652,CAT 125,004,397835,Bigham; David Joseph,20,0,20,0
1708258405652,CAT 125,005,397836,Bigham; David Joseph,19,0,20,1
1708258405652,CAT 125,006,397837,Bigham; David Joseph,16,0,20,4
1708258405652,CAT 125,007,397838,Vanderschuit; Maya Alysia,20,0,20,0
1708258405652,CAT 125,008,397839,Vanderschuit; Maya Alysia,20,0,20,0
1708258405652,CAT 125,009,397840,Vanderschuit; Maya Alysia,20,0,20,0
1708258405652,CAT 125,010,397841,Morales; Celeste Georgianna,15,0,16,1
1708258405652,CAT 125,011,397842,Morales; Celeste Georgianna,16,0,16,0
1708258405652,CAT 125,012,397881,Morales; Celeste Georgianna,19,0,20,1
1708258405652,CAT 125,013,397954,Rose; Becca Rae,18,0,20,2
1708258405652,CAT 125,014,397956,Rose; Becca Rae,20,0,20,0
1708258405652,CAT 125,015,397998,Rose; Becca Rae,19,0,20,1
1708258405652,CAT 125,016,397999,Tosun; Adriana,20,0,20,0
1708258405652,CAT 125,017,398001,Tosun; Adriana,20,0,20,0
1708258405652,CAT 125,018,398009,Irwin; Matthew Joseph,19,0,20,1
1708258405652,CAT 125,019,398010,Irwin; Matthew Joseph,18,0,20,2
1708258405652,CAT 125,020,398014,Irwin; Matthew Joseph,20,0,20,0
1708258406183,CAT 125R,A00,398015,Smith; Lauryn Alissa,19,0,20,1
1708258406183,CAT 125R,B00,398016,Smith; Lauryn Alissa,17,0,20,3
1708258406183,CAT 125R,C00,398017,Smith; Lauryn Alissa,19,0,20,1
1708258406183,CAT 125R,D00,398019,Tosun; Adriana,19,0,20,1
1708258406183,CAT 125R,E00,398020,Hyland; Tina Mae,12,0,20,8
1708258406183,CAT 125R,F00,398027,Hyland; Tina Mae,18,0,20,2
1708258406183,CAT 125R,G00,398028,Hyland; Tina Mae,18,0,20,2
1708258406721,CCE 1,A01,396087,Kenley Grounds; Nicole,40,0,40,0
1708258406721,CCE 1,B01,396142,Quijada; David,39,0,40,1
1708258406721,CCE 1,C01,396159,Bigley; Michele Heather,39,0,40,1
1708258406721,CCE 1,D01,396164,Bigley; Michele Heather,40,0,40,0
1708258406721,CCE 1,E01,396166,Lee; Kassandra,40,0,40,0
1708258406721,CCE 1,F01,396168,Lee; Kassandra,40,0,40,0
1708258406721,CCE 1,G01,396170,Staff,40,0,40,0
1708258406721,CCE 1,H01,396172,Staff,40,0,40,0
1708258407249,CENG 101B,A00,392993,Chen; Shaochen,44,0,45,1
1708258407775,CENG 101C,A00,392997,Li; Yanran,148,0,150,2
1708258408312,CENG 113,A00,393000,Chen; Zheng,69,0,70,1
1708258408312,CENG 113,B00,393001,Li; Wan-Lu,69,0,70,1
1708258408840,CENG 124B,A00,393036,Powell; Alyssa & Russ; Benjamin Edward,113,0,120,7
1708258409368,CENG 157,A00,393220,Opatkiewicz; Justin Paul,50,0,57,7
1708258409895,CENG 160,A00,393231,Powell; Alyssa,70,0,80,10
1708258410426,CENG 170,A01,393238,Drews; Aaron,27,0,30,3
1708258410956,CENG 175,A00,393239,Steinmetz; Nicole F,34,0,35,1
1708258411482,CENG 176B,A01,393285,Opatkiewicz; Justin Paul,46,0,52,6
1708258411482,CENG 176B,B01,393629,Zhang; Liangfang,40,0,49,9
1708258412012,CENG 205,A00,393681,Jahed Motlagh; Zeinab,53,0,60,7
1708258412538,CENG 257,A00,393682,Opatkiewicz; Justin Paul,10,0,13,3
1708258413064,CGS 87,A00,489609,Wesling; Megan E.,20,0,20,0
1708258413593,CGS 100B,A00,396181,Whitley; Leila Marie,28,0,30,2
1708258414120,CGS 109,A00,396194,Whitley; Leila Marie,19,0,20,1
1708258414646,CGS 112,A00,396220,Martin Sandino; Amanda Maria Yoland,22,0,25,3
1708258415178,CGS 114,A00,396223,Steelman; Katherine Wallis,14,0,16,2
1708258415705,CGS 116,A00,396295,Staff,19,0,20,1
1708258416230,CGS 117,A00,396306,Martin Sandino; Amanda Maria Yoland,14,0,15,1
1708258416761,CGS 118,A00,396314,Hankins; Joseph D.,28,0,29,1
1708258417287,CGS 128,A00,396366,Whitley; Leila Marie,14,0,15,1
1708258417815,CGS 137,A00,396865,Martin Sandino; Amanda Maria Yoland,16,0,19,3
1708258418342,CGS 150,A00,396901,Taylor-Garcia; Daphne,18,0,18,0
1708258418868,CGS 196B,A00,396904,Lo; Stanley M.,7,0,7,0
1708258418868,CGS 196B,B00,396973,Brenner; Suzanne A,7,0,7,0
1708258418868,CGS 196B,C00,396985,Jones; Makeba,7,0,7,0
1708258419395,CGS 198,001,396987,Anderson; Patrick W.,0,0,0,0
1708258419395,CGS 198,002,396988,Anderson; Patrick W.,0,0,0,0
1708258419395,CGS 198,003,396989,Anderson; Patrick W.,0,0,0,0
1708258419395,CGS 198,004,396990,Anderson; Patrick W.,0,0,0,0
1708258419925,CGS 200,A00,396991,Perez; Roy,0,0,0,3
1708258420454,CHEM 6A,A01,459563,Deshmukh; Lalit,40,0,40,0
1708258420454,CHEM 6A,A02,459564,Deshmukh; Lalit,35,0,40,5
1708258420454,CHEM 6A,A03,459565,Deshmukh; Lalit,31,0,40,9
1708258420454,CHEM 6A,A04,459566,Deshmukh; Lalit,30,0,38,8
1708258420454,CHEM 6A,A05,459567,Deshmukh; Lalit,40,0,40,0
1708258420454,CHEM 6A,A06,459568,Deshmukh; Lalit,37,0,40,3
1708258420454,CHEM 6A,A07,459569,Deshmukh; Lalit,37,0,40,3
1708258420454,CHEM 6A,A08,459570,Deshmukh; Lalit,0,0,0,0
1708258421052,CHEM 6B,A01,467314,Ortony; Julia Helen,39,0,40,1
1708258421052,CHEM 6B,A02,467322,Ortony; Julia Helen,32,0,40,8
1708258421052,CHEM 6B,A03,467323,Ortony; Julia Helen,40,0,40,0
1708258421052,CHEM 6B,A04,467325,Ortony; Julia Helen,31,0,40,9
1708258421052,CHEM 6B,A05,467326,Ortony; Julia Helen,39,0,40,1
1708258421052,CHEM 6B,A06,467346,Ortony; Julia Helen,40,0,40,0
1708258421052,CHEM 6B,B01,467360,Hopkins; Patrycja Anna,35,0,40,5
1708258421052,CHEM 6B,B02,467363,Hopkins; Patrycja Anna,38,0,40,2
1708258421052,CHEM 6B,B03,467364,Hopkins; Patrycja Anna,35,0,40,5
1708258421052,CHEM 6B,B04,467380,Hopkins; Patrycja Anna,40,0,40,0
1708258421052,CHEM 6B,B05,467381,Hopkins; Patrycja Anna,40,0,40,0
1708258421052,CHEM 6B,B06,467382,Hopkins; Patrycja Anna,39,0,40,1
1708258421594,CHEM 6C,A01,468994,Ternansky; Robert J.,39,0,40,1
1708258421594,CHEM 6C,A02,469054,Ternansky; Robert J.,38,0,40,2
1708258421594,CHEM 6C,A03,469065,Ternansky; Robert J.,39,0,40,1
1708258421594,CHEM 6C,A04,469069,Ternansky; Robert J.,40,0,40,0
1708258421594,CHEM 6C,A05,469080,Ternansky; Robert J.,40,0,40,0
1708258421594,CHEM 6C,B01,469318,Ternansky; Robert J.,39,0,40,1
1708258421594,CHEM 6C,B02,469319,Ternansky; Robert J.,40,0,40,0
1708258421594,CHEM 6C,B03,469320,Ternansky; Robert J.,39,0,40,1
1708258421594,CHEM 6C,B04,469321,Ternansky; Robert J.,40,0,40,0
1708258421594,CHEM 6C,B05,469322,Ternansky; Robert J.,40,0,40,0
1708258421594,CHEM 6C,C01,469323,Schurmeier; Kimberly,38,0,40,2
1708258421594,CHEM 6C,C02,469324,Schurmeier; Kimberly,36,0,40,4
1708258421594,CHEM 6C,C03,469325,Schurmeier; Kimberly,38,0,40,2
1708258421594,CHEM 6C,C04,469326,Schurmeier; Kimberly,36,0,40,4
1708258421594,CHEM 6C,C05,469327,Schurmeier; Kimberly,40,0,40,0
1708258421594,CHEM 6C,D01,460183,Schurmeier; Kimberly,39,0,40,1
1708258421594,CHEM 6C,D02,460184,Schurmeier; Kimberly,32,0,40,8
1708258421594,CHEM 6C,D03,460185,Schurmeier; Kimberly,26,0,40,14
1708258421594,CHEM 6C,D04,460186,Schurmeier; Kimberly,38,0,40,2
1708258421594,CHEM 6C,D05,460187,Schurmeier; Kimberly,40,0,40,0
1708258421594,CHEM 6C,E01,460188,Stallings; Dontarie M,24,0,40,16
1708258421594,CHEM 6C,E02,460190,Stallings; Dontarie M,25,0,40,15
1708258421594,CHEM 6C,E03,460191,Stallings; Dontarie M,3,0,20,17
1708258421594,CHEM 6C,E04,460192,Stallings; Dontarie M,36,0,40,4
1708258421594,CHEM 6C,E05,460193,Stallings; Dontarie M,37,0,40,3
